transaction_id,device_id,device_type,tran_code,mcc,client_id,card_type,pin_inc_count,card_status,sum,oper_type,balance,ip_city,day_of_week,hour_of_day,month,anomaly
1157921,982,4,30,7103,969838140,1,0,0,510.22,8,670814.78,22,2,9,3,True
1595205,1033,4,30,2031,969838140,1,0,0,509.84,8,670304.94,11,3,9,3,True
1656884,96,0,25,4629,969838140,1,0,0,509.86,8,669795.08,1,0,23,3,True
1673909,982,4,30,4629,969838140,1,0,0,510.05,8,669285.03,22,3,2,3,True
1689203,1413,0,10,5840,969838140,1,0,0,510.01,6,669795.04,24,3,9,7,True
2100925,787,0,-1,5426,969838140,1,1,0,509.93,4,669795.04,14,4,17,7,True
2176658,982,4,25,7341,969838140,1,0,0,509.86,8,669285.18,22,0,6,8,True
2319994,378,0,10,2031,969838140,1,0,0,510.01,0,669795.19,25,2,16,8,True
2327304,862,4,451,2085,969838140,1,0,0,509.91,7,669285.28,24,6,18,9,True
2330108,96,0,30,7152,969838140,1,0,0,510.13,8,668775.15,1,6,7,9,True
2754128,982,4,25,7103,969838140,1,0,0,510.14,8,668265.01,22,0,22,9,True
3289172,445,0,10,8007,969838140,1,0,0,510.12,6,668775.13,13,6,14,10,True
3303599,787,0,30,2085,969838140,1,0,0,509.96,8,668265.17,14,4,23,10,True
3736036,535,0,-1,2346,969838140,1,1,0,509.9,4,668265.17,18,2,14,10,True
3783029,96,0,25,5840,969838140,1,0,0,510.03,8,667755.14,1,4,13,10,True
3815661,982,4,451,1115,969838140,1,0,0,510.06,7,667245.08,22,3,8,11,True
3845333,787,0,30,2031,969838140,1,0,0,510.06,8,666735.02,14,0,12,11,True
3982118,862,4,25,3859,969838140,1,0,0,509.92,8,666225.1,24,6,21,11,True
4065585,129,0,20,3859,969838140,1,0,0,510.17,5,665714.93,18,3,1,12,True
4074138,727,0,10,5840,969838140,1,0,0,510.14,0,666225.07,11,2,15,12,True
4463407,862,4,25,5426,969838140,1,0,0,510.17,8,665714.9,24,4,8,1,True
4544552,96,0,451,5426,969838140,1,0,0,510.22,7,665204.68,1,5,23,2,True
4738064,96,0,30,2369,969838140,1,0,0,509.92,8,664694.76,1,5,3,4,True
5114526,96,0,-1,7152,969838140,1,1,0,509.86,1,664694.76,1,4,22,4,True
5197742,982,4,451,2085,969838140,1,0,0,509.74,7,664185.02,22,2,17,4,True
5280509,1033,4,25,7946,969838140,1,0,0,509.84,8,663675.18,11,5,12,5,True
5451638,1033,4,-1,3755,969838140,1,1,0,509.77,1,663675.18,11,0,12,5,True
5530000,982,4,451,8488,969838140,1,0,0,509.73,7,663165.45,22,3,7,5,True
5960306,1033,4,451,3755,969838140,1,0,0,510.01,7,662655.44,11,0,22,6,True
6195724,535,0,-1,2031,969838140,1,1,0,509.91,1,662655.44,18,5,21,6,True
6714746,982,4,25,2346,969838140,1,0,0,510.01,8,662145.43,22,5,8,8,True
6941643,249,0,10,7341,969838140,1,0,0,509.91,6,662655.34,6,0,15,8,True
7264859,96,0,25,2085,969838140,1,0,0,510.12,8,662145.22,1,5,19,8,True
7301086,862,4,30,8007,969838140,1,0,0,510.17,8,661635.05,24,2,18,8,False
7993327,1314,2,20,7352,969838140,1,0,0,510.01,5,661125.04,5,3,5,8,True
8018457,228,0,20,2031,969838140,1,0,0,510.0,5,660615.04,26,4,15,8,True
8170238,647,4,-1,7152,969838140,1,1,0,509.95,4,660615.04,24,3,16,9,True
8243398,535,0,451,5840,969838140,1,0,0,510.04,7,660105.0,18,3,15,11,True
8274839,859,2,20,7152,969838140,1,0,0,509.97,5,659595.03,24,6,22,12,True
8618856,862,4,451,8007,969838140,1,0,0,509.97,7,659085.06,24,1,15,1,True
8683217,1033,4,-1,3859,969838140,1,1,0,509.99,4,659085.06,11,5,6,2,True
8944583,982,4,-1,5426,969838140,1,2,0,510.1,4,659085.06,22,1,10,2,True
9123898,1239,1,10,7352,969838140,1,0,0,510.08,0,659595.14,18,1,3,3,True
9157750,1033,4,30,3853,969838140,1,0,0,510.16,8,659084.98,11,3,5,3,True
9200735,712,0,20,6489,969838140,1,0,0,509.79,5,658575.19,18,6,23,4,True
9294016,1064,0,10,1115,969838140,1,0,0,510.01,6,659085.2,11,2,1,4,True
9318028,254,0,20,2085,969838140,1,0,0,509.96,5,658575.24,6,4,5,5,True
9391790,535,0,451,8007,969838140,1,0,0,509.94,7,658065.3,18,0,0,5,True
9484192,862,4,-1,6489,969838140,1,1,0,509.95,4,658065.3,24,0,8,5,True
9738548,982,4,30,5840,969838140,1,0,0,510.14,8,657555.16,22,1,8,7,True
9903445,1246,0,10,7152,969838140,1,0,0,509.82,0,658064.98,23,4,5,8,True
1067609,549,1,10,4029,198328433,1,0,0,331.94,6,917971.94,17,1,12,1,True
1732194,1044,0,10,3995,198328433,1,0,0,331.96,6,918303.9,11,1,0,1,True
2003431,1405,4,25,4121,198328433,1,0,0,332.12,8,917971.78,24,0,7,2,True
2034151,677,0,10,5991,198328433,1,0,0,331.96,6,918303.74,24,0,23,2,True
2495783,1092,1,25,5991,198328433,1,0,0,332.12,8,917971.62,18,0,22,3,True
2551330,51,0,10,4029,198328433,1,0,0,332.04,6,918303.66,20,2,23,4,True
2655036,1092,1,25,2777,198328433,1,0,0,332.11,8,917971.55,18,2,3,6,True
2721550,1065,0,10,8039,198328433,1,0,0,331.99,6,918303.54,11,6,4,6,True
2759970,117,1,-1,4121,198328433,1,1,0,332.36,4,918303.54,18,2,13,6,True
2853733,37,3,25,6990,198328433,1,0,0,332.2,8,917971.34,11,0,13,6,True
2961518,550,0,10,4164,198328433,1,0,0,331.9,6,918303.24,17,3,17,9,True
3055966,1092,1,451,5777,198328433,1,0,0,332.01,7,917971.23,18,2,18,9,True
3199286,319,0,20,7328,198328433,1,0,0,332.14,5,917639.09,11,1,0,11,True
3205159,117,1,451,6990,198328433,1,0,0,331.74,7,917307.35,18,4,7,11,True
3341230,384,3,-1,4058,198328433,1,1,0,332.18,1,917307.35,25,6,4,11,True
3405677,1434,0,30,8843,198328433,1,0,0,331.84,8,916975.51,24,5,1,12,True
3826290,117,1,30,4865,198328433,1,0,0,331.99,8,916643.52,18,6,2,12,True
3896687,942,0,10,9793,198328433,1,0,0,331.85,6,916975.37,24,1,17,12,True
4158304,135,2,451,4058,198328433,1,0,0,331.92,7,916643.45,18,6,1,12,True
4310810,1092,1,451,5991,198328433,1,0,0,331.88,7,916311.57,18,2,4,3,True
4379429,117,1,30,4029,198328433,1,0,0,332.05,8,915979.52,18,4,11,3,True
4533504,1037,0,20,4700,198328433,1,0,0,332.19,3,915647.33,11,1,9,3,True
4695142,37,3,-1,4700,198328433,1,1,0,332.29,4,915647.33,11,1,1,3,True
4754733,71,1,451,3995,198328433,1,0,0,332.1,7,915315.23,20,6,5,3,True
4878608,1434,0,30,7328,198328433,1,0,0,331.95,8,914983.28,24,4,18,6,True
4940665,327,0,20,8843,198328433,1,0,0,332.34,3,914650.94,11,3,5,6,True
4968792,649,0,20,3995,198328433,1,0,0,332.09,5,914318.85,24,0,1,7,True
5153571,1010,0,20,7855,198328433,1,0,0,332.02,5,913986.83,26,2,14,7,True
5208645,135,2,30,4366,198328433,1,0,0,332.19,8,913654.64,18,1,8,8,False
5469634,384,3,30,7328,198328433,1,0,0,331.97,8,913322.67,25,6,0,8,True
6650444,1092,1,451,7407,198328433,1,0,0,332.12,7,912990.55,18,5,4,9,True
6933543,1405,4,30,4029,198328433,1,0,0,332.11,8,912658.44,24,2,8,9,True
7189512,542,0,20,4366,198328433,1,0,0,332.1,5,912326.34,17,3,7,9,True
7392999,71,1,30,2052,198328433,1,0,0,331.98,8,911994.36,20,4,18,10,False
7940148,1434,0,30,3995,198328433,1,0,0,331.79,8,911662.57,24,2,11,10,True
8014351,677,0,10,4700,198328433,1,0,0,331.84,6,911994.41,24,3,6,10,True
8290884,656,2,20,7935,198328433,1,0,0,332.3,3,911662.11,18,6,17,11,True
8361043,1092,1,-1,4908,198328433,1,1,0,331.8,1,911662.11,18,5,1,12,True
8613957,1434,0,25,7328,198328433,1,0,0,331.92,8,911330.19,24,4,15,2,True
8735252,1094,0,20,7935,198328433,1,0,0,332.29,5,910997.9,0,5,0,3,True
8768353,1405,4,-1,4908,198328433,1,1,0,331.89,4,910997.9,24,2,12,5,True
9002729,329,1,10,8843,198328433,1,0,0,332.37,6,911330.27,11,6,17,6,True
9058638,135,2,451,4965,198328433,1,0,0,331.83,7,910998.44,18,2,8,7,True
9213887,117,1,451,2777,198328433,1,0,0,332.01,7,910666.43,18,6,17,7,True
9347352,135,2,-1,4164,198328433,1,1,0,331.84,1,910666.43,18,0,12,8,True
9352690,1137,1,10,8843,198328433,1,0,0,332.09,6,910998.52,24,1,3,8,True
9433753,117,1,451,4549,198328433,1,0,0,331.73,7,910666.79,18,1,7,9,True
9487972,1363,0,10,4865,198328433,1,0,0,331.87,0,910998.66,16,2,9,9,True
9652048,71,1,30,3995,198328433,1,0,0,332.09,8,910666.57,20,0,15,9,True
9673046,1090,0,20,7935,198328433,1,0,0,331.93,5,910334.64,18,6,2,10,True
9742598,1434,0,-1,7407,198328433,1,1,0,332.06,4,910334.64,24,0,21,10,True
9999483,1405,4,30,7855,198328433,1,0,0,332.13,8,910002.51,24,3,20,11,True
1432347,1341,4,25,2634,527729205,0,0,0,721.98,8,631160.02,24,6,21,2,True
1581923,1285,1,-1,4952,527729205,0,1,0,721.66,4,631160.02,24,2,0,2,True
1712967,1341,4,25,3499,527729205,0,0,0,722.09,8,630437.93,24,3,4,3,True
1773419,887,2,20,5362,527729205,0,0,0,721.96,5,629715.97,27,2,16,3,True
1868787,1075,0,20,5411,527729205,0,0,0,721.74,5,628994.23,18,4,11,4,True
1911006,572,0,20,9799,527729205,0,0,0,721.94,3,628272.29,11,5,18,5,True
2015243,1388,1,451,4952,527729205,0,0,0,722.02,7,627550.27,24,5,10,6,True
2021103,1341,4,-1,5362,527729205,0,1,0,721.83,4,627550.27,24,6,4,7,True
2654527,1388,1,25,3499,527729205,0,0,0,722.04,8,626828.23,24,4,15,7,False
2742708,631,3,25,4141,527729205,0,0,0,722.06,8,626106.17,11,5,23,8,True
2794269,212,4,451,8581,527729205,0,0,0,722.1,7,625384.07,9,2,22,10,False
3061611,208,0,451,9799,527729205,0,0,0,722.24,7,624661.83,9,3,16,10,True
3078470,726,0,20,2634,527729205,0,0,0,722.24,3,623939.59,11,4,21,11,True
3099486,305,1,10,5411,527729205,0,0,0,721.91,6,624661.5,4,2,23,12,True
3148953,1421,0,10,6075,527729205,0,0,0,722.06,6,625383.56,24,2,7,12,True
3260926,1315,0,10,7333,527729205,0,0,0,721.77,0,626105.33,5,0,16,1,True
3710054,1388,1,25,3560,527729205,0,0,0,722.15,8,625383.18,24,2,16,1,True
3760785,1341,4,451,2734,527729205,0,0,0,721.95,7,624661.23,24,1,4,1,True
3869604,212,4,451,8779,527729205,0,0,0,721.88,7,623939.35,9,0,10,1,True
3873801,1467,0,20,7333,527729205,0,0,0,722.19,5,623217.16,11,4,19,2,True
3893719,956,1,-1,6075,527729205,0,1,0,722.14,4,623217.16,13,2,9,3,True
3911992,1388,1,-1,1290,527729205,0,2,0,722.2,4,623217.16,24,3,16,3,True
4423127,631,3,30,8779,527729205,0,0,0,722.18,8,622494.98,11,1,21,3,True
4460021,1341,4,451,7782,527729205,0,0,0,722.25,7,621772.73,24,4,22,4,True
4499517,585,2,30,2734,527729205,0,0,0,721.96,8,621050.77,11,3,2,4,True
4866761,631,3,25,9799,527729205,0,0,0,722.04,8,620328.73,11,6,7,4,True
4922866,208,0,30,2734,527729205,0,0,0,722.06,8,619606.67,9,0,6,6,True
5022082,212,4,25,7782,527729205,0,0,0,722.2,8,618884.47,9,4,2,7,True
5093840,212,4,-1,5411,527729205,0,1,0,721.99,4,618884.47,9,2,23,7,True
5290073,1270,1,10,1290,527729205,0,0,0,721.95,6,619606.42,23,3,12,8,True
5424685,1388,1,451,8779,527729205,0,0,0,722.18,7,618884.24,24,2,22,8,True
5463607,1341,4,451,2634,527729205,0,0,0,721.94,7,618162.3,24,4,2,8,True
5655529,939,0,10,4135,527729205,0,0,0,721.9,6,618884.2,24,1,10,8,True
5783930,956,1,25,5987,527729205,0,0,0,721.79,8,618162.41,13,3,11,8,True
5827883,585,2,30,9011,527729205,0,0,0,722.11,8,617440.3,11,3,17,10,True
6418551,1285,1,451,1804,527729205,0,0,0,722.13,7,616718.17,24,3,19,10,True
6814263,454,1,10,6075,527729205,0,0,0,721.9,0,617440.07,13,3,0,11,True
7120725,664,2,20,2734,527729205,0,0,0,722.19,3,616717.88,18,0,23,11,True
7244955,542,0,10,8779,527729205,0,0,0,722.07,6,617439.95,17,3,10,11,True
7273573,1285,1,-1,5987,527729205,0,1,0,721.55,1,617439.95,24,5,2,11,True
7521054,1341,4,451,2734,527729205,0,0,0,722.03,7,616717.92,24,5,3,12,True
7634826,585,2,451,9799,527729205,0,0,0,722.18,7,615995.74,11,1,10,1,True
8341578,267,0,20,1804,527729205,0,0,0,722.17,5,615273.57,6,0,1,2,True
8379882,1388,1,30,5361,527729205,0,0,0,722.06,8,614551.51,24,5,10,3,True
8440454,1388,1,451,9799,527729205,0,0,0,721.82,7,613829.69,24,0,21,4,True
8563889,585,2,-1,6869,527729205,0,1,0,722.15,4,613829.69,11,2,1,4,True
8624321,1388,1,30,6869,527729205,0,0,0,722.01,8,613107.68,24,0,7,5,True
8668307,215,0,20,7333,527729205,0,0,0,722.09,5,612385.59,9,2,11,5,True
8670753,360,0,10,5976,527729205,0,0,0,722.3,0,613107.89,24,6,3,6,True
8845288,1388,1,451,8779,527729205,0,0,0,721.88,7,612386.01,24,5,14,6,True
9032399,1388,1,25,6075,527729205,0,0,0,722.08,8,611663.93,24,1,2,7,True
9073126,1285,1,30,2734,527729205,0,0,0,722.29,8,610941.64,24,1,19,7,True
9170912,585,2,30,4135,527729205,0,0,0,722.15,8,610219.49,11,4,21,8,True
9566621,635,2,20,5987,527729205,0,0,0,721.88,5,609497.61,24,2,6,9,True
9619741,1388,1,451,2634,527729205,0,0,0,722.11,7,608775.5,24,1,14,10,True
9843428,1388,1,451,9011,527729205,0,0,0,722.0,7,608053.5,24,6,5,11,True
1046125,942,0,20,7296,298813281,0,0,0,624.88,5,265488.12,24,4,19,1,True
1479203,1060,1,451,5975,298813281,0,0,0,624.8,7,264863.32,11,0,9,2,True
1673125,780,0,30,2285,298813281,0,0,0,625.01,8,264238.31,14,6,11,3,True
1795772,318,0,10,2759,298813281,0,0,0,625.09,6,264863.4,11,2,9,3,True
1833481,909,2,451,8853,298813281,0,0,0,624.97,7,264238.43,18,2,3,4,True
1934820,1304,0,10,3600,298813281,0,0,0,624.89,6,264863.32,5,6,3,5,True
2064682,1415,4,30,7296,298813281,0,0,0,625.22,8,264238.1,24,5,16,5,True
2216312,341,0,20,3600,298813281,0,0,0,624.96,5,263613.14,24,1,12,6,True
2228761,1314,2,20,5868,298813281,0,0,0,625.0,5,262988.14,5,6,18,7,True
2424850,1060,1,30,5078,298813281,0,0,0,624.82,8,262363.32,11,3,16,7,True
2545600,1415,4,30,4776,298813281,0,0,0,625.02,8,261738.3,24,2,11,11,True
2637926,1415,4,451,5781,298813281,0,0,0,625.2,7,261113.1,24,4,16,12,True
2742558,44,4,30,7010,298813281,0,0,0,624.79,8,260488.31,24,4,15,1,True
2876602,780,0,-1,4832,298813281,0,1,0,624.84,1,260488.31,14,5,12,1,True
2941539,44,4,-1,4776,298813281,0,2,0,625.2,4,260488.31,24,6,15,1,True
2959083,44,4,30,3600,298813281,0,0,0,625.17,8,259863.14,24,5,10,2,True
2966198,587,2,20,9785,298813281,0,0,0,624.94,3,259238.2,24,3,19,2,True
3369762,1060,1,451,6816,298813281,0,0,0,625.01,7,258613.19,11,1,21,2,True
3672154,1060,1,25,9994,298813281,0,0,0,625.07,8,257988.12,11,3,11,3,True
4170481,303,0,20,8275,298813281,0,0,0,625.02,5,257363.1,4,1,23,5,True
4318752,117,1,10,3831,298813281,0,0,0,625.09,0,257988.19,18,2,10,5,True
4527832,909,2,451,4477,298813281,0,0,0,624.99,7,257363.2,18,2,4,5,True
4641801,909,2,-1,4776,298813281,0,1,0,625.08,1,257363.2,18,2,20,8,True
4768348,1060,1,-1,8350,298813281,0,2,0,625.04,1,257363.2,11,5,12,9,True
4852606,238,0,20,5781,298813281,0,0,0,625.0,5,256738.2,26,2,22,10,True
4985798,1415,4,451,1123,298813281,0,0,0,624.89,7,256113.31,24,6,4,10,True
5214856,780,0,-1,3600,298813281,0,1,0,625.1,1,256113.31,14,6,10,10,True
5373758,780,0,25,4776,298813281,0,0,0,624.89,8,255488.42,14,3,7,11,True
5382943,28,1,10,3831,298813281,0,0,0,625.02,6,256113.44,11,4,20,12,True
5463280,44,4,-1,6816,298813281,0,1,0,624.66,1,256113.44,24,3,22,12,True
5489972,780,0,451,8131,298813281,0,0,0,624.92,7,255488.52,14,2,9,1,True
5908473,547,4,451,7296,298813281,0,0,0,625.03,7,254863.49,17,6,11,1,True
5952158,909,2,30,7179,298813281,0,0,0,625.01,8,254238.48,18,5,23,1,True
6077929,1060,1,-1,2285,298813281,0,1,0,625.2,1,254238.48,11,1,10,2,True
6311461,1415,4,451,5868,298813281,0,0,0,624.99,7,253613.49,24,2,13,2,True
6488114,145,0,10,8350,298813281,0,0,0,624.78,0,254238.27,18,4,19,2,True
6627488,679,0,20,7179,298813281,0,0,0,624.79,3,253613.48,24,3,13,3,True
7102634,68,0,10,5078,298813281,0,0,0,625.14,6,254238.62,20,3,22,3,True
7579487,525,0,10,5781,298813281,0,0,0,625.16,6,254863.78,18,0,16,3,True
7826779,909,2,451,1123,298813281,0,0,0,625.12,7,254238.66,18,6,0,3,True
7890389,909,2,-1,3600,298813281,0,1,0,625.11,4,254238.66,18,6,4,4,True
8210593,479,2,20,6275,298813281,0,0,0,624.95,5,253613.71,5,3,8,5,True
8387478,1060,1,25,5417,298813281,0,0,0,624.88,8,252988.83,11,6,1,5,True
8469584,1060,1,25,1855,298813281,0,0,0,624.89,8,252363.94,11,2,8,6,True
8577458,909,2,451,2285,298813281,0,0,0,624.96,7,251738.98,18,5,0,6,True
8592025,204,0,20,4832,298813281,0,0,0,624.96,5,251114.02,9,6,15,7,True
8677352,312,0,10,5781,298813281,0,0,0,625.03,0,251739.05,4,1,11,9,True
9021395,865,0,10,7010,298813281,0,0,0,625.03,6,252364.08,24,2,5,10,True
9363812,1160,0,20,3600,298813281,0,0,0,625.26,5,251738.82,15,2,10,10,True
9832895,1060,1,-1,1855,298813281,0,1,0,625.15,1,251738.82,11,6,14,10,True
9882861,1415,4,25,8131,298813281,0,0,0,625.1,8,251113.72,24,1,22,10,True
9921631,44,4,30,9494,298813281,0,0,0,624.9,8,250488.82,24,3,17,11,True
1761966,522,0,10,1537,443427305,1,0,0,171.75,6,645138.75,18,4,9,1,True
1840353,1436,0,20,5009,443427305,1,0,0,172.42,3,644966.33,24,0,11,1,True
2005963,457,0,10,1072,443427305,1,0,0,172.67,6,645139.0,13,5,13,2,True
2017691,279,2,30,7014,443427305,1,0,0,172.04,8,644966.96,24,0,9,3,True
2175570,987,4,451,6416,443427305,1,0,0,171.96,7,644795.0,22,3,5,3,True
2420731,279,2,451,5412,443427305,1,0,0,172.02,7,644622.98,24,0,8,4,True
2914259,885,3,-1,5689,443427305,1,1,0,171.72,4,644622.98,24,3,3,4,True
3176360,1387,1,10,1829,443427305,1,0,0,172.02,6,644795.0,24,2,17,4,True
3222984,648,3,451,1393,443427305,1,0,0,171.89,7,644623.11,24,6,12,5,True
3308173,882,0,20,5343,443427305,1,0,0,171.88,5,644451.23,27,5,0,5,True
3387338,279,2,25,4916,443427305,1,0,0,172.12,8,644279.11,24,1,4,6,True
3661705,314,0,20,5412,443427305,1,0,0,172.12,5,644106.99,4,6,11,7,True
3798285,648,3,-1,4916,443427305,1,1,0,171.76,4,644106.99,24,0,4,8,True
3858742,279,2,25,8253,443427305,1,0,0,172.0,8,643934.99,24,0,17,8,True
3955980,648,3,451,7156,443427305,1,0,0,171.92,7,643763.07,24,6,1,9,True
3977550,648,3,30,5009,443427305,1,0,0,172.04,8,643591.03,24,0,19,9,True
4165597,711,2,20,7156,443427305,1,0,0,171.99,3,643419.04,18,3,18,9,True
4231549,279,2,-1,7156,443427305,1,1,0,172.08,4,643419.04,24,6,8,9,True
4342649,279,2,-1,1072,443427305,1,2,0,172.17,1,643419.04,24,3,7,9,True
4361830,807,0,10,2521,443427305,1,0,0,171.87,6,643590.91,11,6,15,12,True
4416969,885,3,25,7014,443427305,1,0,0,171.87,8,643419.04,24,1,22,1,True
5134856,266,2,30,2729,443427305,1,0,0,171.8,8,643247.24,6,1,9,1,True
5171867,279,2,25,1537,443427305,1,0,0,171.61,8,643075.63,24,1,19,1,True
5185627,220,0,10,1072,443427305,1,0,0,172.17,6,643247.8,26,6,7,2,True
5245759,266,2,-1,2729,443427305,1,1,0,172.07,4,643247.8,6,0,8,2,True
5657173,266,2,30,4764,443427305,1,0,0,172.08,8,643075.72,6,3,20,3,True
5689148,279,2,451,1072,443427305,1,0,0,172.1,7,642903.62,24,2,23,3,True
5839274,279,2,451,3120,443427305,1,0,0,171.99,7,642731.63,24,6,7,3,True
6000245,312,0,20,2030,443427305,1,0,0,171.94,5,642559.69,4,4,1,3,True
6034680,648,3,451,1393,443427305,1,0,0,171.88,7,642387.81,24,6,9,4,True
6258202,266,2,25,2521,443427305,1,0,0,171.86,8,642215.95,6,2,2,4,True
6352413,1307,0,20,1393,443427305,1,0,0,172.08,5,642043.87,5,5,10,4,True
6356136,149,2,20,4764,443427305,1,0,0,171.96,3,641871.91,18,3,9,5,True
6374756,300,0,20,5689,443427305,1,0,0,172.09,3,641699.82,4,3,20,6,True
6681126,266,2,451,1829,443427305,1,0,0,171.88,7,641527.94,6,3,21,8,True
6839573,885,3,25,6283,443427305,1,0,0,172.1,8,641355.84,24,5,14,8,True
7337206,987,4,451,7855,443427305,1,0,0,171.98,7,641183.86,22,6,4,9,True
7603517,1272,0,10,1829,443427305,1,0,0,171.92,6,641355.78,24,3,4,9,True
8053000,266,2,451,6416,443427305,1,0,0,172.19,7,641183.59,6,1,3,10,True
8133226,279,2,-1,4916,443427305,1,1,0,171.84,4,641183.59,24,6,16,10,False
8298221,885,3,-1,7014,443427305,1,2,0,172.03,1,641183.59,24,1,17,11,True
8439214,558,0,20,8253,443427305,1,0,0,171.91,5,641011.68,17,0,7,11,True
8439530,1256,2,20,1072,443427305,1,0,0,172.09,3,640839.59,23,5,21,12,True
8603296,885,3,451,4764,443427305,1,0,0,171.9,7,640667.69,24,4,9,12,True
8735518,897,0,20,3120,443427305,1,0,0,171.97,3,640495.72,24,0,8,1,True
9188947,987,4,25,6063,443427305,1,0,0,171.97,8,640323.75,22,5,20,2,True
9221982,987,4,25,3882,443427305,1,0,0,172.07,8,640151.68,22,4,20,4,True
9233265,987,4,30,1562,443427305,1,0,0,172.32,8,639979.36,22,1,0,4,True
9396347,987,4,-1,1829,443427305,1,1,0,171.69,1,639979.36,22,3,15,5,True
9470392,108,2,20,5412,443427305,1,0,0,172.0,5,639807.36,3,1,3,5,True
9646917,916,0,10,7570,443427305,1,0,0,172.05,6,639979.41,18,5,20,7,True
9682523,279,2,30,2729,443427305,1,0,0,171.81,8,639807.6,24,2,23,8,True
9816114,883,0,20,2030,443427305,1,0,0,172.0,5,639635.6,24,5,16,9,True
9864566,885,3,451,2030,443427305,1,0,0,172.25,7,639463.35,24,6,10,11,True
1234264,807,0,20,8084,514552667,1,0,0,701.19,3,718764.81,11,3,0,1,True
1315010,1250,1,-1,3534,514552667,1,1,0,700.8,4,718764.81,23,2,10,1,True
1351037,1382,0,10,7968,514552667,1,0,0,701.01,6,719465.82,16,2,20,2,True
1415342,1064,0,20,8141,514552667,1,0,0,701.02,3,718764.8,11,2,2,2,True
1417821,335,4,30,8084,514552667,1,0,0,701.05,8,718063.75,11,5,20,3,True
1689883,1250,1,25,7968,514552667,1,0,0,700.9,8,717362.85,23,5,12,3,True
1803618,29,0,20,7968,514552667,1,0,0,700.7,5,716662.15,11,6,14,5,True
2164079,335,4,451,3306,514552667,1,0,0,700.7,7,715961.45,11,4,4,5,True
2209391,584,0,451,6845,514552667,1,0,0,701.19,7,715260.26,11,0,17,5,True
2329230,260,0,10,2219,514552667,1,0,0,701.1,6,715961.36,6,6,4,8,True
2481844,335,4,451,5678,514552667,1,0,0,701.2,7,715260.16,11,6,23,8,True
2587598,335,4,451,1807,514552667,1,0,0,700.98,7,714559.18,11,5,22,9,True
2779681,1436,0,-1,4509,514552667,1,1,0,701.12,1,714559.18,24,3,19,9,True
3140845,887,2,20,6845,514552667,1,0,0,700.91,5,713858.27,27,6,15,10,True
3182074,300,0,20,3306,514552667,1,0,0,701.05,3,713157.22,4,4,5,10,True
3609368,584,0,451,1961,514552667,1,0,0,701.13,7,712456.09,11,0,15,10,True
3761174,238,0,10,6845,514552667,1,0,0,701.02,6,713157.11,26,2,15,11,True
3807590,335,4,25,3941,514552667,1,0,0,700.86,8,712456.25,11,5,21,11,True
3811551,1186,2,20,3306,514552667,1,0,0,700.84,5,711755.41,24,4,10,12,True
3999884,1009,0,451,8084,514552667,1,0,0,701.03,7,711054.38,26,4,8,12,True
4235424,1009,0,30,8084,514552667,1,0,0,701.24,8,710353.14,26,6,1,1,True
5031148,376,0,20,5678,514552667,1,0,0,700.76,5,709652.38,25,5,3,2,True
5045109,335,4,-1,2219,514552667,1,1,0,701.25,4,709652.38,11,5,12,2,True
5051794,335,4,25,4509,514552667,1,0,0,701.08,8,708951.3,11,0,0,4,True
5254699,584,0,451,3534,514552667,1,0,0,700.83,7,708250.47,11,3,22,5,True
5435836,584,0,-1,6845,514552667,1,1,0,701.11,4,708250.47,11,2,3,6,True
5527910,1009,0,-1,1807,514552667,1,2,0,700.98,4,708250.47,26,5,16,7,True
5578460,1250,1,25,1961,514552667,1,0,0,700.71,8,707549.76,23,6,13,7,True
5730952,584,0,25,8084,514552667,1,0,0,701.3,8,706848.46,11,0,17,8,True
5837548,329,1,10,6845,514552667,1,0,0,700.98,6,707549.44,11,4,20,9,True
6192429,1009,0,-1,7603,514552667,1,1,0,700.96,1,707549.44,26,2,17,9,True
7072082,1436,0,30,4509,514552667,1,0,0,700.89,8,706848.55,24,5,16,10,True
7417597,335,4,451,4509,514552667,1,0,0,700.98,7,706147.57,11,1,7,10,True
7621181,1250,1,451,6845,514552667,1,0,0,700.93,7,705446.64,23,5,7,11,True
7779591,1029,0,20,6845,514552667,1,0,0,701.05,5,704745.59,11,1,12,11,False
8009622,335,4,451,3306,514552667,1,0,0,701.02,7,704044.57,11,2,8,11,True
8231069,1009,0,-1,3534,514552667,1,1,0,701.09,4,704044.57,26,2,15,12,True
8349632,1052,0,20,7603,514552667,1,0,0,700.96,5,703343.61,11,4,12,2,True
8397996,335,4,25,3941,514552667,1,0,0,700.91,8,702642.7,11,5,23,2,True
8481293,1250,1,25,5757,514552667,1,0,0,700.67,8,701942.03,23,3,6,3,True
8547697,1009,0,25,4509,514552667,1,0,0,700.97,8,701241.06,26,6,0,3,True
8565004,335,4,30,3941,514552667,1,0,0,700.68,8,700540.38,11,5,21,3,True
8842681,732,0,10,8084,514552667,1,0,0,701.19,6,701241.57,11,6,12,4,True
8904328,314,0,10,4509,514552667,1,0,0,701.02,0,701942.59,4,6,7,6,True
8987690,1009,0,30,4176,514552667,1,0,0,700.9,8,701241.69,26,3,11,6,True
9090562,335,4,25,8084,514552667,1,0,0,701.24,8,700540.45,11,4,1,7,True
9137994,729,0,20,7603,514552667,1,0,0,701.0,5,699839.45,11,1,13,7,True
9299571,335,4,25,7620,514552667,1,0,0,700.69,8,699138.76,11,2,1,8,True
9299587,1305,2,20,8141,514552667,1,0,0,700.96,5,698437.8,5,6,0,8,True
9841694,1408,1,10,7968,514552667,1,0,0,701.19,0,699138.99,24,5,18,9,True
1748280,1285,1,451,7611,854388310,0,0,0,993.26,7,640243.74,24,3,22,1,True
2387067,309,0,10,1062,854388310,0,0,0,993.16,6,641236.9,4,2,1,1,True
2417988,1480,4,451,6671,854388310,0,0,0,993.19,7,640243.71,24,6,17,2,True
2699244,530,0,20,9533,854388310,0,0,0,992.76,3,639250.95,18,1,0,3,True
2970068,362,0,10,9533,854388310,0,0,0,992.93,0,640243.88,24,6,16,3,True
2996894,1342,3,25,9130,854388310,0,0,0,993.01,8,639250.87,24,4,6,3,True
3765451,234,0,20,9833,854388310,0,0,0,993.14,5,638257.73,26,2,20,4,True
3827240,1285,1,30,6671,854388310,0,0,0,993.28,8,637264.45,24,1,18,5,True
3851263,247,4,-1,5907,854388310,0,1,0,992.99,4,637264.45,6,1,15,5,True
3999950,640,4,30,9533,854388310,0,0,0,993.08,8,636271.37,24,2,17,5,True
4210612,148,1,10,1179,854388310,0,0,0,993.04,0,637264.41,18,6,12,7,True
4348742,1342,3,25,3768,854388310,0,0,0,992.84,8,636271.57,24,2,6,7,True
4716192,1480,4,25,5434,854388310,0,0,0,993.12,8,635278.45,24,5,6,7,True
5008428,247,4,451,9748,854388310,0,0,0,993.13,7,634285.32,6,0,18,8,True
5747560,312,0,10,7611,854388310,0,0,0,992.97,0,635278.29,4,5,18,8,True
5965664,1169,0,10,1062,854388310,0,0,0,992.94,6,636271.23,24,6,17,8,True
6135293,511,1,10,7454,854388310,0,0,0,992.73,0,637263.96,12,4,7,9,True
6199277,1285,1,30,1179,854388310,0,0,0,992.92,8,636271.04,24,4,17,9,True
6261716,1480,4,30,3768,854388310,0,0,0,992.97,8,635278.07,24,4,9,9,True
6322738,1366,4,30,5434,854388310,0,0,0,993.06,8,634285.01,16,3,22,10,True
6579542,1037,0,-1,9833,854388310,0,1,0,993.37,4,634285.01,11,0,9,11,True
6715015,640,4,451,7611,854388310,0,0,0,993.08,7,633291.93,24,2,8,11,True
6758648,1285,1,-1,3768,854388310,0,1,0,992.96,1,633291.93,24,3,23,1,True
6811238,147,0,20,7611,854388310,0,0,0,993.05,3,632298.88,18,6,6,2,True
6838321,640,4,-1,9833,854388310,0,1,0,993.06,4,632298.88,24,1,6,2,True
6852852,97,0,20,3768,854388310,0,0,0,992.83,3,631306.05,3,2,16,3,True
6883320,286,1,10,9130,854388310,0,0,0,992.98,6,632299.03,24,0,16,4,True
6894916,1285,1,25,3768,854388310,0,0,0,993.32,8,631305.71,24,5,9,4,True
7026978,480,0,20,1439,854388310,0,0,0,992.95,5,630312.76,5,3,1,5,True
7284980,247,4,-1,1062,854388310,0,1,0,992.81,4,630312.76,6,3,0,6,True
7285366,247,4,30,2424,854388310,0,0,0,992.85,8,629319.91,6,2,15,6,True
7317099,1285,1,30,1179,854388310,0,0,0,993.31,8,628326.6,24,1,5,6,True
7599609,299,1,10,7611,854388310,0,0,0,992.82,6,629319.42,4,1,22,7,True
7793867,1037,0,30,4978,854388310,0,0,0,992.98,8,628326.44,11,0,23,7,True
7871600,537,0,10,8860,854388310,0,0,0,992.84,6,629319.28,18,5,2,8,True
7898311,640,4,30,2424,854388310,0,0,0,993.08,8,628326.2,24,5,8,9,True
8029037,1342,3,30,9833,854388310,0,0,0,992.95,8,627333.25,24,2,5,9,True
8153182,247,4,-1,6671,854388310,0,1,0,993.1,4,627333.25,6,5,5,9,True
8201709,1037,0,451,9130,854388310,0,0,0,992.94,7,626340.31,11,6,4,1,True
8261791,1480,4,-1,9130,854388310,0,1,0,993.08,1,626340.31,24,6,10,2,True
8524937,1036,1,10,9130,854388310,0,0,0,993.04,6,627333.35,11,3,4,3,True
8546227,260,0,20,2424,854388310,0,0,0,992.8,5,626340.55,6,1,20,3,True
8622578,665,2,20,1062,854388310,0,0,0,992.78,3,625347.77,18,4,8,4,True
8759676,1480,4,451,9748,854388310,0,0,0,993.05,7,624354.72,24,6,3,4,True
8806443,1243,2,20,9748,854388310,0,0,0,992.78,5,623361.94,18,2,8,6,True
8880928,1164,0,20,9130,854388310,0,0,0,993.16,3,622368.78,24,2,8,7,True
9134381,444,2,20,2424,854388310,0,0,0,993.23,5,621375.55,24,3,8,8,True
9158937,1285,1,-1,1179,854388310,0,1,0,992.96,1,621375.55,24,2,4,10,True
9469981,1480,4,-1,1062,854388310,0,2,0,992.86,4,621375.55,24,3,1,10,True
9572404,1342,3,-1,8860,854388310,0,3,1,993.05,4,0.0,24,2,22,10,True
1142327,1352,1,451,5227,988406718,0,0,0,950.06,7,166890.94,24,3,19,2,True
1160072,920,4,451,1365,988406718,0,0,0,950.11,7,165940.83,18,0,7,2,True
1160483,662,1,-1,4576,988406718,0,1,0,950.17,4,165940.83,18,5,9,3,False
2062156,877,2,25,9120,988406718,0,0,0,949.75,8,164991.08,24,1,1,3,True
2265973,920,4,-1,2072,988406718,0,1,0,949.67,1,164991.08,18,6,11,5,True
2278482,662,1,-1,2541,988406718,0,2,0,949.88,4,164991.08,18,5,4,5,True
2456648,662,1,25,8867,988406718,0,0,0,950.19,8,164040.89,18,4,1,6,True
2500736,920,4,30,3115,988406718,0,0,0,949.92,8,163090.97,18,2,12,8,True
2609739,662,1,451,7869,988406718,0,0,0,949.97,7,162141.0,18,5,2,8,True
2793711,920,4,-1,1365,988406718,0,1,0,950.0,4,162141.0,18,5,23,9,True
3153229,461,4,30,6157,988406718,0,0,0,949.92,8,161191.08,13,0,2,11,True
3164942,920,4,-1,2072,988406718,0,1,0,950.1,4,161191.08,18,1,15,11,True
3208622,734,0,20,3455,988406718,0,0,0,949.96,3,160241.12,11,3,9,12,True
3314278,920,4,-1,3524,988406718,0,1,0,950.17,1,160241.12,18,4,3,12,False
3328577,461,4,451,9120,988406718,0,0,0,949.89,7,159291.23,13,1,10,12,True
3459751,980,1,10,5227,988406718,0,0,0,949.91,6,160241.14,22,5,11,12,True
3783841,579,0,10,6872,988406718,0,0,0,949.95,6,161191.09,11,1,0,3,True
4322456,662,1,25,1445,988406718,0,0,0,950.11,8,160240.98,18,1,1,3,True
4345073,458,3,30,5403,988406718,0,0,0,949.75,8,159291.23,13,3,1,5,True
4499940,130,0,10,8867,988406718,0,0,0,949.82,6,160241.05,18,5,21,6,True
4533332,461,4,30,6174,988406718,0,0,0,949.9,8,159291.15,13,0,16,6,True
4574373,920,4,25,5403,988406718,0,0,0,949.78,8,158341.37,18,3,12,6,False
4945942,458,3,25,3386,988406718,0,0,0,949.99,8,157391.38,13,0,20,7,True
5025675,46,1,10,6157,988406718,0,0,0,949.85,6,158341.23,24,1,13,7,True
5142336,759,0,30,7869,988406718,0,0,0,949.94,8,157391.29,24,1,16,8,True
5219488,458,3,451,7882,988406718,0,0,0,949.94,7,156441.35,13,6,9,9,True
5247083,662,1,30,1239,988406718,0,0,0,949.93,8,155491.42,18,1,22,9,True
5341408,1352,1,451,3524,988406718,0,0,0,950.11,7,154541.31,24,6,18,10,False
5449758,920,4,451,6808,988406718,0,0,0,950.1,7,153591.21,18,0,12,10,True
5807787,920,4,-1,9120,988406718,0,1,0,950.02,4,153591.21,18,5,18,10,True
5832641,920,4,25,5771,988406718,0,0,0,950.08,8,152641.13,18,0,0,11,True
6061406,759,0,451,6157,988406718,0,0,0,950.06,7,151691.07,24,2,12,11,True
6256924,800,0,10,4589,988406718,0,0,0,950.22,0,152641.29,11,4,4,12,True
6403632,877,2,451,1365,988406718,0,0,0,949.72,7,151691.57,24,3,2,1,True
6700102,662,1,451,3386,988406718,0,0,0,950.0,7,150741.57,18,6,8,1,False
7079260,1352,1,451,3386,988406718,0,0,0,949.98,7,149791.59,24,2,21,2,True
7309798,920,4,451,4779,988406718,0,0,0,949.74,7,148841.85,18,3,19,2,True
7558128,458,3,451,3115,988406718,0,0,0,950.15,7,147891.7,13,0,3,3,True
7773162,1053,1,10,2541,988406718,0,0,0,950.05,6,148841.75,11,1,10,3,True
7779749,877,2,25,7869,988406718,0,0,0,949.84,8,147891.91,24,2,16,3,True
7889680,461,4,25,1445,988406718,0,0,0,949.98,8,146941.93,13,0,3,4,True
7910350,759,0,451,7882,988406718,0,0,0,949.74,7,145992.19,24,4,23,5,True
7994687,848,2,20,4589,988406718,0,0,0,950.12,5,145042.07,5,1,5,5,True
8101936,939,0,20,3115,988406718,0,0,0,950.03,5,144092.04,24,0,6,5,True
8414221,461,4,25,7042,988406718,0,0,0,949.89,8,143142.15,13,2,14,5,True
8465461,458,3,451,2072,988406718,0,0,0,950.03,7,142192.12,13,2,16,5,True
8784193,260,0,20,2721,988406718,0,0,0,949.81,5,141242.31,6,1,9,7,True
8814700,205,0,20,3545,988406718,0,0,0,949.91,3,140292.4,9,5,2,7,True
8843110,192,2,20,8182,988406718,0,0,0,949.79,5,139342.61,18,4,22,8,True
8851695,1399,0,20,1445,988406718,0,0,0,950.22,3,138392.39,24,1,22,9,True
9326675,759,0,30,6872,988406718,0,0,0,950.27,8,137442.12,24,4,21,9,True
9879608,759,0,30,1365,988406718,0,0,0,949.93,8,136492.19,24,1,14,10,True
9961926,877,2,25,3455,988406718,0,0,0,950.35,8,135541.84,24,3,17,10,True
1144626,1493,4,451,9888,943042597,1,0,0,759.11,7,555507.89,24,0,16,1,True
1195338,1493,4,451,4062,943042597,1,0,0,759.01,7,554748.88,24,0,12,1,True
1233538,1072,0,10,9758,943042597,1,0,0,758.66,6,555507.54,18,3,16,2,True
1250295,535,0,10,4409,943042597,1,0,0,759.08,6,556266.62,18,0,20,2,True
1428598,1012,0,10,9663,943042597,1,0,0,759.12,6,557025.74,26,1,23,3,True
1450413,164,4,451,7152,943042597,1,0,0,759.09,7,556266.65,24,1,12,4,True
1549593,1493,4,25,3923,943042597,1,0,0,758.93,8,555507.72,24,2,21,4,True
1675364,257,1,10,2546,943042597,1,0,0,758.87,6,556266.59,6,4,10,5,True
1709346,588,0,30,7152,943042597,1,0,0,758.87,8,555507.72,24,5,19,5,True
1766031,816,0,20,4656,943042597,1,0,0,758.83,5,554748.89,18,6,4,5,True
2385085,588,0,30,2151,943042597,1,0,0,758.95,8,553989.94,24,6,13,5,True
2534783,238,0,10,7371,943042597,1,0,0,759.0,0,554748.94,26,6,19,5,True
2698563,588,0,-1,9888,943042597,1,1,0,758.94,4,554748.94,24,0,3,5,True
2927657,1493,4,-1,9758,943042597,1,2,0,759.0,4,554748.94,24,1,17,8,True
3129356,882,0,10,9802,943042597,1,0,0,759.04,6,555507.98,27,2,20,9,True
3353729,167,2,25,4409,943042597,1,0,0,758.84,8,554749.14,24,6,11,1,False
3566274,1493,4,-1,4409,943042597,1,1,0,759.22,4,554749.14,24,0,9,3,True
3686923,865,0,20,4409,943042597,1,0,0,758.84,5,553990.3,24,6,15,3,True
4038096,167,2,30,9989,943042597,1,0,0,759.05,8,553231.25,24,1,5,3,True
4315323,967,1,10,3923,943042597,1,0,0,758.94,0,553990.19,13,2,13,3,True
4329895,687,0,10,9989,943042597,1,0,0,759.04,6,554749.23,24,6,10,4,True
4473235,1493,4,25,1499,943042597,1,0,0,759.05,8,553990.18,24,6,15,4,True
4526567,167,2,451,9989,943042597,1,0,0,759.16,7,553231.02,24,3,21,5,True
4757260,498,0,10,2294,943042597,1,0,0,759.24,0,553990.26,12,6,12,6,True
4964282,1493,4,451,2546,943042597,1,0,0,758.97,7,553231.29,24,5,2,6,True
4991530,1406,0,10,4608,943042597,1,0,0,759.11,6,553990.4,24,0,10,6,True
5120428,164,4,451,2151,943042597,1,0,0,758.85,7,553231.55,24,4,10,6,True
5285001,1009,0,25,9057,943042597,1,0,0,758.74,8,552472.81,26,5,11,7,True
5487814,1267,2,20,9888,943042597,1,0,0,759.15,5,551713.66,23,0,21,8,True
5557000,167,2,-1,4409,943042597,1,1,0,759.04,4,551713.66,24,1,13,8,False
5735819,1155,0,20,2151,943042597,1,0,0,758.8,5,550954.86,15,3,1,8,True
6303584,164,4,30,9855,943042597,1,0,0,759.05,8,550195.81,24,2,21,8,True
6324472,1009,0,451,3441,943042597,1,0,0,758.89,7,549436.92,26,6,4,8,True
6398207,588,0,451,7152,943042597,1,0,0,758.84,7,548678.08,24,0,2,8,True
6681103,588,0,-1,3441,943042597,1,1,0,758.88,1,548678.08,24,1,3,9,True
6819369,267,0,20,9888,943042597,1,0,0,758.97,5,547919.11,6,4,13,9,True
6921495,1493,4,30,4409,943042597,1,0,0,759.04,8,547160.07,24,0,22,10,True
6927075,167,2,-1,4656,943042597,1,1,0,759.33,4,547160.07,24,3,8,11,True
7260500,164,4,-1,4608,943042597,1,2,0,758.87,1,547160.07,24,3,19,11,True
7285919,164,4,451,4062,943042597,1,0,0,759.03,7,546401.04,24,6,21,11,True
7442192,164,4,451,2546,943042597,1,0,0,758.85,7,545642.19,24,5,3,12,True
7450902,1493,4,451,9888,943042597,1,0,0,759.1,7,544883.09,24,0,13,1,True
7573669,689,0,20,8441,943042597,1,0,0,758.91,5,544124.18,24,5,21,1,True
7612795,164,4,451,9855,943042597,1,0,0,759.08,7,543365.1,24,1,10,1,True
7768725,726,0,20,7371,943042597,1,0,0,759.11,5,542605.99,11,1,21,1,True
7918899,588,0,451,8441,943042597,1,0,0,759.0,7,541846.99,24,1,7,1,True
8014589,1493,4,-1,9855,943042597,1,1,0,759.14,4,541846.99,24,5,14,1,True
8079373,588,0,451,4608,943042597,1,0,0,758.97,7,541088.02,24,6,23,1,True
8106048,167,2,-1,9989,943042597,1,1,0,759.25,4,541088.02,24,0,3,4,True
8208218,446,1,10,4062,943042597,1,0,0,759.23,6,541847.25,13,1,9,4,True
8961933,1493,4,451,3441,943042597,1,0,0,759.03,7,541088.22,24,1,14,4,True
9208067,1493,4,30,9802,943042597,1,0,0,759.13,8,540329.09,24,4,1,6,True
9245271,588,0,-1,9057,943042597,1,1,0,759.11,1,540329.09,24,3,4,7,True
9365025,588,0,-1,9888,943042597,1,2,0,759.08,4,540329.09,24,1,9,7,True
9370287,192,2,20,4062,943042597,1,0,0,758.9,3,539570.19,18,5,15,10,True
9638229,812,0,20,3441,943042597,1,0,0,759.06,5,538811.13,18,2,4,10,True
9693272,1493,4,451,2294,943042597,1,0,0,759.02,7,538052.11,24,6,13,11,True
9880326,167,2,-1,7371,943042597,1,1,0,759.08,4,538052.11,24,4,0,11,True
9989561,1493,4,451,8441,943042597,1,0,0,758.85,7,537293.26,24,6,9,11,True
1016470,193,1,10,7079,719370723,1,0,0,756.04,0,378791.04,18,1,11,3,True
1219078,279,2,451,7079,719370723,1,0,0,755.97,7,378035.07,24,2,10,4,True
1352480,732,0,451,7079,719370723,1,0,0,756.07,7,377279.0,11,5,13,4,True
1497419,279,2,451,9593,719370723,1,0,0,755.94,7,376523.06,24,1,1,5,True
1575175,537,0,451,8205,719370723,1,0,0,756.04,7,375767.02,18,1,13,6,True
1707226,434,3,-1,7408,719370723,1,1,0,755.83,1,375767.02,24,5,20,7,True
1860670,537,0,25,4461,719370723,1,0,0,755.93,8,375011.09,18,6,7,7,True
2054300,537,0,451,9624,719370723,1,0,0,755.82,7,374255.27,18,1,4,8,True
2427377,537,0,25,5500,719370723,1,0,0,755.68,8,373499.59,18,4,23,8,True
2463627,799,2,20,9096,719370723,1,0,0,755.91,5,372743.68,11,3,20,9,True
2476234,537,0,451,5357,719370723,1,0,0,756.13,7,371987.55,18,0,17,11,True
2604727,920,4,25,7501,719370723,1,0,0,755.98,8,371231.57,18,2,9,2,True
2752654,1155,0,30,7501,719370723,1,0,0,755.74,8,370475.83,15,0,6,7,True
2918248,105,3,451,9112,719370723,1,0,0,756.34,7,369719.49,3,1,6,8,True
3178711,1086,0,20,5357,719370723,1,0,0,755.88,3,368963.61,18,2,5,11,True
3448127,920,4,-1,4940,719370723,1,1,0,756.13,4,368963.61,18,1,10,2,True
3651152,732,0,451,4940,719370723,1,0,0,755.97,7,368207.64,11,5,1,3,True
3688784,1212,0,20,8491,719370723,1,0,0,755.84,5,367451.8,24,0,7,4,True
3884793,920,4,30,7408,719370723,1,0,0,756.03,8,366695.77,18,0,11,4,True
4167524,537,0,-1,3354,719370723,1,1,0,756.12,4,366695.77,18,3,1,5,True
4196008,105,3,451,7501,719370723,1,0,0,756.22,7,365939.55,3,6,7,6,True
4204243,434,3,451,5565,719370723,1,0,0,756.01,7,365183.54,24,1,2,7,True
4220083,1119,0,10,5478,719370723,1,0,0,755.99,6,365939.53,24,2,5,8,True
4233470,1155,0,-1,5478,719370723,1,1,0,756.2,4,365939.53,15,3,23,8,True
4309895,279,2,-1,7408,719370723,1,2,0,756.11,4,365939.53,24,0,19,9,True
4412565,537,0,-1,9112,719370723,1,3,1,756.0,4,365939.53,18,1,23,11,True
1025792,1249,2,20,3404,578559870,1,0,0,465.08,5,323931.92,23,1,0,1,True
1057232,1364,0,10,4869,578559870,1,0,0,465.1,6,324397.02,16,4,20,1,True
1156590,560,2,30,4126,578559870,1,0,0,464.86,8,323932.16,17,4,0,2,True
1277935,128,0,20,5239,578559870,1,0,0,465.27,5,323466.89,18,2,23,3,True
1332726,695,2,-1,8413,578559870,1,1,0,465.13,4,323466.89,24,0,2,3,True
1758051,913,0,-1,1209,578559870,1,2,0,465.16,1,323466.89,18,2,19,3,True
1784567,913,0,451,4697,578559870,1,0,0,464.53,7,323002.36,18,3,22,4,True
1829296,952,0,451,5239,578559870,1,0,0,465.06,7,322537.3,13,1,14,4,True
1988984,952,0,451,7566,578559870,1,0,0,465.18,7,322072.12,13,4,12,5,True
2144103,952,0,451,8413,578559870,1,0,0,465.24,7,321606.88,13,5,3,5,True
2346326,560,2,451,4341,578559870,1,0,0,465.09,7,321141.79,17,1,7,6,True
2365110,355,1,10,1209,578559870,1,0,0,465.05,0,321606.84,24,0,18,7,True
2393278,385,1,-1,1864,578559870,1,1,0,464.87,1,321606.84,25,3,4,8,True
2434616,385,1,-1,5239,578559870,1,2,0,464.74,1,321606.84,25,0,9,8,True
2517899,1307,0,10,7178,578559870,1,0,0,465.24,6,322072.08,5,1,3,9,True
2548142,560,2,451,1209,578559870,1,0,0,464.99,7,321607.09,17,1,3,9,True
2750623,560,2,-1,5239,578559870,1,1,0,465.17,4,321607.09,17,6,7,10,True
3221560,952,0,451,5525,578559870,1,0,0,465.0,7,321142.09,13,4,8,10,True
3532221,913,0,-1,4341,578559870,1,1,0,464.96,4,321142.09,18,1,1,10,False
3921713,560,2,451,3075,578559870,1,0,0,464.72,7,320677.37,17,3,20,10,True
3971870,102,4,30,7566,578559870,1,0,0,464.87,8,320212.5,3,0,7,11,True
4003538,695,2,451,1995,578559870,1,0,0,465.08,7,319747.42,24,0,15,11,True
4026587,256,4,-1,5711,578559870,1,1,0,464.88,4,319747.42,6,4,1,12,True
4170721,952,0,30,2428,578559870,1,0,0,465.27,8,319282.15,13,4,15,12,True
4255294,385,1,30,5525,578559870,1,0,0,464.83,8,318817.32,25,1,3,1,True
4316977,102,4,451,1995,578559870,1,0,0,464.92,7,318352.4,3,3,7,1,False
4404388,102,4,25,8413,578559870,1,0,0,464.79,8,317887.61,3,3,1,2,True
4444254,952,0,451,1209,578559870,1,0,0,464.93,7,317422.68,13,1,9,2,True
4631041,952,0,30,2671,578559870,1,0,0,465.06,8,316957.62,13,3,12,3,True
4738444,350,0,20,7178,578559870,1,0,0,464.91,3,316492.71,24,3,8,3,True
4843150,1363,0,20,7178,578559870,1,0,0,464.78,5,316027.93,16,2,9,4,True
5265793,256,4,-1,8413,578559870,1,1,0,465.05,4,316027.93,6,0,5,5,True
5336934,560,2,30,4697,578559870,1,0,0,465.09,8,315562.84,17,3,23,5,True
5341712,102,4,-1,2671,578559870,1,1,0,465.07,4,315562.84,3,3,6,7,True
5423415,913,0,451,9281,578559870,1,0,0,465.02,7,315097.82,18,4,5,7,True
5566036,952,0,25,9281,578559870,1,0,0,465.13,8,314632.69,13,1,16,7,True
5572658,102,4,-1,4248,578559870,1,1,0,465.2,1,314632.69,3,3,17,8,True
5824655,385,1,30,7566,578559870,1,0,0,465.09,8,314167.6,25,5,18,8,True
5856669,913,0,30,9170,578559870,1,0,0,464.93,8,313702.67,18,2,11,9,True
6139762,1235,1,10,9281,578559870,1,0,0,464.94,0,314167.61,18,2,22,9,True
6396099,256,4,-1,9170,578559870,1,1,0,464.92,4,314167.61,6,1,19,10,False
6637178,385,1,451,4697,578559870,1,0,0,465.07,7,313702.54,25,5,16,10,True
6723083,1170,0,20,3258,578559870,1,0,0,464.85,3,313237.69,24,3,16,10,True
6905540,256,4,25,4697,578559870,1,0,0,465.2,8,312772.49,6,5,0,11,True
7061911,952,0,25,1150,578559870,1,0,0,465.16,8,312307.33,13,3,15,12,True
7073602,256,4,25,1995,578559870,1,0,0,465.14,8,311842.19,6,0,8,1,True
7112991,952,0,-1,6680,578559870,1,1,0,465.15,4,311842.19,13,6,8,1,True
7366088,695,2,30,4697,578559870,1,0,0,464.91,8,311377.28,24,1,5,1,True
7407190,256,4,30,4869,578559870,1,0,0,464.97,8,310912.31,6,4,7,2,True
7905137,256,4,451,4869,578559870,1,0,0,464.88,7,310447.43,6,4,4,2,True
8398460,249,0,20,4869,578559870,1,0,0,465.02,3,309982.41,6,6,12,3,True
8510104,913,0,451,9170,578559870,1,0,0,465.08,7,309517.33,18,4,13,4,True
8585343,913,0,30,6412,578559870,1,0,0,465.04,8,309052.29,18,3,11,5,True
8629899,695,2,451,4126,578559870,1,0,0,465.04,7,308587.25,24,6,7,7,True
9047817,262,2,20,4248,578559870,1,0,0,465.13,3,308122.12,6,0,9,7,True
9247216,607,2,20,1563,578559870,1,0,0,464.96,5,307657.16,24,6,5,9,True
9506851,385,1,25,2671,578559870,1,0,0,464.98,8,307192.18,25,3,12,9,True
9717759,256,4,451,7566,578559870,1,0,0,465.26,7,306726.92,6,5,12,10,True
9819581,603,0,10,9170,578559870,1,0,0,464.93,6,307191.85,24,3,2,10,True
1013067,1201,0,10,6303,451238135,1,0,0,519.19,6,417041.19,24,3,17,2,True
1167685,859,2,451,9976,451238135,1,0,0,518.96,7,416522.23,24,0,0,2,True
1187902,96,0,30,7158,451238135,1,0,0,518.94,8,416003.29,1,3,14,3,True
1320577,27,0,10,6158,451238135,1,0,0,518.94,0,416522.23,11,4,9,3,True
1665393,1070,4,451,3541,451238135,1,0,0,518.82,7,416003.41,18,6,23,3,True
1690032,376,0,10,3783,451238135,1,0,0,518.98,0,416522.39,25,3,13,3,True
1875143,96,0,25,9505,451238135,1,0,0,518.99,8,416003.4,1,3,9,3,True
1937272,1070,4,-1,7158,451238135,1,1,0,519.01,1,416003.4,18,5,7,3,True
2518334,10,4,30,3783,451238135,1,0,0,518.96,8,415484.44,24,3,3,3,True
2537072,96,0,451,1630,451238135,1,0,0,518.92,7,414965.52,1,6,8,4,True
2691766,859,2,451,6509,451238135,1,0,0,518.99,7,414446.53,24,4,11,6,True
2852593,942,0,451,6303,451238135,1,0,0,519.0,7,413927.53,24,1,23,6,True
3133303,1142,2,20,3541,451238135,1,0,0,518.72,3,413408.81,15,4,13,7,True
3171468,796,2,20,6660,451238135,1,0,0,518.93,5,412889.88,11,2,8,7,True
3809542,931,0,10,7158,451238135,1,0,0,518.92,0,413408.8,24,0,19,7,True
3861691,859,2,30,3541,451238135,1,0,0,518.89,8,412889.91,24,4,14,7,True
3909512,942,0,451,4152,451238135,1,0,0,519.09,7,412370.82,24,5,20,8,True
4417652,96,0,451,4152,451238135,1,0,0,519.11,7,411851.71,1,6,7,8,True
4773943,859,2,25,4152,451238135,1,0,0,518.69,8,411333.02,24,3,14,9,True
4818366,1110,0,20,6889,451238135,1,0,0,519.04,3,410813.98,0,3,19,11,False
4858001,859,2,30,6899,451238135,1,0,0,519.12,8,410294.86,24,6,7,11,True
5163663,1070,4,-1,1630,451238135,1,1,0,518.95,4,410294.86,18,1,12,11,True
5295487,653,1,10,2362,451238135,1,0,0,518.93,6,410813.79,24,0,18,12,False
5468327,942,0,451,5980,451238135,1,0,0,518.89,7,410294.9,24,6,4,2,True
5487969,859,2,451,5980,451238135,1,0,0,518.96,7,409775.94,24,0,9,3,False
5748573,1004,4,30,6509,451238135,1,0,0,519.11,8,409256.83,26,2,7,3,False
5809934,10,4,-1,2362,451238135,1,1,0,519.26,1,409256.83,24,5,9,4,True
5919546,1070,4,451,3783,451238135,1,0,0,519.19,7,408737.64,18,2,12,5,True
5947153,10,4,30,2362,451238135,1,0,0,518.88,8,408218.76,24,2,20,6,True
6056058,572,0,20,2362,451238135,1,0,0,519.02,5,407699.74,11,4,6,8,False
6061719,942,0,-1,6158,451238135,1,1,0,519.13,4,407699.74,24,2,16,8,True
6489415,859,2,30,4152,451238135,1,0,0,518.86,8,407180.88,24,5,19,9,True
6683183,942,0,451,9505,451238135,1,0,0,519.12,7,406661.76,24,0,15,10,True
6691778,900,1,10,1078,451238135,1,0,0,518.86,6,407180.62,24,5,6,10,True
6930005,1004,4,-1,4030,451238135,1,1,0,519.12,4,407180.62,26,1,23,10,True
7076364,10,4,30,6158,451238135,1,0,0,518.84,8,406661.78,24,6,21,10,True
7215793,859,2,30,6660,451238135,1,0,0,519.17,8,406142.61,24,3,11,11,True
7276382,457,0,20,1090,451238135,1,0,0,519.1,5,405623.51,13,0,9,1,True
7442847,734,0,20,6509,451238135,1,0,0,518.99,5,405104.52,11,6,6,2,True
7458075,859,2,25,7158,451238135,1,0,0,518.86,8,404585.66,24,3,16,2,True
7577667,1034,1,10,9505,451238135,1,0,0,519.11,6,405104.77,11,5,4,2,False
7773535,1064,0,10,5158,451238135,1,0,0,519.05,0,405623.82,11,6,17,3,True
7821570,96,0,-1,7158,451238135,1,1,0,519.04,1,405623.82,1,2,23,4,True
7862428,10,4,451,5158,451238135,1,0,0,519.11,7,405104.71,24,5,21,4,True
7887222,424,1,10,9976,451238135,1,0,0,519.0,6,405623.71,18,6,8,5,True
8026602,1070,4,451,1090,451238135,1,0,0,519.03,7,405104.68,18,4,10,5,False
8048507,942,0,451,1090,451238135,1,0,0,519.23,7,404585.45,24,4,10,8,True
8378962,319,0,10,7158,451238135,1,0,0,519.13,0,405104.58,11,5,2,9,True
9234118,195,1,10,7158,451238135,1,0,0,518.95,0,405623.53,18,3,8,9,True
9583593,96,0,-1,1630,451238135,1,1,0,518.88,4,405623.53,1,5,10,10,True
9615531,1004,4,-1,2362,451238135,1,2,0,519.2,4,405623.53,26,3,13,10,True
9943271,859,2,451,5158,451238135,1,0,0,519.04,7,405104.49,24,5,16,11,True
9958640,10,4,25,6660,451238135,1,0,0,518.96,8,404585.53,24,1,4,11,True
1000957,218,0,25,5803,145330378,1,0,0,1052.82,8,904658.18,9,2,16,1,True
1043056,218,0,-1,4960,145330378,1,1,0,1053.07,4,904658.18,9,1,12,2,True
1158542,1026,4,-1,3428,145330378,1,2,0,1052.75,4,904658.18,11,2,16,3,True
1377924,262,2,25,9890,145330378,1,0,0,1052.9,8,903605.28,6,2,6,4,True
1409524,1449,0,10,6909,145330378,1,0,0,1052.97,6,904658.25,11,1,15,7,True
2339198,194,1,451,4960,145330378,1,0,0,1052.86,7,903605.39,18,1,8,10,True
2679880,187,4,-1,2777,145330378,1,1,0,1053.36,1,903605.39,18,5,19,12,True
2811151,194,1,451,5968,145330378,1,0,0,1053.15,7,902552.24,18,6,16,1,False
2944220,262,2,25,6609,145330378,1,0,0,1053.24,8,901499.0,6,6,6,6,True
3294297,187,4,451,5803,145330378,1,0,0,1052.91,7,900446.09,18,5,16,7,True
4037193,1408,1,-1,1630,145330378,1,1,0,1053.02,1,900446.09,24,1,0,12,True
4312667,187,4,-1,6300,145330378,1,2,0,1052.83,4,900446.09,18,1,13,2,True
4559799,194,1,-1,4127,145330378,1,3,1,1053.18,4,900446.09,18,3,9,10,True
1088930,35,2,20,9594,168229833,0,0,0,1199.21,3,354163.79,11,4,4,1,True
1173111,720,4,451,3269,168229833,0,0,0,1199.21,7,352964.58,11,0,23,1,True
1174080,278,1,451,8211,168229833,0,0,0,1198.83,7,351765.75,24,2,1,1,True
1434795,468,3,-1,6941,168229833,0,1,0,1198.92,4,351765.75,5,2,5,1,True
1628201,1144,2,25,1781,168229833,0,0,0,1199.11,8,350566.64,15,3,2,2,True
1679447,468,3,451,4597,168229833,0,0,0,1199.14,7,349367.5,5,6,6,3,True
1704465,278,1,25,3269,168229833,0,0,0,1198.72,8,348168.78,24,6,11,3,True
1779624,1169,0,20,1781,168229833,0,0,0,1198.61,5,346970.17,24,3,13,3,True
1978565,318,0,10,5843,168229833,0,0,0,1198.99,6,348169.16,11,2,8,3,True
2063640,1029,0,10,1380,168229833,0,0,0,1199.03,6,349368.19,11,3,20,4,True
2166523,278,1,25,3150,168229833,0,0,0,1199.0,8,348169.19,24,3,23,4,True
2767863,64,0,10,4551,168229833,0,0,0,1198.98,0,349368.17,20,4,20,4,True
2792505,278,1,30,9594,168229833,0,0,0,1199.13,8,348169.04,24,4,9,5,True
2806443,284,3,451,8637,168229833,0,0,0,1199.07,7,346969.97,24,4,10,7,True
3185678,584,0,10,9371,168229833,0,0,0,1198.99,6,348168.96,11,3,18,8,True
3212543,284,3,30,8637,168229833,0,0,0,1198.96,8,346970.0,24,5,22,8,True
3558402,278,1,451,8637,168229833,0,0,0,1199.15,7,345770.85,24,6,2,10,True
3974913,1144,2,451,9371,168229833,0,0,0,1198.92,7,344571.93,15,3,12,10,True
4038760,468,3,-1,9371,168229833,0,1,0,1199.16,1,344571.93,5,1,23,11,False
4053196,303,0,20,2409,168229833,0,0,0,1198.94,3,343372.99,4,5,6,11,True
4351485,1144,2,25,4741,168229833,0,0,0,1199.05,8,342173.94,15,6,20,1,True
4785209,468,3,451,7399,168229833,0,0,0,1198.99,7,340974.95,5,5,1,1,True
4811666,468,3,-1,5680,168229833,0,1,0,1198.89,4,340974.95,5,1,8,1,True
4955101,278,1,-1,6853,168229833,0,2,0,1199.01,4,340974.95,24,4,2,2,True
5108330,720,4,25,9594,168229833,0,0,0,1198.94,8,339776.01,11,6,4,3,True
5191714,1298,0,30,3150,168229833,0,0,0,1198.9,8,338577.11,5,0,0,3,True
5541356,673,0,20,4741,168229833,0,0,0,1198.88,5,337378.23,18,3,4,5,True
5713124,497,0,10,1320,168229833,0,0,0,1199.27,6,338577.5,12,1,17,6,True
5932274,182,1,10,4597,168229833,0,0,0,1198.96,6,339776.46,18,1,3,8,True
6188075,512,0,10,1781,168229833,0,0,0,1199.06,6,340975.52,12,6,11,9,True
6227002,334,0,10,4598,168229833,0,0,0,1198.86,0,342174.38,11,5,7,10,True
6503752,292,1,10,3863,168229833,0,0,0,1198.86,0,343373.24,4,0,6,11,True
6668510,792,1,10,6941,168229833,0,0,0,1198.8,6,344572.04,11,1,14,11,True
6903076,29,0,20,2107,168229833,0,0,0,1198.56,3,343373.48,11,1,17,11,True
7048835,284,3,25,1380,168229833,0,0,0,1198.97,8,342174.51,24,0,8,12,True
7127291,278,1,25,4741,168229833,0,0,0,1198.79,8,340975.72,24,0,7,12,True
7262470,642,0,20,6853,168229833,0,0,0,1199.03,3,339776.69,24,0,12,12,False
7502415,180,0,20,3269,168229833,0,0,0,1199.04,3,338577.65,18,3,17,12,True
7515367,720,4,25,4551,168229833,0,0,0,1198.92,8,337378.73,11,6,7,12,True
7723249,284,3,25,6013,168229833,0,0,0,1199.22,8,336179.51,24,2,21,2,True
7879998,278,1,30,3863,168229833,0,0,0,1198.91,8,334980.6,24,6,15,2,True
7927745,376,0,10,3295,168229833,0,0,0,1199.01,0,336179.61,25,1,6,2,True
7930459,1152,0,20,9594,168229833,0,0,0,1199.02,5,334980.59,15,4,17,3,True
7931011,1144,2,451,3773,168229833,0,0,0,1199.14,7,333781.45,15,1,15,3,True
8420081,824,2,20,3150,168229833,0,0,0,1198.99,5,332582.46,18,3,7,3,True
8616919,1150,0,20,6013,168229833,0,0,0,1199.05,5,331383.41,15,1,8,4,True
8909537,284,3,30,2409,168229833,0,0,0,1198.64,8,330184.77,24,4,0,4,True
8964684,274,1,10,9594,168229833,0,0,0,1198.99,6,331383.76,24,5,16,5,True
9088188,1298,0,-1,2815,168229833,0,1,0,1198.93,4,331383.76,5,6,0,6,True
9132573,1144,2,451,1514,168229833,0,0,0,1198.77,7,330184.99,15,1,9,7,True
9290890,1144,2,25,7399,168229833,0,0,0,1198.9,8,328986.09,15,2,19,9,True
9583284,284,3,30,1320,168229833,0,0,0,1199.03,8,327787.06,24,0,0,10,True
9615497,278,1,25,3150,168229833,0,0,0,1199.09,8,326587.97,24,5,6,10,True
9628470,328,0,10,4551,168229833,0,0,0,1198.81,0,327786.78,11,6,21,11,True
1011670,726,0,20,8493,459905582,1,0,0,933.78,3,636995.22,11,2,21,1,False
1188115,1067,4,25,7539,459905582,1,0,0,934.01,8,636061.21,11,3,2,2,True
1273381,57,3,25,7539,459905582,1,0,0,933.96,8,635127.25,20,1,10,2,True
1276018,1260,0,20,7252,459905582,1,0,0,933.74,3,634193.51,23,3,2,2,True
1365081,612,4,-1,2322,459905582,1,1,0,933.86,4,634193.51,11,0,2,3,True
1432640,530,0,451,7252,459905582,1,0,0,934.29,7,633259.22,18,2,8,3,True
1540599,1067,4,25,3669,459905582,1,0,0,934.0,8,632325.22,11,4,3,4,True
1613687,1209,4,451,6027,459905582,1,0,0,934.04,7,631391.18,24,0,10,5,True
1647637,895,0,10,8812,459905582,1,0,0,933.77,0,632324.95,24,5,14,5,True
1666605,57,3,-1,9960,459905582,1,1,0,933.99,4,632324.95,20,4,13,6,True
1717546,357,4,451,6229,459905582,1,0,0,934.04,7,631390.91,24,1,3,7,True
2152601,64,0,451,6027,459905582,1,0,0,933.93,7,630456.98,20,1,9,8,True
2166389,612,4,30,5409,459905582,1,0,0,934.25,8,629522.73,11,3,5,9,True
2287342,1266,4,30,6229,459905582,1,0,0,934.24,8,628588.49,23,5,17,9,True
2335777,728,1,-1,7539,459905582,1,1,0,934.1,1,628588.49,11,4,11,11,True
2413166,64,0,30,9877,459905582,1,0,0,934.12,8,627654.37,20,1,9,11,True
2576949,1209,4,25,4956,459905582,1,0,0,933.79,8,626720.58,24,0,18,12,True
2689508,64,0,451,4575,459905582,1,0,0,934.27,7,625786.31,20,5,12,12,True
2701590,1266,4,451,7252,459905582,1,0,0,934.04,7,624852.27,23,1,23,1,True
3416045,728,1,451,5986,459905582,1,0,0,934.06,7,623918.21,11,3,4,2,True
3950874,612,4,451,6027,459905582,1,0,0,934.07,7,622984.14,11,6,0,3,True
3951522,357,4,-1,5357,459905582,1,1,0,934.08,4,622984.14,24,6,19,3,True
3992946,728,1,451,6948,459905582,1,0,0,933.92,7,622050.22,11,1,18,3,True
3998932,57,3,25,4727,459905582,1,0,0,933.82,8,621116.4,20,6,16,6,True
4282002,64,0,25,7539,459905582,1,0,0,933.93,8,620182.47,20,3,17,6,True
4380193,612,4,451,8812,459905582,1,0,0,934.15,7,619248.32,11,1,9,7,True
4671103,612,4,25,2322,459905582,1,0,0,933.61,8,618314.71,11,4,4,8,True
4825444,57,3,25,4727,459905582,1,0,0,934.04,8,617380.67,20,2,1,8,True
4907526,1422,1,10,6476,459905582,1,0,0,933.85,6,618314.52,24,3,17,9,True
4954575,728,1,25,6027,459905582,1,0,0,934.08,8,617380.44,11,2,5,9,True
4961779,811,0,10,9435,459905582,1,0,0,934.33,6,618314.77,18,1,10,10,True
5034560,612,4,451,4575,459905582,1,0,0,933.95,7,617380.82,11,1,14,10,True
5343358,1266,4,-1,7252,459905582,1,1,0,933.84,4,617380.82,23,0,3,10,True
5603635,357,4,-1,4575,459905582,1,2,0,934.02,1,617380.82,24,5,3,11,True
5921920,1067,4,451,7252,459905582,1,0,0,933.98,7,616446.84,11,3,4,12,True
5928936,192,2,20,9435,459905582,1,0,0,934.17,3,615512.67,18,3,16,12,True
6009272,530,0,30,7252,459905582,1,0,0,933.83,8,614578.84,18,6,9,1,True
6209757,1067,4,451,8812,459905582,1,0,0,934.38,7,613644.46,11,6,12,1,True
6342170,1238,0,10,6027,459905582,1,0,0,933.95,6,614578.41,18,0,12,2,True
6386852,357,4,25,6027,459905582,1,0,0,934.15,8,613644.26,24,6,21,2,True
6485132,612,4,30,5357,459905582,1,0,0,933.89,8,612710.37,11,3,17,4,True
6495299,1067,4,451,8812,459905582,1,0,0,933.93,7,611776.44,11,1,2,4,True
6528351,76,0,20,8493,459905582,1,0,0,934.23,5,610842.21,20,4,23,5,True
6670742,530,0,25,5357,459905582,1,0,0,934.0,8,609908.21,18,5,23,6,True
6713809,1209,4,30,2322,459905582,1,0,0,933.93,8,608974.28,24,3,10,6,True
6861203,1209,4,451,7252,459905582,1,0,0,934.31,7,608039.97,24,0,19,7,True
7147578,57,3,25,6948,459905582,1,0,0,934.02,8,607105.95,20,5,17,7,True
7466750,64,0,451,8493,459905582,1,0,0,934.07,7,606171.88,20,0,3,7,True
7529673,357,4,25,5357,459905582,1,0,0,933.87,8,605238.01,24,2,20,7,True
7898933,57,3,30,1271,459905582,1,0,0,933.9,8,604304.11,20,4,2,9,True
8278630,64,0,451,5357,459905582,1,0,0,934.23,7,603369.88,20,1,7,9,True
8462893,612,4,451,5409,459905582,1,0,0,934.13,7,602435.75,11,4,2,9,True
9328610,530,0,25,6229,459905582,1,0,0,933.92,8,601501.83,18,5,1,11,True
9939585,530,0,451,4956,459905582,1,0,0,934.15,7,600567.68,18,1,13,11,True
9946945,1067,4,25,4575,459905582,1,0,0,934.04,8,599633.64,11,5,22,11,True
1189405,205,0,-1,6124,470045409,0,1,0,988.75,4,235958.0,9,1,1,2,True
1253730,1172,3,30,7512,470045409,0,0,0,989.05,8,234968.95,24,2,4,2,True
1483353,1345,2,-1,8106,470045409,0,1,0,989.0,1,234968.95,24,2,11,2,True
1562561,1212,0,20,2772,470045409,0,0,0,988.95,5,233980.0,24,1,12,2,True
1628515,14,2,451,2314,470045409,0,0,0,989.1,7,232990.9,24,1,1,3,True
1714240,1105,2,20,4067,470045409,0,0,0,988.86,5,232002.04,0,3,20,4,True
1966451,1316,3,30,2961,470045409,0,0,0,988.9,8,231013.14,5,3,18,5,True
2167768,378,0,20,9367,470045409,0,0,0,989.02,5,230024.12,25,6,14,7,True
2325546,767,0,10,8106,470045409,0,0,0,989.02,6,231013.14,14,5,19,7,True
2377999,294,3,25,6124,470045409,0,0,0,989.13,8,230024.01,4,5,16,8,True
2403023,721,4,30,5433,470045409,0,0,0,988.94,8,229035.07,11,1,20,11,True
2410979,1172,3,-1,8251,470045409,0,1,0,988.88,4,229035.07,24,6,22,11,True
2429547,97,0,10,2146,470045409,0,0,0,989.03,0,230024.1,3,5,21,12,True
2475507,1172,3,25,5083,470045409,0,0,0,989.0,8,229035.1,24,4,10,12,True
2703734,660,3,451,3275,470045409,0,0,0,989.11,7,228045.99,18,5,23,12,True
2902653,1403,4,451,5083,470045409,0,0,0,988.91,7,227057.08,24,5,1,2,True
2974352,1316,3,451,3275,470045409,0,0,0,989.03,7,226068.05,5,2,6,2,True
3176174,205,0,30,2314,470045409,0,0,0,988.98,8,225079.07,9,5,20,3,True
3499933,294,3,451,6124,470045409,0,0,0,988.94,7,224090.13,4,5,4,4,True
3828592,660,3,451,5083,470045409,0,0,0,989.0,7,223101.13,18,3,1,4,True
3914140,205,0,30,2314,470045409,0,0,0,989.03,8,222112.1,9,6,1,4,True
3932994,502,0,10,3275,470045409,0,0,0,988.84,0,223100.94,12,6,8,5,True
4073395,294,3,30,2314,470045409,0,0,0,989.06,8,222111.88,4,2,19,5,True
4075693,1316,3,-1,2146,470045409,0,1,0,989.15,4,222111.88,5,5,13,7,True
4101052,376,0,20,2314,470045409,0,0,0,988.99,5,221122.89,25,0,10,7,True
4323339,14,2,25,4067,470045409,0,0,0,989.21,8,220133.68,24,0,1,7,True
4353720,1338,0,20,6124,470045409,0,0,0,988.86,5,219144.82,18,5,2,7,True
4403076,1172,3,30,2146,470045409,0,0,0,989.15,8,218155.67,24,2,12,8,True
4650721,205,0,25,2713,470045409,0,0,0,989.14,8,217166.53,9,6,8,10,True
4728211,294,3,30,9257,470045409,0,0,0,988.79,8,216177.74,4,1,5,10,True
4756864,1316,3,25,2772,470045409,0,0,0,989.01,8,215188.73,5,2,6,10,True
4831577,980,1,10,4067,470045409,0,0,0,989.08,6,216177.81,22,5,21,10,True
5183868,918,2,20,5083,470045409,0,0,0,988.78,5,215189.03,18,6,1,11,True
5879139,1345,2,451,6124,470045409,0,0,0,989.1,7,214199.93,24,0,5,12,True
5958707,799,2,20,5433,470045409,0,0,0,988.69,3,213211.24,11,3,22,12,True
5975830,877,2,20,6313,470045409,0,0,0,989.05,5,212222.19,24,0,13,1,True
6165364,14,2,25,9257,470045409,0,0,0,988.94,8,211233.25,24,0,11,1,True
6470824,721,4,451,5433,470045409,0,0,0,988.88,7,210244.37,11,1,6,1,True
6484321,1172,3,451,2961,470045409,0,0,0,989.16,7,209255.21,24,4,9,4,True
6509409,14,2,25,5717,470045409,0,0,0,989.1,8,208266.11,24,6,1,4,True
6523092,97,0,20,2961,470045409,0,0,0,989.19,5,207276.92,3,6,9,6,True
6778205,1345,2,-1,9367,470045409,0,1,0,988.83,4,207276.92,24,1,12,6,True
7128764,689,0,10,5083,470045409,0,0,0,989.04,6,208265.96,24,4,22,6,True
7464712,1166,2,20,6313,470045409,0,0,0,989.1,5,207276.86,24,5,4,6,False
8037879,1403,4,451,2961,470045409,0,0,0,989.17,7,206287.69,24,5,23,6,True
8707734,1359,2,20,2961,470045409,0,0,0,988.84,5,205298.85,24,1,20,8,True
8778183,1403,4,-1,7512,470045409,0,1,0,988.81,4,205298.85,24,1,5,8,True
8793485,660,3,30,3275,470045409,0,0,0,988.75,8,204310.1,18,1,21,8,True
9077520,1345,2,451,2961,470045409,0,0,0,988.79,7,203321.31,24,4,22,9,True
9267916,721,4,451,9257,470045409,0,0,0,989.03,7,202332.28,11,2,1,9,True
9320371,800,0,20,2146,470045409,0,0,0,989.07,3,201343.21,11,0,19,9,True
9384226,1316,3,30,4067,470045409,0,0,0,989.16,8,200354.05,5,6,13,11,True
9696835,1345,2,25,5083,470045409,0,0,0,989.19,8,199364.86,24,5,15,11,True
9701111,1172,3,25,6124,470045409,0,0,0,989.07,8,198375.79,24,3,10,11,True
1004416,854,0,25,9844,645465549,0,0,0,451.19,8,987715.81,24,6,20,1,True
1057111,696,2,20,6446,645465549,0,0,0,451.08,5,987264.73,24,3,15,2,True
1347866,1274,4,30,6434,645465549,0,0,0,450.96,8,986813.77,24,0,0,2,True
1395437,257,1,30,7950,645465549,0,0,0,451.08,8,986362.69,6,5,12,2,True
1457041,854,0,25,4007,645465549,0,0,0,450.93,8,985911.76,24,3,11,3,True
1457394,1274,4,451,6446,645465549,0,0,0,451.16,7,985460.6,24,5,7,3,True
1698936,720,4,25,3234,645465549,0,0,0,451.07,8,985009.53,11,1,1,3,True
1974987,1388,1,451,9844,645465549,0,0,0,450.92,7,984558.61,24,1,13,4,True
2072838,257,1,451,9902,645465549,0,0,0,451.04,7,984107.57,6,0,2,5,True
2350242,394,0,10,9902,645465549,0,0,0,450.96,0,984558.53,10,6,3,6,True
2414648,257,1,-1,6434,645465549,0,1,0,450.79,4,984558.53,6,2,2,6,True
2887178,257,1,-1,2464,645465549,0,2,0,450.98,4,984558.53,6,0,2,7,True
2945820,720,4,25,7950,645465549,0,0,0,451.13,8,984107.4,11,0,21,8,True
2997262,89,3,451,8079,645465549,0,0,0,450.98,7,983656.42,1,1,10,8,True
3043258,318,0,20,6434,645465549,0,0,0,450.98,5,983205.44,11,1,2,8,True
3103685,1274,4,25,8079,645465549,0,0,0,450.97,8,982754.47,24,3,9,9,True
3360891,185,1,10,6525,645465549,0,0,0,450.78,6,983205.25,18,0,15,9,True
3516211,720,4,30,2111,645465549,0,0,0,450.9,8,982754.35,11,6,14,12,True
3641572,869,2,20,7114,645465549,0,0,0,451.02,3,982303.33,24,5,3,12,True
3726626,469,4,25,9902,645465549,0,0,0,450.94,8,981852.39,5,6,8,1,True
3804028,1274,4,451,6525,645465549,0,0,0,450.93,7,981401.46,24,4,17,3,True
3876084,897,0,-1,2298,645465549,0,1,0,450.95,4,981401.46,24,0,10,3,True
3896348,854,0,451,9902,645465549,0,0,0,451.2,7,980950.26,24,5,7,4,True
4175074,854,0,451,5752,645465549,0,0,0,450.94,7,980499.32,24,6,11,5,True
4265025,469,4,30,7594,645465549,0,0,0,450.86,8,980048.46,5,5,14,6,True
4347637,897,0,25,7950,645465549,0,0,0,451.01,8,979597.45,24,2,21,7,True
4429626,257,1,25,9334,645465549,0,0,0,450.88,8,979146.57,6,0,15,7,True
4791571,897,0,30,5752,645465549,0,0,0,450.84,8,978695.73,24,3,4,8,True
5117635,89,3,451,7893,645465549,0,0,0,450.7,7,978245.03,1,5,18,8,False
5121149,1388,1,30,7594,645465549,0,0,0,450.97,8,977794.06,24,0,18,8,True
5136650,720,4,30,9844,645465549,0,0,0,451.07,8,977342.99,11,1,16,9,True
5417714,1274,4,30,6434,645465549,0,0,0,451.08,8,976891.91,24,2,10,9,True
5838611,1274,4,451,6446,645465549,0,0,0,451.03,7,976440.88,24,6,21,10,True
5974583,1089,0,20,3234,645465549,0,0,0,451.01,3,975989.87,18,4,0,10,True
6028262,1388,1,451,7950,645465549,0,0,0,451.18,7,975538.69,24,5,12,11,True
6448180,1339,2,20,6446,645465549,0,0,0,450.93,5,975087.76,18,5,17,11,True
6665844,854,0,451,5752,645465549,0,0,0,450.96,7,974636.8,24,5,17,12,True
6912337,372,0,10,3234,645465549,0,0,0,451.0,6,975087.8,25,6,16,12,True
7451114,89,3,30,7893,645465549,0,0,0,451.2,8,974636.6,1,0,22,12,True
7461916,469,4,30,9844,645465549,0,0,0,451.34,8,974185.26,5,2,12,12,True
7473971,1388,1,30,6525,645465549,0,0,0,451.19,8,973734.07,24,1,17,12,True
7649836,89,3,30,1707,645465549,0,0,0,451.1,8,973282.97,1,3,22,12,True
7682994,1272,0,20,3498,645465549,0,0,0,450.86,5,972832.11,24,3,13,1,True
7781924,71,1,10,6525,645465549,0,0,0,451.09,0,973283.2,20,4,13,1,True
7929533,1274,4,451,5752,645465549,0,0,0,451.11,7,972832.09,24,0,18,3,False
8121802,469,4,30,6434,645465549,0,0,0,451.13,8,972380.96,5,4,19,3,True
8172081,1388,1,30,5752,645465549,0,0,0,451.05,8,971929.91,24,3,10,4,True
8281447,580,0,20,9334,645465549,0,0,0,451.1,5,971478.81,11,2,1,5,True
8482964,1274,4,25,9844,645465549,0,0,0,451.07,8,971027.74,24,0,4,6,False
8655150,854,0,25,8079,645465549,0,0,0,450.91,8,970576.83,24,2,5,6,False
8833587,585,2,20,6525,645465549,0,0,0,451.01,5,970125.82,11,3,9,7,True
8886733,89,3,25,2111,645465549,0,0,0,450.81,8,969675.01,1,4,9,7,True
8934568,854,0,451,9334,645465549,0,0,0,450.78,7,969224.23,24,4,14,8,True
9256121,897,0,-1,6525,645465549,0,1,0,451.17,1,969224.23,24,6,4,9,True
9377211,1388,1,451,6446,645465549,0,0,0,450.88,7,968773.35,24,2,19,10,True
9399997,998,0,10,5426,645465549,0,0,0,451.04,0,969224.39,26,1,11,10,True
9664649,257,1,25,3498,645465549,0,0,0,451.16,8,968773.23,6,2,9,10,True
1009912,605,0,451,1191,607040900,0,0,0,763.03,7,669416.97,24,0,3,1,True
1064139,1159,0,20,8103,607040900,0,0,0,763.08,3,668653.89,15,2,17,1,True
1207048,1213,2,30,6559,607040900,0,0,0,763.03,8,667890.86,24,4,10,1,True
1259228,1036,1,10,8318,607040900,0,0,0,762.88,6,668653.74,11,5,19,1,True
1409356,1213,2,451,1922,607040900,0,0,0,762.91,7,667890.83,24,5,7,1,True
1586223,1377,0,20,2635,607040900,0,0,0,762.98,3,667127.85,16,3,9,3,True
1779600,548,2,451,2164,607040900,0,0,0,763.18,7,666364.67,17,2,18,3,False
2066653,739,1,451,2441,607040900,0,0,0,762.82,7,665601.85,24,0,23,3,True
2195267,437,4,-1,5538,607040900,0,1,0,763.07,4,665601.85,24,1,8,5,True
2295465,198,0,20,1191,607040900,0,0,0,763.1,5,664838.75,18,3,16,5,True
2412376,794,2,451,4860,607040900,0,0,0,762.84,7,664075.91,11,1,5,5,True
2415460,1102,2,451,1922,607040900,0,0,0,762.82,7,663313.09,0,6,20,6,True
2949970,739,1,30,2164,607040900,0,0,0,762.84,8,662550.25,24,4,14,7,True
3102996,1102,2,25,1922,607040900,0,0,0,763.1,8,661787.15,0,5,21,7,True
3264003,1213,2,-1,2441,607040900,0,1,0,762.93,4,661787.15,24,5,23,9,True
3377217,219,0,20,8103,607040900,0,0,0,763.14,3,661024.01,9,0,14,9,True
3516751,1102,2,-1,7927,607040900,0,1,0,763.12,4,661024.01,0,0,0,9,True
3591105,794,2,30,2635,607040900,0,0,0,763.23,8,660260.78,11,4,15,9,True
3673781,537,0,10,7927,607040900,0,0,0,763.1,6,661023.88,18,0,20,9,True
3910169,252,4,451,5007,607040900,0,0,0,763.14,7,660260.74,6,5,18,10,True
4131778,85,2,20,2684,607040900,0,0,0,763.22,3,659497.52,1,1,19,11,True
4316340,550,0,10,1191,607040900,0,0,0,762.79,6,660260.31,17,6,6,11,True
4353384,1102,2,451,7927,607040900,0,0,0,763.03,7,659497.28,0,4,4,12,True
4516760,437,4,451,6559,607040900,0,0,0,762.88,7,658734.4,24,4,23,12,True
4792990,81,0,10,1922,607040900,0,0,0,763.2,0,659497.6,1,3,5,12,True
4946984,1213,2,30,2684,607040900,0,0,0,762.94,8,658734.66,24,2,8,12,True
5133396,1213,2,451,6793,607040900,0,0,0,763.34,7,657971.32,24,0,3,1,False
5284387,794,2,30,7927,607040900,0,0,0,763.23,8,657208.09,11,2,8,2,True
5382259,794,2,30,5245,607040900,0,0,0,763.03,8,656445.06,11,4,6,2,True
5955237,794,2,25,3637,607040900,0,0,0,762.86,8,655682.2,11,5,18,3,True
6022949,605,0,30,6559,607040900,0,0,0,762.91,8,654919.29,24,0,16,3,True
6279714,752,0,10,1191,607040900,0,0,0,762.95,0,655682.24,24,4,5,4,False
6347634,790,0,20,5538,607040900,0,0,0,762.93,3,654919.31,11,0,12,5,True
6392908,794,2,30,2635,607040900,0,0,0,762.98,8,654156.33,11,1,11,5,True
6431095,1447,4,30,2164,607040900,0,0,0,762.77,8,653393.56,24,6,0,6,True
6513078,437,4,25,8012,607040900,0,0,0,763.19,8,652630.37,24,6,9,6,True
6585863,794,2,451,7892,607040900,0,0,0,763.03,7,651867.34,11,3,11,7,True
6902777,739,1,451,3987,607040900,0,0,0,763.28,7,651104.06,24,1,18,8,True
6917298,1447,4,451,2635,607040900,0,0,0,763.06,7,650341.0,24,3,5,9,True
7013610,548,2,25,1191,607040900,0,0,0,762.7,8,649578.3,17,5,3,11,True
7029817,1425,0,20,2734,607040900,0,0,0,762.97,5,648815.33,24,6,12,11,True
7108646,548,2,451,2441,607040900,0,0,0,763.19,7,648052.14,17,5,2,11,True
7304485,438,1,10,3637,607040900,0,0,0,762.77,6,648814.91,24,6,2,12,True
7502471,860,1,10,2164,607040900,0,0,0,763.18,0,649578.09,24,4,23,12,True
7577384,1213,2,30,1579,607040900,0,0,0,762.86,8,648815.23,24,4,5,12,True
7719475,27,0,10,4860,607040900,0,0,0,763.01,0,649578.24,11,6,1,3,True
7830583,1213,2,451,7921,607040900,0,0,0,763.14,7,648815.1,24,4,2,3,True
7945294,1114,1,10,5922,607040900,0,0,0,763.29,6,649578.39,0,3,12,4,False
8049938,1271,0,20,8069,607040900,0,0,0,762.89,5,648815.5,23,2,0,4,True
8103693,605,0,-1,9209,607040900,0,1,0,762.83,1,648815.5,24,4,6,4,True
8128910,1447,4,451,2706,607040900,0,0,0,762.73,7,648052.77,24,4,2,6,False
8652930,794,2,-1,6593,607040900,0,1,0,763.18,1,648052.77,11,0,1,7,True
8958152,1102,2,25,2684,607040900,0,0,0,763.09,8,647289.68,0,2,23,7,True
9183598,1213,2,25,2635,607040900,0,0,0,763.25,8,646526.43,24,0,2,7,True
9192585,437,4,-1,2164,607040900,0,1,0,762.84,4,646526.43,24,2,8,9,True
9235376,794,2,451,5007,607040900,0,0,0,763.05,7,645763.38,11,4,15,9,True
9441650,437,4,451,5024,607040900,0,0,0,763.13,7,645000.25,24,4,22,11,True
9702793,1213,2,451,1579,607040900,0,0,0,762.78,7,644237.47,24,0,21,11,True
9956650,739,1,30,5279,607040900,0,0,0,762.9,8,643474.57,24,2,20,11,True
1358787,1160,0,20,8616,357284945,0,0,0,515.97,5,388063.03,15,6,17,2,True
1581111,935,1,10,9211,357284945,0,0,0,516.29,0,388579.32,24,6,23,2,True
1892576,184,0,10,9227,357284945,0,0,0,515.92,6,389095.24,18,5,3,2,True
2208964,1232,1,25,9874,357284945,0,0,0,516.07,8,388579.17,18,3,16,4,True
2372147,111,3,30,9102,357284945,0,0,0,516.12,8,388063.05,3,1,5,5,True
2402294,867,0,451,4435,357284945,0,0,0,516.21,7,387546.84,24,0,13,6,True
2577760,64,0,20,6161,357284945,0,0,0,515.74,5,387031.1,20,1,5,7,True
2611360,1364,0,20,9029,357284945,0,0,0,515.98,3,386515.12,16,4,16,8,True
3143783,873,4,451,4796,357284945,0,0,0,515.96,7,385999.16,24,2,6,9,True
3405815,873,4,-1,2573,357284945,0,1,0,515.84,1,385999.16,24,3,8,9,True
3475919,873,4,451,2573,357284945,0,0,0,515.7,7,385483.46,24,1,4,10,True
3616118,913,0,25,5110,357284945,0,0,0,515.93,8,384967.53,18,1,3,11,True
4070079,1425,0,10,6161,357284945,0,0,0,515.96,0,385483.49,24,1,15,1,True
4075594,867,0,25,5492,357284945,0,0,0,516.04,8,384967.45,24,6,5,5,True
4259612,970,4,30,3934,357284945,0,0,0,515.86,8,384451.59,13,6,2,6,True
4272637,867,0,25,2573,357284945,0,0,0,516.32,8,383935.27,24,3,3,10,True
4296441,970,4,451,6724,357284945,0,0,0,515.84,7,383419.43,13,6,18,11,True
4503623,785,0,-1,7401,357284945,0,1,0,515.84,4,383419.43,14,5,1,12,True
4572443,785,0,451,2364,357284945,0,0,0,516.07,7,382903.36,14,2,15,3,True
4601076,970,4,451,4460,357284945,0,0,0,516.04,7,382387.32,13,0,17,3,True
4624935,867,0,25,7401,357284945,0,0,0,516.17,8,381871.15,24,5,16,3,True
4746966,111,3,30,9211,357284945,0,0,0,516.13,8,381355.02,3,0,12,4,True
4763601,913,0,451,3637,357284945,0,0,0,515.8,7,380839.22,18,6,12,4,True
5052478,1232,1,-1,6161,357284945,0,1,0,515.99,4,380839.22,18,1,15,5,True
5401262,873,4,30,9874,357284945,0,0,0,515.67,8,380323.55,24,5,19,6,True
5564440,970,4,30,8616,357284945,0,0,0,515.92,8,379807.63,13,3,23,6,True
5664550,785,0,-1,9211,357284945,0,1,0,515.97,4,379807.63,14,6,17,7,True
5771403,111,3,-1,2364,357284945,0,2,0,516.19,4,379807.63,3,4,9,9,True
5981674,785,0,-1,9102,357284945,0,3,1,515.77,4,0.0,14,1,9,11,True
1198963,1390,0,-1,7026,678527916,0,1,0,911.66,4,680717.0,24,0,10,1,True
1821909,999,4,451,2538,678527916,0,0,0,911.99,7,679805.01,26,0,2,1,True
1958243,320,1,451,7026,678527916,0,0,0,911.97,7,678893.04,11,4,21,2,True
2119366,834,0,10,9118,678527916,0,0,0,912.06,6,679805.1,5,5,16,3,True
2246537,116,0,10,8086,678527916,0,0,0,911.92,6,680717.02,3,5,22,4,True
2378656,1196,4,25,7686,678527916,0,0,0,912.01,8,679805.01,24,6,11,5,True
2542081,883,0,10,7404,678527916,0,0,0,912.04,6,680717.05,24,5,18,5,True
2649778,1191,4,451,7438,678527916,0,0,0,911.9,7,679805.15,24,6,14,6,True
2782100,203,0,10,7686,678527916,0,0,0,911.72,0,680716.87,9,3,19,7,True
2841856,999,4,25,5800,678527916,0,0,0,912.06,8,679804.81,26,6,4,8,True
2885455,85,2,20,9970,678527916,0,0,0,912.12,5,678892.69,1,3,3,9,True
2930018,320,1,30,5821,678527916,0,0,0,912.35,8,677980.34,11,1,16,9,True
3005795,320,1,451,9118,678527916,0,0,0,911.91,7,677068.43,11,1,4,10,True
3128083,1486,2,20,3577,678527916,0,0,0,911.97,5,676156.46,24,6,6,10,True
3389739,320,1,30,9118,678527916,0,0,0,911.91,8,675244.55,11,3,6,11,True
3706834,640,4,451,2721,678527916,0,0,0,912.13,7,674332.42,24,2,18,12,True
4478791,1390,0,-1,3153,678527916,0,1,0,912.11,4,674332.42,24,4,22,12,True
4709707,211,0,20,3679,678527916,0,0,0,912.09,5,673420.33,9,3,4,12,True
4714262,1191,4,30,7438,678527916,0,0,0,912.21,8,672508.12,24,3,13,12,True
4891130,284,3,451,8917,678527916,0,0,0,911.95,7,671596.17,24,6,20,1,True
4906474,1196,4,25,3679,678527916,0,0,0,911.59,8,670684.58,24,1,18,1,False
4968088,1191,4,30,7686,678527916,0,0,0,912.12,8,669772.46,24,4,20,3,False
5067448,535,0,20,8917,678527916,0,0,0,912.14,3,668860.32,18,2,13,3,False
5125903,98,0,20,7404,678527916,0,0,0,911.87,3,667948.45,3,2,18,4,True
5267203,999,4,451,7404,678527916,0,0,0,912.11,7,667036.34,26,6,9,4,True
5432221,1390,0,451,8960,678527916,0,0,0,911.79,7,666124.55,24,5,7,5,True
5435168,1390,0,25,2395,678527916,0,0,0,911.83,8,665212.72,24,5,10,5,True
5549594,929,0,20,9118,678527916,0,0,0,912.04,3,664300.68,18,1,1,6,True
5602959,1196,4,25,2395,678527916,0,0,0,911.84,8,663388.84,24,2,12,6,True
5870002,916,0,20,8917,678527916,0,0,0,912.05,5,662476.79,18,2,3,6,True
6100407,1191,4,451,2721,678527916,0,0,0,911.87,7,661564.92,24,0,10,7,True
6227551,284,3,25,3577,678527916,0,0,0,911.75,8,660653.17,24,4,19,11,True
6655821,1390,0,451,7026,678527916,0,0,0,911.78,7,659741.39,24,6,8,2,True
6664960,284,3,451,5821,678527916,0,0,0,911.93,7,658829.46,24,0,9,3,True
6699494,284,3,-1,7933,678527916,0,1,0,912.19,4,658829.46,24,2,17,5,True
6705231,1390,0,25,7026,678527916,0,0,0,912.05,8,657917.41,24,1,4,6,True
6728173,1390,0,30,5821,678527916,0,0,0,912.12,8,657005.29,24,2,4,6,True
6755701,1390,0,30,5800,678527916,0,0,0,912.02,8,656093.27,24,1,18,6,True
6873448,999,4,451,8960,678527916,0,0,0,911.59,7,655181.68,26,1,7,7,True
7025720,757,0,-1,7404,678527916,0,1,0,911.85,4,655181.68,24,2,22,8,False
7150798,999,4,-1,2721,678527916,0,2,0,911.8,4,655181.68,26,4,2,9,True
7233473,320,1,-1,3153,678527916,0,3,1,912.14,4,0.0,11,1,7,10,True
1141287,81,0,-1,9745,214082706,0,1,0,222.78,4,776442.0,1,3,18,1,True
1481483,1134,1,30,4294,214082706,0,0,0,223.06,8,776218.94,24,3,23,1,True
1634715,266,2,30,1030,214082706,0,0,0,223.14,8,775995.8,6,6,14,1,True
1673392,126,1,10,9083,214082706,0,0,0,222.92,0,776218.72,18,2,7,1,True
1924012,444,2,-1,3464,214082706,0,1,0,223.05,4,776218.72,24,2,10,2,True
2033495,1134,1,30,1381,214082706,0,0,0,222.79,8,775995.93,24,0,22,2,True
2344518,266,2,25,4363,214082706,0,0,0,222.77,8,775773.16,6,4,16,2,True
2373159,444,2,25,1381,214082706,0,0,0,223.05,8,775550.11,24,1,16,3,True
2869649,1134,1,-1,5327,214082706,0,1,0,223.24,4,775550.11,24,2,1,3,True
3115045,929,0,20,8173,214082706,0,0,0,223.01,5,775327.1,18,3,19,3,True
3397162,882,0,30,5255,214082706,0,0,0,223.07,8,775104.03,27,2,6,5,True
3474481,444,2,30,9472,214082706,0,0,0,223.03,8,774881.0,24,0,11,5,True
3551171,199,0,25,8308,214082706,0,0,0,223.15,8,774657.85,18,5,5,7,True
3755031,81,0,30,6830,214082706,0,0,0,222.93,8,774434.92,1,2,16,7,True
4022450,444,2,25,1381,214082706,0,0,0,223.03,8,774211.89,24,2,20,7,True
4066984,204,0,10,1381,214082706,0,0,0,223.07,6,774434.96,9,6,14,9,True
4282088,1318,0,10,8520,214082706,0,0,0,222.89,0,774657.85,18,0,23,10,True
4578595,199,0,-1,1030,214082706,0,1,0,223.15,4,774657.85,18,2,11,11,True
4788135,611,0,10,9083,214082706,0,0,0,222.8,0,774880.65,11,4,11,11,True
4882851,319,0,10,3590,214082706,0,0,0,222.92,6,775103.57,11,4,19,11,True
5096986,882,0,25,4544,214082706,0,0,0,223.02,8,774880.55,27,3,19,11,True
5103384,882,0,25,6883,214082706,0,0,0,223.25,8,774657.3,27,5,14,12,True
5675006,644,0,10,6830,214082706,0,0,0,223.07,6,774880.37,24,4,12,12,True
6005314,81,0,451,1030,214082706,0,0,0,222.99,7,774657.38,1,5,11,1,True
6357532,266,2,451,4888,214082706,0,0,0,222.57,7,774434.81,6,6,23,3,True
6414516,716,0,10,1381,214082706,0,0,0,222.97,6,774657.78,18,3,22,3,True
6459716,444,2,25,2362,214082706,0,0,0,223.0,8,774434.78,24,4,16,3,True
6532592,713,0,20,4761,214082706,0,0,0,222.97,5,774211.81,18,3,3,4,True
6544432,482,1,10,4091,214082706,0,0,0,222.88,6,774434.69,5,4,1,4,True
6570916,1134,1,30,6883,214082706,0,0,0,222.87,8,774211.82,24,0,0,5,True
6578910,403,0,10,3464,214082706,0,0,0,222.93,6,774434.75,10,1,16,6,True
6804086,81,0,30,9083,214082706,0,0,0,223.08,8,774211.67,1,6,12,7,True
7006316,882,0,-1,9083,214082706,0,1,0,222.94,4,774211.67,27,1,21,7,True
7101866,482,1,10,6830,214082706,0,0,0,222.88,6,774434.55,5,5,4,7,True
7140833,1015,0,10,4686,214082706,0,0,0,222.98,6,774657.53,26,5,23,8,False
7172179,1134,1,451,6883,214082706,0,0,0,223.03,7,774434.5,24,4,0,9,False
7286099,444,2,451,6830,214082706,0,0,0,222.89,7,774211.61,24,5,18,9,True
7399185,1134,1,451,9472,214082706,0,0,0,223.13,7,773988.48,24,3,18,10,False
7400286,882,0,30,8173,214082706,0,0,0,223.2,8,773765.28,27,3,17,11,True
7535262,1039,1,10,9359,214082706,0,0,0,222.76,0,773988.04,11,4,1,12,True
7649643,160,0,10,8173,214082706,0,0,0,223.14,0,774211.18,24,5,20,1,True
7679135,729,0,10,9083,214082706,0,0,0,222.94,6,774434.12,11,2,1,1,True
7774447,127,1,451,4314,214082706,0,0,0,223.05,7,774211.07,18,2,5,1,False
8069053,266,2,25,6883,214082706,0,0,0,223.01,8,773988.06,6,5,14,2,True
8074578,787,0,10,9472,214082706,0,0,0,223.12,6,774211.18,14,2,3,2,True
8077104,1411,0,30,9472,214082706,0,0,0,222.99,8,773988.19,24,3,14,2,True
8132111,1411,0,30,8520,214082706,0,0,0,223.03,8,773765.16,24,6,11,3,True
8368869,1411,0,451,4544,214082706,0,0,0,222.96,7,773542.2,24,5,23,3,True
8370912,266,2,25,4544,214082706,0,0,0,223.15,8,773319.05,6,0,17,3,True
8683476,503,0,10,8173,214082706,0,0,0,223.25,0,773542.3,12,4,7,4,False
8707875,266,2,30,8308,214082706,0,0,0,222.91,8,773319.39,6,6,8,5,True
8799260,1134,1,451,3464,214082706,0,0,0,222.98,7,773096.41,24,1,13,7,True
8949266,81,0,451,5327,214082706,0,0,0,223.02,7,772873.39,1,3,2,7,True
9135137,81,0,30,3590,214082706,0,0,0,223.07,8,772650.32,1,0,0,8,True
9165337,1411,0,30,4091,214082706,0,0,0,222.71,8,772427.61,24,2,0,8,True
9505675,81,0,30,2362,214082706,0,0,0,222.97,8,772204.64,1,5,21,10,True
9542292,81,0,25,4091,214082706,0,0,0,223.04,8,771981.6,1,6,11,11,True
9814862,81,0,451,3178,214082706,0,0,0,222.83,7,771758.77,1,5,9,11,True
9979689,1411,0,30,2362,214082706,0,0,0,222.98,8,771535.79,24,6,21,11,True
1054607,1279,4,451,3694,260907808,0,0,0,161.92,7,627219.08,24,0,20,1,True
1206318,1384,4,451,1262,260907808,0,0,0,162.01,7,627057.07,24,5,11,1,True
1362894,1384,4,30,3694,260907808,0,0,0,162.3,8,626894.77,24,2,19,1,True
1464204,284,3,30,5254,260907808,0,0,0,162.15,8,626732.62,24,3,1,1,True
1610535,284,3,30,8007,260907808,0,0,0,161.63,8,626570.99,24,0,21,1,True
1664666,1317,4,451,5254,260907808,0,0,0,161.8,7,626409.19,18,1,13,2,True
1695725,327,0,10,8392,260907808,0,0,0,162.08,6,626571.27,11,0,6,2,True
1836488,284,3,451,3529,260907808,0,0,0,162.01,7,626409.26,24,2,5,2,True
1863426,1317,4,25,2676,260907808,0,0,0,162.11,8,626247.15,18,2,23,3,True
1893616,1455,2,20,3529,260907808,0,0,0,161.75,5,626085.4,11,5,18,4,True
1967458,1384,4,-1,3694,260907808,0,1,0,161.92,4,626085.4,24,1,20,4,True
2239489,1317,4,30,1663,260907808,0,0,0,161.87,8,625923.53,18,3,6,5,True
2993474,1317,4,-1,7539,260907808,0,1,0,162.09,1,625923.53,18,1,18,5,True
3259808,329,1,10,4132,260907808,0,0,0,162.06,0,626085.59,11,5,2,6,True
3317369,1476,0,20,7539,260907808,0,0,0,162.03,3,625923.56,24,5,20,7,True
3387941,1279,4,451,3529,260907808,0,0,0,161.89,7,625761.67,24,4,22,9,True
3761663,284,3,30,2863,260907808,0,0,0,162.1,8,625599.57,24,4,22,11,True
3816845,314,0,20,4132,260907808,0,0,0,161.94,5,625437.63,4,2,4,11,True
3929219,1256,2,30,1648,260907808,0,0,0,162.02,8,625275.61,23,2,9,12,True
3959199,1463,2,20,7539,260907808,0,0,0,162.0,5,625113.61,11,2,3,12,True
4158871,284,3,451,7189,260907808,0,0,0,161.87,7,624951.74,24,3,22,2,True
4163784,1256,2,-1,4083,260907808,0,1,0,162.01,4,624951.74,23,5,11,2,True
4234032,348,0,10,5290,260907808,0,0,0,162.02,0,625113.76,24,6,1,3,True
4272062,1384,4,451,7539,260907808,0,0,0,162.15,7,624951.61,24,1,5,4,True
4359555,284,3,451,1262,260907808,0,0,0,162.03,7,624789.58,24,6,2,5,True
4423588,1317,4,25,7307,260907808,0,0,0,162.15,8,624627.43,18,0,20,6,True
4558647,1384,4,451,2115,260907808,0,0,0,162.21,7,624465.22,24,2,10,6,True
4638424,284,3,-1,5254,260907808,0,1,0,162.01,4,624465.22,24,6,22,6,True
4719466,1384,4,25,9693,260907808,0,0,0,162.0,8,624303.22,24,5,14,7,True
4781245,1384,4,451,4132,260907808,0,0,0,161.75,7,624141.47,24,2,19,8,True
4782026,1027,0,10,7307,260907808,0,0,0,161.97,6,624303.44,11,3,21,8,True
4871658,1256,2,25,5290,260907808,0,0,0,162.21,8,624141.23,23,6,17,8,True
4944880,811,0,10,1663,260907808,0,0,0,162.09,6,624303.32,18,3,22,8,True
5100182,1017,2,20,8007,260907808,0,0,0,162.17,5,624141.15,26,0,4,8,True
5151156,1279,4,451,7342,260907808,0,0,0,162.07,7,623979.08,24,1,7,9,True
5399257,284,3,-1,4241,260907808,0,1,0,161.93,4,623979.08,24,1,11,9,True
5518712,284,3,30,4891,260907808,0,0,0,161.72,8,623817.36,24,5,3,9,True
5646277,284,3,30,4891,260907808,0,0,0,161.77,8,623655.59,24,3,16,11,True
5708489,1256,2,451,5290,260907808,0,0,0,162.05,7,623493.54,23,6,23,12,True
5784555,1384,4,-1,7539,260907808,0,1,0,162.12,1,623493.54,24,0,23,1,True
5790427,1279,4,25,6318,260907808,0,0,0,161.97,8,623331.57,24,1,4,2,True
5960240,1317,4,25,7189,260907808,0,0,0,162.05,8,623169.52,18,4,21,3,True
6117167,1384,4,25,6689,260907808,0,0,0,162.18,8,623007.34,24,2,0,4,True
6507968,1279,4,451,2863,260907808,0,0,0,162.09,7,622845.25,24,3,9,4,True
6573563,148,1,10,2115,260907808,0,0,0,161.6,0,623006.85,18,0,15,4,True
6700826,76,0,10,5290,260907808,0,0,0,161.81,6,623168.66,20,3,2,5,True
6792276,1256,2,451,4891,260907808,0,0,0,161.77,7,623006.89,23,3,3,5,True
7051476,97,0,20,4083,260907808,0,0,0,162.08,3,622844.81,3,1,3,6,False
7923146,1279,4,451,5812,260907808,0,0,0,162.11,7,622682.7,24,3,1,6,True
8143237,1317,4,25,5254,260907808,0,0,0,161.91,8,622520.79,18,4,1,7,True
8812372,1356,2,20,1648,260907808,0,0,0,162.11,5,622358.68,24,3,13,7,True
8985300,428,0,10,7342,260907808,0,0,0,162.31,6,622520.99,18,6,4,7,True
9203333,300,0,20,4241,260907808,0,0,0,161.94,5,622359.05,4,1,11,7,True
9696129,1384,4,30,5254,260907808,0,0,0,162.17,8,622196.88,24,2,20,9,True
9721851,1317,4,-1,4083,260907808,0,1,0,161.81,1,622196.88,18,4,12,10,True
9888671,284,3,451,4891,260907808,0,0,0,161.98,7,622034.9,24,5,23,11,True
1050270,965,4,451,7468,658283009,1,0,0,612.95,7,851037.05,13,1,0,1,True
1469614,357,4,25,5728,658283009,1,0,0,612.92,8,850424.13,24,3,2,3,True
1513825,357,4,30,5739,658283009,1,0,0,612.8,8,849811.33,24,0,15,3,True
1645362,1076,1,10,8609,658283009,1,0,0,612.91,6,850424.24,18,3,11,4,True
2152446,1429,0,20,5149,658283009,1,0,0,613.0,5,849811.24,24,3,22,5,True
2444631,1390,0,10,9118,658283009,1,0,0,612.84,0,850424.08,24,5,13,5,True
2480598,530,0,20,1518,658283009,1,0,0,612.8,5,849811.28,18,0,23,8,True
2561382,108,2,20,3246,658283009,1,0,0,612.91,5,849198.37,3,1,19,8,True
2565974,262,2,25,3312,658283009,1,0,0,613.01,8,848585.36,6,2,21,9,True
2667824,548,2,20,9752,658283009,1,0,0,613.12,3,847972.24,17,6,10,9,True
2796672,549,1,451,3312,658283009,1,0,0,613.25,7,847358.99,17,1,16,9,True
2819049,262,2,-1,2847,658283009,1,1,0,613.2,4,847358.99,6,6,15,10,True
3002403,29,0,10,8609,658283009,1,0,0,612.71,6,847971.7,11,5,11,10,True
3033462,537,0,10,3246,658283009,1,0,0,613.11,0,848584.81,18,6,3,10,True
3144164,1336,2,451,7664,658283009,1,0,0,613.19,7,847971.62,18,3,0,10,True
3242888,965,4,25,3246,658283009,1,0,0,612.97,8,847358.65,13,4,1,10,True
3377669,549,1,451,2362,658283009,1,0,0,613.01,7,846745.64,17,6,0,11,True
3443709,262,2,30,2847,658283009,1,0,0,613.05,8,846132.59,6,3,22,12,True
3614361,262,2,-1,9752,658283009,1,1,0,613.0,4,846132.59,6,3,12,1,True
3845685,965,4,451,9245,658283009,1,0,0,612.99,7,845519.6,13,5,18,1,True
3906177,234,0,10,2783,658283009,1,0,0,613.26,6,846132.86,26,6,6,1,True
4015300,262,2,25,7468,658283009,1,0,0,612.74,8,845520.12,6,5,9,4,True
4118764,549,1,-1,4223,658283009,1,1,0,612.84,1,845520.12,17,0,18,4,True
4295259,357,4,451,5179,658283009,1,0,0,613.31,7,844906.81,24,5,20,4,True
4784691,1336,2,451,7468,658283009,1,0,0,613.0,7,844293.81,18,1,3,4,True
4949929,965,4,25,7270,658283009,1,0,0,613.18,8,843680.63,13,3,10,5,True
5088946,818,1,10,7270,658283009,1,0,0,613.12,6,844293.75,18,4,17,5,True
5103322,1336,2,25,4466,658283009,1,0,0,613.17,8,843680.58,18,5,7,6,True
5848373,357,4,30,5728,658283009,1,0,0,612.98,8,843067.6,24,6,9,6,True
5860272,262,2,451,7671,658283009,1,0,0,612.71,7,842454.89,6,5,21,7,True
5933116,262,2,30,5728,658283009,1,0,0,613.19,8,841841.7,6,5,21,7,True
5979224,465,0,10,2783,658283009,1,0,0,612.94,6,842454.64,13,3,0,7,True
6001103,1336,2,451,7664,658283009,1,0,0,613.03,7,841841.61,18,1,4,8,True
6195451,549,1,30,2847,658283009,1,0,0,613.03,8,841228.58,17,2,21,8,True
6242756,357,4,30,3246,658283009,1,0,0,612.96,8,840615.62,24,1,19,9,True
6754315,549,1,451,7270,658283009,1,0,0,612.86,7,840002.76,17,0,14,9,True
6846713,428,0,20,2916,658283009,1,0,0,613.18,5,839389.58,18,5,19,9,True
6889318,1336,2,451,4131,658283009,1,0,0,612.88,7,838776.7,18,1,5,11,True
6963820,1336,2,451,7270,658283009,1,0,0,612.89,7,838163.81,18,0,0,1,True
6983674,262,2,451,5728,658283009,1,0,0,613.14,7,837550.67,6,3,21,1,True
7173089,701,2,20,3867,658283009,1,0,0,613.09,5,836937.58,18,0,2,1,True
7321181,253,2,20,9752,658283009,1,0,0,612.96,5,836324.62,6,5,1,2,True
7341349,549,1,30,2783,658283009,1,0,0,613.19,8,835711.43,17,0,22,3,True
7537852,965,4,25,1518,658283009,1,0,0,612.81,8,835098.62,13,3,0,3,False
7627926,1336,2,451,4223,658283009,1,0,0,613.06,7,834485.56,18,4,8,4,True
7668432,965,4,-1,5179,658283009,1,1,0,613.24,4,834485.56,13,4,8,6,True
7862483,262,2,25,4466,658283009,1,0,0,613.0,8,833872.56,6,4,13,6,True
8419172,262,2,-1,9978,658283009,1,1,0,613.09,4,833872.56,6,0,14,6,True
8457936,965,4,451,5179,658283009,1,0,0,613.12,7,833259.44,13,6,22,7,True
8506621,1336,2,451,7270,658283009,1,0,0,612.94,7,832646.5,18,4,14,8,False
8517735,549,1,451,3867,658283009,1,0,0,613.09,7,832033.41,17,4,18,8,False
9030314,1336,2,30,4466,658283009,1,0,0,612.84,8,831420.57,18,4,15,9,True
9398593,262,2,451,9118,658283009,1,0,0,612.94,7,830807.63,6,2,14,9,True
9513622,27,0,10,7468,658283009,1,0,0,613.18,0,831420.81,11,0,21,11,True
1227813,1434,0,20,3336,131225348,1,0,0,420.64,3,925262.36,24,1,7,2,True
1261140,1285,1,-1,2853,131225348,1,1,0,421.3,4,925262.36,24,1,2,5,True
1370869,568,1,-1,2853,131225348,1,2,0,421.02,4,925262.36,11,4,0,5,True
1772990,568,1,451,2258,131225348,1,0,0,421.01,7,924841.35,11,6,0,7,True
1801236,1285,1,451,4817,131225348,1,0,0,421.1,7,924420.25,24,1,14,7,True
2255217,1401,1,451,3523,131225348,1,0,0,420.95,7,923999.3,24,5,15,7,True
2315515,704,3,30,3742,131225348,1,0,0,420.89,8,923578.41,18,2,9,8,True
2339997,1401,1,30,3112,131225348,1,0,0,420.95,8,923157.46,24,4,23,8,False
2566294,454,1,25,9576,131225348,1,0,0,420.92,8,922736.54,13,4,16,10,True
2734868,939,0,10,2853,131225348,1,0,0,420.8,6,923157.34,24,2,16,11,True
2837681,568,1,451,2258,131225348,1,0,0,420.79,7,922736.55,11,4,1,11,True
2855111,704,3,25,2853,131225348,1,0,0,420.82,8,922315.73,18,2,6,11,True
2931508,850,1,451,8373,131225348,1,0,0,421.07,7,921894.66,5,2,4,11,False
3032431,503,0,10,8302,131225348,1,0,0,421.18,6,922315.84,12,0,20,12,True
3208723,1285,1,451,3099,131225348,1,0,0,421.15,7,921894.69,24,6,13,12,True
3250666,568,1,30,3336,131225348,1,0,0,421.02,8,921473.67,11,6,20,12,True
3314479,129,0,20,3523,131225348,1,0,0,420.87,3,921052.8,18,0,9,12,True
3327900,1285,1,25,4462,131225348,1,0,0,420.81,8,920631.99,24,4,8,1,True
3476842,850,1,451,5223,131225348,1,0,0,421.09,7,920210.9,5,6,4,1,True
3671689,1404,2,20,2258,131225348,1,0,0,421.03,5,919789.87,24,6,21,1,True
4120254,454,1,451,5223,131225348,1,0,0,421.18,7,919368.69,13,6,14,2,True
4566801,454,1,451,3112,131225348,1,0,0,421.18,7,918947.51,13,2,20,3,True
4880666,1401,1,451,5900,131225348,1,0,0,420.9,7,918526.61,24,0,14,3,True
4922464,1127,0,20,5900,131225348,1,0,0,421.04,3,918105.57,24,5,0,3,False
5446167,1160,0,10,4817,131225348,1,0,0,420.91,6,918526.48,15,3,5,3,True
5545503,1471,0,20,3742,131225348,1,0,0,421.06,5,918105.42,24,1,21,4,True
5638469,454,1,451,4378,131225348,1,0,0,420.77,7,917684.65,13,3,6,4,True
6314227,850,1,25,1308,131225348,1,0,0,420.88,8,917263.77,5,6,1,5,True
6347345,476,1,10,9576,131225348,1,0,0,421.01,0,917684.78,5,6,12,5,True
6362486,1486,2,20,3742,131225348,1,0,0,421.09,5,917263.69,24,1,14,6,True
6458868,454,1,25,3742,131225348,1,0,0,420.96,8,916842.73,13,4,3,7,True
6517205,1412,2,451,4462,131225348,1,0,0,421.28,7,916421.45,24,3,13,8,True
6708530,704,3,451,4093,131225348,1,0,0,421.12,7,916000.33,18,0,23,9,True
6809499,568,1,-1,3112,131225348,1,1,0,421.02,4,916000.33,11,3,20,10,True
6844045,807,0,20,2853,131225348,1,0,0,421.22,3,915579.11,11,3,3,10,True
7148360,816,0,20,3523,131225348,1,0,0,421.0,5,915158.11,18,4,23,10,True
7217303,850,1,25,5900,131225348,1,0,0,421.09,8,914737.02,5,1,5,10,True
7305675,350,0,10,7030,131225348,1,0,0,421.21,6,915158.23,24,1,16,10,True
7647174,182,1,10,3112,131225348,1,0,0,420.99,6,915579.22,18,4,19,11,True
7779677,568,1,451,3112,131225348,1,0,0,420.89,7,915158.33,11,5,2,11,True
8004626,641,0,10,2258,131225348,1,0,0,420.91,6,915579.24,24,2,0,12,True
8009987,1412,2,25,3099,131225348,1,0,0,421.03,8,915158.21,24,3,0,2,True
8160271,704,3,451,4462,131225348,1,0,0,420.86,7,914737.35,18,2,0,2,True
8333596,568,1,30,8949,131225348,1,0,0,421.0,8,914316.35,11,2,17,3,True
8537738,1412,2,451,5223,131225348,1,0,0,420.68,7,913895.67,24,5,20,3,True
8845119,1039,1,10,3742,131225348,1,0,0,421.09,0,914316.76,11,2,19,5,True
8924543,454,1,30,2853,131225348,1,0,0,421.0,8,913895.76,13,6,3,6,True
8978392,568,1,451,4462,131225348,1,0,0,420.84,7,913474.92,11,6,3,6,True
9049088,568,1,451,8373,131225348,1,0,0,420.57,7,913054.35,11,4,4,6,False
9619393,704,3,30,1308,131225348,1,0,0,421.17,8,912633.18,18,1,7,7,True
9697257,1285,1,451,4093,131225348,1,0,0,421.14,7,912212.04,24,3,0,8,True
9965010,1412,2,451,3742,131225348,1,0,0,421.01,7,911791.03,24,4,9,11,True
1070047,35,2,30,8116,229831613,1,0,0,627.77,8,352556.23,11,1,15,1,True
1125285,608,4,25,8753,229831613,1,0,0,627.74,8,351928.49,24,2,20,2,True
1192890,496,1,10,7239,229831613,1,0,0,628.04,6,352556.53,12,4,10,2,True
1539384,449,4,-1,9055,229831613,1,1,0,628.12,4,352556.53,13,5,13,3,True
1706391,704,3,-1,4823,229831613,1,2,0,628.1,4,352556.53,18,5,17,3,True
1934908,268,2,20,4076,229831613,1,0,0,628.07,3,351928.46,24,6,14,4,True
1939082,535,0,451,3906,229831613,1,0,0,627.96,7,351300.5,18,2,1,4,True
2332537,1101,2,25,9055,229831613,1,0,0,628.06,8,350672.44,0,0,7,4,True
2384364,704,3,-1,8116,229831613,1,1,0,628.01,4,350672.44,18,0,9,4,True
2448824,704,3,451,8116,229831613,1,0,0,627.87,7,350044.57,18,2,15,5,True
2505388,1283,2,20,5935,229831613,1,0,0,627.73,3,349416.84,24,1,4,5,True
2654212,535,0,-1,5935,229831613,1,1,0,628.19,1,349416.84,18,4,12,6,True
2930526,704,3,451,2390,229831613,1,0,0,628.19,7,348788.65,18,4,23,6,True
3114336,35,2,30,8754,229831613,1,0,0,628.05,8,348160.6,11,0,0,7,True
3142343,1101,2,30,7239,229831613,1,0,0,628.01,8,347532.59,0,6,15,7,True
3144901,84,4,25,2530,229831613,1,0,0,628.19,8,346904.4,1,0,10,7,True
3152441,449,4,451,3190,229831613,1,0,0,627.75,7,346276.65,13,3,23,7,True
3373107,449,4,30,3078,229831613,1,0,0,627.9,8,345648.75,13,0,13,9,True
3513563,704,3,-1,2080,229831613,1,1,0,627.92,1,345648.75,18,5,23,10,True
3550613,1064,0,10,9773,229831613,1,0,0,627.85,6,346276.6,11,4,8,12,True
3579584,261,3,30,4248,229831613,1,0,0,628.06,8,345648.54,6,0,13,12,True
3604172,84,4,451,9168,229831613,1,0,0,627.89,7,345020.65,1,5,22,12,True
3652639,608,4,451,5935,229831613,1,0,0,628.01,7,344392.64,24,0,23,1,True
3821984,726,0,10,7239,229831613,1,0,0,628.11,6,345020.75,11,1,2,2,True
3881432,1114,1,-1,4076,229831613,1,1,0,628.04,1,345020.75,0,4,8,3,True
4088495,496,1,10,5896,229831613,1,0,0,628.3,0,345649.05,12,5,8,3,True
4384594,608,4,30,1886,229831613,1,0,0,627.93,8,345021.12,24,1,5,6,True
4609377,679,0,10,5522,229831613,1,0,0,628.12,0,345649.24,24,2,13,7,True
5167755,314,0,20,8753,229831613,1,0,0,628.0,5,345021.24,4,4,11,7,True
5315333,608,4,451,1547,229831613,1,0,0,628.25,7,344392.99,24,1,17,8,True
5517159,145,0,10,4076,229831613,1,0,0,628.21,6,345021.2,18,1,11,8,True
5580652,1212,0,20,1886,229831613,1,0,0,628.09,5,344393.11,24,1,10,8,True
6034716,703,0,10,7956,229831613,1,0,0,628.22,0,345021.33,18,0,22,8,True
6170731,1114,1,-1,2928,229831613,1,1,0,627.89,1,345021.33,0,2,12,8,True
6218032,1114,1,451,1886,229831613,1,0,0,628.22,7,344393.11,0,1,6,9,True
6266647,261,3,-1,2080,229831613,1,1,0,628.0,4,344393.11,6,1,10,10,True
6309101,704,3,451,1521,229831613,1,0,0,628.06,7,343765.05,18,0,3,10,True
6472900,584,0,20,4057,229831613,1,0,0,628.02,5,343137.03,11,0,20,11,True
6705348,1114,1,30,3190,229831613,1,0,0,628.13,8,342508.9,0,5,15,12,True
6822985,1307,0,10,6675,229831613,1,0,0,627.89,6,343136.79,5,5,20,12,True
7115967,84,4,30,3609,229831613,1,0,0,628.08,8,342508.71,1,4,16,1,True
7189302,917,0,20,9168,229831613,1,0,0,627.95,5,341880.76,18,0,0,1,True
7289356,1114,1,25,8929,229831613,1,0,0,627.98,8,341252.78,0,2,6,1,True
7328223,1114,1,25,3906,229831613,1,0,0,627.94,8,340624.84,0,2,19,2,True
7509161,1101,2,30,7239,229831613,1,0,0,628.02,8,339996.82,0,4,16,4,True
7563799,261,3,451,1886,229831613,1,0,0,628.02,7,339368.8,6,0,1,5,True
7588798,608,4,25,2080,229831613,1,0,0,627.86,8,338740.94,24,3,11,6,True
7683636,35,2,-1,8116,229831613,1,1,0,627.9,4,338740.94,11,2,0,6,True
8240635,1201,0,20,3190,229831613,1,0,0,627.65,5,338113.29,24,3,5,7,True
8386676,704,3,-1,2390,229831613,1,1,0,628.08,4,338113.29,18,3,6,8,True
8773785,535,0,451,5935,229831613,1,0,0,627.98,7,337485.31,18,6,22,8,True
9048010,522,0,20,2109,229831613,1,0,0,627.76,5,336857.55,18,3,2,8,True
9441149,1201,0,20,9168,229831613,1,0,0,628.07,3,336229.48,24,3,8,8,True
9491695,84,4,451,4057,229831613,1,0,0,628.02,7,335601.46,1,5,18,11,True
9498165,84,4,25,6397,229831613,1,0,0,628.26,8,334973.2,1,3,7,11,True
1027473,811,0,20,7418,305428527,1,0,0,860.03,3,403711.97,18,5,9,1,True
1200824,390,4,451,4794,305428527,1,0,0,859.88,7,402852.09,10,2,18,2,True
1239413,576,2,20,8971,305428527,1,0,0,860.1,5,401991.99,11,5,19,3,True
1336160,538,0,10,8971,305428527,1,0,0,860.07,6,402852.06,18,1,15,4,True
1461466,239,1,10,9606,305428527,1,0,0,860.32,6,403712.38,26,5,16,4,True
1867253,1029,0,10,5485,305428527,1,0,0,860.33,6,404572.71,11,1,3,6,True
1985089,592,4,25,7418,305428527,1,0,0,860.0,8,403712.71,24,3,17,6,True
2004595,1369,3,30,4762,305428527,1,0,0,860.01,8,402852.7,16,4,16,7,True
2125891,1015,0,451,4828,305428527,1,0,0,860.14,7,401992.56,26,5,19,7,True
2339884,1439,4,25,3037,305428527,1,0,0,860.16,8,401132.4,24,4,23,10,True
2372969,607,2,20,4829,305428527,1,0,0,859.95,5,400272.45,24,0,10,10,True
2697945,1439,4,-1,8556,305428527,1,1,0,859.52,1,400272.45,24,5,20,12,True
2852883,68,0,10,6417,305428527,1,0,0,859.77,6,401132.22,20,5,9,12,True
3200343,858,1,451,6130,305428527,1,0,0,860.14,7,400272.08,24,3,20,12,True
3395497,1015,0,451,6417,305428527,1,0,0,860.17,7,399411.91,26,5,6,1,True
3816139,436,4,30,4794,305428527,1,0,0,860.31,8,398551.6,24,2,23,1,True
3981850,1439,4,451,4762,305428527,1,0,0,859.76,7,397691.84,24,5,18,1,True
4204460,390,4,25,4794,305428527,1,0,0,860.03,8,396831.81,10,1,7,2,True
4337930,22,3,30,9606,305428527,1,0,0,860.06,8,395971.75,11,4,5,3,True
4449855,949,4,25,3832,305428527,1,0,0,859.79,8,395111.96,24,6,20,4,True
4795427,585,2,20,9606,305428527,1,0,0,860.16,5,394251.8,11,0,15,4,True
4855678,858,1,451,5974,305428527,1,0,0,860.14,7,393391.66,24,5,9,4,True
4935303,1439,4,-1,4762,305428527,1,1,0,860.05,4,393391.66,24,6,23,5,True
5618032,858,1,-1,5930,305428527,1,2,0,860.07,4,393391.66,24,2,5,6,True
5629771,949,4,30,5974,305428527,1,0,0,859.89,8,392531.77,24,1,6,7,True
5847046,1439,4,-1,1820,305428527,1,1,0,860.28,4,392531.77,24,0,4,7,True
5900430,1015,0,451,6920,305428527,1,0,0,860.19,7,391671.58,26,3,11,8,True
5954527,1439,4,25,9606,305428527,1,0,0,860.0,8,390811.58,24,5,18,8,True
6089706,390,4,451,3832,305428527,1,0,0,859.87,7,389951.71,10,6,17,8,True
6386849,319,0,10,8556,305428527,1,0,0,860.15,0,390811.86,11,1,13,9,True
6841301,1369,3,30,4829,305428527,1,0,0,859.78,8,389952.08,16,0,10,10,True
7581633,858,1,25,5974,305428527,1,0,0,860.07,8,389092.01,24,2,6,10,True
7582160,1439,4,451,4762,305428527,1,0,0,860.03,7,388231.98,24,2,14,10,True
7646390,1052,0,20,5974,305428527,1,0,0,859.98,5,387372.0,11,2,14,12,True
7702830,1015,0,451,7418,305428527,1,0,0,860.06,7,386511.94,26,0,4,1,True
7800219,22,3,25,7418,305428527,1,0,0,860.32,8,385651.62,11,3,20,2,True
8161041,398,0,10,5485,305428527,1,0,0,860.08,6,386511.7,10,6,3,3,True
8603437,1232,1,10,4794,305428527,1,0,0,860.12,0,387371.82,18,0,17,3,True
8943120,1111,0,20,5930,305428527,1,0,0,860.12,5,386511.7,0,2,14,3,True
9028968,1369,3,451,3832,305428527,1,0,0,859.91,7,385651.79,16,2,4,4,True
9198621,858,1,30,5974,305428527,1,0,0,860.11,8,384791.68,24,5,18,4,True
9269444,1369,3,-1,5974,305428527,1,1,0,860.08,4,384791.68,16,5,15,5,False
9293991,653,1,10,7418,305428527,1,0,0,860.17,6,385651.85,24,3,10,7,True
9313319,193,1,10,2161,305428527,1,0,0,860.01,6,386511.86,18,1,23,8,True
9334440,949,4,30,4762,305428527,1,0,0,860.1,8,385651.76,24,0,10,8,True
9342066,436,4,30,3037,305428527,1,0,0,860.15,8,384791.61,24,1,20,10,True
9490193,858,1,-1,6920,305428527,1,1,0,860.23,4,384791.61,24,2,14,10,True
9593780,1439,4,25,3037,305428527,1,0,0,859.85,8,383931.76,24,3,19,10,True
9737045,1015,0,25,4829,305428527,1,0,0,860.09,8,383071.67,26,6,5,11,True
9794866,858,1,-1,8556,305428527,1,1,0,859.88,4,383071.67,24,2,23,11,True
1069626,1159,0,25,4323,420335531,1,0,0,710.87,8,775288.13,15,3,1,2,True
1258183,1159,0,25,6398,420335531,1,0,0,710.62,8,774577.51,15,6,8,2,True
1480768,471,0,10,3193,420335531,1,0,0,710.89,6,775288.4,5,0,11,2,True
1624845,1233,0,451,3193,420335531,1,0,0,711.04,7,774577.36,18,2,7,3,True
1754206,1391,2,20,4469,420335531,1,0,0,710.73,5,773866.63,24,5,21,6,True
1823224,571,4,25,8297,420335531,1,0,0,711.03,8,773155.6,11,0,10,7,True
1849897,1379,3,451,6707,420335531,1,0,0,710.92,7,772444.68,16,1,21,7,True
1945566,1379,3,30,1774,420335531,1,0,0,710.96,8,771733.72,16,0,9,7,True
2009239,1233,0,25,3604,420335531,1,0,0,711.0,8,771022.72,18,3,15,8,True
2023826,571,4,451,4902,420335531,1,0,0,710.77,7,770311.95,11,6,8,9,True
2374823,1379,3,30,6406,420335531,1,0,0,711.09,8,769600.86,16,4,13,11,True
2496358,199,0,10,6406,420335531,1,0,0,710.77,6,770311.63,18,2,1,11,True
2546434,1159,0,451,5085,420335531,1,0,0,711.01,7,769600.62,15,2,12,1,True
3004869,571,4,451,6872,420335531,1,0,0,710.87,7,768889.75,11,5,13,2,True
3055444,1379,3,451,6897,420335531,1,0,0,711.07,7,768178.68,16,5,6,2,True
3198008,260,0,20,9169,420335531,1,0,0,711.12,3,767467.56,6,5,19,2,True
3504488,1379,3,-1,6398,420335531,1,1,0,710.88,1,767467.56,16,0,0,2,True
3745511,1379,3,451,1774,420335531,1,0,0,710.89,7,766756.67,16,4,19,3,True
4020013,950,0,-1,3193,420335531,1,1,0,710.96,4,766756.67,24,6,18,3,True
4513208,571,4,-1,1330,420335531,1,2,0,710.92,4,766756.67,11,3,15,4,True
4544840,1159,0,451,1774,420335531,1,0,0,711.11,7,766045.56,15,2,13,5,True
4699194,950,0,25,8460,420335531,1,0,0,710.82,8,765334.74,24,3,9,5,True
4744333,1233,0,25,7620,420335531,1,0,0,710.94,8,764623.8,18,6,9,6,True
4817364,571,4,25,9169,420335531,1,0,0,710.9,8,763912.9,11,4,6,6,True
5063247,1233,0,30,8460,420335531,1,0,0,710.96,8,763201.94,18,6,6,8,True
5070447,1380,0,20,8234,420335531,1,0,0,710.92,3,762491.02,16,3,10,9,True
5106568,571,4,25,8297,420335531,1,0,0,710.8,8,761780.22,11,5,15,10,True
5177033,1159,0,-1,5085,420335531,1,1,0,710.92,4,761780.22,15,5,8,10,True
5324581,1379,3,30,4902,420335531,1,0,0,711.11,8,761069.11,16,0,13,10,True
5486277,571,4,-1,6406,420335531,1,1,0,711.0,4,761069.11,11,4,13,11,False
5518486,550,0,10,3193,420335531,1,0,0,711.1,0,761780.21,17,2,5,12,True
5923755,1159,0,451,5671,420335531,1,0,0,710.9,7,761069.31,15,2,20,12,False
6225225,571,4,30,4121,420335531,1,0,0,711.01,8,760358.3,11,2,9,12,True
6359684,1159,0,25,4469,420335531,1,0,0,711.03,8,759647.27,15,2,21,12,True
6523654,1233,0,-1,1330,420335531,1,1,0,710.82,4,759647.27,18,1,14,12,True
7118323,950,0,25,3313,420335531,1,0,0,710.86,8,758936.41,24,1,10,1,True
7215198,1233,0,25,5671,420335531,1,0,0,711.04,8,758225.37,18,5,3,1,True
7529237,1233,0,451,1403,420335531,1,0,0,711.18,7,757514.19,18,1,6,1,True
8038676,1233,0,30,3193,420335531,1,0,0,711.25,8,756802.94,18,2,7,1,True
8040888,96,0,10,3313,420335531,1,0,0,710.81,6,757513.75,1,3,9,1,True
8041173,1379,3,30,9169,420335531,1,0,0,710.99,8,756802.76,16,3,20,2,True
8395492,571,4,-1,4902,420335531,1,1,0,710.61,4,756802.76,11,5,16,3,True
8472144,1159,0,25,2631,420335531,1,0,0,711.1,8,756091.66,15,0,7,4,True
8698720,1159,0,30,6897,420335531,1,0,0,711.13,8,755380.53,15,4,8,5,True
8779456,571,4,30,9169,420335531,1,0,0,711.3,8,754669.23,11,2,4,6,True
8795798,1379,3,451,8460,420335531,1,0,0,710.94,7,753958.29,16,3,7,7,True
8823122,286,1,10,4469,420335531,1,0,0,710.99,0,754669.28,24,3,22,7,True
8920516,1379,3,451,7620,420335531,1,0,0,711.13,7,753958.15,16,6,13,7,True
9072707,991,1,10,4469,420335531,1,0,0,710.98,6,754669.13,22,6,2,8,True
9553504,571,4,-1,7620,420335531,1,1,0,711.01,4,754669.13,11,3,19,9,True
9609720,1233,0,30,1330,420335531,1,0,0,710.93,8,753958.2,18,4,2,10,True
1040475,554,4,451,5625,926691384,1,0,0,289.57,7,747617.43,17,3,12,1,True
1355684,444,2,20,2141,926691384,1,0,0,290.13,3,747327.3,24,5,14,2,True
1377324,1075,0,20,2902,926691384,1,0,0,290.11,5,747037.19,18,3,17,4,True
1617887,656,2,-1,5625,926691384,1,1,0,289.87,4,747037.19,18,3,21,4,True
1645128,656,2,-1,8403,926691384,1,2,0,289.96,4,747037.19,18,4,4,5,True
1645474,1164,0,20,1747,926691384,1,0,0,290.11,5,746747.08,24,6,1,5,True
1651895,1273,0,10,6774,926691384,1,0,0,289.93,0,747037.01,24,2,23,6,True
1903583,656,2,25,2902,926691384,1,0,0,290.01,8,746747.0,18,6,19,9,True
2131031,403,0,25,3296,926691384,1,0,0,290.23,8,746456.77,10,4,14,10,True
2141246,159,2,451,8403,926691384,1,0,0,289.88,7,746166.89,24,6,22,10,True
2141667,1212,0,20,5703,926691384,1,0,0,290.07,5,745876.82,24,0,6,10,True
2351389,1144,2,20,8880,926691384,1,0,0,289.72,3,745587.1,15,4,14,10,True
2370712,656,2,30,2902,926691384,1,0,0,290.33,8,745296.77,18,4,12,11,True
2542935,359,2,20,5703,926691384,1,0,0,290.09,5,745006.68,24,0,14,11,True
2564569,225,3,25,1088,926691384,1,0,0,289.81,8,744716.87,26,5,16,1,True
2606581,656,2,451,1747,926691384,1,0,0,289.99,7,744426.88,18,5,0,2,True
2684357,403,0,-1,8403,926691384,1,1,0,289.83,4,744426.88,10,1,2,2,True
2787599,225,3,451,2141,926691384,1,0,0,289.91,7,744136.97,26,1,13,2,True
2938718,225,3,-1,3296,926691384,1,1,0,289.84,1,744136.97,26,0,4,2,True
3339038,225,3,25,1939,926691384,1,0,0,290.21,8,743846.76,26,6,12,4,True
3417990,554,4,30,8880,926691384,1,0,0,289.86,8,743556.9,17,5,1,5,True
3552842,446,1,10,1939,926691384,1,0,0,289.92,0,743846.82,13,6,12,6,True
3989216,554,4,451,6774,926691384,1,0,0,289.94,7,743556.88,17,6,12,7,True
4011583,225,3,30,5237,926691384,1,0,0,290.25,8,743266.63,26,0,14,7,True
4242687,53,0,20,3769,926691384,1,0,0,289.58,5,742977.05,20,2,10,8,True
4379256,159,2,25,2902,926691384,1,0,0,290.06,8,742686.99,24,1,9,8,True
4423441,1303,0,10,2902,926691384,1,0,0,290.08,0,742977.07,5,3,4,8,True
4457661,350,0,20,1747,926691384,1,0,0,289.98,3,742687.09,24,1,0,9,True
4511800,96,0,20,5625,926691384,1,0,0,289.98,3,742397.11,1,5,12,11,True
4665547,842,2,20,1088,926691384,1,0,0,290.02,5,742107.09,5,6,7,11,True
4734618,159,2,451,3769,926691384,1,0,0,290.22,7,741816.87,24,4,17,11,True
5157839,576,2,20,5625,926691384,1,0,0,289.99,3,741526.88,11,6,13,12,True
5441094,1238,0,10,3769,926691384,1,0,0,289.75,0,741816.63,18,2,20,12,True
5602904,747,1,10,6774,926691384,1,0,0,290.34,6,742106.97,24,3,15,12,True
5645414,554,4,451,1088,926691384,1,0,0,290.13,7,741816.84,17,0,23,1,True
5889496,607,2,20,3024,926691384,1,0,0,290.05,5,741526.79,24,5,22,2,True
6167448,225,3,30,8880,926691384,1,0,0,290.05,8,741236.74,26,1,12,2,True
6825974,656,2,25,8403,926691384,1,0,0,289.94,8,740946.8,18,2,20,2,True
6912360,485,1,10,1724,926691384,1,0,0,289.93,6,741236.73,5,4,0,3,True
7155899,554,4,30,3769,926691384,1,0,0,290.04,8,740946.69,17,4,15,3,True
7558778,656,2,451,8403,926691384,1,0,0,289.97,7,740656.72,18,5,16,3,True
8522463,403,0,-1,2141,926691384,1,1,0,289.84,4,740656.72,10,2,16,5,True
8571311,225,3,25,8403,926691384,1,0,0,290.11,8,740366.61,26,6,16,5,True
8666259,225,3,25,3296,926691384,1,0,0,289.87,8,740076.74,26,4,16,5,True
8921097,1144,2,20,5625,926691384,1,0,0,289.89,5,739786.85,15,2,9,7,False
9018775,159,2,451,2141,926691384,1,0,0,289.64,7,739497.21,24,3,17,9,True
9278267,554,4,30,3769,926691384,1,0,0,289.96,8,739207.25,17,0,1,9,True
9683351,1382,0,10,3769,926691384,1,0,0,290.14,6,739497.39,16,6,3,10,True
9683545,554,4,451,5237,926691384,1,0,0,289.94,7,739207.45,17,3,0,10,True
9748032,403,0,451,3024,926691384,1,0,0,290.0,7,738917.45,10,3,22,10,True
9838185,484,0,10,1724,926691384,1,0,0,289.92,0,739207.37,5,1,1,10,True
9917052,159,2,451,8880,926691384,1,0,0,290.11,7,738917.26,24,2,2,11,True
9925214,225,3,30,6774,926691384,1,0,0,289.93,8,738627.33,26,2,14,11,True
1009068,282,2,20,1975,673168203,1,0,0,636.25,3,288138.75,24,3,23,1,True
1174199,1475,3,30,3071,673168203,1,0,0,636.15,8,287502.6,24,4,2,1,True
1294343,1155,0,10,1975,673168203,1,0,0,636.07,0,288138.67,15,6,21,3,True
1614773,257,1,451,1740,673168203,1,0,0,636.06,7,287502.61,6,4,17,5,True
1828454,993,0,10,3828,673168203,1,0,0,636.0,0,288138.61,22,6,12,5,True
1937940,712,0,20,1975,673168203,1,0,0,635.91,5,287502.7,18,3,3,6,True
2256367,303,0,10,9720,673168203,1,0,0,635.71,6,288138.41,4,2,15,8,True
2623622,436,4,30,5556,673168203,1,0,0,635.77,8,287502.64,24,2,19,8,True
2842516,1387,1,-1,7723,673168203,1,1,0,635.95,4,287502.64,24,4,7,8,False
2915273,1063,0,20,9720,673168203,1,0,0,635.84,5,286866.8,11,1,2,8,True
2928502,1387,1,-1,1975,673168203,1,1,0,636.04,4,286866.8,24,1,13,8,True
3211974,738,2,-1,3071,673168203,1,2,0,636.05,4,286866.8,11,3,0,9,True
3606749,257,1,451,8301,673168203,1,0,0,635.61,7,286231.19,6,6,6,11,True
3634899,594,0,10,5196,673168203,1,0,0,635.75,6,286866.94,24,2,17,12,True
4027819,257,1,30,7723,673168203,1,0,0,636.21,8,286230.73,6,0,8,12,True
4407985,257,1,-1,9720,673168203,1,1,0,635.8,1,286230.73,6,5,13,12,True
4536070,168,0,20,9720,673168203,1,0,0,635.79,5,285594.94,24,0,22,1,True
4576953,1387,1,25,2614,673168203,1,0,0,636.32,8,284958.62,24,3,4,1,True
4591936,738,2,30,5556,673168203,1,0,0,635.82,8,284322.8,11,4,0,1,True
4631662,257,1,451,9720,673168203,1,0,0,635.84,7,283686.96,6,4,5,1,True
4857213,738,2,30,3816,673168203,1,0,0,636.33,8,283050.63,11,5,20,2,True
4973195,145,0,20,9720,673168203,1,0,0,636.04,3,282414.59,18,0,6,3,True
4999450,436,4,-1,3828,673168203,1,1,0,635.79,4,282414.59,24,5,8,4,True
5015874,910,0,20,7723,673168203,1,0,0,635.85,5,281778.74,18,5,2,4,True
5179984,1387,1,25,7723,673168203,1,0,0,636.0,8,281142.74,24,1,5,4,True
5424269,1475,3,451,3071,673168203,1,0,0,635.92,7,280506.82,24,0,4,5,True
5524204,257,1,25,4013,673168203,1,0,0,635.92,8,279870.9,6,2,7,5,True
5567967,1387,1,30,3071,673168203,1,0,0,636.0,8,279234.9,24,0,19,5,True
5669048,1387,1,30,7723,673168203,1,0,0,636.36,8,278598.54,24,3,8,7,True
5770551,866,0,10,7723,673168203,1,0,0,636.08,6,279234.62,24,3,8,8,True
5988974,1475,3,451,8301,673168203,1,0,0,636.09,7,278598.53,24,1,15,8,True
6559130,1475,3,-1,3881,673168203,1,1,0,635.86,4,278598.53,24,0,19,9,True
6919563,889,0,20,2614,673168203,1,0,0,636.15,5,277962.38,27,0,23,10,True
6978603,249,0,10,6979,673168203,1,0,0,635.79,0,278598.17,6,4,18,10,True
7153911,738,2,451,4013,673168203,1,0,0,636.04,7,277962.13,11,4,17,11,True
7202069,436,4,451,6979,673168203,1,0,0,635.93,7,277326.2,24,1,0,11,True
7285247,738,2,-1,1975,673168203,1,1,0,635.96,1,277326.2,11,2,2,12,True
7686666,257,1,451,5556,673168203,1,0,0,636.09,7,276690.11,6,5,10,12,True
7776634,1475,3,451,9720,673168203,1,0,0,636.0,7,276054.11,24,2,15,12,True
7818431,1387,1,30,8301,673168203,1,0,0,636.55,8,275417.56,24,3,23,1,True
7853334,1475,3,-1,8301,673168203,1,1,0,636.01,1,275417.56,24,0,15,1,True
8126751,132,2,20,1740,673168203,1,0,0,636.01,5,274781.55,18,0,20,1,True
8488345,1387,1,451,3828,673168203,1,0,0,636.12,7,274145.43,24,3,4,2,True
8591061,257,1,451,6717,673168203,1,0,0,636.25,7,273509.18,6,2,18,5,True
8679451,1243,2,20,6717,673168203,1,0,0,635.8,3,272873.38,18,3,6,5,True
8759699,1475,3,30,5196,673168203,1,0,0,636.01,8,272237.37,24,3,15,5,True
8865903,1387,1,451,6717,673168203,1,0,0,636.0,7,271601.37,24,2,11,5,True
9003481,738,2,451,2614,673168203,1,0,0,635.87,7,270965.5,11,3,18,7,True
9019554,533,2,20,6717,673168203,1,0,0,636.12,5,270329.38,18,2,21,7,True
9052042,1387,1,451,1740,673168203,1,0,0,636.09,7,269693.29,24,5,7,8,True
9168248,436,4,-1,2614,673168203,1,1,0,635.93,4,269693.29,24,2,8,8,True
9174689,738,2,30,1975,673168203,1,0,0,635.78,8,269057.51,11,3,2,9,True
9247991,1436,0,20,9720,673168203,1,0,0,635.8,5,268421.71,24,2,5,9,False
9273990,436,4,25,1975,673168203,1,0,0,635.95,8,267785.76,24,2,10,9,True
9763925,1123,2,20,3071,673168203,1,0,0,635.72,3,267150.04,24,3,18,9,True
9871045,1475,3,30,9592,673168203,1,0,0,636.02,8,266514.02,24,1,15,9,True
9973637,1475,3,-1,1740,673168203,1,1,0,636.14,4,266514.02,24,5,21,11,True
1199739,503,0,20,1308,991618345,0,0,0,117.89,5,158758.11,12,2,1,1,False
1280017,52,4,30,1808,991618345,0,0,0,117.86,8,158640.25,20,1,15,2,True
1315570,1244,4,25,8570,991618345,0,0,0,117.85,8,158522.4,18,0,8,2,True
1386469,538,0,20,9219,991618345,0,0,0,118.13,5,158404.27,18,3,13,3,True
1510100,1035,0,20,4315,991618345,0,0,0,118.37,5,158285.9,11,0,23,3,True
1769994,866,0,10,1308,991618345,0,0,0,118.27,6,158404.17,24,2,17,4,True
2033110,846,3,30,9233,991618345,0,0,0,118.22,8,158285.95,5,2,13,4,True
2244747,372,0,20,2078,991618345,0,0,0,117.68,3,158168.27,25,4,3,4,True
2334276,52,4,451,7734,991618345,0,0,0,117.96,7,158050.31,20,0,12,5,True
2752866,103,3,451,8130,991618345,0,0,0,117.91,7,157932.4,3,4,14,5,True
2854720,518,2,451,9623,991618345,0,0,0,117.87,7,157814.53,18,3,22,5,True
2918963,52,4,451,6051,991618345,0,0,0,118.13,7,157696.4,20,6,17,5,False
2935283,52,4,451,6239,991618345,0,0,0,118.2,7,157578.2,20,2,19,6,True
3124847,734,0,10,2082,991618345,0,0,0,117.74,6,157695.94,11,4,2,6,True
3329334,53,0,451,8570,991618345,0,0,0,117.92,7,157578.02,20,0,11,8,True
3521176,353,1,10,8570,991618345,0,0,0,117.95,6,157695.97,24,3,6,9,True
3530991,1325,0,25,6043,991618345,0,0,0,117.86,8,157578.11,18,1,16,9,True
3577051,53,0,25,8503,991618345,0,0,0,118.2,8,157459.91,20,1,21,10,True
3590332,53,0,-1,2978,991618345,0,1,0,118.01,4,157459.91,20,3,8,10,True
3672555,53,0,30,1808,991618345,0,0,0,118.18,8,157341.73,20,6,9,10,True
3794544,518,2,451,2978,991618345,0,0,0,117.83,7,157223.9,18,5,19,11,True
3893047,846,3,30,8822,991618345,0,0,0,118.01,8,157105.89,5,3,10,12,True
3893578,53,0,451,7343,991618345,0,0,0,117.69,7,156988.2,20,3,11,12,True
4023386,695,2,-1,9233,991618345,0,1,0,118.28,1,156988.2,24,4,20,12,True
4032487,103,3,451,6239,991618345,0,0,0,118.08,7,156870.12,3,0,3,3,True
4156771,52,4,25,7655,991618345,0,0,0,117.91,8,156752.21,20,2,10,3,True
4496841,103,3,451,8054,991618345,0,0,0,118.04,7,156634.17,3,4,22,3,True
4736801,53,0,30,8570,991618345,0,0,0,118.02,8,156516.15,20,1,18,5,True
4957192,53,0,25,4222,991618345,0,0,0,118.07,8,156398.08,20,2,11,5,True
4958900,846,3,30,7241,991618345,0,0,0,117.97,8,156280.11,5,0,21,6,True
5289945,518,2,25,6051,991618345,0,0,0,118.0,8,156162.11,18,3,11,8,True
5343784,1325,0,451,8054,991618345,0,0,0,117.98,7,156044.13,18,6,3,9,True
5351007,103,3,-1,7343,991618345,0,1,0,117.66,1,156044.13,3,6,4,10,True
5369643,309,0,10,1808,991618345,0,0,0,118.19,0,156162.32,4,0,19,10,True
5474457,518,2,451,7241,991618345,0,0,0,117.87,7,156044.45,18,4,16,1,True
5532765,103,3,30,8130,991618345,0,0,0,117.97,8,155926.48,3,1,16,1,True
5579134,1325,0,30,1294,991618345,0,0,0,117.82,8,155808.66,18,5,3,2,True
5951995,103,3,25,9233,991618345,0,0,0,117.87,8,155690.79,3,3,17,3,True
5957401,471,0,20,7241,991618345,0,0,0,117.91,3,155572.88,5,6,19,4,True
6004875,695,2,30,1294,991618345,0,0,0,117.87,8,155455.01,24,0,8,5,True
6036566,103,3,451,8570,991618345,0,0,0,117.96,7,155337.05,3,5,20,5,True
6691030,103,3,451,3271,991618345,0,0,0,118.01,7,155219.04,3,2,21,5,True
6944984,783,0,20,3253,991618345,0,0,0,117.87,5,155101.17,14,0,20,6,True
7545045,52,4,451,2978,991618345,0,0,0,118.04,7,154983.13,20,1,17,6,True
7673932,846,3,-1,6043,991618345,0,1,0,117.74,4,154983.13,5,4,5,6,True
7697279,695,2,-1,2082,991618345,0,2,0,117.91,4,154983.13,24,1,8,6,True
7726955,518,2,30,3253,991618345,0,0,0,118.09,8,154865.04,18,4,12,6,True
7801044,1463,2,20,1308,991618345,0,0,0,118.18,5,154746.86,11,6,3,7,True
8010103,882,0,20,7241,991618345,0,0,0,117.88,5,154628.98,27,2,11,7,True
8112771,695,2,30,4113,991618345,0,0,0,117.77,8,154511.21,24,6,17,8,True
8303555,52,4,451,3271,991618345,0,0,0,118.03,7,154393.18,20,2,14,8,True
8390230,52,4,25,9547,991618345,0,0,0,117.96,8,154275.22,20,2,21,8,True
8474950,574,2,20,5843,991618345,0,0,0,118.19,5,154157.03,11,2,20,8,True
8719656,518,2,25,3271,991618345,0,0,0,118.08,8,154038.95,18,6,13,9,True
9410277,1325,0,30,7734,991618345,0,0,0,117.68,8,153921.27,18,3,22,10,False
9446363,695,2,30,4315,991618345,0,0,0,117.99,8,153803.28,24,2,22,10,True
9492689,1244,4,-1,7655,991618345,0,1,0,118.02,4,153803.28,18,2,10,11,True
1044977,728,1,25,2306,712762401,0,0,0,334.08,8,679646.92,11,2,12,2,True
1203316,1367,4,30,3396,712762401,0,0,0,333.73,8,679313.19,16,5,2,3,True
1204241,443,2,20,4124,712762401,0,0,0,334.04,5,678979.15,24,0,4,4,True
1306431,728,1,451,8010,712762401,0,0,0,333.95,7,678645.2,11,6,12,4,True
1319471,1328,4,-1,8010,712762401,0,1,0,333.97,4,678645.2,18,4,6,4,True
1563775,1465,4,451,5033,712762401,0,0,0,333.87,7,678311.33,11,1,8,5,True
1902835,496,1,10,9701,712762401,0,0,0,333.94,0,678645.27,12,3,18,5,True
1927171,1367,4,25,7444,712762401,0,0,0,334.05,8,678311.22,16,4,13,5,True
1959409,550,0,-1,3083,712762401,0,1,0,334.17,4,678311.22,17,1,3,6,True
2058013,413,4,-1,9784,712762401,0,2,0,333.89,1,678311.22,18,1,4,6,True
2385503,1328,4,451,4262,712762401,0,0,0,333.85,7,677977.37,18,3,16,6,True
2449406,1128,2,20,3083,712762401,0,0,0,334.37,3,677643.0,24,2,15,7,True
2675327,530,0,30,7223,712762401,0,0,0,334.05,8,677308.95,18,3,0,8,True
2684748,1228,4,25,9462,712762401,0,0,0,334.11,8,676974.84,18,1,16,9,False
3099161,564,0,10,7488,712762401,0,0,0,334.19,6,677309.03,17,3,0,9,True
3204629,728,1,451,4330,712762401,0,0,0,333.87,7,676975.16,11,1,15,10,True
3205649,530,0,-1,4124,712762401,0,1,0,334.04,4,676975.16,18,2,2,11,True
3435152,712,0,10,7366,712762401,0,0,0,333.8,0,677308.96,18,3,12,12,True
3761106,550,0,-1,4124,712762401,0,1,0,334.23,1,677308.96,17,3,14,12,True
3866457,413,4,25,4330,712762401,0,0,0,333.85,8,676975.11,18,5,6,12,True
4204249,327,0,20,7223,712762401,0,0,0,334.24,5,676640.87,11,2,14,1,True
4222636,728,1,25,6271,712762401,0,0,0,333.84,8,676307.03,11,3,23,1,True
4260364,530,0,-1,4330,712762401,0,1,0,334.36,4,676307.03,18,6,9,1,True
4885913,1465,4,30,3396,712762401,0,0,0,333.97,8,675973.06,11,5,21,3,True
4933793,413,4,25,7223,712762401,0,0,0,334.17,8,675638.89,18,6,3,3,True
5333678,413,4,25,9784,712762401,0,0,0,334.12,8,675304.77,18,4,15,4,True
5337411,1228,4,25,9701,712762401,0,0,0,333.88,8,674970.89,18,1,11,4,True
5457412,1314,2,20,2306,712762401,0,0,0,333.91,5,674636.98,5,0,17,4,True
5536533,854,0,10,4330,712762401,0,0,0,334.1,6,674971.08,24,5,7,6,True
5551337,195,1,10,3126,712762401,0,0,0,333.83,6,675304.91,18,0,11,7,True
6082776,413,4,451,9310,712762401,0,0,0,334.0,7,674970.91,18,3,23,8,True
6114135,1465,4,451,7444,712762401,0,0,0,333.88,7,674637.03,11,1,10,8,True
6217958,530,0,10,3126,712762401,0,0,0,334.08,0,674971.11,18,0,9,10,False
6242829,1228,4,-1,4394,712762401,0,1,0,333.95,4,674971.11,18,3,23,10,True
6371410,1465,4,451,9871,712762401,0,0,0,333.94,7,674637.17,11,2,19,10,True
6728835,487,4,-1,7366,712762401,0,1,0,333.89,4,674637.17,12,0,20,11,True
7141541,675,2,20,9310,712762401,0,0,0,334.11,5,674303.06,24,6,9,12,True
7404696,413,4,30,6057,712762401,0,0,0,333.94,8,673969.12,18,2,22,12,True
7411314,1411,0,20,9580,712762401,0,0,0,334.03,3,673635.09,24,1,9,1,True
7490359,579,0,10,5033,712762401,0,0,0,334.22,0,673969.31,11,3,6,2,True
7549572,1205,0,10,2948,712762401,0,0,0,334.0,6,674303.31,24,0,10,2,True
7843339,267,0,20,9310,712762401,0,0,0,334.08,3,673969.23,6,0,21,3,True
7942856,1367,4,-1,7223,712762401,0,1,0,334.04,4,673969.23,16,5,8,3,True
8069623,1412,2,20,5033,712762401,0,0,0,333.81,3,673635.42,24,1,15,4,True
8370005,1367,4,25,7366,712762401,0,0,0,333.78,8,673301.64,16,4,16,5,True
8517107,1367,4,451,7223,712762401,0,0,0,334.09,7,672967.55,16,6,19,6,True
8691110,1228,4,30,7488,712762401,0,0,0,333.64,8,672633.91,18,6,4,7,True
8746800,413,4,30,4330,712762401,0,0,0,334.21,8,672299.7,18,4,23,7,True
8760899,413,4,30,8950,712762401,0,0,0,333.86,8,671965.84,18,2,19,8,True
9040358,1465,4,30,3126,712762401,0,0,0,333.75,8,671632.09,11,3,21,10,True
9276123,1328,4,30,7223,712762401,0,0,0,333.69,8,671298.4,18,0,16,10,True
9378512,479,2,20,4394,712762401,0,0,0,333.87,3,670964.53,5,5,0,11,True
9504820,530,0,30,4394,712762401,0,0,0,334.13,8,670630.4,18,2,17,11,True
9625709,866,0,20,4262,712762401,0,0,0,334.03,5,670296.37,24,2,20,11,False
1100763,787,0,451,1858,754271714,1,0,0,339.99,7,116737.01,14,6,8,1,True
1236137,673,0,451,1438,754271714,1,0,0,339.94,7,116397.07,18,0,12,1,True
1296650,300,0,10,2294,754271714,1,0,0,339.87,6,116736.94,4,3,3,2,True
1459815,851,1,30,4547,754271714,1,0,0,339.98,8,116396.96,5,4,19,2,True
1774214,699,4,25,9980,754271714,1,0,0,340.05,8,116056.91,18,3,0,2,True
1856045,633,4,30,5866,754271714,1,0,0,339.91,8,115717.0,11,5,15,3,True
2071481,801,4,25,1777,754271714,1,0,0,339.88,8,115377.12,11,4,3,4,True
2617351,199,0,451,8725,754271714,1,0,0,339.85,7,115037.27,18,5,16,4,True
2697057,1239,1,10,5494,754271714,1,0,0,340.09,6,115377.36,18,6,19,5,True
2718952,1029,0,10,5494,754271714,1,0,0,340.06,0,115717.42,11,6,23,6,True
2844051,199,0,-1,2665,754271714,1,1,0,339.85,4,115717.42,18,1,9,7,True
3087017,633,4,30,2077,754271714,1,0,0,340.09,8,115377.33,11,0,18,8,True
3204039,699,4,451,8274,754271714,1,0,0,339.77,7,115037.56,18,3,23,8,True
3406130,633,4,-1,5478,754271714,1,1,0,339.94,1,115037.56,11,4,19,8,True
3416591,587,2,451,4865,754271714,1,0,0,339.79,7,114697.77,24,5,0,9,True
3803698,716,0,20,9321,754271714,1,0,0,339.88,5,114357.89,18,2,1,10,False
3941464,633,4,451,3920,754271714,1,0,0,340.07,7,114017.82,11,4,19,12,True
3987958,587,2,25,2665,754271714,1,0,0,340.14,8,113677.68,24,0,16,12,True
4158046,801,4,451,2077,754271714,1,0,0,339.83,7,113337.85,11,3,18,3,True
4370773,587,2,451,9858,754271714,1,0,0,339.6,7,112998.25,24,0,14,3,True
4547082,673,0,30,9980,754271714,1,0,0,340.16,8,112658.09,18,1,12,3,True
4732757,628,0,10,8274,754271714,1,0,0,339.95,6,112998.04,11,4,16,3,True
4759029,801,4,451,6066,754271714,1,0,0,339.9,7,112658.14,11,6,14,4,True
4802302,199,0,-1,4080,754271714,1,1,0,339.82,1,112658.14,18,2,20,4,True
4864599,319,0,10,5063,754271714,1,0,0,340.01,0,112998.15,11,3,18,4,True
4927982,673,0,451,2665,754271714,1,0,0,339.95,7,112658.2,18,4,10,4,True
4930730,633,4,30,6398,754271714,1,0,0,340.29,8,112317.91,11,1,4,5,True
4979180,673,0,25,9321,754271714,1,0,0,340.09,8,111977.82,18,6,16,5,True
5072183,391,3,451,9321,754271714,1,0,0,339.85,7,111637.97,10,5,10,5,True
5448257,529,2,20,4842,754271714,1,0,0,340.03,5,111297.94,18,4,18,6,True
5665089,673,0,451,2844,754271714,1,0,0,340.01,7,110957.93,18,1,3,8,True
5824289,587,2,-1,5116,754271714,1,1,0,340.31,4,110957.93,24,0,23,9,True
6141985,1467,0,10,8725,754271714,1,0,0,339.91,6,111297.84,11,2,20,9,True
6453296,699,4,-1,1438,754271714,1,1,0,340.08,1,111297.84,18,4,8,9,True
6678639,699,4,451,9926,754271714,1,0,0,340.02,7,110957.82,18,5,22,9,True
6724930,824,2,20,4865,754271714,1,0,0,339.72,5,110618.1,18,5,17,10,True
6946453,787,0,25,9858,754271714,1,0,0,340.05,8,110278.05,14,1,23,10,True
6994218,587,2,25,8274,754271714,1,0,0,339.78,8,109938.27,24,5,12,10,True
7148127,851,1,451,4865,754271714,1,0,0,339.74,7,109598.53,5,3,23,11,True
7149472,801,4,-1,1777,754271714,1,1,0,339.96,1,109598.53,11,6,23,11,True
7466159,851,1,30,4865,754271714,1,0,0,339.99,8,109258.54,5,0,0,11,True
7610550,633,4,451,2665,754271714,1,0,0,340.17,7,108918.37,11,5,8,12,True
7810655,787,0,-1,3920,754271714,1,1,0,339.9,4,108918.37,14,6,16,12,True
7819846,787,0,451,5063,754271714,1,0,0,339.94,7,108578.43,14,3,22,2,True
7900801,787,0,451,1777,754271714,1,0,0,339.85,7,108238.58,14,0,1,2,True
8221760,633,4,-1,2294,754271714,1,1,0,339.85,4,108238.58,11,4,16,3,True
8286778,712,0,20,9321,754271714,1,0,0,339.96,3,107898.62,18,5,18,3,True
8327236,699,4,-1,5063,754271714,1,1,0,340.09,4,107898.62,18,0,16,4,True
8443295,391,3,-1,5494,754271714,1,2,0,340.17,4,107898.62,10,0,11,6,True
8511864,391,3,451,2665,754271714,1,0,0,340.03,7,107558.59,10,2,7,6,True
8725942,787,0,451,8274,754271714,1,0,0,340.04,7,107218.55,14,2,22,6,True
8814184,587,2,25,5866,754271714,1,0,0,339.86,8,106878.69,24,4,3,8,True
9097330,787,0,25,8914,754271714,1,0,0,339.94,8,106538.75,14,0,7,8,True
9190897,607,2,20,1608,754271714,1,0,0,339.92,3,106198.83,24,2,22,8,True
9739144,633,4,451,9321,754271714,1,0,0,340.12,7,105858.71,11,2,3,8,True
9909991,587,2,25,1608,754271714,1,0,0,339.92,8,105518.79,24,3,12,10,False
1207620,641,0,10,6528,283474675,1,0,0,268.91,6,458374.91,24,3,14,1,True
1325452,479,2,451,9714,283474675,1,0,0,268.93,7,458105.98,5,4,11,1,True
1487040,695,2,30,9229,283474675,1,0,0,269.12,8,457836.86,24,2,19,1,True
1757991,525,0,30,4730,283474675,1,0,0,269.06,8,457567.8,18,3,21,2,True
1909986,913,0,20,6127,283474675,1,0,0,269.04,5,457298.76,18,4,1,2,True
2019569,101,3,451,2806,283474675,1,0,0,269.22,7,457029.54,3,4,16,3,True
2127618,44,4,-1,3989,283474675,1,1,0,268.98,4,457029.54,24,0,9,4,True
2563945,525,0,451,7024,283474675,1,0,0,269.04,7,456760.5,18,1,17,6,True
2614846,174,3,25,6912,283474675,1,0,0,269.13,8,456491.37,24,2,18,6,True
2739131,101,3,-1,7062,283474675,1,1,0,268.94,4,456491.37,3,2,19,7,True
2805201,81,0,20,2702,283474675,1,0,0,269.18,3,456222.19,1,4,5,8,True
2931492,525,0,451,6912,283474675,1,0,0,269.13,7,455953.06,18,3,8,8,True
3031921,101,3,30,2435,283474675,1,0,0,268.89,8,455684.17,3,2,15,10,True
3317571,734,0,30,4426,283474675,1,0,0,268.95,8,455415.22,11,3,1,11,True
3409371,174,3,25,6127,283474675,1,0,0,268.85,8,455146.37,24,3,17,12,True
3570636,101,3,-1,2814,283474675,1,1,0,269.09,4,455146.37,3,1,21,12,True
3652953,174,3,451,7862,283474675,1,0,0,269.12,7,454877.25,24,4,14,12,True
3665767,695,2,451,2814,283474675,1,0,0,269.12,7,454608.13,24,3,13,1,True
3721395,630,0,20,2806,283474675,1,0,0,268.98,3,454339.15,11,5,15,1,True
3963337,44,4,25,2465,283474675,1,0,0,269.14,8,454070.01,24,6,2,4,True
4074858,174,3,-1,2702,283474675,1,1,0,268.93,4,454070.01,24,1,13,6,True
4213547,174,3,30,3454,283474675,1,0,0,268.95,8,453801.06,24,6,12,6,True
4350765,695,2,-1,2435,283474675,1,1,0,269.09,4,453801.06,24,0,4,7,True
4798361,174,3,451,4426,283474675,1,0,0,268.98,7,453532.08,24,5,11,7,True
4909108,525,0,451,4373,283474675,1,0,0,268.87,7,453263.21,18,1,21,7,True
5465442,44,4,451,1558,283474675,1,0,0,269.06,7,452994.15,24,4,16,8,True
5678175,44,4,25,9714,283474675,1,0,0,269.19,8,452724.96,24,5,22,9,True
5689566,101,3,30,2806,283474675,1,0,0,268.81,8,452456.15,3,5,18,9,True
5708979,479,2,-1,9784,283474675,1,1,0,269.21,4,452456.15,5,2,20,9,True
5869698,101,3,25,9229,283474675,1,0,0,268.72,8,452187.43,3,0,9,10,True
5909163,1201,0,10,2806,283474675,1,0,0,268.86,6,452456.29,24,4,3,10,True
5934441,479,2,451,6912,283474675,1,0,0,269.13,7,452187.16,5,0,3,10,True
5985863,1111,0,10,1558,283474675,1,0,0,268.65,6,452455.81,0,6,16,10,True
6147307,174,3,451,9229,283474675,1,0,0,268.85,7,452186.96,24,6,15,11,True
6464080,44,4,-1,6509,283474675,1,1,0,269.0,4,452186.96,24,0,2,12,True
6642238,44,4,30,3233,283474675,1,0,0,269.32,8,451917.64,24,1,4,1,False
6863118,341,0,10,2814,283474675,1,0,0,269.2,0,452186.84,24,2,2,1,True
7245268,1445,2,20,9714,283474675,1,0,0,268.85,3,451917.99,24,5,16,2,True
7453479,44,4,25,6912,283474675,1,0,0,269.04,8,451648.95,24,0,2,4,True
7751883,101,3,451,6912,283474675,1,0,0,268.9,7,451380.05,3,2,8,4,True
7915711,479,2,-1,2465,283474675,1,1,0,269.02,4,451380.05,5,4,18,4,True
7974097,734,0,30,7460,283474675,1,0,0,268.92,8,451111.13,11,5,16,4,True
8070900,1315,0,20,5930,283474675,1,0,0,268.86,3,450842.27,5,1,19,5,True
8269411,695,2,451,3454,283474675,1,0,0,268.99,7,450573.28,24,5,0,5,True
8731346,734,0,451,2465,283474675,1,0,0,268.89,7,450304.39,11,4,23,8,True
8967723,101,3,30,3454,283474675,1,0,0,269.15,8,450035.24,3,2,17,8,True
9013836,44,4,25,7862,283474675,1,0,0,269.12,8,449766.12,24,0,14,9,True
9256126,44,4,451,9714,283474675,1,0,0,269.07,7,449497.05,24,4,10,10,True
9559717,537,0,10,2702,283474675,1,0,0,268.7,6,449765.75,18,6,13,10,True
9645645,734,0,451,9784,283474675,1,0,0,269.07,7,449496.68,11,5,21,10,True
9847718,525,0,30,3233,283474675,1,0,0,268.69,8,449227.99,18,3,15,11,False
1312907,1406,0,20,6781,326889782,0,0,0,533.94,5,998918.06,24,3,15,2,True
1454993,1382,0,10,7381,326889782,0,0,0,534.05,0,999452.11,16,0,15,3,True
2205196,1167,4,451,4698,326889782,0,0,0,534.04,7,998918.07,24,3,8,3,True
2231079,193,1,10,9598,326889782,0,0,0,533.97,0,999452.04,18,3,15,6,True
2276107,1167,4,25,7381,326889782,0,0,0,533.99,8,998918.05,24,1,22,7,True
2478991,1232,1,10,2622,326889782,0,0,0,533.84,6,999451.89,18,2,23,7,True
2491531,1317,4,451,1259,326889782,0,0,0,533.9,7,998917.99,18,3,21,9,True
2499031,1167,4,25,4698,326889782,0,0,0,533.97,8,998384.02,24,5,0,10,True
2748349,1144,2,451,5344,326889782,0,0,0,533.98,7,997850.04,15,4,9,10,True
3184527,325,0,10,6781,326889782,0,0,0,534.14,0,998384.18,11,0,7,12,True
3299666,116,0,10,4683,326889782,0,0,0,533.91,6,998918.09,3,0,17,12,True
3453338,1151,4,30,4698,326889782,0,0,0,534.29,8,998383.8,15,3,6,3,True
4378827,1167,4,30,6781,326889782,0,0,0,534.09,8,997849.71,24,3,12,3,True
4881985,1167,4,-1,2827,326889782,0,1,0,534.21,4,997849.71,24,0,1,4,True
4904367,1167,4,451,1869,326889782,0,0,0,534.27,7,997315.44,24,2,20,5,True
4916001,882,0,20,3346,326889782,0,0,0,533.84,5,996781.6,27,6,5,8,True
5025004,1167,4,-1,9259,326889782,0,1,0,533.78,1,996781.6,24,0,5,12,True
5190845,1151,4,25,5639,326889782,0,0,0,534.29,8,996247.31,15,4,23,2,True
5301183,841,1,30,1026,326889782,0,0,0,533.87,8,995713.44,5,1,18,4,True
5502570,502,0,20,1026,326889782,0,0,0,534.09,3,995179.35,12,2,9,4,True
5517135,1318,0,10,4698,326889782,0,0,0,534.0,6,995713.35,18,5,22,5,True
5997438,571,4,25,3826,326889782,0,0,0,533.97,8,995179.38,11,5,14,7,True
6414090,841,1,-1,3434,326889782,0,1,0,533.97,1,995179.38,5,0,15,7,True
6529381,27,0,10,3434,326889782,0,0,0,533.73,0,995713.11,11,5,4,8,True
6719383,1317,4,451,4270,326889782,0,0,0,534.3,7,995178.81,18,2,7,9,True
6739420,125,4,451,5923,326889782,0,0,0,533.99,7,994644.82,18,4,19,9,True
6791757,630,0,10,6745,326889782,0,0,0,533.73,6,995178.55,11,0,21,9,True
6853633,1033,4,-1,6870,326889782,0,1,0,534.22,4,995178.55,11,1,0,10,True
6865592,841,1,-1,6835,326889782,0,2,0,534.2,4,995178.55,5,3,17,11,True
7063470,571,4,-1,3346,326889782,0,3,1,533.75,1,0.0,11,2,17,11,True
1199164,204,0,-1,5130,302066811,1,1,0,320.97,1,261255.0,9,1,12,3,True
1238382,564,0,451,9148,302066811,1,0,0,320.74,7,260934.26,17,1,15,4,True
1277840,218,0,-1,1513,302066811,1,1,0,320.9,4,260934.26,9,6,17,5,True
1346263,611,0,20,4428,302066811,1,0,0,320.91,5,260613.35,11,0,13,5,True
1545510,392,4,451,4135,302066811,1,0,0,321.18,7,260292.17,10,5,0,6,True
1639711,564,0,451,6971,302066811,1,0,0,320.99,7,259971.18,17,0,21,6,True
1675392,392,4,-1,7098,302066811,1,1,0,320.7,1,259971.18,10,6,0,11,True
1793630,137,2,20,6136,302066811,1,0,0,320.92,5,259650.26,18,1,7,12,True
2019733,218,0,25,9453,302066811,1,0,0,321.14,8,259329.12,9,6,0,1,True
2054742,392,4,-1,9453,302066811,1,1,0,320.88,4,259329.12,10,0,1,1,True
2424193,748,1,10,9877,302066811,1,0,0,321.1,0,259650.22,24,1,8,2,True
2431711,1459,1,10,7098,302066811,1,0,0,321.15,6,259971.37,11,4,13,3,True
2444113,877,2,20,6332,302066811,1,0,0,321.03,3,259650.34,24,0,12,3,True
2573425,392,4,30,1207,302066811,1,0,0,321.04,8,259329.3,10,4,12,3,True
2910562,392,4,451,9653,302066811,1,0,0,320.81,7,259008.49,10,1,18,4,True
2920287,977,4,30,6869,302066811,1,0,0,321.16,8,258687.33,22,5,19,5,True
3128588,1009,0,10,4282,302066811,1,0,0,320.96,0,259008.29,26,1,22,5,True
3290759,977,4,451,3263,302066811,1,0,0,321.27,7,258687.02,22,0,12,5,True
3689139,318,0,10,8752,302066811,1,0,0,321.25,6,259008.27,11,2,11,6,True
3818976,716,0,20,1036,302066811,1,0,0,321.03,5,258687.24,18,1,22,6,True
4131925,183,1,10,1036,302066811,1,0,0,320.99,0,259008.23,18,5,13,6,True
4412855,392,4,25,1207,302066811,1,0,0,320.96,8,258687.27,10,4,4,8,True
4601276,662,1,10,5130,302066811,1,0,0,320.88,0,259008.15,18,4,4,9,True
4827327,299,1,10,3227,302066811,1,0,0,321.07,6,259329.22,4,4,20,9,True
5216012,204,0,-1,1720,302066811,1,1,0,321.07,4,259329.22,9,2,22,10,True
5230065,538,0,20,9653,302066811,1,0,0,320.87,5,259008.35,18,0,21,10,True
5383151,977,4,-1,9148,302066811,1,1,0,321.0,4,259008.35,22,4,4,10,True
6064082,392,4,451,4135,302066811,1,0,0,320.98,7,258687.37,10,5,3,11,True
6117970,1065,0,20,7487,302066811,1,0,0,321.09,3,258366.28,11,1,14,11,True
6228178,977,4,451,8752,302066811,1,0,0,320.84,7,258045.44,22,2,6,11,True
6255908,204,0,451,3729,302066811,1,0,0,320.91,7,257724.53,9,2,14,11,True
6342988,392,4,451,7098,302066811,1,0,0,320.98,7,257403.55,10,5,20,12,True
6344264,392,4,451,1207,302066811,1,0,0,321.01,7,257082.54,10,1,19,2,True
6459573,392,4,-1,9653,302066811,1,1,0,321.11,4,257082.54,10,1,17,2,True
6513698,204,0,30,7098,302066811,1,0,0,321.11,8,256761.43,9,3,23,2,True
6994818,564,0,451,9653,302066811,1,0,0,321.01,7,256440.42,17,2,6,2,True
7144288,204,0,30,5130,302066811,1,0,0,321.02,8,256119.4,9,2,9,3,True
7363143,564,0,451,6332,302066811,1,0,0,321.14,7,255798.26,17,1,22,3,True
8137055,218,0,30,7487,302066811,1,0,0,321.16,8,255477.1,9,6,12,3,True
8181762,392,4,451,1207,302066811,1,0,0,320.92,7,255156.18,10,1,3,4,True
8576893,1063,0,20,5186,302066811,1,0,0,320.86,5,254835.32,11,2,19,5,True
8871317,1093,0,20,8784,302066811,1,0,0,320.9,5,254514.42,18,0,14,6,True
8949075,392,4,25,4135,302066811,1,0,0,321.2,8,254193.22,10,3,13,6,True
9186201,977,4,30,3263,302066811,1,0,0,320.87,8,253872.35,22,4,1,7,True
9205944,557,1,10,6332,302066811,1,0,0,321.04,6,254193.39,17,1,4,7,True
9223896,204,0,451,4282,302066811,1,0,0,321.13,7,253872.26,9,5,8,7,True
9308127,794,2,20,9877,302066811,1,0,0,321.13,5,253551.13,11,2,15,9,True
9528055,392,4,-1,8784,302066811,1,1,0,321.06,4,253551.13,10,1,2,9,True
9624787,204,0,451,4135,302066811,1,0,0,321.03,7,253230.1,9,5,8,9,True
9657628,204,0,-1,5130,302066811,1,1,0,320.99,4,253230.1,9,6,22,9,True
1245739,192,2,20,2968,856512306,0,0,0,898.09,5,845490.91,18,2,15,1,True
1445751,469,4,451,2755,856512306,0,0,0,897.94,7,844592.97,5,3,19,1,True
1591007,1132,0,25,2755,856512306,0,0,0,898.02,8,843694.95,24,5,15,2,True
1720776,807,0,30,2755,856512306,0,0,0,897.8,8,842797.15,11,0,9,2,True
1791809,1429,0,20,2968,856512306,0,0,0,898.23,3,841898.92,24,4,3,3,True
1841679,469,4,25,4262,856512306,0,0,0,898.04,8,841000.88,5,6,19,3,True
1851791,807,0,25,1996,856512306,0,0,0,898.28,8,840102.6,11,6,13,3,True
1935560,807,0,25,2453,856512306,0,0,0,897.84,8,839204.76,11,2,6,4,True
2019166,429,0,30,4461,856512306,0,0,0,898.13,8,838306.63,24,1,4,5,True
2227904,1132,0,30,4192,856512306,0,0,0,898.02,8,837408.61,24,1,19,6,True
2551334,807,0,25,9574,856512306,0,0,0,898.0,8,836510.61,11,5,11,6,True
2556454,469,4,30,4262,856512306,0,0,0,898.27,8,835612.34,5,4,2,7,True
2638811,1132,0,451,2067,856512306,0,0,0,898.12,7,834714.22,24,3,19,7,True
2954104,1132,0,30,4192,856512306,0,0,0,898.25,8,833815.97,24,5,12,8,True
2980210,1026,4,-1,1996,856512306,0,1,0,897.84,4,833815.97,11,6,12,8,True
3035912,807,0,451,4262,856512306,0,0,0,898.32,7,832917.65,11,2,16,9,True
3057405,816,0,20,2755,856512306,0,0,0,898.03,5,832019.62,18,4,22,11,True
3091296,303,0,20,2852,856512306,0,0,0,897.95,5,831121.67,4,5,22,12,True
3225099,1026,4,-1,2067,856512306,0,1,0,898.09,1,831121.67,11,5,9,12,True
3512764,1026,4,-1,9574,856512306,0,2,0,898.09,1,831121.67,11,2,0,12,True
3594741,1026,4,451,2153,856512306,0,0,0,898.07,7,830223.6,11,3,6,12,True
3696727,469,4,451,2067,856512306,0,0,0,897.87,7,829325.73,5,2,10,12,True
4153550,807,0,-1,1996,856512306,0,1,0,898.18,4,829325.73,11,3,5,1,True
4240271,1387,1,10,2968,856512306,0,0,0,898.42,6,830224.15,24,3,23,3,True
4245064,469,4,451,7344,856512306,0,0,0,897.95,7,829326.2,5,4,15,3,True
4382664,807,0,-1,4192,856512306,0,1,0,898.25,4,829326.2,11,1,20,3,True
4516237,807,0,25,4192,856512306,0,0,0,897.97,8,828428.23,11,5,8,3,True
4625822,429,0,451,9182,856512306,0,0,0,897.92,7,827530.31,24,3,1,4,True
4979519,1116,0,10,7344,856512306,0,0,0,897.89,6,828428.2,24,4,19,4,True
5111099,1426,1,10,4461,856512306,0,0,0,897.82,6,829326.02,24,6,6,4,True
5132907,1026,4,25,4461,856512306,0,0,0,898.02,8,828428.0,11,4,7,5,True
5183692,834,0,20,6271,856512306,0,0,0,897.92,5,827530.08,5,3,6,5,True
5294255,429,0,25,2755,856512306,0,0,0,897.91,8,826632.17,24,5,22,5,True
5516683,469,4,451,2067,856512306,0,0,0,897.98,7,825734.19,5,4,1,8,True
5650638,429,0,-1,9182,856512306,0,1,0,897.99,4,825734.19,24,3,12,8,True
5939475,996,0,10,9182,856512306,0,0,0,898.07,6,826632.26,26,3,18,9,True
5946894,469,4,451,7344,856512306,0,0,0,897.94,7,825734.32,5,0,23,9,True
5959216,1132,0,25,4461,856512306,0,0,0,897.95,8,824836.37,24,5,15,9,True
6299941,1132,0,-1,9574,856512306,0,1,0,898.11,4,824836.37,24,2,13,10,False
6365021,807,0,25,1606,856512306,0,0,0,897.83,8,823938.54,11,2,3,12,True
6379603,1026,4,-1,2067,856512306,0,1,0,898.28,1,823938.54,11,1,15,12,True
6855980,705,1,10,2153,856512306,0,0,0,897.94,6,824836.48,18,2,19,1,True
6886812,807,0,30,9352,856512306,0,0,0,898.05,8,823938.43,11,6,2,1,False
7398131,848,2,20,4192,856512306,0,0,0,898.2,5,823040.23,5,2,0,2,True
7448459,469,4,-1,4192,856512306,0,1,0,897.93,4,823040.23,5,0,10,2,True
7628470,1026,4,30,1996,856512306,0,0,0,897.94,8,822142.29,11,0,16,3,True
7665941,429,0,30,2968,856512306,0,0,0,898.05,8,821244.24,24,4,6,3,True
7862923,812,0,10,1606,856512306,0,0,0,897.64,0,822141.88,18,2,15,4,True
8109978,195,1,10,1606,856512306,0,0,0,898.01,6,823039.89,18,6,11,4,True
8504996,1132,0,30,1996,856512306,0,0,0,897.91,8,822141.98,24,0,5,4,True
8670314,1401,1,10,2067,856512306,0,0,0,898.07,0,823040.05,24,6,5,6,True
8777784,1132,0,25,7344,856512306,0,0,0,897.97,8,822142.08,24,6,14,6,True
9062410,807,0,25,9574,856512306,0,0,0,897.88,8,821244.2,11,2,23,7,True
9452180,616,1,10,9182,856512306,0,0,0,898.01,6,822142.21,11,1,22,8,True
9600045,469,4,-1,7344,856512306,0,1,0,898.0,1,822142.21,5,4,10,9,True
9695044,429,0,451,4262,856512306,0,0,0,898.04,7,821244.17,24,1,18,10,True
9829766,1035,0,10,1996,856512306,0,0,0,898.13,0,822142.3,11,0,15,10,True
9901773,1026,4,451,5046,856512306,0,0,0,897.85,7,821244.45,11,0,15,10,True
9908344,807,0,25,9352,856512306,0,0,0,898.21,8,820346.24,11,6,4,11,True
1119689,333,1,451,2892,769945989,1,0,0,182.97,7,125771.03,11,4,15,1,False
1240674,1451,1,10,8005,769945989,1,0,0,182.98,6,125954.01,11,6,18,2,True
1257984,907,0,20,4417,769945989,1,0,0,182.74,5,125771.27,2,0,16,2,True
1544075,207,4,451,4390,769945989,1,0,0,183.1,7,125588.17,9,0,20,2,True
1647236,1413,0,-1,4417,769945989,1,1,0,183.09,4,125588.17,24,0,6,3,True
1954296,514,4,25,4851,769945989,1,0,0,183.01,8,125405.16,12,3,4,3,True
2247044,1413,0,25,4679,769945989,1,0,0,183.15,8,125222.01,24,6,20,4,True
2314354,514,4,30,8151,769945989,1,0,0,183.29,8,125038.72,12,1,5,6,True
2440733,202,4,451,8005,769945989,1,0,0,182.85,7,124855.87,9,5,15,6,True
2518306,424,1,10,3716,769945989,1,0,0,182.93,6,125038.8,18,4,6,7,True
2533701,1284,2,20,4851,769945989,1,0,0,182.83,3,124855.97,24,2,1,8,True
2789293,1273,0,30,8005,769945989,1,0,0,183.0,8,124672.97,24,0,18,10,True
2945983,202,4,25,2892,769945989,1,0,0,183.2,8,124489.77,9,3,0,11,True
3763537,207,4,25,4679,769945989,1,0,0,183.21,8,124306.56,9,4,12,11,True
3850969,207,4,-1,4558,769945989,1,1,0,183.14,1,124306.56,9,6,23,11,True
4156509,1413,0,-1,6175,769945989,1,2,0,183.05,1,124306.56,24,0,6,11,True
4388504,949,4,25,4390,769945989,1,0,0,182.79,8,124123.77,24,5,3,12,True
4511419,207,4,-1,3716,769945989,1,1,0,182.95,4,124123.77,9,5,18,12,True
4794688,1025,1,10,3716,769945989,1,0,0,182.95,6,124306.72,11,4,18,12,True
4825812,1413,0,25,4851,769945989,1,0,0,182.95,8,124123.77,24,6,16,1,True
5007132,1044,0,10,2735,769945989,1,0,0,182.8,6,124306.57,11,3,17,3,True
5071506,77,4,25,5511,769945989,1,0,0,183.01,8,124123.56,1,0,10,4,True
5112552,900,1,-1,4417,769945989,1,1,0,182.93,1,124123.56,24,2,5,4,True
5131352,202,4,30,2648,769945989,1,0,0,183.05,8,123940.51,9,5,14,5,True
5391888,514,4,451,8855,769945989,1,0,0,182.75,7,123757.76,12,5,15,5,True
5675560,1273,0,451,5356,769945989,1,0,0,182.91,7,123574.85,24,5,3,6,True
5793712,825,2,20,2648,769945989,1,0,0,182.98,3,123391.87,18,2,4,6,True
5876016,1273,0,451,4699,769945989,1,0,0,182.87,7,123209.0,24,1,9,7,True
5876585,207,4,451,1793,769945989,1,0,0,182.82,7,123026.18,9,5,14,7,True
6388809,77,4,30,4699,769945989,1,0,0,183.06,8,122843.12,1,3,4,8,True
6618927,76,0,10,1793,769945989,1,0,0,183.14,6,123026.26,20,0,23,8,True
6687702,207,4,25,2892,769945989,1,0,0,183.0,8,122843.26,9,2,13,9,True
6907914,333,1,451,8005,769945989,1,0,0,182.96,7,122660.3,11,6,17,9,True
7054418,333,1,451,6175,769945989,1,0,0,182.84,7,122477.46,11,3,12,10,True
7465645,1164,0,20,5511,769945989,1,0,0,183.42,5,122294.04,24,5,9,11,True
7663012,333,1,25,4417,769945989,1,0,0,183.14,8,122110.9,11,5,4,11,True
7707781,537,0,20,8855,769945989,1,0,0,182.87,5,121928.03,18,6,15,12,True
7773858,512,0,10,8855,769945989,1,0,0,182.94,6,122110.97,12,1,2,1,True
7972047,207,4,451,4851,769945989,1,0,0,182.85,7,121928.12,9,0,7,1,True
7972773,319,0,10,8151,769945989,1,0,0,182.99,6,122111.11,11,4,9,2,True
8007864,1273,0,25,4699,769945989,1,0,0,183.0,8,121928.11,24,4,21,2,True
8033549,202,4,451,5356,769945989,1,0,0,183.0,7,121745.11,9,3,9,4,True
8232240,1102,2,20,6175,769945989,1,0,0,183.02,5,121562.09,0,0,11,4,True
8306910,333,1,451,9363,769945989,1,0,0,182.85,7,121379.24,11,3,0,5,True
8634160,329,1,10,4390,769945989,1,0,0,183.07,6,121562.31,11,5,21,7,True
8700136,202,4,30,2735,769945989,1,0,0,182.98,8,121379.33,9,3,6,8,True
8761196,202,4,30,4930,769945989,1,0,0,183.01,8,121196.32,9,6,3,9,True
8867816,1012,0,20,5511,769945989,1,0,0,182.98,5,121013.34,26,3,19,9,True
9115761,77,4,30,8005,769945989,1,0,0,183.04,8,120830.3,1,2,7,9,True
9169175,900,1,451,6175,769945989,1,0,0,182.93,7,120647.37,24,4,16,9,True
9404714,1467,0,10,2735,769945989,1,0,0,182.94,6,120830.31,11,2,22,10,True
9649521,202,4,30,6175,769945989,1,0,0,182.97,8,120647.34,9,3,23,11,True
9697750,207,4,25,2892,769945989,1,0,0,182.86,8,120464.48,9,3,3,11,True
9740624,1413,0,451,4699,769945989,1,0,0,183.33,7,120281.15,24,5,3,11,True
9808903,900,1,-1,9363,769945989,1,1,0,183.02,4,120281.15,24,5,7,11,True
1006068,166,4,25,6501,983146468,1,0,0,913.02,8,116716.98,24,1,11,1,True
1017152,589,1,451,6877,983146468,1,0,0,912.92,7,115804.06,24,0,1,1,True
1057609,166,4,30,9450,983146468,1,0,0,912.88,8,114891.18,24,3,20,2,True
1058780,166,4,-1,5226,983146468,1,1,0,912.99,1,114891.18,24,4,9,2,True
1171980,166,4,25,2733,983146468,1,0,0,912.63,8,113978.55,24,4,10,3,True
1342498,215,0,25,1875,983146468,1,0,0,913.07,8,113065.48,9,5,0,3,True
1483549,883,0,-1,2733,983146468,1,1,0,913.05,1,113065.48,24,0,14,3,True
1632153,1167,4,30,6493,983146468,1,0,0,913.14,8,112152.34,24,1,10,3,True
1826398,1243,2,20,3911,983146468,1,0,0,912.81,5,111239.53,18,5,8,5,True
1832301,166,4,451,1875,983146468,1,0,0,913.23,7,110326.3,24,1,5,5,True
1991626,589,1,30,6877,983146468,1,0,0,912.97,8,109413.33,24,5,9,5,True
2209340,154,4,451,6501,983146468,1,0,0,913.02,7,108500.31,18,5,11,5,True
2225777,215,0,30,6501,983146468,1,0,0,912.95,8,107587.36,9,0,13,6,True
2556311,681,2,20,4047,983146468,1,0,0,912.81,3,106674.55,24,3,20,6,True
2895472,1429,0,10,1237,983146468,1,0,0,912.74,6,107587.29,24,5,17,7,True
2959839,1072,0,25,7838,983146468,1,0,0,913.0,8,106674.29,18,5,17,8,True
3040085,118,2,20,7947,983146468,1,0,0,913.02,3,105761.27,18,0,22,9,True
3133777,589,1,451,6391,983146468,1,0,0,913.05,7,104848.22,24,3,22,10,True
3154323,467,0,20,9027,983146468,1,0,0,912.87,3,103935.35,5,0,17,10,True
3669122,883,0,30,2538,983146468,1,0,0,913.0,8,103022.35,24,5,14,10,False
3865807,883,0,451,6875,983146468,1,0,0,913.12,7,102109.23,24,2,20,11,True
3995930,1477,2,25,7076,983146468,1,0,0,913.09,8,101196.14,24,6,21,12,True
4231057,154,4,30,7292,983146468,1,0,0,912.97,8,100283.17,18,2,8,12,True
4266611,1027,0,10,9027,983146468,1,0,0,913.02,6,101196.19,11,1,8,2,True
4311143,1072,0,451,6391,983146468,1,0,0,913.01,7,100283.18,18,1,19,3,True
4599538,1167,4,25,9508,983146468,1,0,0,913.07,8,99370.11,24,0,5,4,True
4787548,154,4,30,3911,983146468,1,0,0,913.13,8,98456.98,18,4,21,4,True
4898290,883,0,-1,6391,983146468,1,1,0,912.85,4,98456.98,24,5,13,5,True
5199943,128,0,10,6875,983146468,1,0,0,913.15,6,99370.13,18,4,3,6,True
5216071,1483,0,20,9450,983146468,1,0,0,913.17,5,98456.96,24,0,6,7,True
5372091,1072,0,451,1204,983146468,1,0,0,913.26,7,97543.7,18,2,18,7,True
5585228,589,1,-1,9508,983146468,1,1,0,912.98,4,97543.7,24,6,3,8,True
5991679,215,0,30,6875,983146468,1,0,0,913.08,8,96630.62,9,2,19,8,True
6108105,1151,4,25,6493,983146468,1,0,0,913.03,8,95717.59,15,2,3,10,True
6232126,509,0,20,1619,983146468,1,0,0,912.87,5,94804.72,12,0,5,10,True
6513142,1477,2,-1,9027,983146468,1,1,0,913.26,4,94804.72,24,5,3,11,True
6529371,129,0,10,1237,983146468,1,0,0,912.74,6,95717.46,18,4,3,11,True
6587002,695,2,20,4047,983146468,1,0,0,913.05,3,94804.41,24,4,1,1,True
7215830,883,0,451,7370,983146468,1,0,0,913.04,7,93891.37,24,0,22,1,True
7330989,158,2,20,2733,983146468,1,0,0,912.98,5,92978.39,24,6,19,1,True
7452443,154,4,25,1619,983146468,1,0,0,912.89,8,92065.5,18,0,18,2,True
7598292,883,0,451,1875,983146468,1,0,0,912.87,7,91152.63,24,0,22,2,False
7652927,215,0,25,7292,983146468,1,0,0,913.15,8,90239.48,9,6,12,3,True
7702194,677,0,20,3461,983146468,1,0,0,912.68,5,89326.8,24,1,15,6,True
7913774,1477,2,-1,7292,983146468,1,1,0,912.77,4,89326.8,24,1,5,7,True
8185005,883,0,451,8069,983146468,1,0,0,913.27,7,88413.53,24,5,12,8,True
8348748,589,1,25,7370,983146468,1,0,0,913.02,8,87500.51,24,3,18,9,True
8888597,1477,2,451,6875,983146468,1,0,0,912.71,7,86587.8,24,2,7,10,True
8967328,1167,4,-1,7076,983146468,1,1,0,912.93,1,86587.8,24,3,0,10,False
9113727,883,0,30,2733,983146468,1,0,0,913.02,8,85674.78,24,6,18,10,True
9178465,215,0,451,7947,983146468,1,0,0,912.98,7,84761.8,9,1,21,10,True
9560146,23,0,10,7947,983146468,1,0,0,913.08,6,85674.88,11,3,3,11,False
9839706,1072,0,451,2733,983146468,1,0,0,912.9,7,84761.98,18,1,6,11,True
9972170,1167,4,-1,8855,983146468,1,1,0,913.08,1,84761.98,24,1,1,11,True
1000596,502,0,25,3629,821481548,0,0,0,1185.97,8,710734.03,12,1,3,1,True
1044339,677,0,10,2448,821481548,0,0,0,1185.95,6,711919.98,24,1,8,2,True
1319058,302,1,10,7074,821481548,0,0,0,1185.97,0,713105.95,4,4,8,3,True
1657851,329,1,25,2006,821481548,0,0,0,1186.02,8,711919.93,11,4,13,4,True
1673715,1380,0,10,8581,821481548,0,0,0,1186.28,6,713106.21,16,4,23,7,True
1749694,502,0,25,8080,821481548,0,0,0,1185.67,8,711920.54,12,1,4,8,True
1949437,1089,0,-1,8360,821481548,0,1,0,1186.08,4,711920.54,18,3,21,8,True
2047324,341,0,10,4833,821481548,0,0,0,1186.2,0,713106.74,24,5,18,8,True
2263193,1215,3,451,8080,821481548,0,0,0,1186.09,7,711920.65,24,6,13,10,True
2396768,1089,0,451,4833,821481548,0,0,0,1186.19,7,710734.46,18,1,11,12,True
2707483,329,1,25,8581,821481548,0,0,0,1186.21,8,709548.25,11,1,8,1,True
2977272,502,0,25,8108,821481548,0,0,0,1186.15,8,708362.1,12,4,1,1,True
3020141,1089,0,30,7432,821481548,0,0,0,1185.99,8,707176.11,18,4,23,3,True
3220997,126,1,10,4848,821481548,0,0,0,1186.4,6,708362.51,18,1,7,3,True
3379051,1212,0,20,4446,821481548,0,0,0,1186.15,3,707176.36,24,3,18,3,True
3513853,1215,3,451,4833,821481548,0,0,0,1186.05,7,705990.31,24,3,17,3,True
3906642,329,1,30,6613,821481548,0,0,0,1186.02,8,704804.29,11,4,18,4,True
4080517,329,1,-1,9765,821481548,0,1,0,1186.04,4,704804.29,11,6,14,4,True
4519208,472,4,30,2141,821481548,0,0,0,1185.94,8,703618.35,5,4,3,4,True
4782847,1089,0,-1,7171,821481548,0,1,0,1185.98,1,703618.35,18,2,14,6,True
4788204,800,0,10,8581,821481548,0,0,0,1185.66,6,704804.01,11,1,21,6,True
4884646,269,0,10,3629,821481548,0,0,0,1186.18,0,705990.19,24,1,2,6,True
5680629,1015,0,20,7074,821481548,0,0,0,1186.01,3,704804.18,26,5,11,7,True
5896518,787,0,20,6181,821481548,0,0,0,1185.92,5,703618.26,14,0,10,7,False
5984034,502,0,451,4369,821481548,0,0,0,1186.11,7,702432.15,12,2,9,7,True
6251664,1089,0,451,9765,821481548,0,0,0,1185.95,7,701246.2,18,2,12,8,True
6290878,1480,4,451,7432,821481548,0,0,0,1185.76,7,700060.44,24,0,23,8,True
6528201,204,0,20,5874,821481548,0,0,0,1186.01,3,698874.43,9,2,7,10,True
6772483,900,1,30,8827,821481548,0,0,0,1186.1,8,697688.33,24,5,1,10,True
6847910,538,0,10,5874,821481548,0,0,0,1185.89,6,698874.22,18,2,16,11,True
6935171,588,0,10,5297,821481548,0,0,0,1185.77,6,700059.99,24,3,12,12,True
7091398,1480,4,30,4848,821481548,0,0,0,1186.06,8,698873.93,24,1,10,1,True
7127513,472,4,30,2141,821481548,0,0,0,1185.98,8,697687.95,5,3,6,1,True
7255585,1480,4,30,3454,821481548,0,0,0,1186.04,8,696501.91,24,1,5,1,True
7425138,1215,3,451,8360,821481548,0,0,0,1185.97,7,695315.94,24,4,2,1,True
7494326,342,0,10,4848,821481548,0,0,0,1185.99,6,696501.93,24,5,10,1,True
7557446,1480,4,30,2458,821481548,0,0,0,1185.88,8,695316.05,24,2,17,2,True
7619453,900,1,-1,6181,821481548,0,1,0,1186.07,4,695316.05,24,1,22,3,True
7630660,472,4,451,6613,821481548,0,0,0,1186.34,7,694129.71,5,2,8,3,True
7878377,472,4,-1,2458,821481548,0,1,0,1185.74,4,694129.71,5,1,11,3,True
8140323,329,1,25,6851,821481548,0,0,0,1186.18,8,692943.53,11,6,19,4,True
8232650,502,0,25,5297,821481548,0,0,0,1186.05,8,691757.48,12,1,18,5,True
8331057,1089,0,20,5297,821481548,0,0,0,1186.02,5,690571.46,18,0,16,6,True
8490346,502,0,30,2458,821481548,0,0,0,1186.07,8,689385.39,12,0,17,6,True
8625308,1480,4,25,8360,821481548,0,0,0,1185.94,8,688199.45,24,5,18,6,False
8689535,1164,0,20,6851,821481548,0,0,0,1186.14,5,687013.31,24,3,12,6,True
8907740,662,1,10,7171,821481548,0,0,0,1186.18,6,688199.49,18,3,21,6,True
8941489,900,1,30,3886,821481548,0,0,0,1186.12,8,687013.37,24,4,17,8,True
8985882,1215,3,30,6851,821481548,0,0,0,1186.1,8,685827.27,24,0,18,8,False
9321062,497,0,20,4848,821481548,0,0,0,1185.97,5,684641.3,12,4,10,9,True
9495309,871,0,20,3484,821481548,0,0,0,1185.74,5,683455.56,24,0,1,9,True
9632371,299,1,10,2006,821481548,0,0,0,1185.98,6,684641.54,4,1,18,9,True
9970219,1298,0,10,2141,821481548,0,0,0,1185.88,0,685827.42,5,2,3,10,True
9994968,1480,4,451,8827,821481548,0,0,0,1186.02,7,684641.4,24,3,20,10,True
1005143,966,4,451,2192,925471139,0,0,0,280.85,7,870697.15,13,2,16,1,True
1057338,647,4,25,1129,925471139,0,0,0,280.87,8,870416.28,24,5,9,3,True
1204950,1446,1,25,9834,925471139,0,0,0,280.99,8,870135.29,24,0,12,4,True
1234585,1140,0,-1,6111,925471139,0,1,0,281.06,4,870135.29,15,3,8,5,True
1489191,469,4,451,9834,925471139,0,0,0,281.3,7,869853.99,5,1,13,5,True
1685164,1140,0,30,1093,925471139,0,0,0,281.19,8,869572.8,15,0,9,6,True
2034354,34,1,10,5963,925471139,0,0,0,281.02,6,869853.82,11,5,10,6,True
2086704,950,0,20,3002,925471139,0,0,0,281.03,3,869572.79,24,2,16,6,False
2201082,1446,1,451,9866,925471139,0,0,0,280.7,7,869292.09,24,3,0,7,True
2460905,1140,0,451,6111,925471139,0,0,0,280.91,7,869011.18,15,3,19,8,True
2489947,1270,1,25,7643,925471139,0,0,0,280.9,8,868730.28,23,4,16,8,True
2727859,1446,1,30,9600,925471139,0,0,0,280.87,8,868449.41,24,3,22,9,True
3065663,1270,1,451,8622,925471139,0,0,0,281.0,7,868168.41,23,1,23,10,True
3153266,1270,1,30,7643,925471139,0,0,0,280.94,8,867887.47,23,5,17,10,True
3158151,1022,4,25,6207,925471139,0,0,0,280.95,8,867606.52,11,4,3,12,True
3691350,469,4,30,6923,925471139,0,0,0,281.01,8,867325.51,5,3,11,12,True
3778604,799,2,20,6207,925471139,0,0,0,280.86,5,867044.65,11,0,19,12,True
3846196,1270,1,25,4734,925471139,0,0,0,280.71,8,866763.94,23,4,18,3,True
4121252,883,0,30,9834,925471139,0,0,0,280.74,8,866483.2,24,3,13,3,True
4243231,219,0,10,9600,925471139,0,0,0,281.03,6,866764.23,9,1,13,4,True
4248838,1072,0,10,1093,925471139,0,0,0,280.98,0,867045.21,18,3,18,4,True
4388960,1270,1,-1,6207,925471139,0,1,0,281.14,1,867045.21,23,3,5,5,True
4543492,1363,0,20,9600,925471139,0,0,0,281.05,5,866764.16,16,0,4,5,True
4546991,469,4,25,1093,925471139,0,0,0,281.08,8,866483.08,5,4,0,6,True
5016635,848,2,20,5168,925471139,0,0,0,281.01,5,866202.07,5,2,23,6,False
5442631,649,0,20,2991,925471139,0,0,0,280.93,5,865921.14,24,3,8,6,True
5486074,647,4,30,5714,925471139,0,0,0,281.26,8,865639.88,24,1,21,7,True
5700016,1140,0,25,1129,925471139,0,0,0,281.02,8,865358.86,15,3,23,8,True
6158947,1255,0,10,9866,925471139,0,0,0,280.7,0,865639.56,23,6,3,8,True
6326736,220,0,20,5714,925471139,0,0,0,280.83,5,865358.73,26,2,12,9,True
6639446,1406,0,20,2991,925471139,0,0,0,280.97,5,865077.76,24,4,14,9,True
6741911,883,0,30,1093,925471139,0,0,0,281.1,8,864796.66,24,4,17,10,True
6745128,1223,3,30,3957,925471139,0,0,0,281.03,8,864515.63,24,5,0,11,True
6767791,1102,2,20,2407,925471139,0,0,0,281.1,5,864234.53,0,1,19,1,True
6865397,1446,1,451,2991,925471139,0,0,0,281.0,7,863953.53,24,3,9,2,True
7026737,376,0,20,6207,925471139,0,0,0,281.02,3,863672.51,25,4,19,2,True
7831779,579,0,10,2130,925471139,0,0,0,280.95,6,863953.46,11,1,0,3,True
7847295,647,4,-1,4734,925471139,0,1,0,281.22,4,863953.46,24,2,19,4,True
8192087,882,0,20,2991,925471139,0,0,0,280.66,3,863672.8,27,3,22,4,True
8275102,647,4,30,3957,925471139,0,0,0,281.28,8,863391.52,24,3,20,5,True
8565666,848,2,20,5714,925471139,0,0,0,280.84,5,863110.68,5,1,18,5,True
8614167,580,0,20,9866,925471139,0,0,0,280.98,3,862829.7,11,5,6,6,True
8710942,883,0,25,1129,925471139,0,0,0,280.97,8,862548.73,24,4,1,7,True
8732878,966,4,451,9834,925471139,0,0,0,281.19,7,862267.54,13,2,6,7,False
8900246,469,4,451,8396,925471139,0,0,0,281.0,7,861986.54,5,3,17,8,True
8910558,469,4,30,1129,925471139,0,0,0,281.33,8,861705.21,5,1,17,8,True
9242753,647,4,451,7643,925471139,0,0,0,281.08,7,861424.13,24,5,13,9,False
9535536,1140,0,451,2407,925471139,0,0,0,281.28,7,861142.85,15,5,20,9,True
9569308,812,0,20,6207,925471139,0,0,0,280.7,5,860862.15,18,5,3,10,True
9572317,1140,0,25,2407,925471139,0,0,0,281.07,8,860581.08,15,6,13,11,True
9784479,1140,0,-1,9866,925471139,0,1,0,281.03,1,860581.08,15,5,21,11,True
1025710,765,4,-1,3216,378413987,0,1,0,180.03,4,172399.0,14,5,16,1,True
1266021,1179,0,25,6121,378413987,0,0,0,179.95,8,172219.05,24,2,11,1,True
1356577,765,4,25,3883,378413987,0,0,0,180.01,8,172039.04,14,5,2,1,True
1408993,810,4,-1,8846,378413987,0,1,0,180.06,1,172039.04,18,1,23,2,True
1410838,1179,0,451,5578,378413987,0,0,0,180.11,7,171858.93,24,6,3,5,True
1788216,1179,0,451,4305,378413987,0,0,0,180.12,7,171678.81,24,4,21,5,True
2060347,640,4,25,3444,378413987,0,0,0,179.95,8,171498.86,24,4,3,6,True
2475038,522,0,10,1381,378413987,0,0,0,179.93,0,171678.79,18,0,7,6,False
2539122,402,3,451,6121,378413987,0,0,0,180.09,7,171498.7,10,1,0,6,True
2752579,971,4,-1,1627,378413987,0,1,0,180.0,1,171498.7,13,6,5,8,True
2946832,971,4,451,8923,378413987,0,0,0,180.02,7,171318.68,13,6,19,9,True
3156112,1179,0,25,9551,378413987,0,0,0,179.99,8,171138.69,24,3,2,9,True
3175584,952,0,10,8846,378413987,0,0,0,179.81,6,171318.5,13,0,19,10,False
3199108,799,2,20,1781,378413987,0,0,0,180.01,3,171138.49,11,6,7,10,True
3343551,780,0,10,3830,378413987,0,0,0,179.8,6,171318.29,14,6,15,10,True
3397716,975,4,30,5578,378413987,0,0,0,179.9,8,171138.39,22,0,21,10,True
3547950,810,4,30,5822,378413987,0,0,0,179.88,8,170958.51,18,1,22,10,True
3557353,402,3,25,7249,378413987,0,0,0,179.88,8,170778.63,10,4,5,10,True
4074789,975,4,25,8846,378413987,0,0,0,179.87,8,170598.76,22,5,21,12,True
4164262,971,4,25,1627,378413987,0,0,0,180.15,8,170418.61,13,3,1,1,True
4321303,402,3,25,6233,378413987,0,0,0,180.06,8,170238.55,10,5,14,1,True
4452995,640,4,-1,3216,378413987,0,1,0,179.93,4,170238.55,24,3,23,2,True
4475575,544,3,-1,9594,378413987,0,2,0,180.27,4,170238.55,17,6,3,3,True
4498979,544,3,30,3769,378413987,0,0,0,179.91,8,170058.64,17,5,17,3,True
4880319,334,0,20,8923,378413987,0,0,0,179.84,3,169878.8,11,5,2,4,True
5072101,640,4,451,3883,378413987,0,0,0,179.66,7,169699.14,24,5,21,4,True
5327562,1179,0,451,1781,378413987,0,0,0,179.89,7,169519.25,24,0,15,4,True
5465378,879,1,451,6121,378413987,0,0,0,180.21,7,169339.04,27,3,12,5,True
5561769,640,4,25,8923,378413987,0,0,0,180.03,8,169159.01,24,0,6,5,True
5909605,640,4,25,8846,378413987,0,0,0,179.99,8,168979.02,24,5,4,6,True
5958713,1387,1,10,3216,378413987,0,0,0,180.02,0,169159.04,24,3,2,8,True
6000853,59,0,20,3830,378413987,0,0,0,179.67,5,168979.37,20,5,18,8,True
6075597,975,4,30,5578,378413987,0,0,0,180.2,8,168799.17,22,3,14,10,True
6085579,1361,2,20,3883,378413987,0,0,0,179.75,3,168619.42,16,2,21,10,True
6630814,765,4,-1,8923,378413987,0,1,0,179.99,4,168619.42,14,6,12,11,True
6787450,320,1,10,3444,378413987,0,0,0,179.92,6,168799.34,11,6,10,11,True
6882624,879,1,451,3216,378413987,0,0,0,179.84,7,168619.5,27,4,5,12,True
7005932,402,3,-1,3444,378413987,0,1,0,179.88,4,168619.5,10,6,13,1,True
7318211,1179,0,30,3830,378413987,0,0,0,179.98,8,168439.52,24,0,8,2,True
8316092,1179,0,451,1627,378413987,0,0,0,180.06,7,168259.46,24,4,7,3,True
8339809,752,0,10,9594,378413987,0,0,0,179.99,6,168439.45,24,5,1,3,True
8496408,971,4,451,3444,378413987,0,0,0,180.1,7,168259.35,13,6,23,3,True
8537868,879,1,451,3444,378413987,0,0,0,180.06,7,168079.29,27,5,23,5,True
8808791,1283,2,20,1627,378413987,0,0,0,180.06,5,167899.23,24,6,20,6,True
8831951,879,1,30,8923,378413987,0,0,0,180.04,8,167719.19,27,4,7,6,True
8861496,470,1,10,1627,378413987,0,0,0,179.85,6,167899.04,5,3,9,7,True
9081481,303,0,20,1781,378413987,0,0,0,179.99,5,167719.05,4,1,3,7,True
9196455,640,4,-1,1781,378413987,0,1,0,179.71,4,167719.05,24,4,5,8,True
9344227,810,4,25,3883,378413987,0,0,0,179.98,8,167539.07,18,5,13,8,True
9370242,1044,0,20,5822,378413987,0,0,0,179.98,5,167359.09,11,3,3,9,True
9702186,402,3,30,3769,378413987,0,0,0,179.78,8,167179.31,10,5,18,9,True
9855250,640,4,451,7249,378413987,0,0,0,180.04,7,166999.27,24,6,21,10,True
9999812,723,1,10,5822,378413987,0,0,0,180.13,6,167179.4,11,2,11,10,True
1308552,319,0,30,1948,850222340,0,0,0,1070.01,8,252319.99,11,5,17,1,True
1587848,752,0,25,5478,850222340,0,0,0,1069.9,8,251250.09,24,0,0,1,True
1736909,59,0,25,6348,850222340,0,0,0,1069.75,8,250180.34,20,4,9,2,True
2043951,286,1,10,4655,850222340,0,0,0,1070.07,6,251250.41,24,4,3,2,True
2349104,250,4,451,9539,850222340,0,0,0,1070.07,7,250180.34,6,3,11,3,True
2500849,250,4,451,5996,850222340,0,0,0,1069.9,7,249110.44,6,6,20,4,True
2957034,59,0,451,5126,850222340,0,0,0,1070.07,7,248040.37,20,4,22,4,True
3038087,568,1,25,1948,850222340,0,0,0,1070.36,8,246970.01,11,2,19,5,True
3094567,443,2,20,5126,850222340,0,0,0,1070.18,5,245899.83,24,2,21,5,True
3112922,1388,1,10,4655,850222340,0,0,0,1070.0,0,246969.83,24,1,5,6,True
3247557,825,2,20,7137,850222340,0,0,0,1069.78,3,245900.05,18,5,1,7,True
3281002,250,4,25,9539,850222340,0,0,0,1069.97,8,244830.08,6,0,4,7,True
3349409,250,4,25,9539,850222340,0,0,0,1070.22,8,243759.86,6,6,2,7,True
3357564,186,4,30,9543,850222340,0,0,0,1070.05,8,242689.81,18,6,12,8,True
3568109,211,0,20,4914,850222340,0,0,0,1069.89,3,241619.92,9,4,16,8,True
3660384,568,1,25,9539,850222340,0,0,0,1069.79,8,240550.13,11,5,12,8,True
3763174,662,1,30,4914,850222340,0,0,0,1069.99,8,239480.14,18,2,12,9,True
3854228,662,1,30,6348,850222340,0,0,0,1070.13,8,238410.01,18,6,17,9,True
3874934,186,4,30,1574,850222340,0,0,0,1070.16,8,237339.85,18,0,2,10,True
3886662,250,4,25,9199,850222340,0,0,0,1070.07,8,236269.78,6,2,1,11,True
4152348,319,0,451,1963,850222340,0,0,0,1069.96,7,235199.82,11,5,21,12,True
4233766,250,4,30,9539,850222340,0,0,0,1069.65,8,234130.17,6,4,3,12,True
4244749,1012,0,20,4914,850222340,0,0,0,1069.87,5,233060.3,26,0,23,1,True
4885613,752,0,25,9539,850222340,0,0,0,1069.83,8,231990.47,24,6,9,1,True
5139753,662,1,451,1972,850222340,0,0,0,1070.01,7,230920.46,18,0,20,2,True
5184148,687,0,20,5004,850222340,0,0,0,1070.03,5,229850.43,24,0,8,3,True
5324047,998,0,10,6455,850222340,0,0,0,1069.8,0,230920.23,26,6,10,4,True
5473071,568,1,30,5407,850222340,0,0,0,1069.93,8,229850.3,11,1,9,4,True
5971556,653,1,10,1574,850222340,0,0,0,1069.73,6,230920.03,24,5,5,4,True
6372907,1422,1,10,5478,850222340,0,0,0,1070.16,6,231990.19,24,5,22,5,False
6462007,319,0,-1,7509,850222340,0,1,0,1070.06,4,231990.19,11,6,10,5,True
6499480,662,1,451,6348,850222340,0,0,0,1070.2,7,230919.99,18,1,9,7,True
6577283,362,0,10,1574,850222340,0,0,0,1070.11,6,231990.1,24,2,23,7,True
6908653,752,0,25,7509,850222340,0,0,0,1069.7,8,230920.4,24,3,14,8,True
6933602,568,1,25,1972,850222340,0,0,0,1069.86,8,229850.54,11,3,22,9,True
6991634,752,0,-1,1942,850222340,0,1,0,1069.95,1,229850.54,24,2,12,10,True
7156449,752,0,-1,9539,850222340,0,2,0,1069.97,4,229850.54,24,2,21,10,True
7158844,1436,0,20,7509,850222340,0,0,0,1070.12,5,228780.42,24,6,19,11,True
7210447,662,1,451,1942,850222340,0,0,0,1069.9,7,227710.52,18,0,19,11,True
7296088,319,0,-1,5004,850222340,0,1,0,1070.0,1,227710.52,11,2,12,11,True
7509001,662,1,451,5126,850222340,0,0,0,1070.03,7,226640.49,18,5,1,11,True
7577430,752,0,25,7509,850222340,0,0,0,1069.92,8,225570.57,24,4,7,12,True
7877658,568,1,451,5407,850222340,0,0,0,1069.95,7,224500.62,11,2,13,1,True
8049849,568,1,-1,5126,850222340,0,1,0,1070.02,1,224500.62,11,4,5,2,True
8190597,568,1,451,7137,850222340,0,0,0,1069.91,7,223430.71,11,5,17,3,True
8303850,250,4,451,5126,850222340,0,0,0,1070.06,7,222360.65,6,6,11,3,True
8353310,1123,2,20,5004,850222340,0,0,0,1069.9,5,221290.75,24,1,15,4,True
8496449,1315,0,20,1948,850222340,0,0,0,1070.12,5,220220.63,5,4,5,4,True
8612609,1035,0,10,9543,850222340,0,0,0,1069.92,6,221290.55,11,2,10,7,True
8672106,568,1,451,1948,850222340,0,0,0,1069.96,7,220220.59,11,5,18,7,True
9012985,1455,2,20,1942,850222340,0,0,0,1069.92,5,219150.67,11,5,0,8,True
9014573,319,0,451,2835,850222340,0,0,0,1069.84,7,218080.83,11,1,8,8,False
9236966,1406,0,20,4914,850222340,0,0,0,1069.88,5,217010.95,24,2,13,10,False
9417861,662,1,451,1942,850222340,0,0,0,1069.91,7,215941.04,18,0,10,10,True
9589236,186,4,25,7137,850222340,0,0,0,1069.98,8,214871.06,18,3,0,10,True
9688120,752,0,25,5407,850222340,0,0,0,1069.88,8,213801.18,24,3,11,11,True
1061598,816,0,20,4604,380060374,1,0,0,107.11,5,528782.89,18,5,12,1,True
1113074,879,1,451,4310,380060374,1,0,0,107.07,7,528675.82,27,4,23,2,True
1430740,846,3,-1,9866,380060374,1,1,0,106.99,4,528675.82,5,5,9,4,True
1996261,1434,0,10,2911,380060374,1,0,0,107.09,6,528782.91,24,2,20,4,True
2378855,616,1,10,4604,380060374,1,0,0,107.08,6,528889.99,11,6,20,9,True
2396278,535,0,20,6406,380060374,1,0,0,106.89,3,528783.1,18,6,12,11,True
2721500,1265,4,30,2410,380060374,1,0,0,106.92,8,528676.18,23,5,12,1,False
2803312,279,2,20,9179,380060374,1,0,0,107.2,3,528568.98,24,1,22,2,True
3009108,1250,1,25,2211,380060374,1,0,0,107.17,8,528461.81,23,2,21,3,True
3024110,1231,2,30,4007,380060374,1,0,0,107.09,8,528354.72,18,3,21,3,True
3390059,703,0,20,6895,380060374,1,0,0,106.99,5,528247.73,18,1,4,3,False
3485130,1231,2,25,5117,380060374,1,0,0,107.03,8,528140.7,18,1,19,5,True
3977937,511,1,25,5547,380060374,1,0,0,106.73,8,528033.97,12,5,14,6,True
4104131,1015,0,20,2410,380060374,1,0,0,107.08,5,527926.89,26,5,10,7,True
4235180,276,0,20,4007,380060374,1,0,0,106.98,5,527819.91,24,0,11,8,True
4389819,398,0,20,5547,380060374,1,0,0,107.08,5,527712.83,10,0,18,9,True
4562664,1090,0,20,5547,380060374,1,0,0,107.16,5,527605.67,18,2,19,9,True
4839110,1250,1,451,4912,380060374,1,0,0,106.86,7,527498.81,23,6,5,10,True
5036053,511,1,25,2410,380060374,1,0,0,107.03,8,527391.78,12,0,13,11,True
5214343,1265,4,25,4623,380060374,1,0,0,106.99,8,527284.79,23,0,15,12,True
5365725,879,1,451,8852,380060374,1,0,0,106.92,7,527177.87,27,6,7,2,False
5651539,446,1,10,6895,380060374,1,0,0,107.09,6,527284.96,13,6,15,2,True
5893998,1250,1,451,6895,380060374,1,0,0,106.98,7,527177.98,23,5,20,2,True
6515795,879,1,451,4623,380060374,1,0,0,107.1,7,527070.88,27,2,21,2,True
6571609,580,0,20,8341,380060374,1,0,0,106.87,5,526964.01,11,2,14,4,True
6667085,1164,0,10,7173,380060374,1,0,0,107.04,6,527071.05,24,0,12,4,True
6807672,1378,3,-1,2299,380060374,1,1,0,106.99,4,527071.05,16,1,10,5,True
6925604,1250,1,25,1167,380060374,1,0,0,107.1,8,526963.95,23,4,16,7,True
6966903,511,1,-1,4623,380060374,1,1,0,107.03,4,526963.95,12,3,13,8,True
6976057,1231,2,-1,6932,380060374,1,2,0,107.01,4,526963.95,18,1,12,8,True
7061203,1378,3,-1,8341,380060374,1,3,1,107.08,1,526963.95,16,2,15,10,True
1879407,895,0,451,2203,393037692,0,0,0,554.97,7,106577.03,24,3,23,1,True
1996972,1319,1,30,2203,393037692,0,0,0,554.97,8,106022.06,18,1,20,1,True
2489238,1234,3,25,3027,393037692,0,0,0,555.1,8,105466.96,18,3,2,2,True
2550754,1319,1,-1,6978,393037692,0,1,0,554.97,4,105466.96,18,0,9,2,True
2674841,41,2,30,5245,393037692,0,0,0,555.07,8,104911.89,11,2,11,3,True
3588710,895,0,451,7233,393037692,0,0,0,555.09,7,104356.8,24,1,9,3,True
3818006,895,0,25,8957,393037692,0,0,0,555.02,8,103801.78,24,4,0,4,True
3935973,249,0,10,1085,393037692,0,0,0,555.11,6,104356.89,6,2,6,6,True
4113372,299,1,-1,3027,393037692,0,1,0,555.2,4,104356.89,4,6,14,6,True
4153856,1186,2,20,6978,393037692,0,0,0,554.94,5,103801.95,24,4,2,7,True
4190647,86,4,451,3436,393037692,0,0,0,554.77,7,103247.18,1,5,5,7,True
4336677,299,1,25,4384,393037692,0,0,0,554.91,8,102692.27,4,2,2,8,True
4779857,86,4,30,8750,393037692,0,0,0,554.97,8,102137.3,1,1,22,9,True
4788290,41,2,451,3027,393037692,0,0,0,555.02,7,101582.28,11,0,14,9,True
4795003,1234,3,30,5115,393037692,0,0,0,554.83,8,101027.45,18,0,1,10,True
4945448,299,1,451,9868,393037692,0,0,0,554.87,7,100472.58,4,5,1,10,True
5086552,75,3,451,9868,393037692,0,0,0,554.99,7,99917.59,20,3,18,11,False
5127171,1190,3,451,3027,393037692,0,0,0,554.89,7,99362.7,24,2,14,11,True
5266498,1303,0,20,4467,393037692,0,0,0,555.15,5,98807.55,5,5,12,2,True
5373787,1190,3,25,4467,393037692,0,0,0,554.96,8,98252.59,24,6,20,2,True
5398230,910,0,10,3407,393037692,0,0,0,554.86,0,98807.45,18,4,2,3,True
5532563,86,4,451,7233,393037692,0,0,0,555.01,7,98252.44,1,2,7,4,True
5682881,1234,3,-1,6022,393037692,0,1,0,554.99,4,98252.44,18,5,0,4,True
5738118,895,0,30,3027,393037692,0,0,0,554.67,8,97697.77,24,3,3,5,True
5856818,1190,3,25,3407,393037692,0,0,0,554.87,8,97142.9,24,1,7,5,True
6004811,695,2,30,2203,393037692,0,0,0,555.12,8,96587.78,24,3,1,5,True
6134708,1068,2,20,5901,393037692,0,0,0,554.78,5,96033.0,18,1,4,6,True
6202527,695,2,-1,3407,393037692,0,1,0,555.16,4,96033.0,24,3,7,6,True
6242914,86,4,-1,7559,393037692,0,2,0,555.07,1,96033.0,1,1,9,7,True
6491814,1190,3,30,2203,393037692,0,0,0,555.13,8,95477.87,24,1,16,8,True
6635450,1319,1,25,3436,393037692,0,0,0,555.2,8,94922.67,18,3,14,8,True
7072619,1190,3,25,6304,393037692,0,0,0,554.97,8,94367.7,24,4,4,9,True
7210029,1190,3,451,8166,393037692,0,0,0,555.08,7,93812.62,24,1,13,9,True
7253609,75,3,25,3436,393037692,0,0,0,555.01,8,93257.61,20,4,13,9,True
7347281,1318,0,20,4467,393037692,0,0,0,554.95,3,92702.66,18,0,5,1,True
7835783,1234,3,25,8166,393037692,0,0,0,554.97,8,92147.69,18,4,12,1,True
8041200,695,2,30,5901,393037692,0,0,0,555.09,8,91592.6,24,1,7,2,True
8442419,299,1,30,3407,393037692,0,0,0,554.91,8,91037.69,4,1,5,2,True
8587312,1190,3,25,6978,393037692,0,0,0,554.79,8,90482.9,24,0,18,4,True
8783906,895,0,30,8166,393037692,0,0,0,555.1,8,89927.8,24,0,7,4,True
8804211,1190,3,451,8957,393037692,0,0,0,554.95,7,89372.85,24,6,10,5,True
8888601,1255,0,10,4384,393037692,0,0,0,555.01,0,89927.86,23,5,20,5,True
8987720,299,1,451,4467,393037692,0,0,0,555.21,7,89372.65,4,5,21,6,True
9082203,1190,3,25,3407,393037692,0,0,0,555.15,8,88817.5,24,1,1,6,True
9099020,1459,1,10,9868,393037692,0,0,0,554.95,0,89372.45,11,5,9,6,True
9277745,86,4,-1,3436,393037692,0,1,0,555.2,1,89372.45,1,1,3,7,True
9510496,41,2,-1,6304,393037692,0,2,0,555.26,4,89372.45,11,2,4,7,True
9629707,1406,0,10,8166,393037692,0,0,0,554.89,0,89927.34,24,0,5,7,True
9706452,732,0,20,1840,393037692,0,0,0,554.99,5,89372.35,11,2,16,8,True
9852485,1234,3,-1,8750,393037692,0,1,0,555.02,4,89372.35,18,5,7,9,True
9854386,1152,0,10,5115,393037692,0,0,0,555.12,6,89927.47,15,0,13,9,True
9932209,299,1,30,3410,393037692,0,0,0,554.68,8,89372.79,4,0,13,10,True
9947050,86,4,25,4384,393037692,0,0,0,555.27,8,88817.52,1,3,9,11,True
1042562,531,0,20,1805,650328404,0,0,0,837.04,3,576176.96,18,0,0,3,True
1305508,610,0,25,7764,650328404,0,0,0,836.87,8,575340.09,11,6,1,4,True
1461905,376,0,25,4526,650328404,0,0,0,836.97,8,574503.12,25,3,1,6,True
1878914,1184,4,451,4116,650328404,0,0,0,836.74,7,573666.38,24,0,22,7,True
2175929,305,1,10,5889,650328404,0,0,0,837.08,0,574503.46,4,5,15,9,True
2281606,459,1,10,7531,650328404,0,0,0,836.97,6,575340.43,13,0,6,10,True
2390223,811,0,25,3712,650328404,0,0,0,837.02,8,574503.41,18,3,10,11,True
2639724,573,0,-1,9565,650328404,0,1,0,836.93,4,574503.41,11,1,3,11,True
2675027,1127,0,10,3490,650328404,0,0,0,837.1,0,575340.51,24,0,9,12,True
2723090,1321,0,20,3238,650328404,0,0,0,837.02,3,574503.49,18,2,0,1,True
2873157,376,0,25,1640,650328404,0,0,0,837.16,8,573666.33,25,4,11,1,False
2897895,1386,4,451,1640,650328404,0,0,0,836.99,7,572829.34,24,0,8,1,True
2977978,610,0,451,7265,650328404,0,0,0,837.0,7,571992.34,11,6,12,2,True
2999336,811,0,-1,8833,650328404,0,1,0,836.93,1,571992.34,18,1,11,2,False
3027305,787,0,10,4526,650328404,0,0,0,836.83,6,572829.17,14,4,6,5,True
3280998,1386,4,25,1640,650328404,0,0,0,836.95,8,571992.22,24,6,3,6,True
3335044,205,0,20,4526,650328404,0,0,0,836.82,3,571155.4,9,6,8,8,True
3423102,376,0,-1,9170,650328404,0,1,0,836.86,4,571155.4,25,1,17,8,True
3603404,573,0,25,4526,650328404,0,0,0,837.09,8,570318.31,11,5,9,8,True
3742418,1184,4,25,8777,650328404,0,0,0,837.17,8,569481.14,24,2,12,8,True
3966169,1184,4,25,9170,650328404,0,0,0,836.93,8,568644.21,24,6,0,9,True
4057611,811,0,25,8833,650328404,0,0,0,837.19,8,567807.02,18,1,7,10,True
4073924,376,0,-1,7531,650328404,0,1,0,837.0,4,567807.02,25,5,23,10,True
4242718,1184,4,451,5889,650328404,0,0,0,837.2,7,566969.82,24,3,3,11,True
4698629,610,0,25,7479,650328404,0,0,0,837.05,8,566132.77,11,1,11,11,True
4877240,993,0,451,3490,650328404,0,0,0,837.09,7,565295.68,22,0,6,12,True
4944839,993,0,30,7200,650328404,0,0,0,836.71,8,564458.97,22,5,6,2,True
4983537,59,0,20,1805,650328404,0,0,0,836.98,5,563621.99,20,6,12,2,True
5206706,1184,4,25,5889,650328404,0,0,0,837.21,8,562784.78,24,0,6,2,True
5528123,859,2,20,4116,650328404,0,0,0,837.37,3,561947.41,24,0,16,3,True
6002456,249,0,10,7200,650328404,0,0,0,837.03,0,562784.44,6,1,3,3,True
6184091,1386,4,451,8777,650328404,0,0,0,837.02,7,561947.42,24,2,16,4,True
6199816,573,0,30,8777,650328404,0,0,0,837.04,8,561110.38,11,4,3,4,True
6236490,998,0,20,5889,650328404,0,0,0,836.92,3,560273.46,26,0,12,4,True
6278282,1386,4,451,8833,650328404,0,0,0,836.86,7,559436.6,24,0,1,5,True
6314093,1390,0,20,7531,650328404,0,0,0,837.03,5,558599.57,24,2,8,5,True
6927330,573,0,-1,9170,650328404,0,1,0,836.98,4,558599.57,11,2,23,5,True
7007260,1338,0,10,8833,650328404,0,0,0,836.95,6,559436.52,18,1,4,6,True
7387413,376,0,451,8777,650328404,0,0,0,836.87,7,558599.65,25,1,20,6,True
7794590,376,0,451,8833,650328404,0,0,0,837.27,7,557762.38,25,0,16,6,True
7883591,1184,4,451,7531,650328404,0,0,0,836.73,7,556925.65,24,2,10,7,True
7904332,811,0,451,7200,650328404,0,0,0,837.14,7,556088.51,18,6,16,8,True
7987411,610,0,25,1640,650328404,0,0,0,837.16,8,555251.35,11,3,3,8,True
8084179,1184,4,451,8301,650328404,0,0,0,836.89,7,554414.46,24,2,3,9,True
8352642,1025,1,10,3301,650328404,0,0,0,836.92,6,555251.38,11,2,2,9,True
8442238,610,0,30,7531,650328404,0,0,0,837.03,8,554414.35,11,2,1,10,True
8449484,1184,4,-1,4116,650328404,0,1,0,836.81,4,554414.35,24,5,19,10,True
8712061,376,0,-1,7479,650328404,0,2,0,837.19,4,554414.35,25,4,15,11,True
8731151,1386,4,-1,7087,650328404,0,3,1,836.89,4,0.0,24,2,12,11,True
1115314,457,0,451,2253,465388842,0,0,0,122.89,7,605380.11,13,4,22,2,True
1274170,817,4,451,2253,465388842,0,0,0,123.2,7,605256.91,18,0,9,2,True
1447993,1388,1,10,3523,465388842,0,0,0,123.09,0,605380.0,24,1,6,3,True
1482120,360,0,10,1287,465388842,0,0,0,123.09,6,605503.09,24,6,13,3,True
1771695,926,4,25,3523,465388842,0,0,0,123.17,8,605379.92,18,2,20,4,True
1773151,467,0,20,1954,465388842,0,0,0,123.08,5,605256.84,5,3,10,4,True
2073234,1111,0,20,3495,465388842,0,0,0,122.62,5,605134.22,0,3,21,4,True
2088472,1477,2,20,5638,465388842,0,0,0,123.0,5,605011.22,24,6,19,5,True
2140644,457,0,451,8256,465388842,0,0,0,123.41,7,604887.81,13,2,0,6,True
2579529,130,0,30,8256,465388842,0,0,0,122.95,8,604764.86,18,2,19,6,True
2718193,1030,4,-1,4346,465388842,0,1,0,123.28,4,604764.86,11,3,8,6,True
2735142,130,0,451,6819,465388842,0,0,0,123.36,7,604641.5,18,4,21,7,True
2953031,130,0,25,2670,465388842,0,0,0,123.09,8,604518.41,18,6,22,7,True
2960948,926,4,451,3523,465388842,0,0,0,122.93,7,604395.48,18,2,17,8,True
3346326,457,0,451,6819,465388842,0,0,0,122.98,7,604272.5,13,0,19,9,True
3398443,130,0,25,6819,465388842,0,0,0,123.06,8,604149.44,18,4,12,10,True
3669856,685,3,25,2656,465388842,0,0,0,123.06,8,604026.38,24,4,17,10,True
4053114,123,0,20,8285,465388842,0,0,0,122.79,5,603903.59,18,6,9,10,True
4128269,666,4,-1,8256,465388842,0,1,0,123.11,4,603903.59,18,5,18,10,True
4163612,685,3,-1,3523,465388842,0,2,0,123.14,4,603903.59,24,2,1,11,False
4343596,448,0,10,8613,465388842,0,0,0,123.45,0,604027.04,13,4,11,3,True
5532311,1030,4,25,4909,465388842,0,0,0,123.02,8,603904.02,11,6,5,3,True
5676844,457,0,25,9206,465388842,0,0,0,122.87,8,603781.15,13,1,17,4,True
6024112,817,4,-1,8285,465388842,0,1,0,123.05,1,603781.15,18,3,14,4,False
6089470,666,4,451,1298,465388842,0,0,0,122.92,7,603658.23,18,0,0,5,True
6114001,665,2,20,1954,465388842,0,0,0,123.05,5,603535.18,18,1,13,6,True
6355028,1386,4,30,5567,465388842,0,0,0,122.99,8,603412.19,24,5,17,6,True
6398889,817,4,25,4538,465388842,0,0,0,123.11,8,603289.08,18,2,3,7,True
6417766,866,0,20,3523,465388842,0,0,0,123.04,5,603166.04,24,0,4,7,True
6492353,457,0,451,2253,465388842,0,0,0,123.07,7,603042.97,13,1,10,8,True
6645620,926,4,-1,4538,465388842,0,1,0,122.75,4,603042.97,18,1,18,10,True
6790115,1186,2,20,4346,465388842,0,0,0,122.98,5,602919.99,24,6,19,12,True
6906847,666,4,451,4346,465388842,0,0,0,122.94,7,602797.05,18,4,7,12,True
6955911,457,0,451,3495,465388842,0,0,0,122.86,7,602674.19,13,3,21,1,True
6975919,457,0,30,2656,465388842,0,0,0,123.0,8,602551.19,13,5,19,1,True
7244807,666,4,25,8613,465388842,0,0,0,122.91,8,602428.28,18,6,0,1,True
7342949,523,2,20,8285,465388842,0,0,0,122.91,3,602305.37,18,0,14,2,True
7461744,464,1,10,1954,465388842,0,0,0,123.07,0,602428.44,13,1,20,2,True
7501169,350,0,10,8613,465388842,0,0,0,122.96,6,602551.4,24,2,1,3,True
7756365,457,0,25,1954,465388842,0,0,0,122.71,8,602428.69,13,3,12,3,True
7769428,1273,0,10,2670,465388842,0,0,0,122.84,6,602551.53,24,6,23,3,True
7912132,926,4,25,3523,465388842,0,0,0,122.9,8,602428.63,18,0,15,3,True
8003657,251,4,25,2670,465388842,0,0,0,123.15,8,602305.48,6,6,1,4,True
8076875,454,1,10,3495,465388842,0,0,0,123.07,0,602428.55,13,4,9,4,True
8201025,685,3,451,1954,465388842,0,0,0,123.12,7,602305.43,24,6,6,6,True
8324989,251,4,25,3523,465388842,0,0,0,123.04,8,602182.39,6,2,10,6,True
8413584,279,2,20,3523,465388842,0,0,0,123.22,5,602059.17,24,1,12,7,True
8457200,251,4,30,8613,465388842,0,0,0,122.78,8,601936.39,6,1,6,7,True
8465728,1030,4,-1,8613,465388842,0,1,0,122.94,4,601936.39,11,2,6,7,True
8540340,817,4,25,4909,465388842,0,0,0,123.04,8,601813.35,18,2,20,8,True
8714161,685,3,451,8613,465388842,0,0,0,122.98,7,601690.37,24,6,19,8,True
8905148,1386,4,25,9728,465388842,0,0,0,123.06,8,601567.31,24,2,11,10,True
8943046,685,3,30,2253,465388842,0,0,0,123.1,8,601444.21,24,1,1,10,True
9100443,128,0,10,4538,465388842,0,0,0,123.43,0,601567.64,18,4,13,10,True
9129073,251,4,30,5638,465388842,0,0,0,123.17,8,601444.47,6,4,12,11,True
9607466,666,4,30,4909,465388842,0,0,0,123.14,8,601321.33,18,1,20,11,True
9747296,947,2,20,4909,465388842,0,0,0,123.0,5,601198.33,24,0,21,11,True
1100310,1267,2,30,1069,224496248,1,0,0,336.11,8,301252.89,23,6,15,1,True
1110769,1250,1,451,5370,224496248,1,0,0,335.98,7,300916.91,23,2,19,2,True
1258496,250,4,-1,5717,224496248,1,1,0,335.87,4,300916.91,6,2,15,3,True
1406716,1250,1,25,6704,224496248,1,0,0,336.22,8,300580.69,23,6,21,6,True
1461864,1267,2,30,2242,224496248,1,0,0,335.96,8,300244.73,23,5,3,6,True
1666459,1267,2,25,2868,224496248,1,0,0,336.0,8,299908.73,23,5,4,6,False
1752852,627,0,20,6704,224496248,1,0,0,336.03,3,299572.7,11,1,21,7,True
2046730,1250,1,30,9366,224496248,1,0,0,335.81,8,299236.89,23,1,6,8,True
2101473,1267,2,451,2242,224496248,1,0,0,336.06,7,298900.83,23,4,9,8,True
2199042,979,0,20,1069,224496248,1,0,0,335.89,5,298564.94,22,1,8,8,True
2440469,1022,4,30,4656,224496248,1,0,0,336.09,8,298228.85,11,3,19,10,True
2473778,250,4,25,2868,224496248,1,0,0,336.19,8,297892.66,6,6,11,10,True
2885534,250,4,-1,1196,224496248,1,1,0,336.1,4,297892.66,6,1,11,10,True
3030358,1267,2,30,9878,224496248,1,0,0,336.01,8,297556.65,23,3,8,10,True
3096611,365,0,451,6056,224496248,1,0,0,336.18,7,297220.47,25,5,22,11,True
3353686,1179,0,10,3096,224496248,1,0,0,335.95,0,297556.42,24,2,3,11,True
3464317,1374,4,-1,8788,224496248,1,1,0,335.84,1,297556.42,16,1,3,12,True
3484812,365,0,-1,9366,224496248,1,2,0,335.8,4,297556.42,25,5,13,1,True
3573597,1267,2,30,4465,224496248,1,0,0,336.12,8,297220.3,23,6,11,2,True
4074681,365,0,-1,9878,224496248,1,1,0,335.81,4,297220.3,25,3,7,3,True
4323158,1374,4,25,5717,224496248,1,0,0,336.2,8,296884.1,16,1,9,3,True
4366847,326,4,-1,1069,224496248,1,1,0,335.83,4,296884.1,11,1,4,5,True
4380829,250,4,25,7748,224496248,1,0,0,336.04,8,296548.06,6,4,17,7,True
4489421,326,4,-1,3147,224496248,1,1,0,335.78,4,296548.06,11,6,5,7,True
4505462,269,0,-1,3288,224496248,1,2,0,335.83,1,296548.06,24,0,20,7,True
4511143,81,0,20,2242,224496248,1,0,0,336.0,3,296212.06,1,1,15,8,True
4525982,269,0,30,7165,224496248,1,0,0,336.02,8,295876.04,24,3,19,8,True
4544685,1022,4,-1,6704,224496248,1,1,0,335.77,1,295876.04,11,2,4,8,True
4874979,250,4,25,2640,224496248,1,0,0,336.02,8,295540.02,6,6,9,9,True
4935351,628,0,10,8788,224496248,1,0,0,335.94,0,295875.96,11,6,19,10,True
4965134,269,0,25,3685,224496248,1,0,0,335.82,8,295540.14,24,1,6,10,True
5081212,365,0,-1,2868,224496248,1,1,0,336.07,1,295540.14,25,4,16,11,True
5289404,1267,2,25,9366,224496248,1,0,0,335.87,8,295204.27,23,5,11,12,True
5451206,993,0,20,8187,224496248,1,0,0,335.99,3,294868.28,22,3,19,12,True
5767520,1250,1,-1,9366,224496248,1,1,0,336.13,4,294868.28,23,6,19,1,True
5881147,326,4,30,2868,224496248,1,0,0,336.02,8,294532.26,11,4,21,1,True
5906210,215,0,10,3685,224496248,1,0,0,335.94,6,294868.2,9,2,11,1,True
5910926,365,0,451,2242,224496248,1,0,0,335.83,7,294532.37,25,1,18,2,True
5947288,365,0,451,3288,224496248,1,0,0,336.09,7,294196.28,25,2,2,2,True
5973072,326,4,30,9040,224496248,1,0,0,335.84,8,293860.44,11,6,23,3,True
6018348,1463,2,20,2640,224496248,1,0,0,336.03,5,293524.41,11,0,17,3,True
6020997,854,0,20,9040,224496248,1,0,0,335.98,5,293188.43,24,4,0,3,True
6508279,326,4,-1,2868,224496248,1,1,0,335.84,1,293188.43,11,5,23,3,True
6547065,956,1,10,3096,224496248,1,0,0,335.83,0,293524.26,13,3,23,3,True
6666904,326,4,451,5717,224496248,1,0,0,335.97,7,293188.29,11,3,9,4,True
6881581,1022,4,-1,2640,224496248,1,1,0,336.16,1,293188.29,11,5,4,4,True
7244021,1374,4,-1,2640,224496248,1,2,0,335.91,4,293188.29,16,6,14,4,True
7479775,130,0,10,5717,224496248,1,0,0,336.04,6,293524.33,18,6,0,5,True
8054243,326,4,451,2242,224496248,1,0,0,335.91,7,293188.42,11,2,15,5,False
8304961,180,0,20,3147,224496248,1,0,0,335.95,5,292852.47,18,3,20,5,True
8693444,250,4,30,9878,224496248,1,0,0,335.83,8,292516.64,6,5,17,5,True
8695886,1022,4,451,2242,224496248,1,0,0,336.08,7,292180.56,11,1,20,6,True
8761926,1022,4,30,6056,224496248,1,0,0,335.81,8,291844.75,11,2,22,6,True
8781240,250,4,451,4465,224496248,1,0,0,336.14,7,291508.61,6,3,4,7,True
8946496,1356,2,20,1196,224496248,1,0,0,336.24,5,291172.37,24,3,17,7,True
9160737,250,4,30,8788,224496248,1,0,0,336.01,8,290836.36,6,5,6,9,True
9504145,1022,4,30,6056,224496248,1,0,0,335.85,8,290500.51,11,6,0,9,True
9617154,1374,4,25,2640,224496248,1,0,0,336.23,8,290164.28,16,3,10,10,True
9649771,365,0,30,2242,224496248,1,0,0,336.31,8,289827.97,25,3,7,11,True
1007130,420,4,30,8212,368567122,0,0,0,234.22,8,204154.78,18,5,7,1,True
1496527,1000,0,10,8071,368567122,0,0,0,234.07,6,204388.85,26,5,22,1,True
1695039,1473,4,451,4038,368567122,0,0,0,233.99,7,204154.86,24,0,3,1,True
1721352,502,0,10,4038,368567122,0,0,0,234.08,6,204388.94,12,6,1,1,True
1760539,278,1,10,2013,368567122,0,0,0,234.03,6,204622.97,24,1,20,2,True
1795383,1473,4,30,3117,368567122,0,0,0,234.23,8,204388.74,24,4,16,2,True
1853680,1277,2,451,9119,368567122,0,0,0,233.88,7,204154.86,24,4,23,3,True
2277467,1205,0,-1,3117,368567122,0,1,0,234.02,1,204154.86,24,2,10,4,True
2302340,402,3,30,6843,368567122,0,0,0,233.86,8,203921.0,10,5,16,4,True
2633595,910,0,10,4663,368567122,0,0,0,234.26,0,204155.26,18,3,0,4,True
2998701,1232,1,10,4663,368567122,0,0,0,234.08,0,204389.34,18,5,15,6,True
3257887,314,0,10,8297,368567122,0,0,0,233.69,6,204623.03,4,1,4,6,True
3349737,1277,2,25,9119,368567122,0,0,0,233.91,8,204389.12,24,4,18,7,True
3475276,1277,2,451,6065,368567122,0,0,0,234.01,7,204155.11,24,4,23,8,True
3649009,1205,0,25,9119,368567122,0,0,0,234.01,8,203921.1,24,2,19,9,True
3757734,1277,2,451,4663,368567122,0,0,0,233.73,7,203687.37,24,6,11,10,True
3863316,327,0,20,9119,368567122,0,0,0,234.11,3,203453.26,11,4,8,10,True
3878136,1473,4,30,3117,368567122,0,0,0,234.12,8,203219.14,24,0,1,10,True
3911453,1473,4,451,8297,368567122,0,0,0,233.94,7,202985.2,24,1,7,11,True
3916411,1277,2,451,4629,368567122,0,0,0,234.23,7,202750.97,24,2,1,11,True
3942552,369,1,10,5736,368567122,0,0,0,233.76,6,202984.73,25,5,20,11,True
4292896,1473,4,-1,9527,368567122,0,1,0,233.86,1,202984.73,24,0,20,12,True
4910178,402,3,451,3117,368567122,0,0,0,234.11,7,202750.62,10,1,8,1,True
4920796,402,3,25,9119,368567122,0,0,0,234.12,8,202516.5,10,4,1,3,True
4984325,200,0,10,8405,368567122,0,0,0,233.75,0,202750.25,9,2,15,3,True
5214196,1205,0,30,2830,368567122,0,0,0,234.03,8,202516.22,24,4,22,3,True
5217014,402,3,25,4629,368567122,0,0,0,233.86,8,202282.36,10,1,22,4,True
5451869,1277,2,451,8297,368567122,0,0,0,234.08,7,202048.28,24,1,20,5,True
5903241,1277,2,451,7742,368567122,0,0,0,233.93,7,201814.35,24,4,2,5,True
6211307,1205,0,451,6843,368567122,0,0,0,234.06,7,201580.29,24,5,15,5,True
6219312,1473,4,30,4663,368567122,0,0,0,234.35,8,201345.94,24,0,4,5,True
6412901,420,4,451,2013,368567122,0,0,0,234.22,7,201111.72,18,6,7,6,True
6514963,652,0,10,6843,368567122,0,0,0,234.02,6,201345.74,24,4,19,7,True
6611570,420,4,25,8297,368567122,0,0,0,234.28,8,201111.46,18,0,4,7,True
6673582,1277,2,451,6065,368567122,0,0,0,234.11,7,200877.35,24,0,17,8,True
6735760,1473,4,-1,2830,368567122,0,1,0,233.88,4,200877.35,24,6,8,9,True
7010875,1473,4,451,7031,368567122,0,0,0,234.07,7,200643.28,24,3,18,11,True
7022631,1473,4,451,5736,368567122,0,0,0,234.02,7,200409.26,24,4,17,11,True
7059183,1473,4,451,8212,368567122,0,0,0,233.98,7,200175.28,24,0,20,11,True
7064054,1205,0,451,9723,368567122,0,0,0,234.03,7,199941.25,24,2,6,12,True
7195233,228,0,10,9119,368567122,0,0,0,233.93,0,200175.18,26,3,12,1,True
7303649,234,0,20,9527,368567122,0,0,0,234.27,5,199940.91,26,2,19,2,True
7513610,917,0,10,3117,368567122,0,0,0,233.72,6,200174.63,18,6,8,3,True
7581377,979,0,20,3117,368567122,0,0,0,233.8,5,199940.83,22,1,19,3,True
7693766,1485,0,10,6065,368567122,0,0,0,234.12,6,200174.95,24,3,13,4,True
7883717,402,3,30,5736,368567122,0,0,0,234.01,8,199940.94,10,6,16,4,True
7926483,1404,2,20,9428,368567122,0,0,0,234.05,5,199706.89,24,2,1,5,True
8007289,1277,2,30,8212,368567122,0,0,0,234.02,8,199472.87,24,5,18,6,True
8194318,402,3,30,8405,368567122,0,0,0,234.07,8,199238.8,10,4,7,7,True
8566295,1473,4,25,2013,368567122,0,0,0,234.17,8,199004.63,24,5,21,7,True
8583170,1205,0,451,5736,368567122,0,0,0,233.94,7,198770.69,24,3,3,7,True
8645676,420,4,-1,7031,368567122,0,1,0,233.64,1,198770.69,18,1,14,8,False
8765390,1422,1,10,9119,368567122,0,0,0,233.87,6,199004.56,24,1,15,9,False
9631307,1245,1,10,9527,368567122,0,0,0,234.05,6,199238.61,18,1,17,9,True
9832460,1205,0,30,8405,368567122,0,0,0,233.86,8,199004.75,24,5,15,9,True
1040026,538,0,20,5700,583470867,0,0,0,439.75,3,182620.25,18,1,9,1,True
1177520,824,2,30,7154,583470867,0,0,0,439.98,8,182180.27,18,1,0,1,True
1389511,551,0,10,2153,583470867,0,0,0,440.02,6,182620.29,17,6,5,4,True
1712206,824,2,-1,5851,583470867,0,1,0,439.96,4,182620.29,18,4,14,4,True
1783462,627,0,30,5602,583470867,0,0,0,440.25,8,182180.04,11,5,5,4,True
1810292,393,1,30,3134,583470867,0,0,0,440.32,8,181739.72,10,3,12,5,True
1917367,662,1,10,3134,583470867,0,0,0,439.93,6,182179.65,18,0,7,5,True
1993513,627,0,451,5700,583470867,0,0,0,439.79,7,181739.86,11,0,20,5,True
2131783,580,0,20,1748,583470867,0,0,0,439.96,3,181299.9,11,1,17,7,True
2585155,824,2,451,2062,583470867,0,0,0,440.08,7,180859.82,18,1,15,7,True
2824032,393,1,30,7821,583470867,0,0,0,439.88,8,180419.94,10,3,10,7,True
2939287,824,2,30,2062,583470867,0,0,0,439.89,8,179980.05,18,1,5,8,True
3391311,859,2,451,7154,583470867,0,0,0,440.15,7,179539.9,24,5,9,10,True
3726585,393,1,25,8937,583470867,0,0,0,440.01,8,179099.89,10,6,14,10,True
3737544,859,2,25,9108,583470867,0,0,0,440.23,8,178659.66,24,1,3,11,True
3842460,979,0,20,2062,583470867,0,0,0,439.83,3,178219.83,22,4,15,11,True
3971674,824,2,-1,2062,583470867,0,1,0,439.84,4,178219.83,18,0,16,12,False
4082655,627,0,451,2062,583470867,0,0,0,440.0,7,177779.83,11,6,1,3,True
4289537,859,2,-1,7154,583470867,0,1,0,439.89,1,177779.83,24,1,15,3,False
4309200,393,1,451,8937,583470867,0,0,0,439.73,7,177340.1,10,6,1,4,True
4576656,769,3,451,6140,583470867,0,0,0,439.94,7,176900.16,14,0,18,4,False
4784059,1262,0,20,8937,583470867,0,0,0,440.02,5,176460.14,23,2,2,5,False
4910948,769,3,25,5700,583470867,0,0,0,440.13,8,176020.01,14,2,10,5,True
5568289,627,0,451,5602,583470867,0,0,0,439.99,7,175580.02,11,4,0,6,True
5744555,859,2,30,2153,583470867,0,0,0,440.1,8,175139.92,24,0,15,7,True
5785324,769,3,-1,8937,583470867,0,1,0,440.0,1,175139.92,14,4,13,8,True
5812975,769,3,25,1570,583470867,0,0,0,440.05,8,174699.87,14,2,13,9,True
5838630,1406,0,20,5851,583470867,0,0,0,440.03,5,174259.84,24,0,23,9,True
6008511,824,2,451,5602,583470867,0,0,0,440.04,7,173819.8,18,2,8,10,True
6300006,222,2,20,5602,583470867,0,0,0,440.1,5,173379.7,26,5,5,10,True
6387714,393,1,25,7821,583470867,0,0,0,440.19,8,172939.51,10,6,21,10,True
6391447,268,2,20,5851,583470867,0,0,0,439.83,3,172499.68,24,6,22,11,True
6438455,627,0,451,2062,583470867,0,0,0,440.11,7,172059.57,11,1,16,11,True
6590299,649,0,20,9108,583470867,0,0,0,439.91,5,171619.66,24,5,0,12,True
6684770,769,3,451,8937,583470867,0,0,0,439.88,7,171179.78,14,2,5,12,True
6720214,824,2,30,6140,583470867,0,0,0,439.98,8,170739.8,18,1,3,1,True
6720887,824,2,25,2062,583470867,0,0,0,440.0,8,170299.8,18,1,14,4,True
6772374,393,1,451,9108,583470867,0,0,0,439.61,7,169860.19,10,0,9,4,True
6864124,769,3,-1,7154,583470867,0,1,0,440.21,4,169860.19,14,6,7,5,True
6879228,769,3,30,6695,583470867,0,0,0,440.25,8,169419.94,14,3,9,5,True
6960587,940,1,10,8937,583470867,0,0,0,440.0,6,169859.94,24,0,0,6,True
7028063,859,2,451,5602,583470867,0,0,0,440.26,7,169419.68,24,1,9,6,True
7037599,859,2,30,6695,583470867,0,0,0,439.9,8,168979.78,24,3,9,6,True
7514186,627,0,30,1570,583470867,0,0,0,439.91,8,168539.87,11,5,23,7,True
7747043,859,2,30,1748,583470867,0,0,0,439.98,8,168099.89,24,5,1,7,True
7988725,859,2,30,2153,583470867,0,0,0,439.92,8,167659.97,24,3,15,8,True
8046363,393,1,30,8937,583470867,0,0,0,439.84,8,167220.13,10,4,20,8,True
8545058,511,1,10,5700,583470867,0,0,0,439.86,6,167659.99,12,0,4,8,True
8559621,1007,2,20,1748,583470867,0,0,0,439.99,5,167220.0,26,1,14,9,True
9095318,769,3,30,3720,583470867,0,0,0,440.05,8,166779.95,14,3,20,10,True
9412220,627,0,451,1748,583470867,0,0,0,439.79,7,166340.16,11,5,5,11,True
9964274,824,2,451,6695,583470867,0,0,0,440.0,7,165900.16,18,5,18,11,True
1123355,846,3,25,4615,975299233,1,0,0,114.93,8,502270.07,5,3,9,1,True
1549154,1398,4,451,8952,975299233,1,0,0,114.84,7,502155.23,24,3,15,1,True
1582674,554,4,451,2363,975299233,1,0,0,115.1,7,502040.13,17,5,18,1,True
1622756,1398,4,25,1800,975299233,1,0,0,114.89,8,501925.24,24,4,6,1,True
1901129,84,4,451,7835,975299233,1,0,0,114.83,7,501810.41,1,5,8,5,True
2219636,554,4,-1,8902,975299233,1,1,0,114.69,4,501810.41,17,0,0,5,True
2771095,993,0,10,6490,975299233,1,0,0,115.04,6,501925.45,22,6,23,7,True
2852391,446,1,10,3037,975299233,1,0,0,114.9,6,502040.35,13,3,9,7,True
2989719,866,0,451,8765,975299233,1,0,0,115.13,7,501925.22,24,2,16,8,True
3244078,1355,4,30,2789,975299233,1,0,0,114.96,8,501810.26,24,1,19,8,True
3272704,1027,0,10,2789,975299233,1,0,0,114.91,6,501925.17,11,5,10,9,True
3377028,1124,0,20,4783,975299233,1,0,0,115.01,3,501810.16,24,1,4,11,True
3447154,846,3,30,4615,975299233,1,0,0,114.86,8,501695.3,5,4,10,12,True
3524513,1304,0,20,6502,975299233,1,0,0,114.97,5,501580.33,5,0,23,12,True
3602843,1272,0,10,4769,975299233,1,0,0,115.11,6,501695.44,24,1,23,1,True
3922073,84,4,25,3165,975299233,1,0,0,114.81,8,501580.63,1,1,2,2,True
3958811,846,3,30,6539,975299233,1,0,0,115.01,8,501465.62,5,4,12,3,False
3999538,846,3,25,4548,975299233,1,0,0,115.07,8,501350.55,5,2,1,3,True
4056797,1355,4,451,4548,975299233,1,0,0,114.86,7,501235.69,24,2,8,4,True
4145257,554,4,25,1800,975299233,1,0,0,115.04,8,501120.65,17,3,12,6,True
4245613,1150,0,10,2934,975299233,1,0,0,114.98,6,501235.63,15,2,15,7,True
4443060,866,0,451,3572,975299233,1,0,0,114.98,7,501120.65,24,2,21,8,True
4491387,1355,4,451,8495,975299233,1,0,0,115.42,7,501005.23,24,4,18,9,True
4525901,1355,4,451,8902,975299233,1,0,0,114.9,7,500890.33,24,0,3,10,True
4556966,846,3,-1,4872,975299233,1,1,0,114.78,1,500890.33,5,6,2,11,True
4798336,1398,4,451,8902,975299233,1,0,0,114.77,7,500775.56,24,6,3,12,True
4937884,1277,2,20,2789,975299233,1,0,0,114.73,5,500660.83,24,6,9,12,True
5126956,84,4,25,8484,975299233,1,0,0,115.27,8,500545.56,1,5,4,1,True
5386606,1355,4,-1,8484,975299233,1,1,0,115.2,4,500545.56,24,2,7,1,True
5678035,554,4,30,3572,975299233,1,0,0,114.88,8,500430.68,17,6,6,1,True
5923619,1132,0,10,7835,975299233,1,0,0,115.13,6,500545.81,24,1,17,1,False
6267107,1283,2,20,4783,975299233,1,0,0,115.03,5,500430.78,24,4,1,1,True
6601953,1398,4,25,3037,975299233,1,0,0,114.81,8,500315.97,24,5,11,2,True
6761543,846,3,30,7835,975299233,1,0,0,114.86,8,500201.11,5,6,4,3,True
6853207,1398,4,451,6116,975299233,1,0,0,114.87,7,500086.24,24,2,8,4,True
6867180,846,3,451,8005,975299233,1,0,0,115.06,7,499971.18,5,2,14,4,True
7006644,594,0,10,4548,975299233,1,0,0,115.3,0,500086.48,24,0,1,4,True
7171058,554,4,451,3572,975299233,1,0,0,114.99,7,499971.49,17,2,2,4,True
7173633,866,0,451,5061,975299233,1,0,0,114.83,7,499856.66,24,4,3,4,True
7273760,1123,2,20,4548,975299233,1,0,0,114.85,5,499741.81,24,2,11,4,True
7455249,84,4,451,8737,975299233,1,0,0,115.26,7,499626.55,1,0,6,5,True
7594113,1355,4,451,3637,975299233,1,0,0,115.13,7,499511.42,24,2,21,6,True
7662951,1398,4,451,2363,975299233,1,0,0,114.96,7,499396.46,24,0,5,6,True
8070136,767,0,10,8952,975299233,1,0,0,115.24,6,499511.7,14,4,15,6,True
8333174,866,0,-1,5061,975299233,1,1,0,115.06,4,499511.7,24,6,7,6,True
8824420,1435,2,20,4769,975299233,1,0,0,114.97,5,499396.73,24,5,9,6,True
8843746,846,3,-1,5130,975299233,1,1,0,115.04,1,499396.73,5,2,5,7,True
9032791,1398,4,30,8005,975299233,1,0,0,114.96,8,499281.77,24,6,0,8,True
9243514,866,0,30,3809,975299233,1,0,0,115.13,8,499166.64,24,4,5,8,True
9445937,1355,4,30,9947,975299233,1,0,0,115.02,8,499051.62,24,2,22,10,True
9667599,1355,4,25,8952,975299233,1,0,0,115.05,8,498936.57,24,1,19,11,True
1056651,650,3,25,2849,585914698,1,0,0,585.23,8,209106.77,24,4,13,1,True
1083465,502,0,30,8281,585914698,1,0,0,585.04,8,208521.73,12,2,15,2,True
1477751,916,0,20,6249,585914698,1,0,0,585.15,3,207936.58,18,2,1,3,True
1560080,101,3,451,8676,585914698,1,0,0,585.21,7,207351.37,3,3,21,3,True
1665603,353,1,10,6983,585914698,1,0,0,585.09,6,207936.46,24,1,9,3,True
1811856,1406,0,20,2849,585914698,1,0,0,584.91,3,207351.55,24,2,11,4,True
2414610,1203,4,25,6983,585914698,1,0,0,584.66,8,206766.89,24,1,14,4,False
2445190,101,3,25,8740,585914698,1,0,0,585.07,8,206181.82,3,4,11,4,True
2511509,502,0,25,2083,585914698,1,0,0,584.91,8,205596.91,12,5,14,5,True
2870804,650,3,451,8676,585914698,1,0,0,585.03,7,205011.88,24,5,22,5,True
3020177,650,3,-1,4881,585914698,1,1,0,585.07,4,205011.88,24,2,15,5,True
3175769,650,3,25,9794,585914698,1,0,0,585.03,8,204426.85,24,3,21,5,True
3211683,659,4,-1,8676,585914698,1,1,0,585.12,4,204426.85,18,6,12,5,True
3286212,659,4,-1,9794,585914698,1,2,0,584.96,4,204426.85,18,5,4,7,True
3482457,23,0,25,8356,585914698,1,0,0,584.96,8,203841.89,11,2,17,7,True
3615088,502,0,30,9193,585914698,1,0,0,585.14,8,203256.75,12,6,0,7,True
3747861,650,3,30,4881,585914698,1,0,0,584.88,8,202671.87,24,4,23,8,True
3815638,1034,1,10,7772,585914698,1,0,0,585.26,0,203257.13,11,3,17,8,True
3894162,101,3,25,6222,585914698,1,0,0,585.32,8,202671.81,3,3,21,8,True
3929241,1454,1,10,9160,585914698,1,0,0,585.15,6,203256.96,11,6,15,9,True
3963905,23,0,451,1050,585914698,1,0,0,585.05,7,202671.91,11,0,21,10,True
4304426,659,4,451,8192,585914698,1,0,0,584.93,7,202086.98,18,4,8,10,True
4456837,567,1,10,6222,585914698,1,0,0,584.91,6,202671.89,11,3,10,11,True
5103810,659,4,30,9116,585914698,1,0,0,584.95,8,202086.94,18,6,12,11,True
5469228,101,3,30,9116,585914698,1,0,0,584.9,8,201502.04,3,3,22,11,False
5604108,1205,0,451,9086,585914698,1,0,0,585.09,7,200916.95,24,2,6,12,True
5884739,23,0,25,3400,585914698,1,0,0,584.68,8,200332.27,11,0,16,3,True
5931135,1203,4,451,8680,585914698,1,0,0,584.84,7,199747.43,24,6,14,3,True
6270001,1467,0,20,9193,585914698,1,0,0,584.82,5,199162.61,11,6,19,3,True
6327291,101,3,30,6983,585914698,1,0,0,584.74,8,198577.87,3,2,0,3,True
6365832,572,0,10,7772,585914698,1,0,0,585.0,6,199162.87,11,4,21,4,True
6376526,1203,4,-1,9116,585914698,1,1,0,585.26,1,199162.87,24,6,6,4,True
6686475,1205,0,25,7772,585914698,1,0,0,585.04,8,198577.83,24,2,20,5,True
6720282,1169,0,20,2639,585914698,1,0,0,585.3,3,197992.53,24,3,17,6,True
6843968,1205,0,30,8740,585914698,1,0,0,585.18,8,197407.35,24,0,15,7,True
6958407,1411,0,451,6222,585914698,1,0,0,584.97,7,196822.38,24,5,1,7,True
7038787,101,3,25,4639,585914698,1,0,0,585.05,8,196237.33,3,1,3,9,True
7154233,399,2,20,8680,585914698,1,0,0,585.07,3,195652.26,10,0,0,9,True
7266482,1284,2,20,9794,585914698,1,0,0,584.83,3,195067.43,24,5,13,12,True
7420107,502,0,451,4698,585914698,1,0,0,585.13,7,194482.3,12,6,20,1,True
7436107,650,3,30,2639,585914698,1,0,0,584.88,8,193897.42,24,1,21,3,True
7503777,1411,0,30,7343,585914698,1,0,0,585.04,8,193312.38,24,0,15,3,True
7516806,576,2,451,6864,585914698,1,0,0,584.77,7,192727.61,11,2,2,3,True
7675423,650,3,25,8281,585914698,1,0,0,585.0,8,192142.61,24,2,6,3,True
7750696,23,0,-1,6249,585914698,1,1,0,584.96,4,192142.61,11,1,18,3,True
7798466,1411,0,30,9116,585914698,1,0,0,584.92,8,191557.69,24,3,23,6,True
7847702,1132,0,10,2083,585914698,1,0,0,584.71,0,192142.4,24,5,20,6,True
7874740,393,1,10,9116,585914698,1,0,0,584.93,6,192727.33,10,3,23,7,True
7881512,333,1,10,6983,585914698,1,0,0,585.14,6,193312.47,11,5,8,7,True
8291683,23,0,451,7343,585914698,1,0,0,584.89,7,192727.58,11,6,12,7,True
8309737,1203,4,-1,6249,585914698,1,1,0,584.89,1,192727.58,24,1,14,8,True
8444758,650,3,451,1050,585914698,1,0,0,585.11,7,192142.47,24,4,14,8,True
8823183,576,2,451,8740,585914698,1,0,0,585.09,7,191557.38,11,1,8,9,True
8829489,659,4,25,9794,585914698,1,0,0,584.97,8,190972.41,18,3,10,9,False
8966351,1203,4,-1,9086,585914698,1,1,0,585.2,4,190972.41,24,2,19,10,True
9414412,576,2,-1,9116,585914698,1,2,0,585.19,4,190972.41,11,3,18,10,True
9424020,1205,0,-1,4881,585914698,1,3,1,585.2,4,190972.41,24,4,3,10,True
1375586,1086,0,20,9763,219605123,0,0,0,1038.01,5,74186.99,18,2,14,1,True
1486532,947,2,20,5919,219605123,0,0,0,1038.11,5,73148.88,24,3,10,1,True
1576654,275,0,30,8729,219605123,0,0,0,1037.86,8,72111.02,24,5,23,1,True
1695348,1454,1,25,6535,219605123,0,0,0,1038.09,8,71072.93,11,5,20,2,True
1786160,275,0,30,6535,219605123,0,0,0,1038.2,8,70034.73,24,6,21,2,True
2283019,1454,1,-1,2588,219605123,0,1,0,1037.87,4,70034.73,11,3,10,4,True
2355943,485,1,10,9531,219605123,0,0,0,1037.9,6,71072.63,5,5,18,5,True
2418215,942,0,10,7137,219605123,0,0,0,1037.94,6,72110.57,24,3,22,6,True
2447999,303,0,10,3336,219605123,0,0,0,1038.12,6,73148.69,4,5,4,7,False
2457157,1139,3,30,6535,219605123,0,0,0,1038.18,8,72110.51,15,3,7,9,True
2666296,807,0,25,3336,219605123,0,0,0,1037.96,8,71072.55,11,3,16,9,True
3274687,1139,3,30,6077,219605123,0,0,0,1037.61,8,70034.94,15,5,13,9,True
3574207,599,0,10,2618,219605123,0,0,0,1037.7,0,71072.64,24,6,16,9,True
3578774,1387,1,10,6614,219605123,0,0,0,1037.83,6,72110.47,24,5,16,12,True
3801589,816,0,10,3156,219605123,0,0,0,1037.9,6,73148.37,18,5,21,1,True
3921997,60,4,-1,2954,219605123,0,1,0,1038.37,4,73148.37,20,3,4,1,True
3981190,1139,3,451,4979,219605123,0,0,0,1037.84,7,72110.53,15,2,7,2,True
4080276,807,0,30,2210,219605123,0,0,0,1037.99,8,71072.54,11,2,8,2,True
4300987,1139,3,451,4809,219605123,0,0,0,1037.96,7,70034.58,15,6,16,2,True
4307073,1139,3,451,6614,219605123,0,0,0,1037.9,7,68996.68,15,5,1,3,True
4414122,807,0,-1,2618,219605123,0,1,0,1038.11,4,68996.68,11,4,15,3,True
4583033,807,0,25,8729,219605123,0,0,0,1037.72,8,67958.96,11,4,1,4,True
4623873,603,0,20,2850,219605123,0,0,0,1037.96,5,66921.0,24,4,8,4,True
4650993,275,0,25,9473,219605123,0,0,0,1037.77,8,65883.23,24,4,5,7,True
4979760,1454,1,25,9531,219605123,0,0,0,1037.94,8,64845.29,11,5,3,9,True
5200429,1139,3,-1,6200,219605123,0,1,0,1037.91,1,64845.29,15,6,4,9,True
5662005,299,1,10,2618,219605123,0,0,0,1038.26,6,65883.55,4,6,9,9,True
5960475,1454,1,25,4094,219605123,0,0,0,1037.81,8,64845.74,11,6,12,9,True
6008486,253,2,20,3156,219605123,0,0,0,1037.96,5,63807.78,6,4,20,9,True
6073168,807,0,25,6077,219605123,0,0,0,1037.89,8,62769.89,11,1,17,10,True
6086614,980,1,10,9245,219605123,0,0,0,1038.17,6,63808.06,22,6,17,10,True
6264721,1139,3,25,1623,219605123,0,0,0,1038.02,8,62770.04,15,6,20,10,True
6283842,942,0,20,6077,219605123,0,0,0,1037.88,5,61732.16,24,3,6,11,True
6288773,60,4,30,2332,219605123,0,0,0,1037.99,8,60694.17,20,5,18,12,True
6295793,1139,3,25,3156,219605123,0,0,0,1037.91,8,59656.26,15,1,3,1,True
6335417,1065,0,10,9763,219605123,0,0,0,1037.85,6,60694.11,11,1,16,1,True
6822911,1361,2,20,9763,219605123,0,0,0,1038.26,5,59655.85,16,0,23,2,True
6968801,1139,3,451,4891,219605123,0,0,0,1037.85,7,58618.0,15,6,9,2,True
6969135,275,0,-1,6200,219605123,0,1,0,1038.25,4,58618.0,24,3,18,2,True
8354331,711,2,20,8729,219605123,0,0,0,1037.96,5,57580.04,18,3,0,3,True
8406006,60,4,30,9531,219605123,0,0,0,1038.04,8,56542.0,20,4,21,6,True
8447214,807,0,30,3156,219605123,0,0,0,1038.06,8,55503.94,11,6,16,6,True
8805508,1461,0,20,9763,219605123,0,0,0,1038.16,5,54465.78,11,1,18,7,True
8902143,411,2,20,4891,219605123,0,0,0,1037.94,5,53427.84,18,4,7,7,True
8989319,790,0,10,7707,219605123,0,0,0,1038.22,0,54466.06,11,1,12,8,True
9001910,1139,3,30,3336,219605123,0,0,0,1038.09,8,53427.97,15,6,1,9,True
9114574,60,4,451,2588,219605123,0,0,0,1038.07,7,52389.9,20,5,9,9,True
9120775,1454,1,451,6077,219605123,0,0,0,1037.87,7,51352.03,11,0,18,10,True
9301008,689,0,20,2588,219605123,0,0,0,1037.88,3,50314.15,24,2,21,10,True
9428757,1012,0,20,3156,219605123,0,0,0,1038.14,3,49276.01,26,4,15,11,False
9948377,1454,1,-1,4809,219605123,0,1,0,1037.78,4,49276.01,11,2,14,11,True
1159756,834,0,451,8648,224394340,1,0,0,193.91,7,577957.09,5,3,1,2,True
1401433,950,0,451,9184,224394340,1,0,0,193.98,7,577763.11,24,4,21,2,True
1496253,850,1,451,2171,224394340,1,0,0,194.07,7,577569.04,5,1,18,3,True
1692246,177,4,30,3315,224394340,1,0,0,194.09,8,577374.95,24,2,18,3,True
1742762,950,0,25,4308,224394340,1,0,0,193.91,8,577181.04,24,2,8,3,True
1782768,1377,0,20,5582,224394340,1,0,0,193.86,3,576987.18,16,1,16,4,True
1892189,325,0,20,5958,224394340,1,0,0,194.1,3,576793.08,11,0,6,5,True
2045958,850,1,25,6252,224394340,1,0,0,194.15,8,576598.93,5,3,10,5,True
2188269,950,0,-1,4057,224394340,1,1,0,194.04,4,576598.93,24,4,23,8,True
2220564,1224,4,-1,8697,224394340,1,2,0,194.2,4,576598.93,24,1,14,8,True
2415561,215,0,20,6557,224394340,1,0,0,193.98,3,576404.95,9,2,13,8,True
2441138,1224,4,-1,2171,224394340,1,1,0,193.8,4,576404.95,24,3,0,11,True
2468735,1224,4,30,6557,224394340,1,0,0,193.93,8,576211.02,24,1,14,12,True
2698382,1224,4,25,2171,224394340,1,0,0,194.12,8,576016.9,24,4,22,12,True
2839314,950,0,25,6557,224394340,1,0,0,194.38,8,575822.52,24,4,17,1,True
3283228,950,0,25,3886,224394340,1,0,0,193.81,8,575628.71,24,5,4,1,True
3486413,1017,2,20,5582,224394340,1,0,0,193.96,5,575434.75,26,3,11,3,True
3847660,1224,4,25,3982,224394340,1,0,0,194.02,8,575240.73,24,3,3,4,True
4214468,177,4,-1,2171,224394340,1,1,0,193.93,1,575240.73,24,2,22,5,True
4326658,897,0,20,5582,224394340,1,0,0,193.99,5,575046.74,24,3,15,6,True
4676900,1312,0,20,6019,224394340,1,0,0,193.9,5,574852.84,5,5,15,6,True
4700678,1224,4,451,9784,224394340,1,0,0,193.87,7,574658.97,24,1,15,6,True
4742150,1027,0,10,3886,224394340,1,0,0,193.92,0,574852.89,11,6,19,7,True
4776253,850,1,-1,4308,224394340,1,1,0,194.0,4,574852.89,5,5,13,7,True
4907927,834,0,25,3008,224394340,1,0,0,193.77,8,574659.12,5,1,19,8,True
5195090,854,0,20,3982,224394340,1,0,0,193.9,3,574465.22,24,5,18,9,True
5365038,1224,4,30,6318,224394340,1,0,0,194.09,8,574271.13,24,4,13,9,True
5457118,145,0,10,8648,224394340,1,0,0,194.08,6,574465.21,18,0,7,9,True
5522580,950,0,25,2171,224394340,1,0,0,193.95,8,574271.26,24,5,13,9,True
5921629,850,1,-1,6318,224394340,1,1,0,194.18,4,574271.26,5,1,4,10,True
6108975,29,0,10,2171,224394340,1,0,0,194.21,6,574465.47,11,3,12,10,True
6189095,479,2,20,6019,224394340,1,0,0,193.76,5,574271.71,5,2,2,11,True
6374847,1069,1,10,5582,224394340,1,0,0,193.87,0,574465.58,18,2,7,11,True
7379904,1224,4,30,6019,224394340,1,0,0,194.03,8,574271.55,24,5,10,11,True
7733005,834,0,25,5582,224394340,1,0,0,194.07,8,574077.48,5,5,22,1,True
7951051,950,0,-1,9784,224394340,1,1,0,193.97,1,574077.48,24,1,2,1,True
7955579,129,0,10,8648,224394340,1,0,0,194.01,6,574271.49,18,1,13,2,True
7960240,1092,1,10,4057,224394340,1,0,0,193.7,0,574465.19,18,1,7,2,True
8219930,850,1,25,6557,224394340,1,0,0,194.15,8,574271.04,5,2,5,2,True
8901982,1224,4,451,8697,224394340,1,0,0,193.86,7,574077.18,24,1,13,4,True
9052768,1224,4,451,4057,224394340,1,0,0,194.16,7,573883.02,24,1,19,5,True
9073898,1224,4,-1,5582,224394340,1,1,0,194.02,1,573883.02,24,4,5,5,True
9089553,1224,4,451,5582,224394340,1,0,0,193.89,7,573689.13,24,4,1,6,True
9093266,47,1,10,3982,224394340,1,0,0,194.12,0,573883.25,24,4,3,7,True
9324266,850,1,30,5958,224394340,1,0,0,194.19,8,573689.06,5,6,11,8,True
9344409,353,1,10,3008,224394340,1,0,0,193.78,6,573882.84,24,1,22,8,True
9364541,850,1,25,8648,224394340,1,0,0,194.08,8,573688.76,5,1,23,9,True
9441218,850,1,-1,6557,224394340,1,1,0,194.08,4,573688.76,5,3,0,9,True
9450652,834,0,25,6318,224394340,1,0,0,193.88,8,573494.88,5,1,12,10,True
9755672,950,0,25,6318,224394340,1,0,0,193.98,8,573300.9,24,6,1,11,True
9915562,177,4,25,9784,224394340,1,0,0,194.37,8,573106.53,24,0,7,11,False
1182179,327,0,20,8895,492690255,1,0,0,957.21,3,753940.79,11,6,9,1,True
1357797,879,1,25,2576,492690255,1,0,0,956.77,8,752984.02,27,4,3,2,True
1470445,1164,0,10,6736,492690255,1,0,0,956.8,6,753940.82,24,5,2,2,True
1762141,1435,2,451,8895,492690255,1,0,0,957.11,7,752983.71,24,3,8,3,True
2057522,413,4,-1,5157,492690255,1,1,0,956.92,4,752983.71,18,0,1,3,True
2152617,1434,0,20,8407,492690255,1,0,0,956.99,3,752026.72,24,4,6,3,True
2201962,1402,4,25,3396,492690255,1,0,0,957.09,8,751069.63,24,6,17,3,True
2313150,398,0,10,2576,492690255,1,0,0,956.92,6,752026.55,10,4,1,4,True
2360367,1201,0,10,9141,492690255,1,0,0,956.96,0,752983.51,24,1,14,5,False
2361543,971,4,-1,9109,492690255,1,1,0,957.09,4,752983.51,13,5,5,6,True
2880750,1179,0,451,7113,492690255,1,0,0,957.01,7,752026.5,24,2,9,6,True
3237436,1435,2,30,4300,492690255,1,0,0,957.13,8,751069.37,24,5,5,7,False
3300636,413,4,25,3396,492690255,1,0,0,956.79,8,750112.58,18,0,16,8,True
3350580,318,0,10,7872,492690255,1,0,0,957.2,6,751069.78,11,4,9,8,True
3571821,1179,0,25,3613,492690255,1,0,0,957.09,8,750112.69,24,1,9,8,True
3799396,365,0,10,5994,492690255,1,0,0,956.95,6,751069.64,25,4,6,8,True
3801009,971,4,25,6000,492690255,1,0,0,957.12,8,750112.52,13,4,18,8,True
3814553,413,4,30,7865,492690255,1,0,0,957.03,8,749155.49,18,5,15,9,True
4027196,1402,4,451,6000,492690255,1,0,0,957.12,7,748198.37,24,1,12,9,False
4801636,413,4,30,6736,492690255,1,0,0,957.04,8,747241.33,18,6,10,9,True
4876728,670,0,20,2469,492690255,1,0,0,957.12,5,746284.21,18,5,20,10,True
5136300,879,1,25,3613,492690255,1,0,0,957.05,8,745327.16,27,5,5,11,True
5141154,1402,4,30,5994,492690255,1,0,0,957.03,8,744370.13,24,1,16,12,True
5146800,1162,2,20,4811,492690255,1,0,0,956.97,3,743413.16,24,1,10,1,True
5884189,1140,0,10,7872,492690255,1,0,0,957.1,0,744370.26,15,4,21,1,True
6198339,1179,0,30,2576,492690255,1,0,0,956.68,8,743413.58,24,2,6,2,False
6228514,1413,0,10,8025,492690255,1,0,0,957.04,6,744370.62,24,4,6,4,True
6383294,194,1,10,4364,492690255,1,0,0,956.99,0,745327.61,18,5,3,4,True
6815384,256,4,25,4811,492690255,1,0,0,956.93,8,744370.68,6,1,3,4,True
7029338,879,1,30,6736,492690255,1,0,0,957.07,8,743413.61,27,2,2,5,True
7084776,879,1,30,4349,492690255,1,0,0,956.85,8,742456.76,27,4,0,5,True
7112098,1278,0,10,7872,492690255,1,0,0,956.9,0,743413.66,24,4,2,6,True
7330673,1273,0,20,2485,492690255,1,0,0,957.05,5,742456.61,24,0,3,6,True
7640302,942,0,20,6482,492690255,1,0,0,957.19,5,741499.42,24,0,14,7,True
7741540,1402,4,-1,3396,492690255,1,1,0,957.01,4,741499.42,24,1,19,7,True
7940876,1435,2,-1,4300,492690255,1,2,0,956.81,1,741499.42,24,3,10,8,True
8048408,130,0,20,2485,492690255,1,0,0,956.9,3,740542.52,18,2,5,8,True
8120227,1179,0,451,8025,492690255,1,0,0,957.25,7,739585.27,24,3,16,8,True
8218535,622,4,451,1461,492690255,1,0,0,956.93,7,738628.34,11,6,20,9,True
8240027,971,4,-1,5114,492690255,1,1,0,956.91,4,738628.34,13,0,9,10,True
8269535,879,1,30,6000,492690255,1,0,0,956.79,8,737671.55,27,2,17,11,True
8492296,413,4,-1,2945,492690255,1,1,0,957.01,4,737671.55,18,6,2,12,True
8621962,256,4,451,5114,492690255,1,0,0,957.38,7,736714.17,6,0,5,1,True
8641466,818,1,10,4364,492690255,1,0,0,957.06,6,737671.23,18,4,15,1,True
8697579,1435,2,451,5114,492690255,1,0,0,957.0,7,736714.23,24,1,0,1,True
8744787,622,4,451,4811,492690255,1,0,0,956.92,7,735757.31,11,5,19,4,True
8821564,185,1,10,4300,492690255,1,0,0,956.94,6,736714.25,18,5,18,5,True
8822750,971,4,451,9141,492690255,1,0,0,957.01,7,735757.24,13,5,7,5,True
8974307,748,1,10,8025,492690255,1,0,0,956.94,0,736714.18,24,4,7,5,True
8986503,1179,0,-1,2945,492690255,1,1,0,957.08,4,736714.18,24,0,19,5,True
9370608,1179,0,451,4811,492690255,1,0,0,957.4,7,735756.78,24,5,16,6,True
9419493,622,4,25,2945,492690255,1,0,0,956.9,8,734799.88,11,2,19,6,True
9590773,747,1,10,7872,492690255,1,0,0,956.86,6,735756.74,24,4,14,7,True
9774118,622,4,30,8407,492690255,1,0,0,956.89,8,734799.85,11,1,14,8,True
9775793,971,4,25,2945,492690255,1,0,0,956.96,8,733842.89,13,2,6,11,True
9904054,1325,0,20,9109,492690255,1,0,0,957.21,5,732885.68,18,0,4,11,True
1074880,299,1,451,3592,955491217,1,0,0,670.94,7,660175.06,4,5,4,1,True
1147528,1197,3,30,7787,955491217,1,0,0,671.36,8,659503.7,24,4,17,2,True
1171885,299,1,-1,2337,955491217,1,1,0,671.12,4,659503.7,4,5,0,4,True
1180522,597,4,451,2251,955491217,1,0,0,671.06,7,658832.64,24,1,9,5,True
1467049,507,4,-1,1027,955491217,1,1,0,671.06,1,658832.64,12,0,11,5,False
1557278,842,2,20,4532,955491217,1,0,0,670.99,3,658161.65,5,5,5,5,True
1662487,1197,3,30,6660,955491217,1,0,0,670.88,8,657490.77,24,6,23,5,True
2296330,774,2,20,3384,955491217,1,0,0,670.7,3,656820.07,14,5,14,5,True
2342872,1088,4,30,3526,955491217,1,0,0,671.05,8,656149.02,18,3,13,6,True
2385480,649,0,10,6469,955491217,1,0,0,671.02,0,656820.04,24,1,3,7,True
2569181,597,4,451,7787,955491217,1,0,0,670.94,7,656149.1,24,3,21,8,True
2902046,1088,4,451,3526,955491217,1,0,0,670.97,7,655478.13,18,4,17,9,True
2978523,507,4,451,3642,955491217,1,0,0,671.12,7,654807.01,12,4,9,9,True
3024593,1197,3,451,7852,955491217,1,0,0,670.99,7,654136.02,24,5,15,10,True
3101083,817,4,451,9656,955491217,1,0,0,670.91,7,653465.11,18,5,5,10,True
3139612,53,0,20,2723,955491217,1,0,0,671.22,3,652793.89,20,5,13,10,True
3154645,1088,4,-1,2686,955491217,1,1,0,670.78,4,652793.89,18,2,6,10,True
3155225,1088,4,25,3992,955491217,1,0,0,670.92,8,652122.97,18,1,14,11,False
3403979,591,0,10,6469,955491217,1,0,0,671.04,6,652794.01,24,1,21,12,True
3479708,507,4,-1,6989,955491217,1,1,0,670.82,4,652794.01,12,5,17,12,True
3529600,1086,0,25,4532,955491217,1,0,0,671.07,8,652122.94,18,3,0,12,True
3552036,327,0,20,2307,955491217,1,0,0,671.13,5,651451.81,11,3,11,2,True
3642309,507,4,30,9401,955491217,1,0,0,671.02,8,650780.79,12,1,20,2,True
3963222,1488,0,20,3592,955491217,1,0,0,671.15,5,650109.64,24,2,16,3,True
4029863,611,0,10,7787,955491217,1,0,0,671.27,6,650780.91,11,2,8,3,True
4173972,14,2,20,8884,955491217,1,0,0,670.88,5,650110.03,24,4,22,4,True
4623909,1052,0,20,7787,955491217,1,0,0,670.81,3,649439.22,11,3,12,4,True
4923745,1197,3,30,3642,955491217,1,0,0,671.11,8,648768.11,24,6,19,4,True
5382973,817,4,30,2686,955491217,1,0,0,671.05,8,648097.06,18,1,23,4,True
5491415,1088,4,25,7787,955491217,1,0,0,670.91,8,647426.15,18,3,16,5,True
5508232,507,4,30,2723,955491217,1,0,0,671.14,8,646755.01,12,6,11,5,True
5543844,597,4,451,2723,955491217,1,0,0,671.08,7,646083.93,24,2,12,5,True
5997498,507,4,-1,3642,955491217,1,1,0,670.85,4,646083.93,12,4,9,6,True
6158310,817,4,30,3722,955491217,1,0,0,670.87,8,645413.06,18,5,13,6,True
6312163,1197,3,30,3384,955491217,1,0,0,671.0,8,644742.06,24,3,1,6,True
6487910,1086,0,451,6655,955491217,1,0,0,670.88,7,644071.18,18,0,18,7,True
6618381,299,1,-1,1963,955491217,1,1,0,671.01,4,644071.18,4,2,14,9,True
6957257,1086,0,451,2723,955491217,1,0,0,671.21,7,643399.97,18,5,12,9,True
7132178,1197,3,451,3655,955491217,1,0,0,671.15,7,642728.82,24,4,7,10,True
7199445,1197,3,25,3722,955491217,1,0,0,671.11,8,642057.71,24,4,4,11,True
7347665,129,0,10,9656,955491217,1,0,0,671.14,6,642728.85,18,5,8,12,True
7433853,1197,3,-1,2251,955491217,1,1,0,670.94,1,642728.85,24,5,7,1,True
7516268,507,4,-1,7520,955491217,1,2,0,671.0,1,642728.85,12,6,20,1,True
7658073,597,4,451,6989,955491217,1,0,0,670.82,7,642058.03,24,0,15,1,True
7703383,1039,1,10,2307,955491217,1,0,0,671.11,6,642729.14,11,1,18,1,True
7706810,507,4,25,1963,955491217,1,0,0,670.79,8,642058.35,12,1,14,3,True
7737765,1086,0,30,3592,955491217,1,0,0,671.19,8,641387.16,18,1,22,4,True
8005323,1088,4,451,7852,955491217,1,0,0,670.67,7,640716.49,18,2,5,4,True
8373761,1088,4,25,7787,955491217,1,0,0,671.24,8,640045.25,18,3,23,5,True
8568854,1086,0,25,3106,955491217,1,0,0,671.22,8,639374.03,18,4,4,6,True
8698642,507,4,-1,7787,955491217,1,1,0,671.15,1,639374.03,12,2,21,8,True
8821345,1086,0,25,6078,955491217,1,0,0,670.84,8,638703.19,18,1,6,8,True
8844714,817,4,30,2307,955491217,1,0,0,671.01,8,638032.18,18,2,5,9,True
8854295,299,1,451,2307,955491217,1,0,0,670.79,7,637361.39,4,4,12,9,False
9011218,1088,4,451,2723,955491217,1,0,0,671.09,7,636690.3,18,5,10,9,True
9039087,132,2,20,3526,955491217,1,0,0,670.93,5,636019.37,18,5,9,9,True
9309704,238,0,20,3106,955491217,1,0,0,670.97,5,635348.4,26,4,0,10,False
9821307,299,1,451,2477,955491217,1,0,0,671.02,7,634677.38,4,2,6,11,True
1105638,748,1,451,2954,149392052,1,0,0,157.35,7,770269.65,24,2,11,1,False
1157079,883,0,20,5295,149392052,1,0,0,156.91,5,770112.74,24,0,5,2,True
1181996,1019,0,10,2839,149392052,1,0,0,156.91,6,770269.65,26,2,21,3,True
1195190,1027,0,10,4440,149392052,1,0,0,157.1,0,770426.75,11,6,6,3,True
1338520,1315,0,451,1090,149392052,1,0,0,156.96,7,770269.79,5,5,12,4,True
1455380,1211,4,-1,4885,149392052,1,1,0,156.62,4,770269.79,24,4,16,4,True
1519434,1195,1,10,6264,149392052,1,0,0,156.93,0,770426.72,24,2,5,5,True
1605814,530,0,10,8826,149392052,1,0,0,156.97,6,770583.69,18,4,12,5,True
1680912,269,0,20,4440,149392052,1,0,0,156.94,5,770426.75,24,1,13,6,True
1716200,194,1,10,4894,149392052,1,0,0,156.84,6,770583.59,18,2,13,7,True
1991676,972,3,451,4440,149392052,1,0,0,157.0,7,770426.59,13,3,16,7,True
2094494,317,4,451,6639,149392052,1,0,0,156.95,7,770269.64,4,3,19,8,True
2298035,1116,0,451,8075,149392052,1,0,0,157.08,7,770112.56,24,6,12,8,True
2321694,972,3,451,9303,149392052,1,0,0,157.01,7,769955.55,13,6,19,9,True
2592262,972,3,451,5731,149392052,1,0,0,156.93,7,769798.62,13,4,9,9,True
2801815,474,4,451,2839,149392052,1,0,0,157.2,7,769641.42,5,0,18,11,True
3207577,1211,4,25,4894,149392052,1,0,0,156.69,8,769484.73,24,5,2,11,False
3321016,513,4,-1,6050,149392052,1,1,0,157.01,4,769484.73,12,3,17,2,True
3629869,509,0,10,8185,149392052,1,0,0,156.9,0,769641.63,12,3,2,2,True
3962685,513,4,-1,1426,149392052,1,1,0,157.02,4,769641.63,12,0,7,3,True
4475600,769,3,-1,8525,149392052,1,2,0,156.99,4,769641.63,14,4,0,5,False
4562690,1116,0,25,8185,149392052,1,0,0,156.88,8,769484.75,24,6,6,7,True
4765462,448,0,10,1629,149392052,1,0,0,157.16,6,769641.91,13,1,18,7,True
5065496,513,4,30,8074,149392052,1,0,0,156.94,8,769484.97,12,6,15,7,True
5099184,972,3,451,2954,149392052,1,0,0,156.82,7,769328.15,13,0,16,7,True
5144356,1315,0,451,2095,149392052,1,0,0,157.02,7,769171.13,5,2,22,8,True
5194832,1116,0,451,8826,149392052,1,0,0,157.01,7,769014.12,24,3,0,8,True
5204253,769,3,-1,1629,149392052,1,1,0,157.16,4,769014.12,14,5,2,9,True
5236777,972,3,-1,4894,149392052,1,2,0,156.73,4,769014.12,13,1,18,9,True
5375707,1297,0,10,8826,149392052,1,0,0,156.9,6,769171.02,5,0,15,9,True
5792061,21,0,20,2095,149392052,1,0,0,157.09,5,769013.93,11,3,9,9,True
5794453,611,0,20,8185,149392052,1,0,0,157.11,5,768856.82,11,3,3,10,True
6156662,474,4,30,4328,149392052,1,0,0,157.03,8,768699.79,5,0,12,10,True
6178374,769,3,-1,9626,149392052,1,1,0,156.95,4,768699.79,14,6,23,11,True
6528838,513,4,-1,4328,149392052,1,2,0,157.09,4,768699.79,12,6,15,12,True
7043996,972,3,30,8075,149392052,1,0,0,157.17,8,768542.62,13,3,15,1,True
7113192,748,1,25,4186,149392052,1,0,0,156.95,8,768385.67,24,4,22,1,True
7586603,644,0,10,8185,149392052,1,0,0,156.61,6,768542.28,24,1,14,1,True
7597246,769,3,451,4186,149392052,1,0,0,156.64,7,768385.64,14,6,15,1,True
7930264,1315,0,25,2954,149392052,1,0,0,157.16,8,768228.48,5,2,5,1,True
7954062,679,0,10,7477,149392052,1,0,0,156.98,0,768385.46,24,2,12,2,True
8001208,318,0,10,4328,149392052,1,0,0,156.96,6,768542.42,11,5,8,3,True
8204990,1211,4,451,9376,149392052,1,0,0,156.76,7,768385.66,24,4,10,3,True
8258490,317,4,-1,9376,149392052,1,1,0,157.19,1,768385.66,4,5,10,4,True
8933722,769,3,451,9303,149392052,1,0,0,157.03,7,768228.63,14,1,14,4,True
9085874,871,0,10,8185,149392052,1,0,0,157.06,6,768385.69,24,1,0,5,True
9101904,972,3,25,8185,149392052,1,0,0,156.8,8,768228.89,13,4,9,5,True
9123262,1315,0,-1,4894,149392052,1,1,0,157.0,4,768228.89,5,6,20,6,True
9123965,1116,0,-1,4894,149392052,1,2,0,156.84,1,768228.89,24,0,12,6,True
9181719,1318,0,20,6639,149392052,1,0,0,156.99,5,768071.9,18,3,14,6,True
9298008,748,1,30,1426,149392052,1,0,0,156.94,8,767914.96,24,2,4,7,True
9302242,474,4,30,1426,149392052,1,0,0,156.9,8,767758.06,5,2,5,7,True
9588482,748,1,451,4885,149392052,1,0,0,157.13,7,767600.93,24,5,3,8,True
9767476,748,1,-1,9303,149392052,1,1,0,156.98,4,767600.93,24,2,11,8,True
9864426,748,1,451,7477,149392052,1,0,0,156.97,7,767443.96,24,6,3,9,True
9914469,769,3,25,6050,149392052,1,0,0,156.88,8,767287.08,14,3,21,11,True
1312663,1402,4,-1,7764,737586578,0,1,0,992.96,1,180069.0,24,3,17,1,False
1572808,202,4,451,5217,737586578,0,0,0,993.13,7,179075.87,9,2,12,2,True
1636538,154,4,451,7473,737586578,0,0,0,993.13,7,178082.74,18,5,20,3,True
1733080,1402,4,451,8105,737586578,0,0,0,993.24,7,177089.5,24,3,23,4,True
1991256,202,4,451,3231,737586578,0,0,0,993.01,7,176096.49,9,1,11,4,False
2007656,554,4,30,9682,737586578,0,0,0,993.33,8,175103.16,17,3,15,5,True
2063767,325,0,10,7764,737586578,0,0,0,992.94,0,176096.1,11,6,17,5,True
2088023,202,4,25,5146,737586578,0,0,0,993.06,8,175103.04,9,0,0,6,True
2173766,202,4,30,3231,737586578,0,0,0,993.0,8,174110.04,9,4,19,8,True
2315611,1390,0,10,5146,737586578,0,0,0,993.32,6,175103.36,24,0,15,8,True
2599261,1402,4,30,7392,737586578,0,0,0,992.95,8,174110.41,24,5,3,9,True
3044053,484,0,10,2571,737586578,0,0,0,992.93,0,175103.34,5,4,3,11,True
3197398,441,4,451,4339,737586578,0,0,0,993.07,7,174110.27,24,6,1,11,True
3266770,154,4,30,5146,737586578,0,0,0,993.0,8,173117.27,18,2,2,11,True
3319294,1075,0,20,8225,737586578,0,0,0,992.77,3,172124.5,18,0,14,12,True
3365672,480,0,10,8225,737586578,0,0,0,993.04,6,173117.54,5,0,10,12,True
3767149,554,4,451,7473,737586578,0,0,0,992.93,7,172124.61,17,4,19,1,True
3788242,202,4,-1,2358,737586578,0,1,0,993.11,4,172124.61,9,6,4,1,True
3942962,202,4,-1,1541,737586578,0,2,0,992.97,4,172124.61,9,1,2,3,True
3990643,512,0,10,9682,737586578,0,0,0,992.73,6,173117.34,12,3,3,3,True
4020714,154,4,-1,9682,737586578,0,1,0,992.94,4,173117.34,18,5,9,4,True
4060299,441,4,30,8240,737586578,0,0,0,992.84,8,172124.5,24,5,17,4,True
4383355,202,4,30,5217,737586578,0,0,0,993.14,8,171131.36,9,3,22,5,True
4665357,154,4,25,8105,737586578,0,0,0,993.23,8,170138.13,18,5,13,6,True
4726038,441,4,30,2571,737586578,0,0,0,993.13,8,169145.0,24,3,18,6,True
4920958,202,4,451,2358,737586578,0,0,0,993.06,7,168151.94,9,2,10,6,True
5057717,154,4,30,2358,737586578,0,0,0,993.19,8,167158.75,18,5,18,7,True
5111757,372,0,20,8240,737586578,0,0,0,993.19,3,166165.56,25,5,12,8,True
5222405,249,0,10,1061,737586578,0,0,0,992.84,0,167158.4,6,0,2,8,True
5378965,918,2,20,8105,737586578,0,0,0,992.89,5,166165.51,18,2,17,8,True
5779658,1402,4,25,8105,737586578,0,0,0,992.93,8,165172.58,24,0,21,9,True
5842102,1191,4,30,4809,737586578,0,0,0,992.98,8,164179.6,24,1,2,9,True
6392056,1044,0,20,4809,737586578,0,0,0,992.84,5,163186.76,11,0,21,10,True
6408376,441,4,25,3214,737586578,0,0,0,992.92,8,162193.84,24,0,9,11,True
6513503,441,4,25,1061,737586578,0,0,0,993.06,8,161200.78,24,4,6,11,True
6834353,318,0,10,7764,737586578,0,0,0,992.9,6,162193.68,11,3,17,11,True
6855958,471,0,20,8240,737586578,0,0,0,992.88,3,161200.8,5,3,5,1,True
6868961,1125,1,10,4339,737586578,0,0,0,992.87,0,162193.67,24,0,16,3,True
6931075,220,0,10,7392,737586578,0,0,0,992.91,6,163186.58,26,1,16,3,True
6946007,202,4,451,8225,737586578,0,0,0,993.0,7,162193.58,9,5,16,3,False
7213977,154,4,-1,6828,737586578,0,1,0,993.04,1,162193.58,18,2,8,3,True
7267499,114,0,10,7392,737586578,0,0,0,993.1,6,163186.68,3,0,9,3,True
7406925,441,4,25,1782,737586578,0,0,0,992.98,8,162193.7,24,2,6,3,True
7591484,554,4,25,8105,737586578,0,0,0,992.89,8,161200.81,17,6,22,4,True
7684574,239,1,10,4339,737586578,0,0,0,993.01,0,162193.82,26,1,19,5,True
7708425,1238,0,10,1782,737586578,0,0,0,993.08,6,163186.9,18,2,17,6,True
8063104,1402,4,25,7764,737586578,0,0,0,992.79,8,162194.11,24,5,0,6,True
8243755,1191,4,451,8240,737586578,0,0,0,993.06,7,161201.05,24,2,17,8,True
8390694,154,4,25,1061,737586578,0,0,0,993.05,8,160208.0,18,1,12,8,True
8624194,441,4,-1,4809,737586578,0,1,0,992.94,4,160208.0,24,6,8,9,True
8812321,154,4,30,3231,737586578,0,0,0,992.87,8,159215.13,18,1,14,9,True
9098389,554,4,30,1061,737586578,0,0,0,993.52,8,158221.61,17,0,6,9,True
9317083,154,4,451,5217,737586578,0,0,0,993.08,7,157228.53,18,0,13,9,True
9353939,554,4,25,6828,737586578,0,0,0,993.1,8,156235.43,17,2,9,10,True
9699955,1402,4,-1,5146,737586578,0,1,0,993.05,4,156235.43,24,0,14,11,True
9939878,554,4,451,4339,737586578,0,0,0,993.01,7,155242.42,17,2,1,11,True
1054085,42,2,451,5756,461945067,1,0,0,811.24,7,122645.76,24,5,21,1,True
1666045,937,0,25,2314,461945067,1,0,0,811.17,8,121834.59,24,0,10,1,True
1905742,42,2,30,2913,461945067,1,0,0,810.96,8,121023.63,24,3,18,3,True
1937212,1214,4,-1,1018,461945067,1,1,0,810.99,4,121023.63,24,0,9,4,True
2014880,736,1,10,2913,461945067,1,0,0,810.76,0,121834.39,11,4,19,5,True
2480313,729,0,10,2314,461945067,1,0,0,811.01,0,122645.4,11,6,4,5,True
2737007,1152,0,10,8422,461945067,1,0,0,811.11,0,123456.51,15,5,14,6,True
3059336,1454,1,10,6636,461945067,1,0,0,811.17,0,124267.68,11,4,6,7,True
3070732,564,0,10,2790,461945067,1,0,0,811.08,6,125078.76,17,6,20,7,True
3126293,151,4,25,9630,461945067,1,0,0,810.67,8,124268.09,18,4,6,8,True
3138202,1019,0,25,3602,461945067,1,0,0,811.07,8,123457.02,26,4,1,9,True
3298012,866,0,30,7937,461945067,1,0,0,811.08,8,122645.94,24,0,18,10,True
3440756,1019,0,-1,3880,461945067,1,1,0,810.84,4,122645.94,26,3,14,10,True
3524966,1214,4,30,8132,461945067,1,0,0,810.77,8,121835.17,24,3,19,10,True
3696023,1044,0,10,3947,461945067,1,0,0,811.16,6,122646.33,11,4,13,10,True
3977258,1214,4,-1,2099,461945067,1,1,0,810.86,4,122646.33,24,0,6,10,False
4296001,192,2,20,3657,461945067,1,0,0,810.69,5,121835.64,18,1,1,11,True
4302949,937,0,451,4356,461945067,1,0,0,811.21,7,121024.43,24,3,0,11,True
4506670,151,4,25,6636,461945067,1,0,0,811.12,8,120213.31,18,5,6,11,True
4567530,42,2,30,8132,461945067,1,0,0,811.16,8,119402.15,24,0,13,11,True
4588279,151,4,451,6128,461945067,1,0,0,811.0,7,118591.15,18,0,18,1,False
4670761,591,0,20,1018,461945067,1,0,0,811.07,3,117780.08,24,2,21,1,True
4707138,866,0,-1,4389,461945067,1,1,0,810.88,4,117780.08,24,4,16,1,True
4774593,309,0,20,5756,461945067,1,0,0,810.86,3,116969.22,4,1,23,1,True
4830401,151,4,-1,4319,461945067,1,1,0,810.86,4,116969.22,18,2,23,2,True
5123697,937,0,451,3947,461945067,1,0,0,810.82,7,116158.4,24,0,2,2,True
5556298,866,0,30,4356,461945067,1,0,0,810.79,8,115347.61,24,4,2,2,True
5707993,1210,0,10,8762,461945067,1,0,0,811.1,0,116158.71,24,5,15,3,True
5920155,215,0,10,7937,461945067,1,0,0,811.06,6,116969.77,9,1,7,3,True
6167320,1214,4,451,5760,461945067,1,0,0,810.77,7,116159.0,24,0,17,4,True
6526469,866,0,451,7937,461945067,1,0,0,810.75,7,115348.25,24,1,2,4,True
6580447,42,2,25,2913,461945067,1,0,0,811.24,8,114537.01,24,4,11,4,True
6617519,588,0,10,6128,461945067,1,0,0,810.81,6,115347.82,24,6,2,5,True
6625910,1214,4,25,6636,461945067,1,0,0,810.96,8,114536.86,24,5,20,5,True
6981112,866,0,451,3552,461945067,1,0,0,810.96,7,113725.9,24,4,0,6,True
7177944,192,2,20,1478,461945067,1,0,0,811.12,5,112914.78,18,5,21,7,True
7202293,151,4,25,8422,461945067,1,0,0,811.29,8,112103.49,18,6,19,7,True
7320095,1019,0,451,5756,461945067,1,0,0,811.03,7,111292.46,26,5,15,9,True
7339508,937,0,25,8422,461945067,1,0,0,810.9,8,110481.56,24,3,3,9,True
7499511,1214,4,-1,4584,461945067,1,1,0,810.92,4,110481.56,24,3,15,10,True
7986658,151,4,25,8762,461945067,1,0,0,811.23,8,109670.33,18,4,17,11,True
8154524,1297,0,20,4356,461945067,1,0,0,810.81,5,108859.52,5,5,7,11,True
8520780,151,4,30,7937,461945067,1,0,0,811.34,8,108048.18,18,1,17,12,True
8565727,116,0,10,4356,461945067,1,0,0,811.15,0,108859.33,3,1,3,1,True
8597887,151,4,451,3657,461945067,1,0,0,810.97,7,108048.36,18,0,12,2,False
8627705,151,4,451,2314,461945067,1,0,0,810.99,7,107237.37,18,3,20,2,True
8704626,1155,0,20,1478,461945067,1,0,0,811.11,3,106426.26,15,5,9,3,True
8738567,151,4,-1,6128,461945067,1,1,0,811.04,4,106426.26,18,2,9,3,True
8818385,1214,4,-1,3947,461945067,1,2,0,811.4,1,106426.26,24,3,21,4,True
8963722,866,0,451,3947,461945067,1,0,0,810.8,7,105615.46,24,5,9,6,True
9034923,1214,4,25,3657,461945067,1,0,0,811.03,8,104804.43,24,3,16,7,True
9100259,866,0,30,8422,461945067,1,0,0,811.18,8,103993.25,24,0,19,8,True
9166977,42,2,451,4584,461945067,1,0,0,811.38,7,103181.87,24,4,5,9,True
9573577,1019,0,30,1478,461945067,1,0,0,811.04,8,102370.83,26,1,1,9,True
9658556,1214,4,25,1478,461945067,1,0,0,811.08,8,101559.75,24,5,6,9,True
9954531,1019,0,30,8422,461945067,1,0,0,811.18,8,100748.57,26,2,0,11,True
1015955,228,0,20,1007,939995366,0,0,0,941.13,5,481314.87,26,6,5,2,True
1072695,47,1,30,7004,939995366,0,0,0,941.03,8,480373.84,24,4,10,5,True
1228299,649,0,20,3157,939995366,0,0,0,941.27,5,479432.57,24,6,0,5,True
1280729,1415,4,451,8070,939995366,0,0,0,941.05,7,478491.52,24,5,22,6,True
1285370,1415,4,451,5834,939995366,0,0,0,940.83,7,477550.69,24,2,10,6,True
1346646,930,3,451,4408,939995366,0,0,0,941.05,7,476609.64,18,5,21,8,True
1912177,930,3,451,1980,939995366,0,0,0,940.76,7,475668.88,18,3,16,9,True
1992225,1415,4,451,6514,939995366,0,0,0,940.99,7,474727.89,24,6,17,10,True
2067487,47,1,451,5610,939995366,0,0,0,940.84,7,473787.05,24,4,4,10,True
2123798,404,1,10,6592,939995366,0,0,0,941.16,6,474728.21,10,4,1,11,True
2227904,1201,0,20,3102,939995366,0,0,0,940.74,5,473787.47,24,0,3,11,True
2347303,341,0,30,3157,939995366,0,0,0,941.07,8,472846.4,24,0,23,11,True
2426701,930,3,25,8070,939995366,0,0,0,941.06,8,471905.34,18,3,3,1,True
2472470,341,0,-1,8070,939995366,0,1,0,940.8,4,471905.34,24,0,8,1,True
2598006,1446,1,10,6988,939995366,0,0,0,941.01,0,472846.35,24,2,10,2,True
2679564,47,1,-1,5834,939995366,0,1,0,941.01,4,472846.35,24,0,10,3,True
2742217,1111,0,20,1980,939995366,0,0,0,941.03,3,471905.32,0,4,7,3,True
3269317,535,0,10,3157,939995366,0,0,0,941.18,6,472846.5,18,4,7,5,True
4117031,250,4,-1,8070,939995366,0,1,0,940.89,4,472846.5,6,1,20,6,True
4325111,341,0,451,8070,939995366,0,0,0,940.91,7,471905.59,24,1,22,6,True
4527166,1041,0,20,7004,939995366,0,0,0,940.82,5,470964.77,11,0,17,6,True
4527582,47,1,25,6514,939995366,0,0,0,940.8,8,470023.97,24,0,13,7,True
4814057,341,0,30,6592,939995366,0,0,0,941.04,8,469082.93,24,5,5,7,True
4946572,1144,2,20,1007,939995366,0,0,0,940.82,3,468142.11,15,5,20,7,True
4989559,1415,4,30,6134,939995366,0,0,0,940.92,8,467201.19,24,5,3,8,True
5127262,341,0,25,6988,939995366,0,0,0,940.73,8,466260.46,24,6,21,8,False
5133301,341,0,451,3157,939995366,0,0,0,941.05,7,465319.41,24,0,14,10,True
5151226,250,4,451,1007,939995366,0,0,0,941.02,7,464378.39,6,1,9,10,True
5278579,1134,1,10,6592,939995366,0,0,0,941.16,0,465319.55,24,3,21,11,True
5293656,1415,4,30,6514,939995366,0,0,0,940.92,8,464378.63,24,4,0,11,True
5614820,250,4,25,5834,939995366,0,0,0,940.85,8,463437.78,6,3,19,11,True
5859223,250,4,451,7004,939995366,0,0,0,940.92,7,462496.86,6,1,12,1,True
5998401,930,3,-1,3452,939995366,0,1,0,941.15,4,462496.86,18,2,10,1,True
6212988,47,1,25,4408,939995366,0,0,0,940.54,8,461556.32,24,1,19,1,True
6483964,250,4,451,6516,939995366,0,0,0,941.01,7,460615.31,6,5,14,1,True
6708468,47,1,30,3452,939995366,0,0,0,941.11,8,459674.2,24,3,18,2,True
6740890,607,2,20,8070,939995366,0,0,0,940.89,5,458733.31,24,1,21,2,True
6820521,1415,4,30,3452,939995366,0,0,0,941.0,8,457792.31,24,0,7,4,True
7115162,250,4,25,9574,939995366,0,0,0,940.97,8,456851.34,6,4,1,4,True
7204537,341,0,30,6134,939995366,0,0,0,940.69,8,455910.65,24,5,11,4,True
7449387,1027,0,10,5610,939995366,0,0,0,941.0,6,456851.65,11,5,19,4,True
7783058,250,4,30,3452,939995366,0,0,0,940.82,8,455910.83,6,2,6,5,True
8104894,930,3,30,6988,939995366,0,0,0,940.99,8,454969.84,18,2,18,5,True
8139782,341,0,451,5834,939995366,0,0,0,941.03,7,454028.81,24,1,15,6,True
8431219,930,3,451,1980,939995366,0,0,0,941.04,7,453087.77,18,0,19,6,True
8441721,320,1,10,3102,939995366,0,0,0,941.01,6,454028.78,11,4,21,6,True
8524717,47,1,25,1952,939995366,0,0,0,940.82,8,453087.96,24,6,10,7,True
8533632,930,3,-1,6516,939995366,0,1,0,940.92,4,453087.96,18,0,6,7,True
8853637,641,0,20,6134,939995366,0,0,0,941.29,5,452146.67,24,6,10,8,True
8950756,930,3,451,3157,939995366,0,0,0,941.06,7,451205.61,18,3,17,8,True
9327987,930,3,30,6134,939995366,0,0,0,940.81,8,450264.8,18,0,4,9,True
9356490,583,2,20,3157,939995366,0,0,0,941.04,3,449323.76,11,3,11,9,True
9447509,1238,0,20,3157,939995366,0,0,0,941.12,5,448382.64,18,2,2,9,True
9519448,59,0,10,5834,939995366,0,0,0,940.88,6,449323.52,20,5,18,11,True
1015586,1252,4,451,1102,936914118,1,0,0,923.01,7,746496.99,23,2,7,2,False
1107382,1297,0,30,9537,936914118,1,0,0,923.0,8,745573.99,5,0,13,3,True
1132949,1404,2,25,9537,936914118,1,0,0,923.23,8,744650.76,24,6,23,3,False
1290229,1297,0,451,3707,936914118,1,0,0,923.25,7,743727.51,5,0,22,5,True
1488638,1404,2,451,2498,936914118,1,0,0,922.84,7,742804.67,24,3,19,5,True
1687370,1252,4,30,2526,936914118,1,0,0,923.22,8,741881.45,23,0,23,6,True
1763803,1404,2,30,5794,936914118,1,0,0,922.93,8,740958.52,24,3,17,7,True
1770197,783,0,25,9208,936914118,1,0,0,923.07,8,740035.45,14,1,2,7,True
1845695,1252,4,30,3707,936914118,1,0,0,922.95,8,739112.5,23,4,2,8,True
1969582,1297,0,25,7651,936914118,1,0,0,922.89,8,738189.61,5,1,16,9,True
2176888,145,0,20,5794,936914118,1,0,0,923.05,5,737266.56,18,2,18,10,True
2183192,1297,0,30,2526,936914118,1,0,0,922.88,8,736343.68,5,0,8,10,True
2298807,1404,2,451,3707,936914118,1,0,0,922.98,7,735420.7,24,0,9,10,True
2599557,334,0,20,5302,936914118,1,0,0,922.86,5,734497.84,11,4,12,10,True
2821117,618,3,-1,2526,936914118,1,1,0,923.03,1,734497.84,11,2,0,11,True
2936266,1252,4,-1,6656,936914118,1,2,0,922.95,4,734497.84,23,6,12,11,True
3432109,1252,4,451,5498,936914118,1,0,0,923.03,7,733574.81,23,3,7,11,True
3479174,341,0,20,5209,936914118,1,0,0,922.72,5,732652.09,24,5,17,11,True
3713107,1297,0,-1,5956,936914118,1,1,0,923.19,1,732652.09,5,6,6,12,True
3786630,916,0,20,4361,936914118,1,0,0,922.91,5,731729.18,18,1,21,2,True
3877440,783,0,30,4730,936914118,1,0,0,922.9,8,730806.28,14,0,7,3,True
4336342,618,3,25,5956,936914118,1,0,0,923.08,8,729883.2,11,2,1,3,True
4424130,1093,0,20,1711,936914118,1,0,0,922.88,5,728960.32,18,6,9,4,True
4584029,1245,1,25,9537,936914118,1,0,0,923.0,8,728037.32,18,4,8,4,True
5157931,618,3,30,7651,936914118,1,0,0,923.21,8,727114.11,11,2,19,4,True
5200680,1252,4,25,4865,936914118,1,0,0,922.98,8,726191.13,23,3,9,5,True
5230100,1297,0,451,2498,936914118,1,0,0,923.08,7,725268.05,5,0,22,6,True
5450271,373,1,10,6656,936914118,1,0,0,923.04,6,726191.09,25,1,14,7,True
5667342,1012,0,10,2526,936914118,1,0,0,922.96,6,727114.05,26,6,11,8,True
5864663,1245,1,-1,5360,936914118,1,1,0,922.85,4,727114.05,18,3,23,8,True
5988901,1404,2,30,5498,936914118,1,0,0,923.13,8,726190.92,24,3,19,9,True
6612934,1252,4,-1,6656,936914118,1,1,0,922.84,4,726190.92,23,2,0,9,True
6984255,1404,2,25,2526,936914118,1,0,0,922.68,8,725268.24,24,3,23,9,True
7478419,783,0,30,9537,936914118,1,0,0,922.99,8,724345.25,14,5,12,9,True
7652592,783,0,30,4865,936914118,1,0,0,923.25,8,723422.0,14,5,18,10,True
7861454,783,0,25,5302,936914118,1,0,0,923.1,8,722498.9,14,0,6,10,True
7896344,618,3,451,5498,936914118,1,0,0,922.82,7,721576.08,11,3,14,11,True
8079316,783,0,451,5794,936914118,1,0,0,922.99,7,720653.09,14,4,8,1,False
8147955,732,0,10,9208,936914118,1,0,0,922.98,0,721576.07,11,2,6,3,True
8490770,787,0,10,7651,936914118,1,0,0,922.87,6,722498.94,14,4,20,4,True
8618651,1245,1,451,2526,936914118,1,0,0,922.91,7,721576.03,18,5,15,5,True
8675930,1404,2,451,9208,936914118,1,0,0,922.86,7,720653.17,24,5,11,7,True
8786352,1245,1,451,2050,936914118,1,0,0,923.16,7,719730.01,18,3,17,8,True
8961462,1404,2,451,5498,936914118,1,0,0,922.94,7,718807.07,24,2,19,8,True
9051207,1252,4,451,2526,936914118,1,0,0,922.64,7,717884.43,23,6,13,9,True
9077618,117,1,10,2498,936914118,1,0,0,923.2,6,718807.63,18,1,1,9,True
9545769,266,2,20,2498,936914118,1,0,0,922.9,5,717884.73,6,6,18,9,True
9668312,1252,4,-1,4730,936914118,1,1,0,923.05,4,717884.73,23,5,10,10,True
9723704,783,0,-1,5498,936914118,1,2,0,923.03,1,717884.73,14,2,7,11,True
9799706,1245,1,25,5956,936914118,1,0,0,923.12,8,716961.61,18,0,6,11,True
1019325,1278,0,451,2083,251702665,0,0,0,931.94,7,279104.06,24,5,2,2,True
1129901,1278,0,30,1521,251702665,0,0,0,932.09,8,278171.97,24,2,19,3,True
1327767,1142,2,-1,2424,251702665,0,1,0,932.01,4,278171.97,15,4,14,4,True
1834731,1425,0,10,8696,251702665,0,0,0,931.63,0,279103.6,24,5,20,4,True
2068140,1142,2,30,8696,251702665,0,0,0,932.36,8,278171.24,15,0,4,4,True
2230502,1142,2,30,5617,251702665,0,0,0,932.21,8,277239.03,15,6,4,6,True
2342474,792,1,10,8696,251702665,0,0,0,932.04,6,278171.07,11,2,6,7,False
2503217,314,0,20,1854,251702665,0,0,0,931.89,3,277239.18,4,5,21,7,True
2655869,1142,2,30,3573,251702665,0,0,0,931.93,8,276307.25,15,2,2,7,True
3456669,97,0,20,9749,251702665,0,0,0,931.85,3,275375.4,3,6,18,7,True
3661504,509,0,20,7221,251702665,0,0,0,932.12,5,274443.28,12,6,2,7,True
3763962,1181,2,451,4182,251702665,0,0,0,931.9,7,273511.38,24,1,1,8,True
4004944,733,3,30,9079,251702665,0,0,0,932.15,8,272579.23,11,1,14,9,True
4297081,1278,0,-1,9979,251702665,0,1,0,932.17,1,272579.23,24,4,15,10,True
4317522,733,3,-1,7102,251702665,0,2,0,932.0,4,272579.23,11,3,20,10,True
4365474,733,3,451,7644,251702665,0,0,0,932.1,7,271647.13,11,6,0,10,True
4526581,1249,2,20,9317,251702665,0,0,0,932.2,5,270714.93,23,3,1,11,False
4860389,1142,2,25,6634,251702665,0,0,0,931.97,8,269782.96,15,2,1,11,True
4902443,1132,0,30,7102,251702665,0,0,0,932.23,8,268850.73,24,6,6,11,True
5009941,1239,1,25,7644,251702665,0,0,0,931.94,8,267918.79,18,3,7,12,True
5022522,733,3,451,6634,251702665,0,0,0,931.95,7,266986.84,11,3,23,12,True
5039295,1278,0,25,3573,251702665,0,0,0,931.92,8,266054.92,24,0,4,12,True
5160465,1326,3,30,7644,251702665,0,0,0,932.08,8,265122.84,18,2,11,2,True
5310748,733,3,25,7214,251702665,0,0,0,931.97,8,264190.87,11,1,7,2,True
5331584,204,0,20,9686,251702665,0,0,0,932.14,5,263258.73,9,2,17,3,True
5897917,1278,0,451,9979,251702665,0,0,0,931.94,7,262326.79,24,3,7,5,False
6053035,1278,0,451,5617,251702665,0,0,0,931.88,7,261394.91,24,1,9,6,True
6306424,35,2,20,7214,251702665,0,0,0,932.12,5,260462.79,11,4,9,7,True
6470703,1459,1,25,7473,251702665,0,0,0,932.19,8,259530.6,11,0,9,7,True
6714170,1278,0,25,1665,251702665,0,0,0,932.03,8,258598.57,24,4,13,9,True
6777416,1278,0,451,4846,251702665,0,0,0,931.88,7,257666.69,24,3,0,10,False
6852484,51,0,20,9749,251702665,0,0,0,931.89,3,256734.8,20,2,6,10,True
6928984,371,3,25,3425,251702665,0,0,0,931.88,8,255802.92,25,5,7,10,True
7008206,579,0,10,1665,251702665,0,0,0,931.7,6,256734.62,11,5,21,11,True
7062862,448,0,10,4363,251702665,0,0,0,932.08,0,257666.7,13,5,3,11,True
7076049,733,3,25,7221,251702665,0,0,0,932.18,8,256734.52,11,4,12,12,True
7080441,1250,1,10,3573,251702665,0,0,0,932.13,6,257666.65,23,6,4,12,True
7291909,1132,0,451,9749,251702665,0,0,0,932.02,7,256734.63,24,0,1,2,True
7612129,1132,0,451,9079,251702665,0,0,0,932.03,7,255802.6,24,1,5,2,True
7879484,1278,0,451,9879,251702665,0,0,0,931.91,7,254870.69,24,6,20,3,True
8131181,1132,0,30,9686,251702665,0,0,0,932.08,8,253938.61,24,0,2,6,True
8447091,1326,3,25,6634,251702665,0,0,0,932.05,8,253006.56,18,0,17,7,True
8448953,733,3,25,4363,251702665,0,0,0,931.87,8,252074.69,11,0,1,8,True
8458718,371,3,-1,2719,251702665,0,1,0,932.49,4,252074.69,25,1,13,8,True
8461615,1459,1,-1,2719,251702665,0,2,0,932.02,1,252074.69,11,1,22,8,True
8901828,1181,2,30,1854,251702665,0,0,0,932.26,8,251142.43,24,4,8,8,True
8987253,914,2,20,4363,251702665,0,0,0,932.07,5,250210.36,18,3,3,9,True
9020061,371,3,-1,3573,251702665,0,1,0,931.97,4,250210.36,25,0,4,9,True
9023471,371,3,451,8696,251702665,0,0,0,931.98,7,249278.38,25,3,20,9,True
9268405,371,3,30,2603,251702665,0,0,0,932.0,8,248346.38,25,5,3,11,True
9392579,371,3,451,3984,251702665,0,0,0,932.03,7,247414.35,25,5,22,11,True
9805958,443,2,20,4363,251702665,0,0,0,931.84,3,246482.51,24,3,22,11,True
9839538,371,3,30,5690,251702665,0,0,0,932.1,8,245550.41,25,5,15,11,True
1039275,587,2,30,2374,229072155,1,0,0,1043.91,8,259035.09,24,2,10,1,True
1270493,262,2,20,7711,229072155,1,0,0,1043.86,5,257991.23,6,5,23,1,True
1423843,1116,0,10,9180,229072155,1,0,0,1043.87,6,259035.1,24,1,20,1,True
1548576,1250,1,10,2374,229072155,1,0,0,1044.05,6,260079.15,23,3,23,1,True
1817816,826,1,-1,8800,229072155,1,1,0,1043.92,1,260079.15,18,3,9,2,True
1862449,1238,0,-1,3541,229072155,1,2,0,1044.09,4,260079.15,18,3,23,2,True
1900933,471,0,10,7891,229072155,1,0,0,1044.17,0,261123.32,5,3,4,3,True
2246796,587,2,25,2374,229072155,1,0,0,1044.06,8,260079.26,24,6,17,4,True
2264005,1238,0,25,7763,229072155,1,0,0,1043.98,8,259035.28,18,0,19,5,True
2325669,1027,0,10,3541,229072155,1,0,0,1044.38,6,260079.66,11,5,20,6,True
2560637,597,4,-1,4625,229072155,1,1,0,1044.21,4,260079.66,24,5,7,7,True
2745154,204,0,20,3431,229072155,1,0,0,1043.88,5,259035.78,9,4,13,8,True
2884617,677,0,451,3431,229072155,1,0,0,1044.0,7,257991.78,24,4,13,8,True
3033547,597,4,30,8168,229072155,1,0,0,1044.37,8,256947.41,24,0,13,8,True
3158988,1238,0,451,5494,229072155,1,0,0,1044.13,7,255903.28,18,5,15,9,True
3237151,1338,0,10,9180,229072155,1,0,0,1044.01,6,256947.29,18,4,6,10,True
3408058,1027,0,20,9180,229072155,1,0,0,1043.82,5,255903.47,11,4,11,11,True
3413961,844,1,10,5494,229072155,1,0,0,1044.19,6,256947.66,5,0,20,1,False
3530524,1238,0,451,5494,229072155,1,0,0,1044.13,7,255903.53,18,6,5,1,True
4540478,677,0,451,8800,229072155,1,0,0,1044.11,7,254859.42,24,0,2,1,True
4592299,587,2,-1,4625,229072155,1,1,0,1043.94,1,254859.42,24,5,9,2,True
4649247,1169,0,20,9528,229072155,1,0,0,1043.95,5,253815.47,24,0,6,2,True
4824080,597,4,-1,3877,229072155,1,1,0,1043.99,1,253815.47,24,5,18,5,True
4859696,677,0,451,3541,229072155,1,0,0,1043.8,7,252771.67,24,3,3,6,True
5058946,1238,0,451,8168,229072155,1,0,0,1044.17,7,251727.5,18,1,17,7,True
5253765,587,2,451,7891,229072155,1,0,0,1043.98,7,250683.52,24,2,2,7,True
5327744,1238,0,30,9595,229072155,1,0,0,1044.12,8,249639.4,18,4,4,7,True
5452568,325,0,10,5494,229072155,1,0,0,1043.8,6,250683.2,11,6,21,7,True
5614355,1238,0,451,7891,229072155,1,0,0,1044.24,7,249638.96,18,5,18,7,True
5958710,1238,0,25,4625,229072155,1,0,0,1043.97,8,248594.99,18,2,16,8,True
6001061,677,0,451,3431,229072155,1,0,0,1044.39,7,247550.6,24,5,20,8,True
6345594,715,0,10,4625,229072155,1,0,0,1044.05,0,248594.65,18,6,8,9,True
6485176,677,0,30,9180,229072155,1,0,0,1043.98,8,247550.67,24,6,0,9,True
6744521,1238,0,30,8168,229072155,1,0,0,1044.05,8,246506.62,18,5,1,9,True
6771323,597,4,451,9613,229072155,1,0,0,1044.01,7,245462.61,24,2,6,10,True
7079407,1238,0,451,3541,229072155,1,0,0,1044.19,7,244418.42,18,2,7,10,True
7304186,826,1,451,5974,229072155,1,0,0,1043.95,7,243374.47,18,3,11,10,True
7554587,677,0,30,7711,229072155,1,0,0,1044.04,8,242330.43,24,3,21,11,True
7600841,597,4,30,7711,229072155,1,0,0,1044.04,8,241286.39,24,0,13,12,True
7605746,164,4,451,3541,229072155,1,0,0,1043.83,7,240242.56,24,1,22,12,True
7873181,587,2,-1,8168,229072155,1,1,0,1044.09,1,240242.56,24,2,16,12,True
7945381,587,2,451,5494,229072155,1,0,0,1043.98,7,239198.58,24,5,9,12,True
7967381,597,4,30,7763,229072155,1,0,0,1043.92,8,238154.66,24,5,17,12,True
8027946,164,4,25,5494,229072155,1,0,0,1044.03,8,237110.63,24,6,23,1,True
8109831,587,2,451,9595,229072155,1,0,0,1044.04,7,236066.59,24,0,22,2,False
8314128,677,0,451,3541,229072155,1,0,0,1043.89,7,235022.7,24,5,15,3,True
8502594,587,2,451,7891,229072155,1,0,0,1043.95,7,233978.75,24,1,13,3,True
8545501,748,1,10,9595,229072155,1,0,0,1043.91,6,235022.66,24,0,13,4,True
8822847,826,1,451,4625,229072155,1,0,0,1044.12,7,233978.54,18,4,13,5,True
9220199,587,2,25,6462,229072155,1,0,0,1044.03,8,232934.51,24,1,23,5,True
9285611,826,1,30,7763,229072155,1,0,0,1043.99,8,231890.52,18,0,13,8,True
9335148,1288,0,20,3877,229072155,1,0,0,1043.97,5,230846.55,24,1,18,8,True
9439484,677,0,25,5974,229072155,1,0,0,1043.92,8,229802.63,24,4,6,8,True
9734327,1238,0,25,4625,229072155,1,0,0,1044.05,8,228758.58,18,0,20,9,True
9930167,677,0,30,3541,229072155,1,0,0,1044.0,8,227714.58,24,6,4,9,True
9938117,605,0,20,3431,229072155,1,0,0,1044.01,5,226670.57,24,1,20,10,True
9969298,587,2,-1,5494,229072155,1,1,0,1043.99,4,226670.57,24,0,23,10,True
1035253,806,1,30,4376,615394396,0,0,0,1107.08,8,782507.92,11,5,16,1,True
1653646,502,0,10,7420,615394396,0,0,0,1106.89,6,783614.81,12,6,12,2,True
1696094,27,0,10,9066,615394396,0,0,0,1107.0,6,784721.81,11,3,0,2,True
1788276,348,0,10,4229,615394396,0,0,0,1106.95,0,785828.76,24,1,20,3,True
1799141,255,2,451,4376,615394396,0,0,0,1107.11,7,784721.65,6,0,6,3,True
1813664,1318,0,20,2399,615394396,0,0,0,1106.75,5,783614.9,18,1,7,4,True
1859997,539,4,30,3738,615394396,0,0,0,1106.93,8,782507.97,18,3,21,4,True
1869477,602,4,30,6342,615394396,0,0,0,1106.87,8,781401.1,24,4,8,5,True
2035182,859,2,25,2389,615394396,0,0,0,1107.17,8,780293.93,24,3,0,5,True
2131429,539,4,451,9932,615394396,0,0,0,1106.69,7,779187.24,18,5,20,5,True
2530911,602,4,-1,9118,615394396,0,1,0,1106.93,1,779187.24,24,0,5,6,True
2558326,806,1,25,3658,615394396,0,0,0,1106.65,8,778080.59,11,0,9,7,True
2735407,276,0,10,9118,615394396,0,0,0,1106.83,0,779187.42,24,3,16,7,True
2872601,14,2,20,8777,615394396,0,0,0,1107.08,5,778080.34,24,3,11,9,True
2885829,539,4,451,4229,615394396,0,0,0,1107.04,7,776973.3,18,4,20,9,True
2896170,249,0,20,2389,615394396,0,0,0,1107.04,3,775866.26,6,5,12,9,True
3193353,255,2,25,1227,615394396,0,0,0,1106.93,8,774759.33,6,6,10,11,True
3379447,255,2,-1,9066,615394396,0,1,0,1107.02,1,774759.33,6,5,14,11,True
3484850,255,2,25,9118,615394396,0,0,0,1107.13,8,773652.2,6,6,2,2,True
3546202,539,4,30,7420,615394396,0,0,0,1107.09,8,772545.11,18,4,15,2,True
4202207,1086,0,20,6603,615394396,0,0,0,1106.83,5,771438.28,18,3,19,3,True
4246079,602,4,30,4727,615394396,0,0,0,1107.11,8,770331.17,24,4,9,3,True
4272315,1152,0,10,3658,615394396,0,0,0,1106.81,6,771437.98,15,0,23,4,True
4402101,539,4,-1,3658,615394396,0,1,0,1107.09,1,771437.98,18,5,1,6,True
4423612,859,2,30,9996,615394396,0,0,0,1106.93,8,770331.05,24,2,23,6,False
5138219,602,4,30,1940,615394396,0,0,0,1107.23,8,769223.82,24,0,1,7,True
5436030,1152,0,20,5594,615394396,0,0,0,1106.98,3,768116.84,15,2,9,7,True
5604902,602,4,-1,8777,615394396,0,1,0,1107.15,4,768116.84,24,2,12,7,True
6312271,255,2,30,9118,615394396,0,0,0,1106.79,8,767010.05,6,3,16,7,True
6501909,539,4,451,2399,615394396,0,0,0,1106.94,7,765903.11,18,2,6,8,True
6752084,200,0,10,8722,615394396,0,0,0,1106.93,6,767010.04,9,6,0,8,True
6795384,255,2,30,1940,615394396,0,0,0,1106.92,8,765903.12,6,5,22,9,False
7067145,539,4,30,9066,615394396,0,0,0,1106.96,8,764796.16,18,6,2,10,True
7080785,806,1,-1,9932,615394396,0,1,0,1106.94,1,764796.16,11,4,16,11,True
7191864,255,2,25,2525,615394396,0,0,0,1106.95,8,763689.21,6,0,17,11,True
7373958,602,4,30,6603,615394396,0,0,0,1106.85,8,762582.36,24,4,22,12,True
7541401,255,2,25,4727,615394396,0,0,0,1107.08,8,761475.28,6,3,19,1,False
7635797,602,4,451,4727,615394396,0,0,0,1106.73,7,760368.55,24,4,23,1,True
7725553,1124,0,20,2399,615394396,0,0,0,1107.19,5,759261.36,24,1,7,1,True
7796578,951,0,20,1940,615394396,0,0,0,1107.14,3,758154.22,24,5,7,3,True
7834128,255,2,451,6342,615394396,0,0,0,1107.02,7,757047.2,6,3,11,4,True
7902567,806,1,25,1568,615394396,0,0,0,1106.82,8,755940.38,11,5,10,5,True
8675409,602,4,-1,1927,615394396,0,1,0,1106.96,4,755940.38,24,0,3,5,True
8719286,917,0,10,6127,615394396,0,0,0,1106.92,0,757047.3,18,6,11,5,True
8793644,539,4,451,4727,615394396,0,0,0,1107.14,7,755940.16,18,3,16,6,True
8814718,602,4,-1,1568,615394396,0,1,0,1107.1,4,755940.16,24,5,0,6,True
8963634,806,1,30,8777,615394396,0,0,0,1107.28,8,754832.88,11,1,20,6,True
9004148,602,4,25,2525,615394396,0,0,0,1107.05,8,753725.83,24,6,19,6,True
9314376,806,1,25,9932,615394396,0,0,0,1107.07,8,752618.76,11,1,1,7,True
9436112,509,0,10,1568,615394396,0,0,0,1106.8,0,753725.56,12,4,4,8,True
9615559,929,0,10,2389,615394396,0,0,0,1106.87,6,754832.43,18,6,12,10,True
9616639,859,2,25,8777,615394396,0,0,0,1107.05,8,753725.38,24,3,12,11,True
1279046,82,4,30,4186,897084963,0,0,0,378.88,8,553249.12,1,5,18,1,True
1368696,160,0,451,3145,897084963,0,0,0,378.79,7,552870.33,24,3,19,1,True
1557530,857,1,-1,9559,897084963,0,1,0,378.94,1,552870.33,24,6,4,2,True
1918972,82,4,30,9755,897084963,0,0,0,379.19,8,552491.14,1,6,8,4,True
1965210,857,1,451,5188,897084963,0,0,0,379.05,7,552112.09,24,4,15,4,True
2433029,1354,0,10,8350,897084963,0,0,0,379.06,6,552491.15,24,5,22,4,True
2494364,689,0,20,3087,897084963,0,0,0,379.15,5,552112.0,24,5,0,4,True
2555175,1015,0,10,4186,897084963,0,0,0,379.15,0,552491.15,26,4,23,5,True
2675731,160,0,451,5507,897084963,0,0,0,379.01,7,552112.14,24,0,21,5,True
3037904,82,4,30,2445,897084963,0,0,0,378.82,8,551733.32,1,6,8,6,True
3270627,82,4,25,6073,897084963,0,0,0,378.99,8,551354.33,1,0,5,6,True
3351263,857,1,25,9745,897084963,0,0,0,379.03,8,550975.3,24,5,0,7,True
3667268,160,0,30,9555,897084963,0,0,0,379.13,8,550596.17,24,2,0,7,True
3702520,641,0,20,3613,897084963,0,0,0,379.09,5,550217.08,24,0,5,8,True
3962506,160,0,451,5507,897084963,0,0,0,378.79,7,549838.29,24,2,5,9,True
4177442,449,4,451,3087,897084963,0,0,0,378.96,7,549459.33,13,5,20,10,True
4238538,82,4,25,4186,897084963,0,0,0,378.9,8,549080.43,1,4,3,11,True
4733744,82,4,30,2721,897084963,0,0,0,379.04,8,548701.39,1,4,14,12,True
5085093,449,4,30,6258,897084963,0,0,0,378.73,8,548322.66,13,2,0,12,True
5511531,1428,1,451,3560,897084963,0,0,0,379.23,7,547943.43,24,4,3,12,True
5918680,82,4,451,3145,897084963,0,0,0,378.82,7,547564.61,1,5,7,1,True
5972254,168,0,10,9804,897084963,0,0,0,379.02,0,547943.63,24,1,16,2,True
6023361,962,0,20,8946,897084963,0,0,0,379.22,5,547564.41,13,6,5,3,True
6088489,82,4,25,3087,897084963,0,0,0,378.88,8,547185.53,1,5,19,4,True
6281879,160,0,451,3613,897084963,0,0,0,379.15,7,546806.38,24,0,0,5,True
6561116,449,4,-1,8350,897084963,0,1,0,378.91,4,546806.38,13,6,19,6,True
6599796,449,4,30,5188,897084963,0,0,0,378.97,8,546427.41,13,6,19,6,True
6735803,200,0,20,5188,897084963,0,0,0,379.11,5,546048.3,9,4,10,6,True
6928852,1019,0,10,5664,897084963,0,0,0,379.02,0,546427.32,26,3,17,6,True
6948944,1428,1,451,7621,897084963,0,0,0,379.03,7,546048.29,24,4,3,8,True
6963517,1428,1,30,3087,897084963,0,0,0,378.89,8,545669.4,24,5,14,9,True
6976444,759,0,20,8829,897084963,0,0,0,378.92,5,545290.48,24,1,1,9,True
7251607,1428,1,30,2445,897084963,0,0,0,379.08,8,544911.4,24,1,8,10,True
7364587,46,1,10,2445,897084963,0,0,0,379.17,0,545290.57,24,6,15,10,True
7376897,627,0,10,9559,897084963,0,0,0,378.89,6,545669.46,11,4,8,11,True
7988671,761,2,20,5188,897084963,0,0,0,379.26,3,545290.2,24,3,7,1,True
8119110,160,0,25,1960,897084963,0,0,0,379.03,8,544911.17,24,1,15,1,True
8164725,857,1,451,5507,897084963,0,0,0,378.86,7,544532.31,24,1,16,6,True
8212743,160,0,25,5507,897084963,0,0,0,379.03,8,544153.28,24,0,19,7,True
8326487,449,4,25,3145,897084963,0,0,0,379.12,8,543774.16,13,2,9,7,True
8565266,449,4,451,3087,897084963,0,0,0,378.9,7,543395.26,13,4,1,8,True
8774990,160,0,25,8350,897084963,0,0,0,378.96,8,543016.3,24,4,20,8,True
8802120,503,0,20,5507,897084963,0,0,0,379.17,3,542637.13,12,4,21,9,True
8958670,350,0,10,8065,897084963,0,0,0,379.05,6,543016.18,24,1,21,9,True
8966586,160,0,30,3145,897084963,0,0,0,379.14,8,542637.04,24,6,22,9,True
9238678,1428,1,-1,8421,897084963,0,1,0,378.78,4,542637.04,24,0,4,9,True
9812129,449,4,30,3087,897084963,0,0,0,379.0,8,542258.04,13,6,0,10,True
9825718,449,4,451,8350,897084963,0,0,0,379.07,7,541878.97,13,5,2,10,True
9903133,857,1,-1,9842,897084963,0,1,0,378.92,4,541878.97,24,4,23,10,True
9959761,160,0,451,9804,897084963,0,0,0,379.21,7,541499.76,24,0,21,11,True
1244924,731,4,451,7695,424132168,0,0,0,1013.96,7,602012.04,11,6,1,1,True
2063133,443,2,25,7296,424132168,0,0,0,1013.97,8,600998.07,24,3,6,2,True
2131340,274,1,25,8047,424132168,0,0,0,1013.88,8,599984.19,24,4,20,2,True
2192091,1326,3,-1,1847,424132168,0,1,0,1013.9,4,599984.19,18,3,3,3,True
2303445,344,3,30,8644,424132168,0,0,0,1014.14,8,598970.05,24,2,7,3,True
2333217,1273,0,20,7708,424132168,0,0,0,1014.0,3,597956.05,24,6,11,7,True
2635033,1076,1,10,6273,424132168,0,0,0,1013.97,6,598970.02,18,1,1,7,True
2768062,731,4,451,8046,424132168,0,0,0,1013.92,7,597956.1,11,6,15,8,True
2801424,269,0,10,4709,424132168,0,0,0,1014.07,0,598970.17,24,3,17,8,True
2885098,344,3,30,9898,424132168,0,0,0,1014.17,8,597956.0,24,5,6,8,True
2913601,269,0,20,8046,424132168,0,0,0,1013.97,5,596942.03,24,3,12,9,True
2934508,1145,4,451,4709,424132168,0,0,0,1014.02,7,595928.01,15,0,6,9,True
3125825,599,0,20,8961,424132168,0,0,0,1013.61,3,594914.4,24,2,2,9,True
3398090,731,4,451,4215,424132168,0,0,0,1013.72,7,593900.68,11,5,5,9,True
3460495,1175,2,20,5539,424132168,0,0,0,1014.13,5,592886.55,24,4,20,10,True
3515109,1089,0,10,4536,424132168,0,0,0,1013.87,6,593900.42,18,6,11,10,True
3542352,443,2,-1,1480,424132168,0,1,0,1013.76,4,593900.42,24,4,3,10,True
3841068,1326,3,-1,2063,424132168,0,2,0,1014.0,4,593900.42,18,1,5,11,True
4316059,186,4,451,9733,424132168,0,0,0,1013.85,7,592886.57,18,4,17,11,True
4337922,1145,4,-1,3064,424132168,0,1,0,1014.13,4,592886.57,15,1,15,11,True
4401710,1326,3,451,5860,424132168,0,0,0,1014.02,7,591872.55,18,6,11,1,True
4560091,344,3,451,9733,424132168,0,0,0,1014.05,7,590858.5,24,3,10,2,True
4604464,1326,3,25,9733,424132168,0,0,0,1014.01,8,589844.49,18,6,21,3,True
4713948,980,1,10,1007,424132168,0,0,0,1013.73,6,590858.22,22,0,2,3,True
5001298,1247,0,10,8046,424132168,0,0,0,1014.1,6,591872.32,23,0,7,4,True
5281260,275,0,20,1847,424132168,0,0,0,1013.97,5,590858.35,24,3,0,7,True
5320595,274,1,451,5860,424132168,0,0,0,1014.12,7,589844.23,24,0,21,8,True
5649904,411,2,20,4215,424132168,0,0,0,1013.91,5,588830.32,18,0,17,8,True
5863239,804,0,20,6876,424132168,0,0,0,1013.89,5,587816.43,11,4,15,8,True
6033639,1326,3,25,4215,424132168,0,0,0,1014.01,8,586802.42,18,0,10,9,True
6383387,63,3,451,8046,424132168,0,0,0,1013.95,7,585788.47,20,0,19,11,False
6433975,537,0,10,7695,424132168,0,0,0,1014.0,6,586802.47,18,3,7,11,True
6640178,831,1,10,9898,424132168,0,0,0,1014.02,6,587816.49,5,5,20,11,True
6732508,304,0,20,1480,424132168,0,0,0,1014.03,5,586802.46,4,5,2,12,True
6779495,1488,0,20,7289,424132168,0,0,0,1014.21,5,585788.25,24,6,3,12,True
6824569,81,0,20,1078,424132168,0,0,0,1013.87,5,584774.38,1,0,5,12,True
7145101,1145,4,30,1007,424132168,0,0,0,1013.78,8,583760.6,15,0,8,1,True
7172887,274,1,-1,1480,424132168,0,1,0,1013.89,1,583760.6,24,3,21,1,True
7223605,443,2,451,4050,424132168,0,0,0,1013.87,7,582746.73,24,5,16,2,True
7320935,1326,3,451,8961,424132168,0,0,0,1014.02,7,581732.71,18,1,16,2,True
7476210,713,0,10,4709,424132168,0,0,0,1014.07,6,582746.78,18,1,1,2,True
8100839,63,3,451,2063,424132168,0,0,0,1014.19,7,581732.59,20,2,2,2,True
8145345,1326,3,25,9898,424132168,0,0,0,1013.79,8,580718.8,18,4,16,4,True
8216805,63,3,25,4536,424132168,0,0,0,1013.86,8,579704.94,20,2,13,4,True
8458397,731,4,451,4536,424132168,0,0,0,1013.86,7,578691.08,11,5,20,4,True
8671650,542,0,25,1101,424132168,0,0,0,1013.89,8,577677.19,17,3,0,5,True
8771923,1326,3,451,2063,424132168,0,0,0,1013.78,7,576663.41,18,0,17,6,True
8859498,274,1,451,5539,424132168,0,0,0,1013.89,7,575649.52,24,5,22,6,True
9027624,274,1,451,8047,424132168,0,0,0,1014.02,7,574635.5,24,5,11,8,True
9187131,542,0,-1,7296,424132168,0,1,0,1013.99,4,574635.5,17,5,8,8,True
9253649,443,2,451,2063,424132168,0,0,0,1013.94,7,573621.56,24,0,8,9,True
9363515,1272,0,20,4215,424132168,0,0,0,1013.96,5,572607.6,24,3,12,9,True
9436831,1364,0,10,8644,424132168,0,0,0,1014.09,0,573621.69,16,5,22,9,True
9629570,186,4,25,6273,424132168,0,0,0,1014.01,8,572607.68,18,1,11,9,True
9667129,537,0,10,1480,424132168,0,0,0,1014.09,6,573621.77,18,4,23,9,True
9760994,344,3,25,6876,424132168,0,0,0,1014.18,8,572607.59,24,5,3,9,True
9794758,186,4,25,7238,424132168,0,0,0,1014.0,8,571593.59,18,5,22,10,True
9889216,542,0,25,7289,424132168,0,0,0,1014.06,8,570579.53,17,3,2,11,True
1029219,365,0,10,1559,581429430,0,0,0,671.01,0,683232.01,25,2,23,1,True
1041759,1387,1,451,4622,581429430,0,0,0,670.96,7,682561.05,24,2,7,2,True
1080021,945,1,10,7347,581429430,0,0,0,671.07,0,683232.12,24,0,23,2,True
1362896,600,4,30,3617,581429430,0,0,0,671.0,8,682561.12,24,3,6,4,True
1564360,929,0,10,3726,581429430,0,0,0,671.02,6,683232.14,18,1,4,5,True
1974026,1090,0,30,7329,581429430,0,0,0,671.2,8,682560.94,18,0,15,5,True
1977076,655,3,30,5040,581429430,0,0,0,671.13,8,681889.81,18,4,21,6,True
2016372,600,4,25,1482,581429430,0,0,0,671.29,8,681218.52,24,4,3,7,True
2598222,655,3,30,3955,581429430,0,0,0,670.86,8,680547.66,18,4,8,7,True
2820691,655,3,451,4108,581429430,0,0,0,671.03,7,679876.63,18,5,21,7,True
2866110,1090,0,25,4361,581429430,0,0,0,670.74,8,679205.89,18,4,6,8,True
3092234,822,4,30,3955,581429430,0,0,0,671.0,8,678534.89,18,6,19,8,False
3171102,600,4,-1,4297,581429430,0,1,0,671.05,1,678534.89,24,0,4,9,True
3173774,822,4,451,3955,581429430,0,0,0,670.94,7,677863.95,18,4,10,9,True
3363359,223,2,20,7883,581429430,0,0,0,671.1,5,677192.85,26,3,10,9,True
3471822,655,3,25,2818,581429430,0,0,0,670.96,8,676521.89,18,3,17,9,True
3569747,715,0,10,4076,581429430,0,0,0,671.05,6,677192.94,18,2,21,11,True
3763384,655,3,30,5512,581429430,0,0,0,670.93,8,676522.01,18,3,11,11,True
4022570,822,4,451,7236,581429430,0,0,0,671.2,7,675850.81,18,6,5,11,True
4191691,1435,2,20,4622,581429430,0,0,0,670.99,5,675179.82,24,1,17,12,True
4426561,1238,0,10,2818,581429430,0,0,0,670.85,0,675850.67,18,4,9,12,True
4645815,655,3,-1,7236,581429430,0,1,0,670.95,1,675850.67,18,2,0,2,True
4694415,1387,1,25,7347,581429430,0,0,0,670.75,8,675179.92,24,1,3,2,True
4732418,1387,1,451,7212,581429430,0,0,0,671.21,7,674508.71,24,3,15,2,True
4879979,1459,1,10,7236,581429430,0,0,0,671.14,0,675179.85,11,2,10,4,True
5184067,367,1,10,9728,581429430,0,0,0,671.5,6,675851.35,25,4,12,5,True
5387185,822,4,30,5212,581429430,0,0,0,671.07,8,675180.28,18,3,19,5,True
5445723,1090,0,30,6517,581429430,0,0,0,671.24,8,674509.04,18,4,22,5,True
5499215,822,4,451,7347,581429430,0,0,0,671.33,7,673837.71,18,5,12,6,False
5635893,1090,0,30,3617,581429430,0,0,0,671.01,8,673166.7,18,4,13,8,True
5682885,234,0,10,5944,581429430,0,0,0,670.95,6,673837.65,26,6,20,8,True
5992164,1090,0,451,4622,581429430,0,0,0,671.01,7,673166.64,18,0,9,9,True
6070204,600,4,-1,7347,581429430,0,1,0,670.87,4,673166.64,24,5,12,9,True
6101061,1387,1,25,3955,581429430,0,0,0,670.94,8,672495.7,24,5,23,10,True
6171117,1034,1,10,3955,581429430,0,0,0,670.83,0,673166.53,11,1,9,10,True
6205603,822,4,451,8037,581429430,0,0,0,670.9,7,672495.63,18,0,8,10,True
6294887,1090,0,30,5219,581429430,0,0,0,671.21,8,671824.42,18,1,6,11,True
6337409,600,4,-1,3617,581429430,0,1,0,671.26,4,671824.42,24,2,9,12,True
6758716,1114,1,10,1559,581429430,0,0,0,671.11,0,672495.53,0,0,17,1,True
7424117,1411,0,20,3814,581429430,0,0,0,671.17,5,671824.36,24,1,17,1,True
7530601,600,4,30,4361,581429430,0,0,0,671.16,8,671153.2,24,0,12,3,True
7778497,879,1,10,3726,581429430,0,0,0,671.08,6,671824.28,27,0,23,4,True
7882093,1156,1,10,4297,581429430,0,0,0,670.88,6,672495.16,15,5,3,4,True
8026108,600,4,451,3726,581429430,0,0,0,671.18,7,671823.98,24,6,23,4,True
8165315,530,0,10,9728,581429430,0,0,0,671.16,6,672495.14,18,3,11,4,True
8284695,644,0,10,7347,581429430,0,0,0,671.17,0,673166.31,24,2,4,5,True
8483254,822,4,25,3814,581429430,0,0,0,670.94,8,672495.37,18,3,5,5,True
8668163,1090,0,-1,1559,581429430,0,1,0,670.66,4,672495.37,18,6,13,5,True
8670080,1387,1,30,8037,581429430,0,0,0,671.17,8,671824.2,24,5,8,6,True
8892172,115,2,20,2818,581429430,0,0,0,671.02,3,671153.18,3,3,13,6,True
8941011,822,4,451,9554,581429430,0,0,0,671.11,7,670482.07,18,4,22,6,True
8946477,822,4,30,7329,581429430,0,0,0,670.75,8,669811.32,18,2,9,9,True
8951234,1387,1,30,5212,581429430,0,0,0,670.78,8,669140.54,24,2,13,10,True
9070482,1387,1,25,3726,581429430,0,0,0,670.89,8,668469.65,24,0,17,10,True
9161022,600,4,30,6517,581429430,0,0,0,671.01,8,667798.64,24,3,22,10,True
9988111,147,0,20,2818,581429430,0,0,0,670.98,3,667127.66,18,2,4,11,True
1017745,360,0,10,2069,667437938,1,0,0,755.69,6,666200.69,24,5,11,1,True
1040602,565,4,30,9870,667437938,1,0,0,755.84,8,665444.85,11,1,7,1,True
1197388,554,4,30,5530,667437938,1,0,0,756.13,8,664688.72,17,2,1,1,True
1481435,319,0,20,4700,667437938,1,0,0,756.03,5,663932.69,11,0,13,1,True
1889622,1254,4,-1,2069,667437938,1,1,0,756.19,4,663932.69,23,1,18,1,True
2011171,82,4,451,3295,667437938,1,0,0,756.18,7,663176.51,1,5,18,1,True
2669333,565,4,451,6977,667437938,1,0,0,756.34,7,662420.17,11,2,4,2,True
2921681,316,2,30,4524,667437938,1,0,0,756.0,8,661664.17,4,6,23,2,True
3399335,1377,0,10,5947,667437938,1,0,0,756.25,6,662420.42,16,2,10,2,False
3600997,599,0,20,5947,667437938,1,0,0,756.1,5,661664.32,24,3,12,2,True
3685605,565,4,30,6977,667437938,1,0,0,756.15,8,660908.17,11,3,21,4,True
3942733,316,2,451,4130,667437938,1,0,0,756.05,7,660152.12,4,4,19,4,False
3975495,554,4,-1,6342,667437938,1,1,0,756.17,1,660152.12,17,6,0,5,True
4249667,316,2,30,3605,667437938,1,0,0,756.11,8,659396.01,4,3,22,5,True
4750416,1273,0,20,1331,667437938,1,0,0,756.05,3,658639.96,24,6,12,6,True
4906675,1254,4,25,8368,667437938,1,0,0,756.11,8,657883.85,23,0,9,7,False
4946157,703,0,451,2857,667437938,1,0,0,756.0,7,657127.85,18,6,8,7,True
4973347,703,0,30,5530,667437938,1,0,0,756.01,8,656371.84,18,3,17,7,False
4976562,82,4,-1,3660,667437938,1,1,0,755.9,4,656371.84,1,0,9,7,True
5056285,316,2,-1,7518,667437938,1,2,0,755.94,1,656371.84,4,6,17,8,True
5466108,554,4,25,4700,667437938,1,0,0,756.13,8,655615.71,17,5,21,9,True
5485024,565,4,451,3295,667437938,1,0,0,755.72,7,654859.99,11,3,18,9,True
5616719,565,4,451,8368,667437938,1,0,0,756.04,7,654103.95,11,2,15,12,True
5688950,554,4,451,3462,667437938,1,0,0,756.03,7,653347.92,17,6,11,1,True
6065970,82,4,451,8217,667437938,1,0,0,755.8,7,652592.12,1,1,0,1,True
6137313,316,2,-1,5503,667437938,1,1,0,756.07,1,652592.12,4,6,13,2,True
6152790,205,0,20,9870,667437938,1,0,0,755.84,5,651836.28,9,6,20,2,False
6169295,464,1,10,3462,667437938,1,0,0,755.68,6,652591.96,13,1,12,3,True
6227344,696,2,20,8368,667437938,1,0,0,755.81,5,651836.15,24,6,23,4,False
6441880,1053,1,10,4526,667437938,1,0,0,756.2,6,652592.35,11,3,18,4,False
6615390,47,1,10,5947,667437938,1,0,0,756.03,6,653348.38,24,1,17,4,True
6696535,554,4,-1,9870,667437938,1,1,0,756.03,4,653348.38,17,3,2,4,True
6710638,82,4,-1,1331,667437938,1,2,0,755.95,1,653348.38,1,4,6,6,True
6752337,554,4,25,5059,667437938,1,0,0,755.93,8,652592.45,17,4,5,6,True
6755416,939,0,20,3660,667437938,1,0,0,755.92,3,651836.53,24,2,0,6,True
7079667,362,0,10,4130,667437938,1,0,0,756.14,0,652592.67,24,6,10,7,True
7336893,316,2,451,4130,667437938,1,0,0,755.91,7,651836.76,4,0,2,7,True
7348720,82,4,-1,3660,667437938,1,1,0,756.08,4,651836.76,1,4,10,11,True
7414682,82,4,25,3462,667437938,1,0,0,755.99,8,651080.77,1,4,11,12,True
7747216,554,4,451,5947,667437938,1,0,0,756.12,7,650324.65,17,2,1,1,True
8068462,703,0,451,5503,667437938,1,0,0,755.85,7,649568.8,18,1,11,1,True
8222372,82,4,25,8368,667437938,1,0,0,756.23,8,648812.57,1,2,10,1,True
8248528,703,0,451,4524,667437938,1,0,0,755.78,7,648056.79,18,3,19,2,True
8299445,1254,4,451,7518,667437938,1,0,0,756.09,7,647300.7,23,5,22,6,True
8556722,703,0,25,7185,667437938,1,0,0,756.12,8,646544.58,18,1,0,6,True
8803036,703,0,25,3295,667437938,1,0,0,756.08,8,645788.5,18,5,16,6,True
8812458,479,2,20,8217,667437938,1,0,0,756.0,3,645032.5,5,6,1,6,True
8985544,51,0,20,5059,667437938,1,0,0,756.05,3,644276.45,20,0,19,7,True
9013387,316,2,451,4524,667437938,1,0,0,755.98,7,643520.47,4,6,6,7,True
9207994,316,2,25,7185,667437938,1,0,0,755.95,8,642764.52,4,0,22,7,True
9252411,825,2,20,7518,667437938,1,0,0,756.13,5,642008.39,18,2,4,8,True
9342498,316,2,-1,1331,667437938,1,1,0,756.14,4,642008.39,4,3,1,9,True
9720007,1254,4,451,5059,667437938,1,0,0,755.74,7,641252.65,23,5,8,9,True
9750908,565,4,30,3605,667437938,1,0,0,755.95,8,640496.7,11,3,4,10,True
9875157,703,0,451,9870,667437938,1,0,0,755.88,7,639740.82,18,0,20,10,True
9939996,747,1,10,5503,667437938,1,0,0,755.92,6,640496.74,24,4,16,11,True
1035164,1399,0,30,6639,175070237,1,0,0,908.94,8,827198.06,24,1,23,1,True
1102764,193,1,10,3417,175070237,1,0,0,908.79,6,828106.85,18,4,2,3,True
1210272,594,0,30,5503,175070237,1,0,0,909.0,8,827197.85,24,3,19,3,True
1236443,1412,2,20,6301,175070237,1,0,0,909.01,5,826288.84,24,6,1,6,True
1319288,410,4,-1,6547,175070237,1,1,0,909.07,4,826288.84,18,1,15,8,True
1370948,410,4,-1,8508,175070237,1,2,0,908.88,4,826288.84,18,0,8,9,True
1404731,1122,1,10,3417,175070237,1,0,0,909.05,6,827197.89,24,1,13,9,True
1586795,572,0,20,5893,175070237,1,0,0,909.02,3,826288.87,11,0,2,10,True
1604609,594,0,25,5893,175070237,1,0,0,908.73,8,825380.14,24,3,2,10,True
1701438,129,0,451,2567,175070237,1,0,0,909.01,7,824471.13,18,6,6,10,True
1705708,626,2,20,7516,175070237,1,0,0,909.16,5,823561.97,11,5,23,11,True
2176482,129,0,451,5503,175070237,1,0,0,909.11,7,822652.86,18,2,9,12,False
2409152,168,0,10,6639,175070237,1,0,0,908.99,6,823561.85,24,1,20,1,True
2554336,512,0,20,7152,175070237,1,0,0,909.1,3,822652.75,12,2,2,2,True
2750013,155,1,10,5503,175070237,1,0,0,909.04,6,823561.79,18,2,22,4,True
3044783,1122,1,10,8566,175070237,1,0,0,908.88,6,824470.67,24,0,14,4,True
3249659,129,0,451,5291,175070237,1,0,0,908.97,7,823561.7,18,0,23,4,True
3866183,665,2,20,8508,175070237,1,0,0,909.14,3,822652.56,18,2,23,4,True
4112270,848,2,20,8566,175070237,1,0,0,908.88,3,821743.68,5,5,20,5,False
4131978,727,0,20,5291,175070237,1,0,0,909.1,3,820834.58,11,4,7,5,True
4293818,348,0,20,4451,175070237,1,0,0,908.75,5,819925.83,24,3,11,6,True
4999850,410,4,25,5893,175070237,1,0,0,909.29,8,819016.54,18,5,7,7,False
5157925,537,0,20,5291,175070237,1,0,0,908.92,5,818107.62,18,0,0,8,True
5214604,403,0,25,4742,175070237,1,0,0,909.26,8,817198.36,10,0,21,8,True
5291013,410,4,25,7516,175070237,1,0,0,909.02,8,816289.34,18,5,13,8,True
5475989,1359,2,20,8566,175070237,1,0,0,909.23,5,815380.11,24,1,17,8,True
5652532,1217,0,10,7152,175070237,1,0,0,908.87,0,816288.98,24,0,1,9,True
5707444,312,0,10,7651,175070237,1,0,0,909.17,6,817198.15,4,2,0,9,True
5980076,129,0,451,4451,175070237,1,0,0,908.86,7,816289.29,18,5,23,9,True
6138165,410,4,25,7651,175070237,1,0,0,908.93,8,815380.36,18,4,9,9,True
6298142,989,1,10,6639,175070237,1,0,0,908.95,0,816289.31,22,3,2,10,True
6638255,179,4,25,5291,175070237,1,0,0,909.05,8,815380.26,24,1,10,10,True
7036612,341,0,10,5893,175070237,1,0,0,908.87,0,816289.13,24,6,23,10,True
7134100,129,0,30,5814,175070237,1,0,0,908.91,8,815380.22,18,1,16,11,True
7195220,179,4,30,6639,175070237,1,0,0,908.99,8,814471.23,24,1,20,11,True
7232813,129,0,451,4451,175070237,1,0,0,909.13,7,813562.1,18,1,17,12,True
7249753,1421,0,20,7651,175070237,1,0,0,908.8,5,812653.3,24,4,18,1,True
7390016,179,4,-1,6639,175070237,1,1,0,908.85,4,812653.3,24,6,0,2,True
7557798,129,0,-1,8508,175070237,1,2,0,908.91,1,812653.3,18,2,17,2,True
7907740,903,3,451,5503,175070237,1,0,0,909.04,7,811744.26,2,4,15,2,True
8095298,179,4,25,3417,175070237,1,0,0,908.92,8,810835.34,24,2,13,3,True
8290160,497,0,20,8508,175070237,1,0,0,909.0,3,809926.34,12,6,21,3,True
8291430,403,0,30,8566,175070237,1,0,0,908.95,8,809017.39,10,4,8,4,True
8528147,129,0,451,8508,175070237,1,0,0,909.35,7,808108.04,18,5,0,4,True
8608704,129,0,451,5291,175070237,1,0,0,909.35,7,807198.69,18,5,16,4,True
8684082,1019,0,10,8566,175070237,1,0,0,909.17,0,808107.86,26,0,10,6,True
9076434,903,3,30,6301,175070237,1,0,0,908.64,8,807199.22,2,4,6,7,True
9131925,179,4,30,2567,175070237,1,0,0,909.07,8,806290.15,24,4,4,7,True
9174901,179,4,451,8566,175070237,1,0,0,909.12,7,805381.03,24,2,18,7,True
9223831,410,4,451,5814,175070237,1,0,0,908.81,7,804472.22,18,4,18,9,True
9738318,1359,2,20,5503,175070237,1,0,0,908.83,3,803563.39,24,6,9,11,True
9838922,1399,0,30,4451,175070237,1,0,0,908.93,8,802654.46,24,0,16,11,True
9974956,403,0,-1,6547,175070237,1,1,0,909.24,1,802654.46,10,6,20,11,True
1246923,185,1,451,9112,545445024,1,0,0,958.12,7,936426.88,18,0,6,1,True
1326131,185,1,25,8421,545445024,1,0,0,957.91,8,935468.97,18,5,4,5,True
1506940,685,3,-1,8144,545445024,1,1,0,957.88,4,935468.97,24,6,11,5,True
2421857,281,1,451,1882,545445024,1,0,0,958.12,7,934510.85,24,3,21,6,True
2482185,622,4,30,3562,545445024,1,0,0,958.24,8,933552.61,11,0,11,8,True
2547344,185,1,451,4601,545445024,1,0,0,958.07,7,932594.54,18,6,17,8,True
2662870,685,3,-1,3562,545445024,1,1,0,958.0,4,932594.54,24,0,14,8,True
2678710,622,4,451,4675,545445024,1,0,0,958.14,7,931636.4,11,0,8,10,True
2689804,185,1,25,8340,545445024,1,0,0,958.05,8,930678.35,18,3,0,10,True
2860990,369,1,10,7111,545445024,1,0,0,957.83,0,931636.18,25,0,7,11,True
3297964,1146,2,25,8144,545445024,1,0,0,957.63,8,930678.55,15,4,15,11,True
3316597,622,4,451,8995,545445024,1,0,0,958.1,7,929720.45,11,4,0,12,True
3447164,685,3,451,3429,545445024,1,0,0,958.1,7,928762.35,24,4,18,12,True
3508249,1146,2,25,3453,545445024,1,0,0,957.74,8,927804.61,15,1,2,12,True
3529248,1146,2,-1,9112,545445024,1,1,0,957.88,4,927804.61,15,2,16,12,True
3853646,185,1,30,4628,545445024,1,0,0,958.03,8,926846.58,18,2,14,1,True
3928940,962,0,10,9112,545445024,1,0,0,958.02,6,927804.6,13,1,15,1,True
3938763,185,1,25,4628,545445024,1,0,0,957.94,8,926846.66,18,0,18,2,True
3954921,622,4,-1,8144,545445024,1,1,0,957.8,4,926846.66,11,6,3,2,True
3955591,281,1,-1,8995,545445024,1,2,0,957.72,4,926846.66,24,5,13,3,True
4121163,708,2,20,9925,545445024,1,0,0,957.98,5,925888.68,18,3,8,3,True
4228843,1146,2,25,7111,545445024,1,0,0,958.11,8,924930.57,15,5,3,3,True
5814300,1146,2,451,4628,545445024,1,0,0,957.91,7,923972.66,15,1,0,3,True
6180683,850,1,10,1794,545445024,1,0,0,957.79,6,924930.45,5,5,4,4,True
6195733,1146,2,-1,3209,545445024,1,1,0,958.08,1,924930.45,15,4,19,4,True
6452200,685,3,451,1794,545445024,1,0,0,958.14,7,923972.31,24,3,21,4,True
6695631,281,1,-1,7296,545445024,1,1,0,958.09,4,923972.31,24,0,10,5,False
6725666,185,1,30,8144,545445024,1,0,0,957.9,8,923014.41,18,3,5,6,True
6921615,685,3,30,4324,545445024,1,0,0,957.91,8,922056.5,24,0,18,6,True
7061032,281,1,25,3209,545445024,1,0,0,958.09,8,921098.41,24,5,4,6,False
7111685,1256,2,20,9925,545445024,1,0,0,957.88,5,920140.53,23,0,12,7,True
7183311,130,0,10,3948,545445024,1,0,0,957.92,0,921098.45,18,2,13,7,True
7186464,281,1,-1,1794,545445024,1,1,0,957.89,4,921098.45,24,4,14,7,True
7341427,1146,2,30,7111,545445024,1,0,0,958.01,8,920140.44,15,4,17,8,True
7394394,956,1,10,2775,545445024,1,0,0,958.16,6,921098.6,13,1,4,8,False
7433001,1146,2,25,4675,545445024,1,0,0,957.99,8,920140.61,15,5,16,8,True
7514683,185,1,30,3056,545445024,1,0,0,957.76,8,919182.85,18,2,12,8,True
7519606,1146,2,25,7756,545445024,1,0,0,958.12,8,918224.73,15,4,22,9,True
7572167,622,4,30,5036,545445024,1,0,0,958.09,8,917266.64,11,2,6,10,True
7703314,1146,2,451,9143,545445024,1,0,0,957.91,7,916308.73,15,0,4,11,True
7801129,685,3,451,7756,545445024,1,0,0,958.15,7,915350.58,24,3,20,11,True
7868029,622,4,451,8421,545445024,1,0,0,957.99,7,914392.59,11,3,14,11,True
7933802,1146,2,30,9112,545445024,1,0,0,957.83,8,913434.76,15,2,18,12,True
8161390,185,1,-1,1882,545445024,1,1,0,958.0,1,913434.76,18,0,11,2,True
8213188,281,1,451,3056,545445024,1,0,0,957.91,7,912476.85,24,4,7,3,True
8286168,1146,2,-1,8144,545445024,1,1,0,957.98,1,912476.85,15,5,23,4,True
8358271,685,3,451,4675,545445024,1,0,0,958.16,7,911518.69,24,1,17,5,True
8375214,1146,2,25,3346,545445024,1,0,0,958.15,8,910560.54,15,3,18,5,True
8864894,185,1,451,4601,545445024,1,0,0,957.96,7,909602.58,18,6,14,6,True
8960326,281,1,-1,8421,545445024,1,1,0,958.0,4,909602.58,24,1,8,7,True
8997732,281,1,451,8421,545445024,1,0,0,958.01,7,908644.57,24,5,14,7,True
9078966,622,4,30,3948,545445024,1,0,0,958.07,8,907686.5,11,0,23,7,True
9366763,185,1,451,7529,545445024,1,0,0,958.02,7,906728.48,18,0,12,8,True
9408835,518,2,20,4601,545445024,1,0,0,957.9,5,905770.58,18,0,19,8,True
9506072,130,0,20,3948,545445024,1,0,0,957.94,5,904812.64,18,0,23,8,True
9574883,185,1,-1,4324,545445024,1,1,0,958.08,4,904812.64,18,1,7,9,True
9710938,185,1,451,9112,545445024,1,0,0,957.94,7,903854.7,18,1,4,9,True
9892338,281,1,30,7529,545445024,1,0,0,957.96,8,902896.74,24,4,4,9,True
9984335,1146,2,451,3948,545445024,1,0,0,957.71,7,901939.03,15,1,13,9,True
1466112,528,3,25,6700,989594700,0,0,0,254.98,8,847515.02,18,0,18,1,True
1535272,1363,0,10,2416,989594700,0,0,0,255.06,6,847770.08,16,6,10,1,True
1649372,1400,3,25,2079,989594700,0,0,0,254.79,8,847515.29,24,1,3,2,True
1661783,1278,0,30,5654,989594700,0,0,0,254.91,8,847260.38,24,0,3,2,True
1891043,1278,0,451,1743,989594700,0,0,0,255.23,7,847005.15,24,4,0,2,True
2142984,528,3,30,2107,989594700,0,0,0,255.04,8,846750.11,18,3,21,3,True
2361332,1400,3,451,2058,989594700,0,0,0,255.03,7,846495.08,24,1,18,3,True
2361560,528,3,-1,5435,989594700,0,1,0,254.87,1,846495.08,18,2,2,3,True
2648890,528,3,25,8662,989594700,0,0,0,255.05,8,846240.03,18,5,7,4,True
2669939,1400,3,25,2058,989594700,0,0,0,254.88,8,845985.15,24,6,6,5,True
2967551,160,0,20,9364,989594700,0,0,0,255.08,5,845730.07,24,1,23,5,True
2992128,1029,0,20,6700,989594700,0,0,0,255.05,5,845475.02,11,4,17,5,True
3029236,1400,3,-1,9143,989594700,0,1,0,254.92,4,845475.02,24,4,20,5,True
3561651,1400,3,451,9143,989594700,0,0,0,255.26,7,845219.76,24,3,16,6,True
3861429,1092,1,10,6875,989594700,0,0,0,254.92,6,845474.68,18,6,0,6,True
4169106,1037,0,20,9439,989594700,0,0,0,255.04,5,845219.64,11,2,5,6,True
4286636,1278,0,30,3747,989594700,0,0,0,254.9,8,844964.74,24,0,21,8,True
4409526,529,2,25,9439,989594700,0,0,0,255.02,8,844709.72,18,1,5,9,True
4446658,528,3,-1,2079,989594700,0,1,0,254.64,1,844709.72,18,1,18,9,True
4479985,1324,4,451,5654,989594700,0,0,0,254.88,7,844454.84,18,3,2,9,True
4695596,1278,0,451,1689,989594700,0,0,0,254.86,7,844199.98,24,3,3,10,True
4760681,1324,4,451,9143,989594700,0,0,0,254.89,7,843945.09,18,5,11,10,True
4801888,279,2,20,6875,989594700,0,0,0,254.71,3,843690.38,24,3,17,12,True
5001432,1278,0,-1,9628,989594700,0,1,0,254.98,4,843690.38,24,5,4,2,True
5042688,1324,4,30,2107,989594700,0,0,0,255.03,8,843435.35,18,3,11,3,True
5171748,1324,4,30,6700,989594700,0,0,0,255.25,8,843180.1,18,3,20,4,True
5281834,1278,0,451,1127,989594700,0,0,0,255.08,7,842925.02,24,3,13,4,True
5281912,1278,0,451,9439,989594700,0,0,0,255.12,7,842669.9,24,2,19,5,True
5293818,529,2,25,1543,989594700,0,0,0,255.1,8,842414.8,18,3,2,5,True
5313711,529,2,451,6700,989594700,0,0,0,254.79,7,842160.01,18,1,1,5,True
5759331,529,2,30,9364,989594700,0,0,0,255.32,8,841904.69,18,6,3,6,True
5915905,76,0,20,6875,989594700,0,0,0,255.06,5,841649.63,20,0,18,6,True
6317477,529,2,25,5654,989594700,0,0,0,255.15,8,841394.48,18,3,11,6,True
6340100,1324,4,451,9364,989594700,0,0,0,255.19,7,841139.29,18,4,9,6,False
6492182,1400,3,451,5435,989594700,0,0,0,255.28,7,840884.01,24,5,21,6,True
6504706,1400,3,25,2107,989594700,0,0,0,254.77,8,840629.24,24,0,7,7,True
6861618,1400,3,25,1543,989594700,0,0,0,254.74,8,840374.5,24,3,20,7,True
6934811,529,2,-1,9143,989594700,0,1,0,254.97,4,840374.5,18,2,10,9,True
7203668,1278,0,25,9143,989594700,0,0,0,255.15,8,840119.35,24,6,22,10,True
7308917,1324,4,30,1543,989594700,0,0,0,255.05,8,839864.3,18,6,15,10,True
7405552,1278,0,30,4624,989594700,0,0,0,255.2,8,839609.1,24,6,7,10,True
7471174,529,2,25,2079,989594700,0,0,0,255.09,8,839354.01,18,3,18,2,True
7530331,59,0,20,2058,989594700,0,0,0,255.04,5,839098.97,20,4,10,2,True
7535509,787,0,10,9143,989594700,0,0,0,254.62,6,839353.59,14,0,23,3,True
7604068,529,2,451,6981,989594700,0,0,0,255.1,7,839098.49,18,1,12,4,True
7670367,1278,0,-1,9628,989594700,0,1,0,254.72,4,839098.49,24,1,12,4,True
7702409,529,2,25,1743,989594700,0,0,0,254.93,8,838843.56,18,2,3,4,True
8114583,341,0,20,1743,989594700,0,0,0,255.28,5,838588.28,24,5,23,4,True
8557859,1086,0,10,7533,989594700,0,0,0,254.76,6,838843.04,18,3,8,4,True
8589568,1400,3,30,1127,989594700,0,0,0,254.97,8,838588.07,24,4,3,5,True
8721440,46,1,10,9364,989594700,0,0,0,255.25,6,838843.32,24,0,0,5,True
8818186,670,0,10,6981,989594700,0,0,0,254.8,6,839098.12,18,0,12,6,True
8818542,529,2,451,1543,989594700,0,0,0,255.05,7,838843.07,18,0,1,7,True
9078068,529,2,-1,1743,989594700,0,1,0,255.11,4,838843.07,18,5,1,7,True
9262613,327,0,10,7595,989594700,0,0,0,254.95,6,839098.02,11,6,1,9,True
9306289,529,2,30,2079,989594700,0,0,0,255.03,8,838842.99,18,2,19,11,True
9752028,528,3,25,1127,989594700,0,0,0,255.1,8,838587.89,18,3,5,11,True
1083308,1246,0,451,6138,591496222,1,0,0,300.84,7,867005.16,23,6,7,1,True
1168386,1339,2,451,8080,591496222,1,0,0,301.14,7,866704.02,18,3,14,2,True
1311905,1009,0,20,1383,591496222,1,0,0,300.95,5,866403.07,26,6,15,3,True
1359802,1199,4,451,1032,591496222,1,0,0,301.13,7,866101.94,24,5,0,3,True
1485418,304,0,451,1032,591496222,1,0,0,301.12,7,865800.82,4,6,3,3,True
1771847,848,2,25,4054,591496222,1,0,0,300.94,8,865499.88,5,5,22,4,True
1997095,1246,0,451,2471,591496222,1,0,0,301.07,7,865198.81,23,4,23,5,True
2083161,848,2,451,8513,591496222,1,0,0,301.16,7,864897.65,5,1,1,5,True
2163690,1246,0,25,6313,591496222,1,0,0,300.84,8,864596.81,23,0,9,6,True
2184856,715,0,20,4946,591496222,1,0,0,300.8,3,864296.01,18,3,12,7,True
2218234,360,0,30,8513,591496222,1,0,0,301.08,8,863994.93,24,5,14,8,True
2494934,576,2,451,3024,591496222,1,0,0,300.96,7,863693.97,11,6,21,8,True
2633689,1201,0,20,1383,591496222,1,0,0,300.71,5,863393.26,24,0,23,9,True
3119137,1199,4,451,8513,591496222,1,0,0,301.03,7,863092.23,24,6,11,10,True
3467746,1199,4,30,8513,591496222,1,0,0,301.07,8,862791.16,24,6,19,10,True
3970024,1339,2,451,3454,591496222,1,0,0,300.94,7,862490.22,18,1,22,10,True
3993797,1246,0,-1,8513,591496222,1,1,0,300.84,1,862490.22,23,1,0,11,True
4051840,1205,0,20,4946,591496222,1,0,0,300.93,5,862189.29,24,2,18,12,True
4176761,539,4,-1,1401,591496222,1,1,0,300.78,4,862189.29,18,0,14,12,True
4409333,1199,4,25,8513,591496222,1,0,0,301.09,8,861888.2,24,0,7,1,True
4429250,360,0,451,1032,591496222,1,0,0,300.98,7,861587.22,24,0,12,1,True
4614111,1199,4,-1,3454,591496222,1,1,0,301.27,4,861587.22,24,6,11,1,True
4821779,304,0,25,1401,591496222,1,0,0,300.88,8,861286.34,4,1,8,1,True
5007559,1199,4,25,3647,591496222,1,0,0,300.86,8,860985.48,24,5,1,3,True
5010534,1199,4,-1,4990,591496222,1,1,0,300.69,4,860985.48,24,2,0,3,True
5068800,1246,0,30,2471,591496222,1,0,0,301.2,8,860684.28,23,2,2,3,True
5347973,360,0,451,3050,591496222,1,0,0,301.1,7,860383.18,24,5,3,4,True
5416481,1339,2,25,3180,591496222,1,0,0,300.8,8,860082.38,18,1,12,5,True
5556688,539,4,451,6313,591496222,1,0,0,300.83,7,859781.55,18,2,2,6,True
5757913,1339,2,20,6313,591496222,1,0,0,301.05,5,859480.5,18,2,2,8,True
5764525,812,0,10,9721,591496222,1,0,0,300.94,6,859781.44,18,4,16,9,True
6116070,1199,4,25,3103,591496222,1,0,0,301.1,8,859480.34,24,4,21,10,True
6302913,1199,4,30,6138,591496222,1,0,0,300.9,8,859179.44,24,2,2,10,True
6359328,304,0,30,5744,591496222,1,0,0,301.0,8,858878.44,4,4,0,10,True
6422589,539,4,-1,4946,591496222,1,1,0,300.88,4,858878.44,18,6,5,11,True
6475805,580,0,20,1032,591496222,1,0,0,301.1,5,858577.34,11,6,20,11,True
6659573,1246,0,30,3647,591496222,1,0,0,301.08,8,858276.26,23,4,1,12,False
6899835,703,0,10,3180,591496222,1,0,0,301.29,6,858577.55,18,1,22,12,True
7333289,1199,4,451,4946,591496222,1,0,0,300.61,7,858276.94,24,3,6,12,True
7475548,576,2,451,1032,591496222,1,0,0,301.23,7,857975.71,11,3,17,1,True
7510323,539,4,25,3103,591496222,1,0,0,301.01,8,857674.7,18,6,12,1,True
8125894,635,2,20,1401,591496222,1,0,0,301.03,5,857373.67,24,2,22,2,True
8176424,576,2,-1,7733,591496222,1,1,0,301.01,4,857373.67,11,4,4,3,True
8201640,360,0,30,3103,591496222,1,0,0,301.09,8,857072.58,24,5,9,4,True
8551987,539,4,451,3050,591496222,1,0,0,300.96,7,856771.62,18,6,6,4,True
8718896,848,2,30,3180,591496222,1,0,0,300.84,8,856470.78,5,2,14,4,True
8805123,848,2,-1,3024,591496222,1,1,0,301.05,4,856470.78,5,5,13,4,True
8842432,304,0,30,1401,591496222,1,0,0,301.02,8,856169.76,4,6,10,5,True
8867464,1426,1,10,7882,591496222,1,0,0,301.04,6,856470.8,24,6,4,5,True
8941831,993,0,20,3647,591496222,1,0,0,301.15,5,856169.65,22,2,17,6,True
9632768,539,4,451,3180,591496222,1,0,0,300.67,7,855868.98,18,5,5,8,True
9684021,360,0,451,7035,591496222,1,0,0,301.23,7,855567.75,24,3,8,10,True
9710815,576,2,451,6834,591496222,1,0,0,301.13,7,855266.62,11,6,18,11,True
9811737,539,4,30,8513,591496222,1,0,0,300.87,8,854965.75,18,1,18,11,True
9934098,360,0,451,3050,591496222,1,0,0,300.91,7,854664.84,24,6,13,11,True
9947226,304,0,30,8080,591496222,1,0,0,301.16,8,854363.68,4,3,3,11,True
1065936,1311,2,20,8435,826098432,0,0,0,461.97,5,987217.03,5,5,17,1,True
1131150,716,0,10,4795,826098432,0,0,0,462.0,0,987679.03,18,4,5,1,True
1133486,27,0,-1,1581,826098432,0,1,0,462.09,4,987679.03,11,0,22,1,True
1248418,824,2,25,8352,826098432,0,0,0,462.11,8,987216.92,18,4,8,1,True
1267384,471,0,451,3186,826098432,0,0,0,462.38,7,986754.54,5,2,18,3,True
1313460,292,1,10,5839,826098432,0,0,0,461.87,6,987216.41,4,0,14,3,True
1408363,350,0,451,1751,826098432,0,0,0,462.31,7,986754.1,24,0,7,3,True
1433229,1233,0,10,5597,826098432,0,0,0,461.94,6,987216.04,18,1,14,3,True
1545018,350,0,451,8485,826098432,0,0,0,462.14,7,986753.9,24,6,22,4,True
1664186,471,0,30,8193,826098432,0,0,0,462.1,8,986291.8,5,4,23,5,True
1807623,471,0,30,1581,826098432,0,0,0,462.25,8,985829.55,5,6,3,6,True
2261088,897,0,20,8217,826098432,0,0,0,462.01,5,985367.54,24,1,9,7,True
2283234,1278,0,10,2867,826098432,0,0,0,461.68,0,985829.22,24,0,17,8,True
2585067,738,2,20,5574,826098432,0,0,0,462.34,5,985366.88,11,1,0,9,True
2964474,509,0,-1,5839,826098432,0,1,0,462.08,1,985366.88,12,5,5,9,True
3564255,1408,1,10,8217,826098432,0,0,0,461.92,6,985828.8,24,0,3,9,True
3578739,1405,4,451,5653,826098432,0,0,0,461.83,7,985366.97,24,6,12,10,True
3708207,1429,0,20,8352,826098432,0,0,0,461.87,5,984905.1,24,4,18,10,True
3787608,27,0,451,8352,826098432,0,0,0,461.97,7,984443.13,11,3,5,11,True
3997578,27,0,451,1581,826098432,0,0,0,462.01,7,983981.12,11,5,11,11,False
4095183,350,0,25,6486,826098432,0,0,0,462.22,8,983518.9,24,1,2,11,False
4269691,145,0,20,5653,826098432,0,0,0,461.97,5,983056.93,18,5,4,12,True
4366716,350,0,25,5574,826098432,0,0,0,461.87,8,982595.06,24,6,11,12,True
4725071,471,0,451,4549,826098432,0,0,0,462.06,7,982133.0,5,0,4,1,True
4946845,767,0,25,4446,826098432,0,0,0,461.98,8,981671.02,14,4,6,2,True
5081064,471,0,451,2936,826098432,0,0,0,462.11,7,981208.91,5,5,10,3,True
5352859,1180,1,10,2332,826098432,0,0,0,462.08,6,981670.99,24,2,16,5,True
5422333,27,0,451,2420,826098432,0,0,0,462.15,7,981208.84,11,6,7,6,True
5423805,935,1,30,3226,826098432,0,0,0,462.02,8,980746.82,24,5,15,7,True
5435242,27,0,25,8435,826098432,0,0,0,461.97,8,980284.85,11,5,16,7,True
5582259,27,0,451,4549,826098432,0,0,0,461.95,7,979822.9,11,3,19,7,True
6129314,471,0,451,6486,826098432,0,0,0,461.9,7,979361.0,5,2,15,8,True
6190321,935,1,451,1751,826098432,0,0,0,462.01,7,978898.99,24,3,2,8,True
6261178,484,0,20,5537,826098432,0,0,0,462.15,3,978436.84,5,5,20,9,True
6264411,27,0,25,4795,826098432,0,0,0,461.87,8,977974.97,11,2,14,9,True
6291670,889,0,10,8352,826098432,0,0,0,461.87,6,978436.84,27,3,8,9,True
6504097,279,2,20,5597,826098432,0,0,0,461.84,5,977975.0,24,1,15,10,True
6716630,935,1,25,4969,826098432,0,0,0,461.79,8,977513.21,24,3,12,10,True
6723881,385,1,10,5537,826098432,0,0,0,462.05,6,977975.26,25,4,21,11,True
6752612,767,0,-1,3226,826098432,0,1,0,461.98,1,977975.26,14,5,13,11,True
7865841,509,0,451,5653,826098432,0,0,0,462.3,7,977512.96,12,3,9,11,True
8116709,375,4,30,4795,826098432,0,0,0,462.18,8,977050.78,25,1,20,12,True
8263605,375,4,-1,4184,826098432,0,1,0,461.98,1,977050.78,25,5,4,12,True
8332024,935,1,-1,8485,826098432,0,2,0,461.95,1,977050.78,24,2,17,1,True
8404989,824,2,451,7343,826098432,0,0,0,462.26,7,976588.52,18,6,6,1,True
8405912,183,1,10,3186,826098432,0,0,0,462.07,0,977050.59,18,1,18,3,True
8612732,303,0,20,4549,826098432,0,0,0,462.19,5,976588.4,4,4,8,3,True
8775887,824,2,451,5552,826098432,0,0,0,462.15,7,976126.25,18,3,22,5,True
8836962,1405,4,451,5814,826098432,0,0,0,461.97,7,975664.28,24,2,16,6,True
8911333,767,0,30,3186,826098432,0,0,0,461.89,8,975202.39,14,1,1,6,True
9185089,503,0,10,4795,826098432,0,0,0,462.07,6,975664.46,12,2,20,9,True
9401267,935,1,25,5597,826098432,0,0,0,462.0,8,975202.46,24,6,12,9,True
9523348,375,4,-1,5373,826098432,0,1,0,462.09,1,975202.46,25,0,15,10,True
9541196,471,0,30,8193,826098432,0,0,0,462.05,8,974740.41,5,1,1,10,True
9703761,824,2,30,7343,826098432,0,0,0,461.79,8,974278.62,18,6,15,11,True
9938685,1405,4,451,2936,826098432,0,0,0,462.06,7,973816.56,24,0,14,11,True
9983630,471,0,30,8217,826098432,0,0,0,462.17,8,973354.39,5,0,3,11,True
1074266,1183,4,451,6048,501887306,0,0,0,937.13,7,697735.87,24,6,23,2,True
1156156,1444,3,30,8388,501887306,0,0,0,937.08,8,696798.79,24,2,23,2,True
1239044,1444,3,-1,8208,501887306,0,1,0,936.99,4,696798.79,24,3,21,2,True
1267194,715,0,10,8208,501887306,0,0,0,936.92,0,697735.71,18,6,16,2,True
1523414,681,2,20,7884,501887306,0,0,0,936.88,5,696798.83,24,3,8,3,True
1531636,705,1,25,5415,501887306,0,0,0,937.23,8,695861.6,18,1,4,4,True
1583795,182,1,10,8515,501887306,0,0,0,936.77,0,696798.37,18,4,6,5,True
1996520,1451,1,451,8388,501887306,0,0,0,937.0,7,695861.37,11,4,17,5,True
2019940,1183,4,451,4556,501887306,0,0,0,936.79,7,694924.58,24,4,22,5,True
2032659,1183,4,451,1227,501887306,0,0,0,936.78,7,693987.8,24,5,21,6,True
2519930,1183,4,25,8388,501887306,0,0,0,936.91,8,693050.89,24,4,4,6,True
2958505,1183,4,30,9802,501887306,0,0,0,936.92,8,692113.97,24,4,10,7,True
3221094,348,0,10,7746,501887306,0,0,0,937.02,0,693050.99,24,3,2,9,True
3307077,1444,3,451,7427,501887306,0,0,0,936.98,7,692114.01,24,4,21,10,True
3375830,1183,4,30,4556,501887306,0,0,0,936.89,8,691177.12,24,5,20,10,True
3569120,318,0,10,5415,501887306,0,0,0,937.1,0,692114.22,11,3,23,11,True
3955414,110,4,451,2787,501887306,0,0,0,936.94,7,691177.28,3,1,19,11,True
4245041,857,1,10,1227,501887306,0,0,0,937.03,0,692114.31,24,3,17,2,True
4288655,605,0,20,2276,501887306,0,0,0,937.12,3,691177.19,24,6,6,2,True
4288734,910,0,20,1618,501887306,0,0,0,937.08,5,690240.11,18,5,21,3,True
4314653,705,1,-1,7884,501887306,0,1,0,936.97,4,690240.11,18,5,14,4,True
4491651,1463,2,20,2276,501887306,0,0,0,937.08,3,689303.03,11,5,1,5,True
4561202,1183,4,30,9802,501887306,0,0,0,936.96,8,688366.07,24,0,19,6,True
4826422,1212,0,25,8208,501887306,0,0,0,937.17,8,687428.9,24,4,19,6,True
4827886,1212,0,25,8686,501887306,0,0,0,937.05,8,686491.85,24,1,19,6,True
4993030,448,0,10,7746,501887306,0,0,0,936.86,0,687428.71,13,2,7,7,True
5098044,1183,4,451,7884,501887306,0,0,0,936.81,7,686491.9,24,5,3,8,True
5417037,829,4,451,2122,501887306,0,0,0,937.06,7,685554.84,18,0,17,8,True
5487845,1380,0,20,6351,501887306,0,0,0,936.79,3,684618.05,16,1,10,8,True
5618269,1444,3,451,8208,501887306,0,0,0,936.94,7,683681.11,24,3,13,10,True
5736360,1183,4,451,1513,501887306,0,0,0,937.05,7,682744.06,24,4,19,11,True
6191252,445,0,10,8232,501887306,0,0,0,937.19,0,683681.25,13,4,20,11,True
6295538,129,0,10,2276,501887306,0,0,0,937.03,0,684618.28,18,6,18,11,True
6575125,429,0,20,3443,501887306,0,0,0,936.93,5,683681.35,24,2,17,11,True
6699773,1325,0,20,2276,501887306,0,0,0,936.94,5,682744.41,18,1,10,12,False
6788194,58,2,20,1618,501887306,0,0,0,937.24,5,681807.17,20,5,17,12,True
6969249,27,0,20,8095,501887306,0,0,0,936.83,3,680870.34,11,5,6,1,True
7250708,705,1,451,8232,501887306,0,0,0,936.65,7,679933.69,18,1,15,2,True
7441588,705,1,451,9802,501887306,0,0,0,936.98,7,678996.71,18,1,2,2,True
7462348,68,0,20,8388,501887306,0,0,0,937.04,5,678059.67,20,4,7,3,True
7484008,1444,3,451,8095,501887306,0,0,0,937.09,7,677122.58,24,4,7,3,True
7540850,1119,0,10,8686,501887306,0,0,0,937.02,0,678059.6,24,1,1,3,True
7887522,538,0,10,2787,501887306,0,0,0,936.83,6,678996.43,18,4,18,3,True
8019752,572,0,20,2787,501887306,0,0,0,937.3,5,678059.13,11,6,20,3,True
8072764,1444,3,-1,8232,501887306,0,1,0,937.21,4,678059.13,24,1,6,3,False
8786298,1183,4,-1,5415,501887306,0,2,0,936.62,1,678059.13,24,6,22,4,True
8890305,705,1,30,1618,501887306,0,0,0,936.93,8,677122.2,18,0,15,8,True
9061981,1451,1,25,6048,501887306,0,0,0,937.04,8,676185.16,11,5,17,8,True
9281813,110,4,30,6351,501887306,0,0,0,937.1,8,675248.06,3,4,7,9,True
9663186,346,0,20,8232,501887306,0,0,0,937.23,3,674310.83,24,0,19,11,True
9688330,1183,4,451,8515,501887306,0,0,0,937.31,7,673373.52,24,2,5,11,True
1192003,1205,0,10,5383,923992975,0,0,0,363.05,6,911041.05,24,3,11,1,True
1597006,27,0,451,1510,923992975,0,0,0,363.03,7,910678.02,11,2,0,2,True
1882280,980,1,10,8765,923992975,0,0,0,362.7,6,911040.72,22,3,14,2,False
2081514,459,1,10,8255,923992975,0,0,0,363.13,6,911403.85,13,4,18,6,True
2129951,1127,0,30,1608,923992975,0,0,0,363.04,8,911040.81,24,4,0,8,True
2306597,944,2,20,3841,923992975,0,0,0,362.94,5,910677.87,24,5,16,8,True
2545974,951,0,10,8255,923992975,0,0,0,363.2,0,911041.07,24,5,19,9,True
2685385,286,1,30,1608,923992975,0,0,0,362.77,8,910678.3,24,6,13,10,True
3159087,12,4,25,5654,923992975,0,0,0,363.01,8,910315.29,24,6,21,10,True
3388162,720,4,25,5654,923992975,0,0,0,362.43,8,909952.86,11,2,16,10,True
3582920,883,0,10,6693,923992975,0,0,0,362.89,0,910315.75,24,3,14,11,True
3588398,1232,1,10,6701,923992975,0,0,0,363.08,6,910678.83,18,5,1,11,True
3693778,503,0,-1,1585,923992975,0,1,0,362.98,1,910678.83,12,1,14,12,True
3709409,27,0,-1,6693,923992975,0,2,0,362.94,1,910678.83,11,5,23,1,True
3746416,979,0,20,5316,923992975,0,0,0,362.91,5,910315.92,22,1,17,1,True
3854480,118,2,20,2364,923992975,0,0,0,363.14,3,909952.78,18,3,7,1,True
3885680,503,0,30,8255,923992975,0,0,0,363.07,8,909589.71,12,6,3,2,True
4087918,503,0,25,5383,923992975,0,0,0,363.04,8,909226.67,12,4,0,3,False
4478206,12,4,30,8765,923992975,0,0,0,363.26,8,908863.41,24,6,7,3,True
4669805,27,0,25,6701,923992975,0,0,0,363.08,8,908500.33,11,1,1,3,True
4755807,27,0,25,4064,923992975,0,0,0,363.07,8,908137.26,11,2,13,3,True
4871407,720,4,451,3973,923992975,0,0,0,363.32,7,907773.94,11,2,8,4,True
4893102,503,0,451,8255,923992975,0,0,0,363.1,7,907410.84,12,4,8,4,True
4920454,286,1,451,3841,923992975,0,0,0,362.81,7,907048.03,24,2,13,5,True
5089770,1345,2,20,7279,923992975,0,0,0,363.05,5,906684.98,24,1,12,5,False
5237507,208,0,10,5948,923992975,0,0,0,362.74,6,907047.72,9,3,20,5,True
5326483,12,4,451,4397,923992975,0,0,0,362.74,7,906684.98,24,4,0,7,False
5410291,27,0,30,5316,923992975,0,0,0,362.85,8,906322.13,11,4,17,7,False
5416554,1156,1,10,6602,923992975,0,0,0,363.05,6,906685.18,15,1,4,7,True
5501111,720,4,451,1510,923992975,0,0,0,363.06,7,906322.12,11,1,10,7,True
5523949,12,4,451,6693,923992975,0,0,0,363.05,7,905959.07,24,1,10,8,True
5722655,503,0,25,5383,923992975,0,0,0,362.86,8,905596.21,12,3,9,8,True
5781548,720,4,451,4064,923992975,0,0,0,363.32,7,905232.89,11,3,2,10,True
7046685,1303,0,10,3841,923992975,0,0,0,362.81,0,905595.7,5,0,15,10,True
7102688,720,4,451,7736,923992975,0,0,0,363.02,7,905232.68,11,0,22,11,True
7171612,12,4,30,8273,923992975,0,0,0,363.09,8,904869.59,24,5,3,11,True
7342845,720,4,30,3841,923992975,0,0,0,362.84,8,904506.75,11,3,11,2,True
7399132,286,1,451,5948,923992975,0,0,0,362.98,7,904143.77,24,2,23,2,True
7466753,286,1,25,1479,923992975,0,0,0,363.05,8,903780.72,24,6,20,2,True
7479769,1127,0,30,8237,923992975,0,0,0,363.0,8,903417.72,24,2,3,3,True
7512279,720,4,25,5316,923992975,0,0,0,363.03,8,903054.69,11,3,23,4,True
7632207,27,0,451,5948,923992975,0,0,0,363.03,7,902691.66,11,0,14,4,True
7695407,1063,0,20,5383,923992975,0,0,0,362.95,5,902328.71,11,0,15,4,False
7744594,27,0,30,3973,923992975,0,0,0,363.25,8,901965.46,11,5,5,6,True
7911451,1127,0,451,5316,923992975,0,0,0,363.11,7,901602.35,24,3,21,6,True
8019313,12,4,-1,8237,923992975,0,1,0,362.84,4,901602.35,24,4,10,7,True
8143632,27,0,451,7614,923992975,0,0,0,362.83,7,901239.52,11,3,15,8,True
8197233,12,4,-1,4397,923992975,0,1,0,362.91,4,901239.52,24,4,7,8,True
8240872,12,4,25,7614,923992975,0,0,0,362.9,8,900876.62,24,4,15,8,True
8797870,286,1,451,6701,923992975,0,0,0,363.39,7,900513.23,24,0,16,10,True
9006618,27,0,25,5654,923992975,0,0,0,362.86,8,900150.37,11,3,9,11,True
9403731,1445,2,20,6701,923992975,0,0,0,362.71,5,899787.66,24,5,16,11,True
9679544,286,1,30,1608,923992975,0,0,0,362.94,8,899424.72,24,2,12,11,True
1093094,130,0,451,9569,494569529,1,0,0,165.91,7,801083.09,18,5,18,1,True
1203059,202,4,30,3076,494569529,1,0,0,166.09,8,800917.0,9,6,23,1,True
1236245,744,4,30,6745,494569529,1,0,0,166.14,8,800750.86,24,4,7,1,True
1320664,667,4,-1,9569,494569529,1,1,0,166.12,1,800750.86,18,6,3,1,True
1364097,537,0,25,5438,494569529,1,0,0,166.02,8,800584.84,18,5,7,3,True
1400762,49,3,25,9569,494569529,1,0,0,166.01,8,800418.83,20,4,6,4,True
1472963,130,0,-1,5438,494569529,1,1,0,165.98,1,800418.83,18,3,9,4,True
1699294,64,0,20,6745,494569529,1,0,0,165.95,5,800252.88,20,1,9,5,True
1846404,202,4,451,5387,494569529,1,0,0,166.15,7,800086.73,9,1,5,6,True
1958959,202,4,451,5815,494569529,1,0,0,165.96,7,799920.77,9,1,16,6,True
2157974,49,3,451,1226,494569529,1,0,0,166.06,7,799754.71,20,4,10,7,True
2179515,537,0,-1,1226,494569529,1,1,0,165.95,4,799754.71,18,5,22,7,True
2401323,744,4,30,4937,494569529,1,0,0,165.86,8,799588.85,24,5,23,8,True
2577804,744,4,451,3919,494569529,1,0,0,165.85,7,799423.0,24,2,7,9,True
2625772,744,4,25,3602,494569529,1,0,0,166.33,8,799256.67,24,1,12,9,True
2784954,49,3,451,9569,494569529,1,0,0,165.87,7,799090.8,20,5,7,9,True
3328351,1256,2,20,3076,494569529,1,0,0,165.95,5,798924.85,23,3,12,10,True
3654063,744,4,451,3602,494569529,1,0,0,165.94,7,798758.91,24,6,11,10,False
4215284,438,1,30,1083,494569529,1,0,0,166.25,8,798592.66,24,1,18,10,True
4625542,438,1,-1,6635,494569529,1,1,0,165.82,4,798592.66,24,5,2,11,True
4703768,438,1,30,3799,494569529,1,0,0,165.96,8,798426.7,24,3,19,12,True
4937757,1187,4,30,5387,494569529,1,0,0,166.08,8,798260.62,24,0,4,1,True
5440649,744,4,25,6635,494569529,1,0,0,166.0,8,798094.62,24,0,17,2,True
5880706,145,0,20,1826,494569529,1,0,0,165.96,5,797928.66,18,1,10,3,True
6150290,325,0,20,7554,494569529,1,0,0,165.95,5,797762.71,11,1,18,3,True
6478826,130,0,30,6745,494569529,1,0,0,166.08,8,797596.63,18,2,13,4,True
6549018,202,4,-1,1083,494569529,1,1,0,166.2,4,797596.63,9,4,11,4,True
6721314,537,0,451,3076,494569529,1,0,0,166.01,7,797430.62,18,1,12,7,True
6868443,537,0,-1,1226,494569529,1,1,0,166.0,1,797430.62,18,2,19,8,True
6894348,667,4,25,6635,494569529,1,0,0,165.94,8,797264.68,18,4,21,8,True
6906205,744,4,30,5815,494569529,1,0,0,166.27,8,797098.41,24,5,11,10,True
7042273,916,0,10,4937,494569529,1,0,0,165.81,6,797264.22,18,3,4,11,True
7119304,537,0,25,3076,494569529,1,0,0,166.04,8,797098.18,18,6,12,11,True
7266992,1187,4,-1,1226,494569529,1,1,0,166.18,1,797098.18,24,2,23,11,True
7299420,385,1,10,1226,494569529,1,0,0,166.03,6,797264.21,25,3,6,12,True
7346175,1312,0,20,6549,494569529,1,0,0,166.13,5,797098.08,5,5,8,1,True
7649047,438,1,-1,6745,494569529,1,1,0,166.0,4,797098.08,24,0,7,1,True
8039620,537,0,25,3455,494569529,1,0,0,165.98,8,796932.1,18,3,17,1,True
8063258,739,1,25,3076,494569529,1,0,0,165.93,8,796766.17,24,2,16,2,True
8122507,909,2,20,6549,494569529,1,0,0,165.65,5,796600.52,18,6,16,3,True
8214853,667,4,-1,3919,494569529,1,1,0,165.88,4,796600.52,18,3,12,3,True
8251519,1428,1,10,8138,494569529,1,0,0,166.14,0,796766.66,24,4,19,3,True
8342210,739,1,451,7554,494569529,1,0,0,166.05,7,796600.61,24,6,1,5,True
8869551,130,0,451,3602,494569529,1,0,0,165.89,7,796434.72,18,4,10,6,False
9033603,49,3,-1,8138,494569529,1,1,0,165.85,4,796434.72,20,1,11,7,True
9220770,130,0,451,6549,494569529,1,0,0,165.79,7,796268.93,18,2,12,8,True
9224867,1122,1,10,1083,494569529,1,0,0,165.99,0,796434.92,24,2,6,9,True
9498143,202,4,25,3919,494569529,1,0,0,165.79,8,796269.13,9,3,19,9,True
9667661,49,3,-1,1226,494569529,1,1,0,165.93,1,796269.13,20,6,9,11,True
9695326,537,0,-1,3076,494569529,1,2,0,166.16,4,796269.13,18,0,6,11,True
9856220,744,4,25,3076,494569529,1,0,0,165.95,8,796103.18,24,0,10,11,True
1104700,1070,4,451,9949,857900962,1,0,0,321.86,7,641868.14,18,2,22,1,True
1151429,1243,2,451,3305,857900962,1,0,0,321.66,7,641546.48,18,2,20,2,True
1172244,1162,2,20,3618,857900962,1,0,0,322.1,5,641224.38,24,3,6,4,True
1273758,1243,2,30,8186,857900962,1,0,0,321.98,8,640902.4,18,1,22,4,True
1818451,378,0,10,8902,857900962,1,0,0,322.07,6,641224.47,25,5,0,4,True
1820543,1070,4,451,9684,857900962,1,0,0,321.97,7,640902.5,18,5,3,5,True
1870161,728,1,30,8720,857900962,1,0,0,322.11,8,640580.39,11,5,5,5,True
1951643,687,0,30,3761,857900962,1,0,0,321.96,8,640258.43,24,2,17,7,True
2017622,1325,0,20,1814,857900962,1,0,0,321.86,3,639936.57,18,0,20,8,True
2191466,614,4,30,5606,857900962,1,0,0,322.12,8,639614.45,11,6,17,8,True
2450420,1243,2,-1,5832,857900962,1,1,0,321.95,1,639614.45,18,4,19,9,True
2672830,574,2,20,8408,857900962,1,0,0,321.7,5,639292.75,11,0,12,11,True
2712826,614,4,25,8408,857900962,1,0,0,321.9,8,638970.85,11,3,2,12,True
2842977,1108,1,10,5606,857900962,1,0,0,322.03,6,639292.88,0,0,8,1,True
2867737,512,0,10,9949,857900962,1,0,0,321.98,6,639614.86,12,0,9,1,True
3024618,1262,0,451,8902,857900962,1,0,0,321.94,7,639292.92,23,4,0,1,True
3395180,512,0,20,7097,857900962,1,0,0,321.92,5,638971.0,12,3,6,2,True
3452138,614,4,30,9143,857900962,1,0,0,322.26,8,638648.74,11,5,19,3,True
4015829,614,4,-1,5529,857900962,1,1,0,322.03,4,638648.74,11,0,14,4,True
4506726,343,1,10,9749,857900962,1,0,0,322.14,6,638970.88,24,1,12,4,True
4642883,614,4,30,7097,857900962,1,0,0,322.15,8,638648.73,11,6,9,5,True
5064963,1243,2,451,9949,857900962,1,0,0,322.01,7,638326.72,18,3,16,5,True
5199437,1461,0,10,5988,857900962,1,0,0,321.66,6,638648.38,11,0,6,5,True
5291003,1264,0,451,3618,857900962,1,0,0,321.89,7,638326.49,23,0,6,6,True
5440604,1070,4,-1,9143,857900962,1,1,0,322.18,4,638326.49,18,3,4,6,True
5728508,687,0,30,8902,857900962,1,0,0,322.25,8,638004.24,24,1,14,7,True
6230171,1029,0,20,8408,857900962,1,0,0,321.96,5,637682.28,11,5,5,7,True
6310623,1074,4,451,1814,857900962,1,0,0,322.07,7,637360.21,18,6,14,8,True
6490157,1210,0,20,9991,857900962,1,0,0,321.96,5,637038.25,24,2,19,10,True
6898653,81,0,20,8276,857900962,1,0,0,322.13,5,636716.12,1,2,6,10,True
6961236,1072,0,10,5176,857900962,1,0,0,322.22,6,637038.34,18,2,20,10,True
7199553,144,1,10,3618,857900962,1,0,0,321.76,6,637360.1,18,4,1,11,False
7253220,1264,0,30,8276,857900962,1,0,0,321.92,8,637038.18,23,6,7,12,True
7432987,687,0,-1,7803,857900962,1,1,0,321.72,4,637038.18,24,5,9,12,True
7518630,1074,4,25,9684,857900962,1,0,0,321.83,8,636716.35,18,5,19,2,True
7727293,1352,1,10,1097,857900962,1,0,0,322.0,6,637038.35,24,3,22,2,False
7880840,614,4,25,8408,857900962,1,0,0,322.04,8,636716.31,11,0,13,3,True
8050731,728,1,-1,9749,857900962,1,1,0,322.03,4,636716.31,11,2,5,3,True
8127958,687,0,451,9963,857900962,1,0,0,321.73,7,636394.58,24,6,7,4,True
8196697,1010,0,10,8186,857900962,1,0,0,322.16,0,636716.74,26,2,0,5,True
8362828,1070,4,-1,3490,857900962,1,1,0,321.9,4,636716.74,18,3,19,5,True
8732382,497,0,20,8170,857900962,1,0,0,322.23,5,636394.51,12,4,23,5,True
8884871,820,1,10,7803,857900962,1,0,0,322.09,0,636716.6,18,3,11,5,True
8924444,1243,2,451,8174,857900962,1,0,0,322.0,7,636394.6,18,4,4,7,True
8957498,614,4,451,5832,857900962,1,0,0,322.04,7,636072.56,11,5,10,7,True
9046743,1262,0,451,8902,857900962,1,0,0,322.25,7,635750.31,23,6,19,7,True
9157645,1181,2,20,5988,857900962,1,0,0,322.01,5,635428.3,24,4,10,8,True
9279241,1264,0,-1,8902,857900962,1,1,0,321.84,1,635428.3,23,6,21,8,True
9373718,716,0,10,8902,857900962,1,0,0,321.93,6,635750.23,18,4,23,9,True
9442823,553,1,10,7097,857900962,1,0,0,321.91,6,636072.14,17,2,3,9,True
9579958,502,0,10,3324,857900962,1,0,0,322.13,6,636394.27,12,1,6,9,True
9612502,687,0,25,9963,857900962,1,0,0,322.1,8,636072.17,24,4,17,10,True
9674625,238,0,10,8186,857900962,1,0,0,322.07,0,636394.24,26,5,12,10,True
9844904,1264,0,451,9749,857900962,1,0,0,321.84,7,636072.4,23,1,14,10,True
9963999,1264,0,25,9143,857900962,1,0,0,321.82,8,635750.58,23,0,5,10,True
1220166,441,4,451,8741,925698871,0,0,0,804.9,7,117202.1,24,1,6,2,True
1861010,334,0,451,7017,925698871,0,0,0,804.76,7,116397.34,11,1,22,2,True
1895495,467,0,25,6888,925698871,0,0,0,804.92,8,115592.42,5,3,13,2,True
1947120,467,0,451,3338,925698871,0,0,0,804.93,7,114787.49,5,5,15,2,True
2277620,441,4,451,8189,925698871,0,0,0,804.96,7,113982.53,24,1,16,4,True
2288140,467,0,-1,4977,925698871,0,1,0,805.03,4,113982.53,5,0,19,4,True
2822838,467,0,30,1136,925698871,0,0,0,805.09,8,113177.44,5,0,10,6,True
3022860,496,1,10,6159,925698871,0,0,0,804.66,6,113982.1,12,2,20,7,True
3089191,1406,0,20,1136,925698871,0,0,0,805.03,5,113177.07,24,4,16,10,True
3094671,334,0,451,8741,925698871,0,0,0,804.86,7,112372.21,11,5,14,12,True
3354963,334,0,30,6337,925698871,0,0,0,805.08,8,111567.13,11,1,1,12,True
3405018,810,4,30,5702,925698871,0,0,0,805.1,8,110762.03,18,0,15,1,True
3629044,467,0,30,6888,925698871,0,0,0,805.1,8,109956.93,5,4,4,1,True
3657040,467,0,-1,2543,925698871,0,1,0,805.09,1,109956.93,5,5,17,3,True
3665550,467,0,30,3338,925698871,0,0,0,805.24,8,109151.69,5,4,9,3,True
3899501,334,0,30,8366,925698871,0,0,0,805.32,8,108346.37,11,2,22,6,True
4047341,810,4,451,3236,925698871,0,0,0,804.81,7,107541.56,18,1,23,6,True
4176382,810,4,25,1780,925698871,0,0,0,805.04,8,106736.52,18,5,14,7,True
4257748,334,0,-1,1780,925698871,0,1,0,804.91,1,106736.52,11,4,23,8,True
4436041,467,0,451,1780,925698871,0,0,0,805.12,7,105931.4,5,5,8,8,True
4486670,622,4,451,2543,925698871,0,0,0,804.93,7,105126.47,11,6,21,8,True
4580483,441,4,30,3338,925698871,0,0,0,804.98,8,104321.49,24,3,12,10,True
5284954,630,0,10,3236,925698871,0,0,0,804.88,6,105126.37,11,3,22,11,True
5293606,334,0,30,4749,925698871,0,0,0,805.0,8,104321.37,11,3,22,1,True
5337005,441,4,25,5702,925698871,0,0,0,804.9,8,103516.47,24,1,12,3,True
5350271,810,4,25,4977,925698871,0,0,0,804.82,8,102711.65,18,1,19,4,True
5643279,441,4,451,1780,925698871,0,0,0,804.89,7,101906.76,24,2,9,4,True
5644028,634,1,10,3236,925698871,0,0,0,805.0,6,102711.76,24,6,1,6,True
5842415,810,4,-1,8366,925698871,0,1,0,805.05,4,102711.76,18,6,0,7,True
5998515,810,4,-1,1136,925698871,0,2,0,804.83,4,102711.76,18,1,4,10,True
6047152,810,4,-1,7017,925698871,0,3,1,804.97,1,0.0,18,6,16,11,True
1164760,317,4,25,2986,281641519,1,0,0,935.78,8,769037.22,4,3,2,2,True
1314476,359,2,25,9487,281641519,1,0,0,935.83,8,768101.39,24,6,14,3,True
1377527,204,0,451,3947,281641519,1,0,0,935.94,7,767165.45,9,6,18,4,False
1598937,317,4,25,2531,281641519,1,0,0,935.98,8,766229.47,4,4,4,4,True
1656927,388,3,30,5426,281641519,1,0,0,935.68,8,765293.79,10,1,17,4,True
1791586,184,0,10,2883,281641519,1,0,0,935.82,0,766229.61,18,3,12,7,True
1907543,184,0,451,8255,281641519,1,0,0,935.7,7,765293.91,18,2,9,7,True
1936498,359,2,451,3741,281641519,1,0,0,936.16,7,764357.75,24,0,1,7,True
2331220,388,3,451,2986,281641519,1,0,0,935.95,7,763421.8,10,4,10,8,True
2650890,184,0,451,2986,281641519,1,0,0,936.05,7,762485.75,18,4,3,9,False
2847839,388,3,30,4995,281641519,1,0,0,936.18,8,761549.57,10,0,14,9,True
2858670,359,2,-1,1399,281641519,1,1,0,936.05,4,761549.57,24,1,13,10,True
2869927,704,3,30,2883,281641519,1,0,0,936.0,8,760613.57,18,0,16,10,True
2945678,1037,0,20,2986,281641519,1,0,0,936.24,5,759677.33,11,6,20,11,True
3101081,204,0,30,8255,281641519,1,0,0,936.1,8,758741.23,9,6,4,12,True
3314252,388,3,-1,5513,281641519,1,1,0,936.14,1,758741.23,10,0,4,12,True
3509988,1391,2,25,4430,281641519,1,0,0,935.79,8,757805.44,24,6,10,12,True
3540451,211,0,10,9027,281641519,1,0,0,936.02,0,758741.46,9,1,18,1,True
3708380,184,0,30,3323,281641519,1,0,0,936.12,8,757805.34,18,6,0,2,True
3895059,704,3,451,4194,281641519,1,0,0,936.04,7,756869.3,18,3,17,3,True
4151117,184,0,451,4995,281641519,1,0,0,936.05,7,755933.25,18,4,8,3,True
4202225,184,0,30,4430,281641519,1,0,0,936.07,8,754997.18,18,6,10,4,True
4322412,428,0,10,3323,281641519,1,0,0,935.95,0,755933.13,18,3,19,4,True
4769569,1391,2,25,2975,281641519,1,0,0,935.97,8,754997.16,24,1,11,5,True
4935083,184,0,25,9841,281641519,1,0,0,936.0,8,754061.16,18,2,6,5,True
4990195,317,4,451,7159,281641519,1,0,0,935.89,7,753125.27,4,1,21,6,True
5033546,704,3,25,5513,281641519,1,0,0,936.1,8,752189.17,18,5,15,7,True
5066033,359,2,451,5426,281641519,1,0,0,935.85,7,751253.32,24,6,1,7,False
5181009,704,3,25,6448,281641519,1,0,0,936.1,8,750317.22,18,0,20,9,True
5363374,317,4,25,1399,281641519,1,0,0,935.92,8,749381.3,4,6,18,9,True
5744711,388,3,-1,1828,281641519,1,1,0,935.86,1,749381.3,10,1,22,9,True
5760039,346,0,20,6806,281641519,1,0,0,936.07,3,748445.23,24,0,19,9,True
5769805,317,4,25,7159,281641519,1,0,0,936.05,8,747509.18,4,0,8,11,True
5989356,747,1,10,2485,281641519,1,0,0,935.92,6,748445.1,24,6,1,11,True
6026568,704,3,25,2531,281641519,1,0,0,935.9,8,747509.2,18,4,19,11,True
6084127,628,0,10,3853,281641519,1,0,0,936.16,0,748445.36,11,1,6,11,True
6336671,550,0,20,4194,281641519,1,0,0,935.87,5,747509.49,17,2,23,12,True
6364545,388,3,30,1828,281641519,1,0,0,935.86,8,746573.63,10,3,4,12,True
6471377,359,2,30,5426,281641519,1,0,0,935.94,8,745637.69,24,3,17,12,True
6730276,1391,2,30,6102,281641519,1,0,0,936.05,8,744701.64,24,3,4,12,True
6819768,155,1,10,9465,281641519,1,0,0,935.85,6,745637.49,18,0,16,1,True
6873602,388,3,-1,9465,281641519,1,1,0,936.07,4,745637.49,10,5,8,2,True
7133135,1391,2,30,9841,281641519,1,0,0,935.83,8,744701.66,24,2,13,2,True
7325161,522,0,10,1399,281641519,1,0,0,936.08,6,745637.74,18,0,20,2,True
7665029,1391,2,25,9487,281641519,1,0,0,936.23,8,744701.51,24,2,10,3,True
7877825,359,2,451,7045,281641519,1,0,0,935.87,7,743765.64,24,4,11,3,True
7891357,1315,0,10,2883,281641519,1,0,0,936.06,0,744701.7,5,2,6,4,True
8208777,1391,2,25,4674,281641519,1,0,0,935.94,8,743765.76,24,1,14,4,True
8555396,446,1,10,2485,281641519,1,0,0,936.37,0,744702.13,13,4,13,4,True
8565676,184,0,25,3741,281641519,1,0,0,935.96,8,743766.17,18,1,1,5,True
8829589,204,0,451,1208,281641519,1,0,0,936.07,7,742830.1,9,3,19,7,True
8895749,1391,2,-1,6102,281641519,1,1,0,936.12,4,742830.1,24,4,8,7,True
9284135,577,0,10,2986,281641519,1,0,0,936.06,6,743766.16,11,6,9,7,True
9349778,359,2,30,6102,281641519,1,0,0,936.01,8,742830.15,24,3,12,8,True
9623812,267,0,20,2531,281641519,1,0,0,936.03,5,741894.12,6,3,15,8,True
9640602,204,0,451,6806,281641519,1,0,0,936.1,7,740958.02,9,1,18,10,True
9847027,388,3,30,7159,281641519,1,0,0,935.92,8,740022.1,10,2,12,10,True
9915789,204,0,25,1390,281641519,1,0,0,935.84,8,739086.26,9,5,1,10,True
1289195,540,4,25,6412,856715242,1,0,0,979.26,8,411908.74,17,5,1,1,True
1684657,996,0,10,3384,856715242,1,0,0,979.12,0,412887.86,26,6,0,1,True
1790141,749,4,451,9238,856715242,1,0,0,978.72,7,411909.14,24,1,9,1,True
1797323,583,2,20,8430,856715242,1,0,0,978.85,5,410930.29,11,2,11,1,True
1868039,470,1,451,7204,856715242,1,0,0,978.96,7,409951.33,5,2,12,1,True
1895889,470,1,-1,2738,856715242,1,1,0,979.36,1,409951.33,5,1,23,3,True
2562172,470,1,30,8794,856715242,1,0,0,979.29,8,408972.04,5,4,3,3,True
2571676,268,2,30,5915,856715242,1,0,0,979.13,8,407992.91,24,5,3,3,True
3024671,540,4,-1,6761,856715242,1,1,0,979.12,4,407992.91,17,5,6,3,True
3140214,56,4,-1,3103,856715242,1,2,0,979.02,4,407992.91,20,2,18,4,True
3162174,1448,4,30,7396,856715242,1,0,0,979.06,8,407013.85,11,1,9,6,True
3249607,749,4,25,3103,856715242,1,0,0,979.05,8,406034.8,24,6,2,7,True
3257251,540,4,30,9219,856715242,1,0,0,979.04,8,405055.76,17,2,10,7,True
3266183,1116,0,10,5705,856715242,1,0,0,979.3,6,406035.06,24,5,1,7,True
3284427,572,0,451,1227,856715242,1,0,0,978.94,7,405056.12,11,3,12,7,True
3597591,29,0,20,9219,856715242,1,0,0,978.89,5,404077.23,11,3,3,7,True
3608151,530,0,20,3759,856715242,1,0,0,979.25,5,403097.98,18,4,14,7,True
3679446,268,2,451,3103,856715242,1,0,0,979.1,7,402118.88,24,0,9,8,True
4043919,1363,0,10,3759,856715242,1,0,0,979.07,6,403097.95,16,4,6,8,False
4085735,734,0,20,5915,856715242,1,0,0,979.3,5,402118.65,11,1,5,9,True
4114695,1425,0,10,2738,856715242,1,0,0,978.95,0,403097.6,24,3,3,9,True
4161265,470,1,25,7147,856715242,1,0,0,978.93,8,402118.67,5,4,1,10,True
4308341,503,0,10,2738,856715242,1,0,0,979.18,6,403097.85,12,0,3,10,True
4519987,589,1,10,7147,856715242,1,0,0,979.1,6,404076.95,24,0,2,10,True
4651035,268,2,451,5705,856715242,1,0,0,978.87,7,403098.08,24,0,5,10,True
4949818,540,4,30,3103,856715242,1,0,0,978.73,8,402119.35,17,4,1,11,True
5078596,268,2,-1,2738,856715242,1,1,0,978.99,1,402119.35,24,0,18,11,True
5687910,749,4,451,3759,856715242,1,0,0,978.89,7,401140.46,24,2,3,2,True
5875539,540,4,30,7350,856715242,1,0,0,979.2,8,400161.26,17,6,0,2,True
5994155,56,4,451,7147,856715242,1,0,0,978.8,7,399182.46,20,4,19,3,True
6147341,325,0,10,6306,856715242,1,0,0,979.21,6,400161.67,11,5,6,3,True
6169498,540,4,30,3103,856715242,1,0,0,979.12,8,399182.55,17,0,21,3,True
6197347,749,4,25,6540,856715242,1,0,0,979.07,8,398203.48,24,3,20,3,True
6278572,689,0,10,1789,856715242,1,0,0,979.23,6,399182.71,24,4,11,4,True
6330705,572,0,10,6306,856715242,1,0,0,979.01,0,400161.72,11,1,19,7,True
6371890,1448,4,25,5705,856715242,1,0,0,978.99,8,399182.73,11,4,22,7,True
6711924,56,4,451,3759,856715242,1,0,0,978.74,7,398203.99,20,2,3,8,False
6872575,1448,4,30,8430,856715242,1,0,0,978.87,8,397225.12,11,2,20,8,True
7000445,211,0,20,3103,856715242,1,0,0,979.19,3,396245.93,9,6,17,8,True
7064511,1448,4,451,5705,856715242,1,0,0,978.74,7,395267.19,11,6,6,9,True
7192743,1448,4,30,1560,856715242,1,0,0,979.05,8,394288.14,11,1,11,10,True
7457989,572,0,-1,6540,856715242,1,1,0,979.21,1,394288.14,11,5,19,10,True
7736488,1448,4,-1,8430,856715242,1,2,0,979.14,1,394288.14,11,1,20,12,True
7744916,183,1,10,7350,856715242,1,0,0,978.84,6,395266.98,18,6,17,12,True
8058277,705,1,10,8430,856715242,1,0,0,978.72,6,396245.7,18,2,6,1,True
8224420,952,0,20,3384,856715242,1,0,0,978.96,3,395266.74,13,6,23,2,True
8948309,540,4,25,7350,856715242,1,0,0,979.03,8,394287.71,17,2,4,2,True
9020670,572,0,30,2738,856715242,1,0,0,978.97,8,393308.74,11,6,1,2,True
9129940,268,2,-1,1227,856715242,1,1,0,978.96,1,393308.74,24,3,22,2,False
9221590,1448,4,30,9238,856715242,1,0,0,979.02,8,392329.72,11,3,16,4,True
9221851,1448,4,30,7396,856715242,1,0,0,978.82,8,391350.9,11,5,5,5,True
9248355,470,1,25,6761,856715242,1,0,0,979.15,8,390371.75,5,2,15,7,True
9315876,540,4,-1,2738,856715242,1,1,0,978.9,4,390371.75,17,4,14,7,True
9377949,470,1,30,3384,856715242,1,0,0,978.97,8,389392.78,5,1,18,8,True
9440578,1314,2,20,1560,856715242,1,0,0,978.83,3,388413.95,5,3,11,8,True
9893307,572,0,25,6412,856715242,1,0,0,979.17,8,387434.78,11,0,0,10,True
9897376,200,0,20,7396,856715242,1,0,0,979.27,5,386455.51,9,1,6,11,True
1257802,622,4,30,1910,772933233,1,0,0,535.02,8,419411.98,11,3,8,2,True
1279409,1325,0,20,2970,772933233,1,0,0,535.22,5,418876.76,18,5,0,3,True
1461928,425,4,-1,1494,772933233,1,1,0,535.09,4,418876.76,18,0,13,3,True
1488097,987,4,451,8111,772933233,1,0,0,535.08,7,418341.68,22,3,22,3,True
2115402,443,2,20,2446,772933233,1,0,0,535.12,5,417806.56,24,2,9,3,True
2199046,987,4,25,1642,772933233,1,0,0,535.04,8,417271.52,22,0,2,4,True
2318672,622,4,25,8111,772933233,1,0,0,534.91,8,416736.61,11,0,20,4,False
2422164,987,4,451,2446,772933233,1,0,0,535.31,7,416201.3,22,1,5,4,True
2732028,1179,0,10,2970,772933233,1,0,0,535.0,6,416736.3,24,5,7,4,True
2750991,330,3,451,8459,772933233,1,0,0,535.03,7,416201.27,11,1,11,5,True
2801004,480,0,25,8673,772933233,1,0,0,534.93,8,415666.34,5,1,21,6,True
3081540,360,0,20,8111,772933233,1,0,0,535.03,5,415131.31,24,5,18,6,True
3175808,622,4,-1,2714,772933233,1,1,0,534.87,1,415131.31,11,3,13,7,True
3207742,480,0,-1,8673,772933233,1,2,0,535.0,4,415131.31,5,0,6,8,True
3275323,987,4,451,1443,772933233,1,0,0,535.14,7,414596.17,22,0,3,9,True
3315824,913,0,20,9801,772933233,1,0,0,534.77,5,414061.4,18,0,11,10,True
3324260,425,4,451,8673,772933233,1,0,0,535.03,7,413526.37,18,6,14,11,True
3449853,480,0,451,2349,772933233,1,0,0,534.8,7,412991.57,5,3,20,11,True
3602953,916,0,20,4912,772933233,1,0,0,535.24,3,412456.33,18,5,14,12,True
4111797,425,4,451,5099,772933233,1,0,0,534.96,7,411921.37,18,4,23,12,True
4150085,1111,0,20,6129,772933233,1,0,0,534.78,3,411386.59,0,0,9,12,True
4156471,987,4,-1,5099,772933233,1,1,0,535.06,4,411386.59,22,1,20,12,True
4262314,622,4,25,1910,772933233,1,0,0,534.87,8,410851.72,11,5,23,1,True
4321131,480,0,-1,3566,772933233,1,1,0,534.9,1,410851.72,5,2,21,3,True
4353796,425,4,25,2714,772933233,1,0,0,535.26,8,410316.46,18,4,19,4,False
4541896,883,0,10,2134,772933233,1,0,0,535.49,6,410851.95,24,0,2,4,True
4759010,330,3,-1,5099,772933233,1,1,0,535.18,4,410851.95,11,6,13,5,True
5174034,987,4,451,2714,772933233,1,0,0,535.03,7,410316.92,22,6,0,5,True
5184246,622,4,451,2714,772933233,1,0,0,535.02,7,409781.9,11,6,0,5,False
5306411,480,0,451,8392,772933233,1,0,0,534.86,7,409247.04,5,2,1,6,True
5434924,622,4,25,2446,772933233,1,0,0,535.06,8,408711.98,11,4,7,6,True
5532023,987,4,25,9801,772933233,1,0,0,534.82,8,408177.16,22,5,18,11,True
5873660,987,4,451,9894,772933233,1,0,0,535.08,7,407642.08,22,1,22,12,True
5939775,622,4,25,1443,772933233,1,0,0,534.85,8,407107.23,11,4,19,12,True
6099511,622,4,30,1642,772933233,1,0,0,534.9,8,406572.33,11,2,15,1,True
6328358,425,4,451,3586,772933233,1,0,0,534.98,7,406037.35,18,2,20,1,True
6332660,425,4,30,4912,772933233,1,0,0,535.1,8,405502.25,18,3,0,2,True
6941793,398,0,20,6129,772933233,1,0,0,535.03,3,404967.22,10,2,0,3,True
6954308,425,4,451,9389,772933233,1,0,0,535.03,7,404432.19,18,0,9,3,True
6982855,677,0,20,1443,772933233,1,0,0,534.81,5,403897.38,24,4,14,3,True
7392375,425,4,451,9389,772933233,1,0,0,534.84,7,403362.54,18,2,2,3,True
7612760,987,4,30,8459,772933233,1,0,0,534.87,8,402827.67,22,2,1,4,True
7973110,987,4,451,8953,772933233,1,0,0,535.01,7,402292.66,22,1,16,4,True
8085383,480,0,30,8459,772933233,1,0,0,534.96,8,401757.7,5,2,10,4,True
8261340,622,4,30,6698,772933233,1,0,0,535.04,8,401222.66,11,3,19,5,True
9086726,480,0,451,2714,772933233,1,0,0,534.69,7,400687.97,5,6,11,6,True
9524159,987,4,451,1494,772933233,1,0,0,534.99,7,400152.98,22,3,11,7,True
9541016,987,4,451,8111,772933233,1,0,0,535.06,7,399617.92,22,3,11,7,False
9615379,522,0,10,7934,772933233,1,0,0,535.19,0,400153.11,18,1,20,7,True
9868757,653,1,10,8673,772933233,1,0,0,535.33,6,400688.44,24,1,7,8,True
9921122,987,4,451,2714,772933233,1,0,0,534.84,7,400153.6,22,2,20,10,True
1113082,1112,1,451,8278,515840267,1,0,0,207.04,7,189385.96,0,3,14,2,True
1227387,110,4,-1,2970,515840267,1,1,0,207.06,1,189385.96,3,5,19,2,True
1604966,672,4,451,1842,515840267,1,0,0,206.78,7,189179.18,18,0,18,2,True
1745276,994,4,-1,8609,515840267,1,1,0,206.97,1,189179.18,22,6,22,3,True
1807867,110,4,30,7779,515840267,1,0,0,206.9,8,188972.28,3,0,20,3,True
1939572,110,4,451,3314,515840267,1,0,0,206.99,7,188765.29,3,4,9,4,True
2008904,385,1,10,3309,515840267,1,0,0,207.05,6,188972.34,25,5,17,5,True
2101774,79,4,451,8609,515840267,1,0,0,207.09,7,188765.25,1,3,3,5,True
2404532,994,4,25,6216,515840267,1,0,0,207.01,8,188558.24,22,3,6,5,True
2550328,909,2,451,9699,515840267,1,0,0,207.08,7,188351.16,18,5,9,5,True
2705812,404,1,10,5846,515840267,1,0,0,206.88,6,188558.04,10,4,23,6,True
2740366,1112,1,25,3804,515840267,1,0,0,206.73,8,188351.31,0,4,11,7,True
2850091,672,4,-1,8609,515840267,1,1,0,206.89,4,188351.31,18,5,3,7,True
2962079,728,1,10,9917,515840267,1,0,0,207.09,6,188558.4,11,4,11,7,True
2998883,403,0,-1,8609,515840267,1,1,0,207.01,4,188558.4,10,6,3,8,True
3410428,110,4,451,3804,515840267,1,0,0,206.88,7,188351.52,3,1,12,8,True
3454650,547,4,25,2970,515840267,1,0,0,207.27,8,188144.25,17,3,2,10,True
3569891,403,0,30,8609,515840267,1,0,0,207.18,8,187937.07,10,3,15,10,True
3588627,607,2,20,8278,515840267,1,0,0,207.03,5,187730.04,24,6,23,10,True
3823532,547,4,-1,5707,515840267,1,1,0,207.22,4,187730.04,17,5,8,10,True
4253554,909,2,-1,5354,515840267,1,2,0,206.93,4,187730.04,18,1,13,11,True
4609099,547,4,451,5715,515840267,1,0,0,207.24,7,187522.8,17,6,22,12,True
4719831,757,0,20,3309,515840267,1,0,0,207.05,5,187315.75,24,3,8,1,True
4758047,144,1,10,2855,515840267,1,0,0,207.15,0,187522.9,18,4,9,1,True
4842865,360,0,10,5707,515840267,1,0,0,206.78,6,187729.68,24,2,21,3,True
5145035,994,4,451,1130,515840267,1,0,0,207.08,7,187522.6,22,5,19,4,True
5207061,79,4,30,3314,515840267,1,0,0,206.99,8,187315.61,1,1,9,4,True
5219091,994,4,25,7999,515840267,1,0,0,206.76,8,187108.85,22,3,19,5,True
5366301,547,4,451,5354,515840267,1,0,0,207.21,7,186901.64,17,1,1,6,True
5753894,1404,2,20,9917,515840267,1,0,0,207.15,5,186694.49,24,2,9,7,True
5793899,907,0,10,6216,515840267,1,0,0,207.09,6,186901.58,2,4,21,7,True
5984581,1425,0,20,4213,515840267,1,0,0,206.95,5,186694.63,24,1,10,8,True
6612317,79,4,451,5354,515840267,1,0,0,207.01,7,186487.62,1,3,20,9,True
6672462,1112,1,-1,3314,515840267,1,1,0,206.93,4,186487.62,0,2,21,10,True
6827260,573,0,10,1842,515840267,1,0,0,206.75,6,186694.37,11,0,10,10,True
7019868,79,4,30,8526,515840267,1,0,0,207.03,8,186487.34,1,1,1,11,True
7174622,110,4,451,5715,515840267,1,0,0,206.95,7,186280.39,3,2,6,11,True
7217974,403,0,-1,5354,515840267,1,1,0,207.17,4,186280.39,10,6,3,11,True
7271104,1112,1,-1,4213,515840267,1,2,0,207.14,4,186280.39,0,5,15,12,True
7382104,465,0,10,1842,515840267,1,0,0,207.13,0,186487.52,13,2,8,1,True
7407216,448,0,10,3804,515840267,1,0,0,206.92,6,186694.44,13,3,10,1,True
7427801,994,4,-1,1842,515840267,1,1,0,206.95,4,186694.44,22,2,7,1,True
7489561,576,2,20,7779,515840267,1,0,0,207.12,5,186487.32,11,5,9,2,True
7850838,403,0,25,2518,515840267,1,0,0,206.92,8,186280.4,10,0,10,3,True
7926222,367,1,10,2518,515840267,1,0,0,207.08,6,186487.48,25,3,12,4,True
7938383,79,4,-1,8731,515840267,1,1,0,207.11,1,186487.48,1,6,20,5,True
8009683,465,0,20,6357,515840267,1,0,0,206.94,5,186280.54,13,1,22,6,True
8440288,79,4,451,6216,515840267,1,0,0,206.89,7,186073.65,1,4,7,7,True
8485344,403,0,25,3919,515840267,1,0,0,206.95,8,185866.7,10,4,17,8,True
8508002,1164,0,20,7317,515840267,1,0,0,206.97,3,185659.73,24,0,19,8,True
8688064,110,4,25,2970,515840267,1,0,0,206.94,8,185452.79,3,4,21,8,True
8775508,994,4,-1,1350,515840267,1,1,0,207.03,4,185452.79,22,0,20,9,False
8812302,1463,2,20,8609,515840267,1,0,0,207.1,3,185245.69,11,1,20,9,True
8946219,994,4,25,5846,515840267,1,0,0,206.97,8,185038.72,22,2,8,9,True
8965942,110,4,25,7779,515840267,1,0,0,206.92,8,184831.8,3,4,9,10,True
9116434,670,0,20,5846,515840267,1,0,0,206.85,5,184624.95,18,3,10,11,True
9640872,547,4,-1,4213,515840267,1,1,0,207.33,4,184624.95,17,6,9,11,True
1061231,795,4,451,9751,310131389,1,0,0,209.05,7,169859.95,11,3,13,2,True
1134115,933,4,-1,3837,310131389,1,1,0,208.92,1,169859.95,24,0,16,3,True
1238350,933,4,30,6772,310131389,1,0,0,209.2,8,169650.75,24,4,22,5,True
1316498,1404,2,451,7265,310131389,1,0,0,209.06,7,169441.69,24,0,3,5,True
1390098,795,4,451,1798,310131389,1,0,0,209.0,7,169232.69,11,5,17,6,False
1493349,795,4,-1,9338,310131389,1,1,0,209.02,4,169232.69,11,1,6,7,True
1500479,735,1,25,3801,310131389,1,0,0,208.94,8,169023.75,11,2,7,7,True
1633859,665,2,20,9969,310131389,1,0,0,209.03,3,168814.72,18,6,5,8,True
1709543,729,0,20,6299,310131389,1,0,0,209.06,5,168605.66,11,6,18,9,True
2297405,1243,2,20,4600,310131389,1,0,0,209.08,5,168396.58,18,0,6,10,False
2313063,360,0,20,9284,310131389,1,0,0,208.98,5,168187.6,24,6,23,10,True
2444464,933,4,451,6444,310131389,1,0,0,208.73,7,167978.87,24,2,18,10,True
2622212,735,1,451,7265,310131389,1,0,0,209.18,7,167769.69,11,4,5,11,True
2686068,795,4,25,9338,310131389,1,0,0,208.92,8,167560.77,11,5,1,11,True
2687767,1384,4,451,3801,310131389,1,0,0,208.81,7,167351.96,24,1,10,12,True
2818599,1385,4,30,6444,310131389,1,0,0,208.79,8,167143.17,24,1,8,12,True
2841579,1011,4,25,6594,310131389,1,0,0,208.88,8,166934.29,26,5,15,12,True
2857349,627,0,30,2721,310131389,1,0,0,209.08,8,166725.21,11,1,11,1,True
3045918,866,0,10,1798,310131389,1,0,0,209.04,6,166934.25,24,2,8,1,True
3095202,1011,4,30,3801,310131389,1,0,0,208.93,8,166725.32,26,5,13,2,True
3186314,245,4,30,9969,310131389,1,0,0,209.13,8,166516.19,26,5,15,2,True
3349818,735,1,451,9284,310131389,1,0,0,208.96,7,166307.23,11,5,20,2,True
3832930,1408,1,10,3801,310131389,1,0,0,209.07,6,166516.3,24,4,2,3,True
3886849,795,4,30,1798,310131389,1,0,0,209.27,8,166307.03,11,6,13,3,True
4022904,1385,4,451,3801,310131389,1,0,0,209.11,7,166097.92,24,3,17,4,True
4047154,1385,4,30,3837,310131389,1,0,0,208.99,8,165888.93,24,6,3,4,True
4198281,1011,4,30,6772,310131389,1,0,0,208.96,8,165679.97,26,5,5,5,True
4261145,933,4,451,9338,310131389,1,0,0,209.24,7,165470.73,24,5,12,6,True
5025209,1285,1,10,3996,310131389,1,0,0,208.97,0,165679.7,24,5,19,7,True
5168397,1384,4,451,8014,310131389,1,0,0,209.45,7,165470.25,24,0,9,7,True
5718134,245,4,30,9969,310131389,1,0,0,209.04,8,165261.21,26,6,14,8,True
5796446,1404,2,25,4662,310131389,1,0,0,208.83,8,165052.38,24,4,6,8,True
5832463,309,0,10,4662,310131389,1,0,0,208.72,6,165261.1,4,3,14,8,True
5843548,933,4,451,3996,310131389,1,0,0,208.66,7,165052.44,24,4,3,9,False
5847801,245,4,30,2721,310131389,1,0,0,209.14,8,164843.3,26,3,20,9,True
5859264,1011,4,451,6594,310131389,1,0,0,209.17,7,164634.13,26,6,14,10,True
6555644,933,4,30,3978,310131389,1,0,0,208.97,8,164425.16,24,3,21,10,True
6630789,245,4,25,9338,310131389,1,0,0,209.15,8,164216.01,26,1,18,10,True
6639835,795,4,30,8014,310131389,1,0,0,208.79,8,164007.22,11,5,2,11,True
6748667,1404,2,451,6772,310131389,1,0,0,209.03,7,163798.19,24,6,2,11,True
7145492,1404,2,25,3996,310131389,1,0,0,209.22,8,163588.97,24,6,7,11,True
7149294,1384,4,451,7114,310131389,1,0,0,209.03,7,163379.94,24,2,5,12,True
7449214,1011,4,-1,6772,310131389,1,1,0,208.93,1,163379.94,26,2,9,1,True
7482209,701,2,20,7114,310131389,1,0,0,208.8,5,163171.14,18,3,22,2,True
7659462,735,1,25,2721,310131389,1,0,0,209.13,8,162962.01,11,1,14,2,True
7786577,1169,0,10,3996,310131389,1,0,0,208.88,6,163170.89,24,1,17,2,True
7821517,378,0,20,7265,310131389,1,0,0,209.17,5,162961.72,25,3,15,3,True
7997484,735,1,10,3996,310131389,1,0,0,208.91,6,163170.63,11,4,15,5,True
8255144,394,0,10,3996,310131389,1,0,0,208.91,6,163379.54,10,5,16,6,True
8394507,1385,4,25,9338,310131389,1,0,0,209.18,8,163170.36,24,6,6,6,True
8513674,1385,4,30,7265,310131389,1,0,0,209.06,8,162961.3,24,4,11,6,True
8979985,1488,0,20,4600,310131389,1,0,0,208.88,5,162752.42,24,5,21,7,True
9192015,933,4,451,3996,310131389,1,0,0,208.9,7,162543.52,24,1,5,7,True
9206438,1404,2,-1,1798,310131389,1,1,0,208.94,1,162543.52,24,3,12,7,True
9248186,933,4,451,9284,310131389,1,0,0,208.94,7,162334.58,24,4,18,9,True
9390776,807,0,20,9751,310131389,1,0,0,208.98,5,162125.6,11,0,23,10,True
9554137,1011,4,451,6444,310131389,1,0,0,208.82,7,161916.78,26,0,8,11,True
9764029,245,4,30,7114,310131389,1,0,0,209.14,8,161707.64,26,0,18,11,True
1236988,1463,2,25,4821,905135745,1,0,0,645.99,8,870032.01,11,0,8,1,True
1277085,1463,2,451,5648,905135745,1,0,0,645.93,7,869386.08,11,0,12,1,True
1332371,1108,1,-1,9784,905135745,1,1,0,645.83,4,869386.08,0,2,15,2,True
1352590,1152,0,451,3784,905135745,1,0,0,645.96,7,868740.12,15,3,11,2,True
1379904,1152,0,451,9784,905135745,1,0,0,645.71,7,868094.41,15,1,8,2,True
1550872,1132,0,25,4821,905135745,1,0,0,646.23,8,867448.18,24,4,11,2,True
1756468,41,2,30,1840,905135745,1,0,0,646.09,8,866802.09,11,0,15,6,True
2354691,777,3,451,4821,905135745,1,0,0,645.76,7,866156.33,14,6,2,7,True
2556714,777,3,451,9784,905135745,1,0,0,646.12,7,865510.21,14,2,12,8,True
2893754,1108,1,-1,2382,905135745,1,1,0,645.98,4,865510.21,0,1,17,9,True
2932086,1103,4,451,9784,905135745,1,0,0,646.25,7,864863.96,0,2,23,9,True
2981349,1132,0,451,2382,905135745,1,0,0,645.82,7,864218.14,24,1,7,10,True
3192356,1463,2,451,5469,905135745,1,0,0,646.03,7,863572.11,11,3,10,10,True
3212266,1434,0,10,2382,905135745,1,0,0,646.04,0,864218.15,24,6,14,10,True
3245787,1124,0,25,2227,905135745,1,0,0,646.21,8,863571.94,24,0,18,10,True
3362882,1132,0,30,3784,905135745,1,0,0,645.97,8,862925.97,24,2,4,10,True
3444391,777,3,-1,8521,905135745,1,1,0,645.97,1,862925.97,14,1,9,11,True
3885474,41,2,451,1811,905135745,1,0,0,645.98,7,862279.99,11,6,14,11,True
4106458,1072,0,10,9693,905135745,1,0,0,645.83,6,862925.82,18,2,18,12,True
4380158,1132,0,451,2227,905135745,1,0,0,645.98,7,862279.84,24,2,2,1,True
4852918,1103,4,25,5469,905135745,1,0,0,646.09,8,861633.75,0,3,5,1,True
4874765,664,2,20,9676,905135745,1,0,0,646.2,5,860987.55,18,5,12,1,True
4956696,41,2,451,9784,905135745,1,0,0,646.11,7,860341.44,11,4,20,2,True
4967133,319,0,10,3941,905135745,1,0,0,645.71,6,860987.15,11,6,15,2,True
5057266,1245,1,10,1777,905135745,1,0,0,646.03,6,861633.18,18,1,18,3,True
5088142,1103,4,451,1811,905135745,1,0,0,645.89,7,860987.29,0,4,19,4,True
5181139,96,0,10,9693,905135745,1,0,0,645.86,0,861633.15,1,6,4,4,True
5431656,1103,4,451,9693,905135745,1,0,0,646.22,7,860986.93,0,1,7,5,True
5746277,1103,4,30,5445,905135745,1,0,0,645.94,8,860340.99,0,2,7,5,True
6036416,1463,2,30,2382,905135745,1,0,0,646.14,8,859694.85,11,4,3,5,True
6081053,1103,4,451,5469,905135745,1,0,0,645.93,7,859048.92,0,2,7,6,False
6179011,41,2,451,3941,905135745,1,0,0,646.12,7,858402.8,11,3,12,6,True
6304876,628,0,10,9676,905135745,1,0,0,645.88,6,859048.68,11,2,18,6,True
6327638,1124,0,30,3851,905135745,1,0,0,646.05,8,858402.63,24,2,15,7,True
6717695,777,3,451,1811,905135745,1,0,0,645.91,7,857756.72,14,6,15,7,True
6837769,560,2,20,9784,905135745,1,0,0,646.01,5,857110.71,17,5,14,8,True
7028729,748,1,10,1840,905135745,1,0,0,646.36,6,857757.07,24,3,5,9,True
7133307,641,0,20,5469,905135745,1,0,0,646.04,5,857111.03,24,6,22,9,True
7280197,1463,2,451,8521,905135745,1,0,0,645.82,7,856465.21,11,6,13,10,True
7608439,1463,2,-1,5445,905135745,1,1,0,646.08,1,856465.21,11,6,15,10,True
7747322,1354,0,20,1777,905135745,1,0,0,646.06,5,855819.15,24,6,14,11,False
7923278,1152,0,451,1267,905135745,1,0,0,645.87,7,855173.28,15,1,8,11,False
7938740,438,1,10,1777,905135745,1,0,0,646.03,6,855819.31,24,1,23,12,True
8294706,1463,2,451,2227,905135745,1,0,0,645.92,7,855173.39,11,6,20,12,True
8549779,1152,0,451,1811,905135745,1,0,0,645.62,7,854527.77,15,3,9,1,True
8557848,1103,4,30,5445,905135745,1,0,0,646.1,8,853881.67,0,0,1,4,True
8683969,568,1,10,3941,905135745,1,0,0,645.91,6,854527.58,11,3,22,5,True
8696578,325,0,20,4821,905135745,1,0,0,646.02,5,853881.56,11,1,19,6,True
8758036,1072,0,10,9784,905135745,1,0,0,645.96,6,854527.52,18,2,7,6,True
8770451,605,0,20,9693,905135745,1,0,0,646.0,5,853881.52,24,3,20,8,False
8951228,777,3,-1,9784,905135745,1,1,0,645.93,4,853881.52,14,4,8,8,True
8985135,1152,0,25,9693,905135745,1,0,0,646.17,8,853235.35,15,4,16,8,True
9444819,777,3,451,3851,905135745,1,0,0,645.99,7,852589.36,14,2,23,8,True
9463445,1463,2,30,5445,905135745,1,0,0,646.08,8,851943.28,11,5,8,9,True
9699938,1132,0,451,9676,905135745,1,0,0,646.2,7,851297.08,24,0,10,9,True
9718052,1152,0,25,3941,905135745,1,0,0,645.78,8,850651.3,15,1,3,10,False
9876864,1124,0,-1,2227,905135745,1,1,0,645.97,4,850651.3,24,4,6,10,True
9996902,579,0,10,1840,905135745,1,0,0,646.14,6,851297.44,11,5,17,11,True
1063553,1403,4,25,6112,279084331,1,0,0,604.01,8,282149.99,24,1,18,3,True
1261688,751,4,25,8130,279084331,1,0,0,603.9,8,281546.09,24,0,6,4,True
1338818,751,4,30,3389,279084331,1,0,0,603.89,8,280942.2,24,0,9,4,True
1629759,1007,2,20,4582,279084331,1,0,0,604.0,5,280338.2,26,4,22,5,True
1792220,1482,3,30,8352,279084331,1,0,0,604.07,8,279734.13,24,2,10,6,True
1949647,751,4,25,1582,279084331,1,0,0,604.25,8,279129.88,24,5,14,12,True
1971371,31,3,30,1358,279084331,1,0,0,603.67,8,278526.21,11,3,8,12,False
2072654,780,0,-1,4582,279084331,1,1,0,603.99,1,278526.21,14,6,3,1,True
2428510,1403,4,25,4582,279084331,1,0,0,603.89,8,277922.32,24,5,16,3,True
2513705,42,2,20,5887,279084331,1,0,0,604.04,3,277318.28,24,6,23,5,True
2532699,1403,4,25,8352,279084331,1,0,0,604.43,8,276713.85,24,2,1,6,True
2622012,1482,3,25,8130,279084331,1,0,0,603.8,8,276110.05,24,1,3,6,True
2715605,1232,1,25,4820,279084331,1,0,0,603.86,8,275506.19,18,0,11,7,True
2723815,883,0,10,7879,279084331,1,0,0,603.97,6,276110.16,24,3,2,8,True
2916248,1403,4,451,8352,279084331,1,0,0,604.01,7,275506.15,24,6,10,9,True
2942107,31,3,451,6691,279084331,1,0,0,604.26,7,274901.89,11,4,18,9,True
2979199,1052,0,10,1290,279084331,1,0,0,603.88,6,275505.77,11,3,2,11,True
3009173,780,0,451,1940,279084331,1,0,0,603.87,7,274901.9,14,5,12,12,True
3236005,1144,2,-1,2121,279084331,1,1,0,603.87,1,274901.9,15,6,15,1,True
3510428,1297,0,20,5753,279084331,1,0,0,604.02,5,274297.88,5,0,15,4,True
3635575,1232,1,451,6003,279084331,1,0,0,603.97,7,273693.91,18,4,0,5,True
3637802,751,4,451,6691,279084331,1,0,0,604.02,7,273089.89,24,4,15,5,True
3642183,1482,3,-1,6691,279084331,1,1,0,604.21,1,273089.89,24,0,13,7,True
3727193,1403,4,-1,7879,279084331,1,2,0,604.07,4,273089.89,24,2,8,8,False
4348755,1482,3,-1,7303,279084331,1,3,1,603.75,4,273089.89,24,3,5,11,True
1016239,110,4,451,7214,714467275,0,0,0,166.07,7,82639.93,3,6,3,1,True
1221982,77,4,25,6055,714467275,0,0,0,166.21,8,82473.72,1,6,18,4,True
1445268,77,4,30,6641,714467275,0,0,0,166.03,8,82307.69,1,4,11,4,False
1580754,649,0,25,7106,714467275,0,0,0,165.95,8,82141.74,24,6,18,5,True
2031450,550,0,20,7117,714467275,0,0,0,166.16,5,81975.58,17,0,14,5,True
2240893,159,2,20,7117,714467275,0,0,0,166.16,5,81809.42,24,0,5,5,True
2476362,649,0,25,1323,714467275,0,0,0,165.85,8,81643.57,24,2,20,5,True
2521113,961,4,25,7214,714467275,0,0,0,166.11,8,81477.46,13,4,22,6,True
2724320,649,0,451,5173,714467275,0,0,0,166.07,7,81311.39,24,3,12,6,True
2794162,961,4,-1,6641,714467275,0,1,0,165.7,4,81311.39,13,4,9,7,True
2918919,649,0,25,1432,714467275,0,0,0,165.99,8,81145.4,24,4,21,7,True
3285242,77,4,451,6178,714467275,0,0,0,166.37,7,80979.03,1,0,1,8,True
3374146,961,4,-1,6970,714467275,0,1,0,165.86,4,80979.03,13,3,4,8,True
3474863,1210,0,20,8275,714467275,0,0,0,165.89,5,80813.14,24,5,10,8,True
3773513,961,4,25,3945,714467275,0,0,0,166.08,8,80647.06,13,6,9,8,True
3792132,385,1,451,7214,714467275,0,0,0,165.95,7,80481.11,25,4,14,9,True
3977276,385,1,30,9605,714467275,0,0,0,166.07,8,80315.04,25,6,23,10,True
4013824,714,2,20,9034,714467275,0,0,0,166.16,5,80148.88,18,0,13,11,True
4014102,502,0,20,6178,714467275,0,0,0,165.99,5,79982.89,12,2,23,1,True
4022099,110,4,-1,8198,714467275,0,1,0,165.57,4,79982.89,3,3,4,2,True
4157300,77,4,30,6641,714467275,0,0,0,166.1,8,79816.79,1,3,14,2,True
4222756,445,0,20,9668,714467275,0,0,0,166.23,3,79650.56,13,3,3,3,True
4298217,77,4,25,8275,714467275,0,0,0,166.05,8,79484.51,1,5,4,3,True
4732662,110,4,451,8483,714467275,0,0,0,165.9,7,79318.61,3,6,18,3,False
4842713,1300,4,30,1568,714467275,0,0,0,165.89,8,79152.72,5,1,3,3,True
4963047,1300,4,30,8198,714467275,0,0,0,165.8,8,78986.92,5,6,1,4,True
5094853,1300,4,451,5173,714467275,0,0,0,165.95,7,78820.97,5,4,9,4,True
5112579,649,0,-1,3827,714467275,0,1,0,166.03,4,78820.97,24,3,1,4,True
5380187,77,4,30,1684,714467275,0,0,0,166.12,8,78654.85,1,1,16,5,True
5402135,1300,4,30,3827,714467275,0,0,0,166.2,8,78488.65,5,4,8,6,True
5405555,882,0,20,1432,714467275,0,0,0,166.05,3,78322.6,27,0,12,6,True
5429649,649,0,-1,6609,714467275,0,1,0,166.0,4,78322.6,24,4,6,7,True
5532545,448,0,10,6641,714467275,0,0,0,166.03,6,78488.63,13,4,15,9,True
5594017,649,0,-1,1684,714467275,0,1,0,166.01,1,78488.63,24,2,17,9,True
5769797,77,4,25,3945,714467275,0,0,0,165.8,8,78322.83,1,5,21,9,True
5839789,961,4,451,6368,714467275,0,0,0,165.98,7,78156.85,13,6,7,10,True
5863404,443,2,20,5173,714467275,0,0,0,165.84,5,77991.01,24,1,23,10,True
5921964,77,4,-1,8288,714467275,0,1,0,166.03,4,77991.01,1,5,17,10,True
5961433,385,1,25,8483,714467275,0,0,0,166.05,8,77824.96,25,5,23,10,True
6179835,996,0,10,7214,714467275,0,0,0,166.03,6,77990.99,26,2,8,11,True
6185735,77,4,25,8275,714467275,0,0,0,165.9,8,77825.09,1,4,9,11,True
6399673,551,0,10,9605,714467275,0,0,0,165.89,6,77990.98,17,6,2,11,True
6409864,587,2,20,3945,714467275,0,0,0,165.88,5,77825.1,24,4,15,11,True
6488062,961,4,451,6970,714467275,0,0,0,165.9,7,77659.2,13,5,15,12,True
7164863,77,4,30,6641,714467275,0,0,0,165.99,8,77493.21,1,1,17,12,True
7503263,1474,0,10,6368,714467275,0,0,0,165.67,6,77658.88,24,2,12,12,True
7518978,77,4,30,3776,714467275,0,0,0,166.09,8,77492.79,1,5,19,1,True
7691546,385,1,451,9668,714467275,0,0,0,165.95,7,77326.84,25,0,19,2,True
8101468,77,4,30,6609,714467275,0,0,0,166.08,8,77160.76,1,4,22,3,True
8355128,961,4,25,6609,714467275,0,0,0,166.02,8,76994.74,13,4,12,4,True
8908961,649,0,25,3827,714467275,0,0,0,165.98,8,76828.76,24,3,19,5,True
8954755,716,0,10,8743,714467275,0,0,0,165.91,0,76994.67,18,5,20,6,True
9361750,1300,4,25,8288,714467275,0,0,0,165.88,8,76828.79,5,3,18,6,True
9362877,752,0,10,7214,714467275,0,0,0,166.06,0,76994.85,24,2,23,7,True
9579073,1068,2,20,5173,714467275,0,0,0,166.12,3,76828.73,18,6,6,7,True
9622587,110,4,451,9862,714467275,0,0,0,166.0,7,76662.73,3,0,16,7,True
9707847,77,4,25,7117,714467275,0,0,0,165.8,8,76496.93,1,4,22,9,True
9753140,342,0,20,1432,714467275,0,0,0,166.22,5,76330.71,24,4,21,10,True
1365861,701,2,451,2558,467548052,0,0,0,198.81,7,109838.19,18,5,21,2,True
1399682,989,1,25,1015,467548052,0,0,0,199.01,8,109639.18,22,4,22,3,True
1526534,1142,2,451,3354,467548052,0,0,0,198.59,7,109440.59,15,5,7,4,True
1592557,1205,0,20,1758,467548052,0,0,0,198.92,5,109241.67,24,5,12,4,True
1788954,701,2,25,1497,467548052,0,0,0,198.9,8,109042.77,18,5,8,4,True
1829830,701,2,30,3450,467548052,0,0,0,199.1,8,108843.67,18,2,22,6,True
1896472,759,0,10,4747,467548052,0,0,0,199.06,6,109042.73,24,6,21,7,True
1971853,989,1,-1,3450,467548052,0,1,0,199.07,4,109042.73,22,3,22,7,True
1976031,403,0,20,3922,467548052,0,0,0,199.18,5,108843.55,10,4,9,7,True
2070601,1255,0,25,1497,467548052,0,0,0,199.09,8,108644.46,23,3,13,8,True
2235418,701,2,-1,1455,467548052,0,1,0,198.92,1,108644.46,18,6,23,9,True
2285641,1142,2,-1,3450,467548052,0,2,0,198.87,4,108644.46,15,0,9,9,True
2367550,635,2,20,9370,467548052,0,0,0,198.85,5,108445.61,24,0,15,9,True
2675183,1255,0,-1,2785,467548052,0,1,0,199.12,4,108445.61,23,5,20,10,True
2738645,373,1,10,1243,467548052,0,0,0,199.13,0,108644.74,25,6,6,10,True
3567125,1142,2,30,3450,467548052,0,0,0,199.06,8,108445.68,15,1,21,10,True
3645466,1429,0,10,1564,467548052,0,0,0,199.07,6,108644.75,24,0,22,10,True
3904060,1390,0,25,6625,467548052,0,0,0,199.04,8,108445.71,24,2,4,11,True
3989522,1142,2,-1,2779,467548052,0,1,0,199.03,1,108445.71,15,0,10,1,True
4072734,913,0,20,6625,467548052,0,0,0,198.82,5,108246.89,18,0,9,1,True
4282753,701,2,30,2558,467548052,0,0,0,199.22,8,108047.67,18,0,16,1,True
4354803,1436,0,20,1758,467548052,0,0,0,198.99,5,107848.68,24,2,17,1,True
4514410,314,0,30,3354,467548052,0,0,0,199.17,8,107649.51,4,3,14,1,True
4652120,757,0,451,3354,467548052,0,0,0,199.08,7,107450.43,24,3,2,2,False
4673822,701,2,451,1243,467548052,0,0,0,198.78,7,107251.65,18,3,1,3,True
4699245,1356,2,20,1455,467548052,0,0,0,199.11,5,107052.54,24,3,19,4,True
5216328,1307,0,20,8019,467548052,0,0,0,198.91,3,106853.63,5,0,22,5,True
5266164,816,0,10,8019,467548052,0,0,0,199.0,6,107052.63,18,1,1,5,True
5496725,191,3,451,7446,467548052,0,0,0,199.12,7,106853.51,18,2,15,5,True
5657921,989,1,451,6448,467548052,0,0,0,198.96,7,106654.55,22,5,9,6,True
5736620,42,2,20,3450,467548052,0,0,0,198.88,3,106455.67,24,2,19,6,False
5951407,989,1,451,7510,467548052,0,0,0,198.92,7,106256.75,22,4,21,7,True
6211754,757,0,-1,9024,467548052,0,1,0,198.73,4,106256.75,24,6,12,8,True
6348693,424,1,10,7365,467548052,0,0,0,199.04,0,106455.79,18,5,21,8,True
6528826,627,0,10,1243,467548052,0,0,0,198.76,6,106654.55,11,3,22,8,True
6596845,1105,2,20,1497,467548052,0,0,0,199.05,5,106455.5,0,3,17,8,True
6642143,314,0,-1,9370,467548052,0,1,0,199.08,4,106455.5,4,3,1,9,True
6645212,757,0,30,6448,467548052,0,0,0,198.84,8,106256.66,24,3,20,9,True
6811599,989,1,25,4747,467548052,0,0,0,199.15,8,106057.51,22,5,15,9,True
6910253,664,2,25,9753,467548052,0,0,0,199.11,8,105858.4,18,5,19,12,True
7021952,757,0,451,6073,467548052,0,0,0,198.89,7,105659.51,24,3,0,1,True
7614929,191,3,25,2558,467548052,0,0,0,199.0,8,105460.51,18,0,6,1,True
7709411,701,2,-1,3450,467548052,0,1,0,198.9,4,105460.51,18,1,7,1,True
7768085,327,0,10,6625,467548052,0,0,0,198.91,6,105659.42,11,2,21,1,True
7974465,1142,2,25,9024,467548052,0,0,0,198.75,8,105460.67,15,1,23,3,True
8009872,917,0,20,1015,467548052,0,0,0,198.98,3,105261.69,18,0,20,4,True
8417642,1246,0,20,2785,467548052,0,0,0,198.89,5,105062.8,23,2,2,4,True
8538282,1142,2,25,6625,467548052,0,0,0,198.99,8,104863.81,15,3,18,4,True
8615999,1390,0,451,6625,467548052,0,0,0,199.0,7,104664.81,24,5,9,4,False
8652263,1255,0,30,7446,467548052,0,0,0,198.93,8,104465.88,23,0,5,4,True
9073681,644,0,10,1758,467548052,0,0,0,198.77,6,104664.65,24,5,19,5,True
9196585,314,0,30,1455,467548052,0,0,0,199.11,8,104465.54,4,1,3,7,True
9290467,664,2,30,9370,467548052,0,0,0,199.34,8,104266.2,18,3,8,7,True
9306832,1142,2,25,3450,467548052,0,0,0,199.33,8,104066.87,15,2,3,7,True
9891708,191,3,451,3450,467548052,0,0,0,198.82,7,103868.05,18,5,1,8,True
9949671,1115,1,10,7365,467548052,0,0,0,199.1,6,104067.15,0,6,6,8,True
1283573,1345,2,-1,8314,319835686,0,1,0,454.84,4,427362.0,24,5,21,1,True
1307939,971,4,30,7330,319835686,0,0,0,455.48,8,426906.52,13,2,10,2,True
1539199,971,4,25,7330,319835686,0,0,0,455.16,8,426451.36,13,3,20,2,True
1597511,1345,2,451,5471,319835686,0,0,0,455.27,7,425996.09,24,1,19,3,True
1907123,931,0,30,3698,319835686,0,0,0,455.06,8,425541.03,24,2,7,3,True
1952302,1413,0,20,7701,319835686,0,0,0,454.95,5,425086.08,24,3,10,5,True
1975381,783,0,20,8096,319835686,0,0,0,454.88,5,424631.2,14,3,8,6,True
2142982,457,0,10,5359,319835686,0,0,0,455.19,6,425086.39,13,2,5,7,True
2242381,790,0,20,1564,319835686,0,0,0,455.12,5,424631.27,11,5,6,8,True
2328909,687,0,10,3546,319835686,0,0,0,455.07,0,425086.34,24,4,19,8,False
2548716,1179,0,20,8608,319835686,0,0,0,455.01,3,424631.33,24,6,10,11,True
2577498,971,4,451,3546,319835686,0,0,0,455.01,7,424176.32,13,2,2,12,True
2656057,1175,2,451,8684,319835686,0,0,0,455.05,7,423721.27,24,0,11,12,True
2688370,484,0,20,8684,319835686,0,0,0,454.86,5,423266.41,5,0,13,12,True
3072622,1345,2,451,3698,319835686,0,0,0,455.18,7,422811.23,24,0,12,1,True
3325745,1345,2,25,7330,319835686,0,0,0,454.77,8,422356.46,24,0,17,1,True
3463624,670,0,20,6770,319835686,0,0,0,454.78,3,421901.68,18,1,13,1,True
3553688,1047,3,-1,1564,319835686,0,1,0,454.7,4,421901.68,11,1,9,1,True
3816890,1160,0,10,7007,319835686,0,0,0,454.9,6,422356.58,15,3,15,2,True
4038925,971,4,30,6770,319835686,0,0,0,454.98,8,421901.6,13,5,0,2,True
4058913,1047,3,25,8798,319835686,0,0,0,454.92,8,421446.68,11,0,6,2,True
4138054,1175,2,30,8194,319835686,0,0,0,455.06,8,420991.62,24,6,14,4,True
4515393,255,2,20,7701,319835686,0,0,0,454.77,5,420536.85,6,1,7,4,True
4702004,1264,0,10,7330,319835686,0,0,0,454.97,6,420991.82,23,1,21,4,True
4776866,1175,2,25,2131,319835686,0,0,0,455.12,8,420536.7,24,5,15,4,False
4804010,1047,3,30,8314,319835686,0,0,0,455.39,8,420081.31,11,5,17,4,True
4841877,971,4,451,8798,319835686,0,0,0,455.14,7,419626.17,13,5,3,4,True
4955042,1150,0,10,7939,319835686,0,0,0,455.26,6,420081.43,15,6,3,4,True
5170398,1047,3,25,8314,319835686,0,0,0,455.11,8,419626.32,11,4,7,5,True
5173967,931,0,-1,8608,319835686,0,1,0,454.92,4,419626.32,24,6,4,5,True
5582080,1271,0,20,7939,319835686,0,0,0,454.9,5,419171.42,23,6,6,6,True
5795179,1175,2,30,7701,319835686,0,0,0,454.81,8,418716.61,24,4,19,6,True
5866629,457,0,20,2576,319835686,0,0,0,455.15,3,418261.46,13,5,18,7,True
5907937,931,0,25,3698,319835686,0,0,0,455.07,8,417806.39,24,4,17,8,True
5969797,799,2,20,4908,319835686,0,0,0,454.87,5,417351.52,11,3,19,8,True
6070277,1246,0,10,8684,319835686,0,0,0,455.03,6,417806.55,23,4,5,11,True
6156996,503,0,20,8194,319835686,0,0,0,455.16,5,417351.39,12,0,1,11,True
6499782,966,4,451,3698,319835686,0,0,0,454.93,7,416896.46,13,3,23,11,True
6640289,1175,2,25,5471,319835686,0,0,0,454.69,8,416441.77,24,5,4,12,True
6777680,1459,1,10,4499,319835686,0,0,0,454.96,6,416896.73,11,4,11,12,True
6811702,577,0,20,7004,319835686,0,0,0,454.83,5,416441.9,11,5,21,1,True
6923712,644,0,20,7939,319835686,0,0,0,455.07,3,415986.83,24,1,10,2,True
7021747,1345,2,-1,5315,319835686,0,1,0,454.99,1,415986.83,24,2,20,4,True
7152297,971,4,30,5471,319835686,0,0,0,454.98,8,415531.85,13,1,15,5,True
7793821,1175,2,30,8872,319835686,0,0,0,455.06,8,415076.79,24,4,1,5,True
7853981,931,0,451,1564,319835686,0,0,0,454.92,7,414621.87,24,1,6,6,True
8444513,971,4,30,2131,319835686,0,0,0,454.99,8,414166.88,13,6,6,8,True
8471808,1345,2,30,8314,319835686,0,0,0,455.11,8,413711.77,24,1,14,8,True
8566280,971,4,25,8608,319835686,0,0,0,455.11,8,413256.66,13,4,17,8,False
8947610,1175,2,-1,2576,319835686,0,1,0,454.96,4,413256.66,24,4,15,9,True
9315069,939,0,10,2838,319835686,0,0,0,454.8,0,413711.46,24,2,5,10,True
9486124,966,4,451,5315,319835686,0,0,0,454.71,7,413256.75,13,0,0,10,True
9811537,1175,2,451,7939,319835686,0,0,0,454.91,7,412801.84,24,5,16,11,True
1023464,1088,4,-1,7963,399634036,1,1,0,197.84,1,95321.0,18,6,8,1,True
1108196,350,0,25,3168,399634036,1,0,0,198.04,8,95122.96,24,3,21,3,True
1219981,1088,4,451,8074,399634036,1,0,0,198.05,7,94924.91,18,4,18,3,True
1237678,1088,4,451,8052,399634036,1,0,0,197.86,7,94727.05,18,1,10,3,True
1443636,1153,3,451,1554,399634036,1,0,0,197.94,7,94529.11,15,0,12,3,False
1552046,314,0,20,3168,399634036,1,0,0,197.97,3,94331.14,4,0,16,4,True
1913152,350,0,451,6249,399634036,1,0,0,198.0,7,94133.14,24,0,22,4,True
2046045,350,0,25,7038,399634036,1,0,0,197.98,8,93935.16,24,6,16,4,True
2053556,1088,4,25,3238,399634036,1,0,0,198.16,8,93737.0,18,5,5,4,True
2090580,883,0,20,6249,399634036,1,0,0,197.77,3,93539.23,24,4,9,7,True
2769322,919,4,-1,7963,399634036,1,1,0,198.06,4,93539.23,18,2,6,8,True
2917716,350,0,25,7834,399634036,1,0,0,197.83,8,93341.4,24,2,20,8,True
3058036,378,0,10,8052,399634036,1,0,0,198.17,6,93539.57,25,5,9,8,True
3256738,1142,2,451,2933,399634036,1,0,0,197.92,7,93341.65,15,1,10,10,True
3385578,919,4,451,7963,399634036,1,0,0,197.86,7,93143.79,18,3,23,10,True
3548204,159,2,20,3750,399634036,1,0,0,198.15,5,92945.64,24,0,7,10,True
3678500,919,4,451,6213,399634036,1,0,0,197.89,7,92747.75,18,0,16,11,True
3831747,1153,3,25,6249,399634036,1,0,0,197.57,8,92550.18,15,3,18,11,True
4108002,350,0,25,6119,399634036,1,0,0,198.07,8,92352.11,24,3,12,12,True
4139886,1142,2,25,8074,399634036,1,0,0,198.26,8,92153.85,15,5,4,12,True
4324999,916,0,20,7963,399634036,1,0,0,198.07,3,91955.78,18,0,17,12,True
4415115,350,0,30,8201,399634036,1,0,0,197.96,8,91757.82,24,1,5,1,True
4505333,344,3,30,7418,399634036,1,0,0,198.02,8,91559.8,24,2,6,1,True
4553503,787,0,20,6213,399634036,1,0,0,198.08,3,91361.72,14,4,14,1,True
5156565,350,0,-1,6993,399634036,1,1,0,197.98,4,91361.72,24,0,18,2,True
5182695,344,3,25,8201,399634036,1,0,0,197.8,8,91163.92,24,4,3,2,True
5240764,98,0,20,4344,399634036,1,0,0,197.87,5,90966.05,3,3,20,3,True
5377244,350,0,-1,4344,399634036,1,1,0,197.9,4,90966.05,24,1,12,3,True
5721764,576,2,20,7038,399634036,1,0,0,197.65,5,90768.4,11,4,15,5,True
6251801,350,0,451,4344,399634036,1,0,0,198.04,7,90570.36,24,1,0,5,True
6284078,679,0,10,3508,399634036,1,0,0,197.84,6,90768.2,24,3,19,5,True
6560812,350,0,-1,4344,399634036,1,1,0,198.0,4,90768.2,24,6,9,6,True
6880638,344,3,25,7038,399634036,1,0,0,197.92,8,90570.28,24,2,22,6,True
7042541,919,4,451,8074,399634036,1,0,0,198.16,7,90372.12,18,4,18,7,True
7144009,303,0,20,6993,399634036,1,0,0,198.02,3,90174.1,4,4,12,8,True
7228286,1088,4,30,6119,399634036,1,0,0,198.1,8,89976.0,18,6,9,10,True
7364735,913,0,10,9827,399634036,1,0,0,198.23,6,90174.23,18,2,2,11,True
7725552,1153,3,451,8201,399634036,1,0,0,197.86,7,89976.37,15,2,12,11,True
7894017,1015,0,10,7038,399634036,1,0,0,197.85,0,90174.22,26,1,21,12,True
7909336,1153,3,451,3773,399634036,1,0,0,197.91,7,89976.31,15,5,6,3,True
8084751,1153,3,25,7963,399634036,1,0,0,197.96,8,89778.35,15,0,18,4,True
8113470,350,0,30,6993,399634036,1,0,0,197.92,8,89580.43,24,6,14,4,True
8141313,1153,3,25,3238,399634036,1,0,0,198.11,8,89382.32,15,6,19,4,True
8187810,1088,4,25,3773,399634036,1,0,0,198.29,8,89184.03,18,4,10,5,True
8381282,919,4,-1,9827,399634036,1,1,0,198.04,4,89184.03,18,0,5,5,False
8506376,344,3,451,2933,399634036,1,0,0,197.9,7,88986.13,24,0,3,5,True
8510250,1110,0,10,7834,399634036,1,0,0,198.2,6,89184.33,0,3,5,5,True
8586041,1094,0,10,4344,399634036,1,0,0,197.88,6,89382.21,0,6,4,7,True
9240070,484,0,20,3773,399634036,1,0,0,197.98,5,89184.23,5,0,7,7,True
9332179,937,0,20,5445,399634036,1,0,0,198.03,5,88986.2,24,3,9,8,True
9584118,1142,2,30,6119,399634036,1,0,0,198.06,8,88788.14,15,1,21,8,True
9592889,1153,3,-1,3238,399634036,1,1,0,198.14,4,88788.14,15,3,14,9,False
9830437,350,0,25,4362,399634036,1,0,0,197.77,8,88590.37,24,6,22,9,True
1259091,1137,1,25,8310,486166303,1,0,0,657.91,8,338962.09,24,1,4,2,True
1359755,877,2,20,8310,486166303,1,0,0,657.75,3,338304.34,24,4,21,2,True
1415727,504,4,451,1483,486166303,1,0,0,657.91,7,337646.43,12,2,22,2,True
1492380,765,4,-1,5398,486166303,1,1,0,657.91,4,337646.43,14,4,10,4,True
1533971,504,4,451,4026,486166303,1,0,0,658.33,7,336988.1,12,4,0,4,True
1701752,838,4,30,9219,486166303,1,0,0,657.93,8,336330.17,5,1,7,5,True
1775694,1125,1,10,7126,486166303,1,0,0,658.01,0,336988.18,24,3,23,5,True
2118584,299,1,10,8042,486166303,1,0,0,657.99,0,337646.17,4,6,23,6,True
2261057,504,4,451,6148,486166303,1,0,0,658.05,7,336988.12,12,4,4,7,True
2355403,1421,0,20,9270,486166303,1,0,0,658.02,5,336330.1,24,3,20,7,True
2374587,838,4,451,3938,486166303,1,0,0,658.06,7,335672.04,5,0,11,7,True
2631748,117,1,451,9449,486166303,1,0,0,658.11,7,335013.93,18,2,7,8,True
3135000,163,4,451,3938,486166303,1,0,0,658.1,7,334355.83,24,2,23,8,True
3376110,504,4,-1,9219,486166303,1,1,0,658.21,4,334355.83,12,1,11,8,True
3825805,838,4,30,4026,486166303,1,0,0,658.13,8,333697.7,5,0,10,9,True
3875791,1318,0,20,5822,486166303,1,0,0,657.9,5,333039.8,18,4,9,10,True
3930005,535,0,20,9856,486166303,1,0,0,657.94,5,332381.86,18,3,8,11,True
3973808,504,4,451,9219,486166303,1,0,0,657.84,7,331724.02,12,4,16,11,True
4233896,1052,0,451,7126,486166303,1,0,0,657.88,7,331066.14,11,2,23,11,True
4253132,163,4,-1,1483,486166303,1,1,0,658.16,4,331066.14,24,4,0,12,True
4466227,838,4,451,8310,486166303,1,0,0,658.06,7,330408.08,5,5,1,12,True
4538727,765,4,-1,5822,486166303,1,1,0,657.78,4,330408.08,14,2,6,12,True
4889221,163,4,-1,5822,486166303,1,2,0,658.27,4,330408.08,24,3,3,12,True
5162801,1052,0,451,1483,486166303,1,0,0,658.21,7,329749.87,11,1,14,1,True
5308069,838,4,25,5822,486166303,1,0,0,658.02,8,329091.85,5,3,2,2,True
5373528,838,4,-1,7126,486166303,1,1,0,658.17,4,329091.85,5,1,14,2,True
5411935,117,1,30,5166,486166303,1,0,0,657.83,8,328434.02,18,4,1,3,True
5466707,1305,2,20,5166,486166303,1,0,0,657.71,5,327776.31,5,0,9,3,True
5678465,765,4,30,8042,486166303,1,0,0,657.77,8,327118.54,14,0,16,3,True
5691395,889,0,20,1483,486166303,1,0,0,657.93,3,326460.61,27,1,9,3,True
5894564,1052,0,-1,3938,486166303,1,1,0,657.85,4,326460.61,11,6,8,5,True
6102184,429,0,20,4759,486166303,1,0,0,658.14,5,325802.47,24,1,4,6,True
6203526,117,1,30,3401,486166303,1,0,0,657.77,8,325144.7,18,5,6,7,True
6293968,117,1,451,8310,486166303,1,0,0,658.15,7,324486.55,18,3,4,7,True
6335421,163,4,25,1344,486166303,1,0,0,657.81,8,323828.74,24,0,11,8,True
6485264,1015,0,20,3401,486166303,1,0,0,657.82,5,323170.92,26,1,11,8,True
6926854,1210,0,20,5398,486166303,1,0,0,658.09,5,322512.83,24,0,7,9,True
6935584,117,1,451,8042,486166303,1,0,0,657.81,7,321855.02,18,1,7,9,True
6951506,752,0,10,9219,486166303,1,0,0,657.95,0,322512.97,24,4,7,11,True
7477057,838,4,-1,6759,486166303,1,1,0,658.19,4,322512.97,5,3,9,11,True
7731683,765,4,30,1483,486166303,1,0,0,657.77,8,321855.2,14,0,17,1,True
8140482,1217,0,10,3493,486166303,1,0,0,658.04,6,322513.24,24,3,13,2,True
8234657,765,4,30,3206,486166303,1,0,0,658.11,8,321855.13,14,0,16,2,True
8295124,838,4,-1,7592,486166303,1,1,0,657.9,4,321855.13,5,4,14,3,True
8306906,163,4,30,6759,486166303,1,0,0,658.25,8,321196.88,24,3,1,3,True
8431369,117,1,25,3581,486166303,1,0,0,657.93,8,320538.95,18,0,20,4,True
8544620,765,4,25,7126,486166303,1,0,0,657.83,8,319881.12,14,6,14,4,True
8994132,584,0,10,1483,486166303,1,0,0,658.17,6,320539.29,11,2,3,5,True
9131527,1315,0,20,6148,486166303,1,0,0,657.89,5,319881.4,5,0,20,5,True
9198586,594,0,20,6896,486166303,1,0,0,658.03,3,319223.37,24,1,11,6,True
9246822,1175,2,20,9856,486166303,1,0,0,657.88,5,318565.49,24,3,7,6,True
9270346,842,2,20,3493,486166303,1,0,0,658.23,5,317907.26,5,3,13,6,True
9309296,117,1,-1,9219,486166303,1,1,0,657.89,1,317907.26,18,3,0,7,True
9374518,838,4,25,7592,486166303,1,0,0,658.28,8,317248.98,5,4,8,8,True
9448091,838,4,30,4759,486166303,1,0,0,658.2,8,316590.78,5,4,13,8,True
9594920,504,4,451,6896,486166303,1,0,0,657.81,7,315932.97,12,5,3,9,True
9644671,504,4,25,3938,486166303,1,0,0,658.01,8,315274.96,12,3,13,10,True
9667433,914,2,20,7592,486166303,1,0,0,657.78,3,314617.18,18,0,16,11,False
1018578,1451,1,-1,2233,164812928,1,1,0,118.81,4,790197.0,11,1,5,1,True
1144666,804,0,451,3941,164812928,1,0,0,119.21,7,790077.79,11,3,17,1,True
1161730,804,0,30,9929,164812928,1,0,0,119.09,8,789958.7,11,3,15,2,True
1461023,804,0,451,5408,164812928,1,0,0,118.59,7,789840.11,11,3,23,2,True
2418112,1098,4,25,4243,164812928,1,0,0,119.12,8,789720.99,0,6,14,2,True
2569361,677,0,10,4166,164812928,1,0,0,119.1,6,789840.09,24,1,0,3,True
2802174,787,0,10,8588,164812928,1,0,0,118.91,0,789959.0,14,3,0,3,True
3153115,429,0,25,4243,164812928,1,0,0,119.02,8,789839.98,24,4,10,4,True
3180984,424,1,451,1334,164812928,1,0,0,119.13,7,789720.85,18,0,16,4,True
3199196,429,0,30,4023,164812928,1,0,0,119.02,8,789601.83,24,3,5,5,True
3568171,804,0,-1,8684,164812928,1,1,0,118.83,4,789601.83,11,5,19,5,True
3585280,1000,0,10,1334,164812928,1,0,0,118.87,6,789720.7,26,1,0,6,True
3859616,645,0,20,5531,164812928,1,0,0,118.94,5,789601.76,24,1,5,6,True
3893620,1380,0,10,5408,164812928,1,0,0,119.01,0,789720.77,16,2,13,6,True
3987135,429,0,451,3667,164812928,1,0,0,119.17,7,789601.6,24,1,11,7,True
4078722,429,0,451,7211,164812928,1,0,0,119.09,7,789482.51,24,5,14,7,True
4101879,424,1,-1,7372,164812928,1,1,0,119.16,1,789482.51,18,2,8,8,True
4116952,1098,4,-1,6403,164812928,1,2,0,118.87,4,789482.51,0,5,13,9,True
4260194,1451,1,30,8588,164812928,1,0,0,118.99,8,789363.52,11,2,14,9,True
4404266,557,1,10,3089,164812928,1,0,0,119.15,6,789482.67,17,0,1,10,True
4461145,1090,0,-1,6186,164812928,1,1,0,118.85,4,789482.67,18,1,10,10,True
4566110,1090,0,-1,9929,164812928,1,2,0,118.97,1,789482.67,18,5,19,11,True
4884327,804,0,451,9929,164812928,1,0,0,118.88,7,789363.79,11,6,7,11,True
4949393,580,0,10,8748,164812928,1,0,0,118.83,6,789482.62,11,6,17,1,True
5004477,1098,4,451,2394,164812928,1,0,0,119.19,7,789363.43,0,5,5,1,True
5068786,564,0,451,3890,164812928,1,0,0,118.91,7,789244.52,17,2,22,2,True
5320068,429,0,30,8748,164812928,1,0,0,119.13,8,789125.39,24,2,1,3,True
5433707,1451,1,25,2394,164812928,1,0,0,118.78,8,789006.61,11,0,17,3,True
5475158,882,0,10,4166,164812928,1,0,0,118.88,6,789125.49,27,0,23,4,True
5479407,429,0,-1,8570,164812928,1,1,0,119.07,1,789125.49,24,4,12,4,True
5618927,266,2,20,1334,164812928,1,0,0,118.58,5,789006.91,6,3,13,5,True
6085623,424,1,25,3089,164812928,1,0,0,119.1,8,788887.81,18,5,0,6,True
6240644,318,0,10,6247,164812928,1,0,0,118.88,6,789006.69,11,2,23,6,True
6339765,429,0,25,8748,164812928,1,0,0,118.98,8,788887.71,24,5,9,7,True
6359668,183,1,10,8748,164812928,1,0,0,119.27,6,789006.98,18,2,13,8,True
6480624,1098,4,25,3941,164812928,1,0,0,118.81,8,788888.17,0,0,5,8,True
6629731,424,1,30,8748,164812928,1,0,0,119.1,8,788769.07,18,6,15,8,True
6819917,1090,0,30,8588,164812928,1,0,0,119.13,8,788649.94,18,0,7,9,True
7053579,429,0,25,4023,164812928,1,0,0,118.67,8,788531.27,24,1,4,11,True
7157700,1451,1,451,5531,164812928,1,0,0,118.93,7,788412.34,11,0,0,1,True
7215890,1090,0,25,4243,164812928,1,0,0,118.85,8,788293.49,18,1,0,2,True
7468113,1451,1,-1,2883,164812928,1,1,0,119.06,4,788293.49,11,6,12,2,True
7527552,761,2,20,5953,164812928,1,0,0,118.61,3,788174.88,24,2,1,2,True
7548943,1451,1,25,1399,164812928,1,0,0,119.17,8,788055.71,11,2,1,3,True
7554819,804,0,451,4166,164812928,1,0,0,118.96,7,787936.75,11,2,22,4,True
7793379,1098,4,25,2233,164812928,1,0,0,118.87,8,787817.88,0,6,1,5,True
7798573,804,0,451,9960,164812928,1,0,0,119.13,7,787698.75,11,0,2,5,True
7853264,1401,1,10,7315,164812928,1,0,0,118.89,6,787817.64,24,1,18,6,True
8188070,1419,1,10,7315,164812928,1,0,0,119.31,6,787936.95,24,1,21,6,True
8274174,1319,1,10,3133,164812928,1,0,0,119.26,6,788056.21,18,6,5,7,True
8505794,644,0,20,3941,164812928,1,0,0,118.97,3,787937.24,24,5,6,7,True
8529260,1451,1,451,6186,164812928,1,0,0,118.93,7,787818.31,11,0,4,9,True
8648624,645,0,10,4243,164812928,1,0,0,119.16,6,787937.47,24,5,14,9,True
8802306,1090,0,30,9960,164812928,1,0,0,118.81,8,787818.66,18,0,1,9,True
9101178,1098,4,30,2233,164812928,1,0,0,119.07,8,787699.59,0,0,3,9,True
9104043,1451,1,451,8570,164812928,1,0,0,118.88,7,787580.71,11,4,5,10,True
9245511,804,0,25,4166,164812928,1,0,0,118.88,8,787461.83,11,2,15,10,True
9492907,564,0,30,4166,164812928,1,0,0,119.03,8,787342.8,17,0,23,11,True
9630621,1098,4,30,3890,164812928,1,0,0,118.83,8,787223.97,0,0,4,11,True
1108933,135,2,30,5880,279145349,1,0,0,607.01,8,883849.99,18,5,10,1,True
1259577,255,2,20,1301,279145349,1,0,0,607.08,5,883242.91,6,5,1,2,True
1498204,1271,0,451,6936,279145349,1,0,0,607.25,7,882635.66,23,3,10,2,True
1509857,851,1,-1,1301,279145349,1,1,0,606.97,1,882635.66,5,0,13,3,True
1651564,373,1,30,1719,279145349,1,0,0,607.11,8,882028.55,25,3,16,3,True
1689935,851,1,451,3172,279145349,1,0,0,607.12,7,881421.43,5,6,7,4,True
1749927,1271,0,451,1719,279145349,1,0,0,607.18,7,880814.25,23,3,22,4,True
1850555,551,0,10,2378,279145349,1,0,0,607.18,0,881421.43,17,2,9,5,True
1869782,373,1,25,6015,279145349,1,0,0,606.95,8,880814.48,25,4,21,6,True
2062966,135,2,30,7570,279145349,1,0,0,606.78,8,880207.7,18,0,12,6,True
2166241,1467,0,20,6015,279145349,1,0,0,606.89,3,879600.81,11,5,19,6,True
2437062,325,0,10,2860,279145349,1,0,0,606.81,6,880207.62,11,1,10,7,True
2440585,1271,0,-1,8169,279145349,1,1,0,607.06,1,880207.62,23,5,0,8,True
2512493,373,1,451,6514,279145349,1,0,0,606.91,7,879600.71,25,3,12,8,True
2754146,96,0,30,2860,279145349,1,0,0,607.18,8,878993.53,1,6,4,9,True
2771048,96,0,451,7570,279145349,1,0,0,607.2,7,878386.33,1,3,21,9,True
2786278,544,3,25,4488,279145349,1,0,0,607.17,8,877779.16,17,1,6,10,True
2991593,544,3,25,2378,279145349,1,0,0,606.82,8,877172.34,17,1,23,11,True
3109063,1271,0,451,7938,279145349,1,0,0,606.84,7,876565.5,23,4,6,11,True
3130653,1086,0,10,6354,279145349,1,0,0,606.86,6,877172.36,18,4,16,11,True
3247491,1277,2,20,1301,279145349,1,0,0,606.99,5,876565.37,24,1,10,12,True
3381146,350,0,10,2382,279145349,1,0,0,606.99,6,877172.36,24,5,9,12,True
3396253,96,0,451,2382,279145349,1,0,0,606.99,7,876565.37,1,0,0,1,True
3450045,373,1,30,7554,279145349,1,0,0,606.88,8,875958.49,25,2,2,1,True
3479074,135,2,25,6936,279145349,1,0,0,606.78,8,875351.71,18,3,17,1,True
3654232,577,0,20,1719,279145349,1,0,0,607.07,3,874744.64,11,4,11,3,True
4087446,96,0,25,3172,279145349,1,0,0,607.11,8,874137.53,1,3,10,4,True
4149899,373,1,451,7570,279145349,1,0,0,606.99,7,873530.54,25,2,19,5,False
4350109,1271,0,451,1298,279145349,1,0,0,606.85,7,872923.69,23,0,14,5,True
4371043,1271,0,451,1719,279145349,1,0,0,607.04,7,872316.65,23,4,14,6,False
4678967,373,1,451,5880,279145349,1,0,0,607.04,7,871709.61,25,5,15,6,True
4724933,96,0,451,2382,279145349,1,0,0,607.03,7,871102.58,1,4,16,6,True
5212576,373,1,25,6936,279145349,1,0,0,606.98,8,870495.6,25,0,17,6,False
5222972,459,1,10,6354,279145349,1,0,0,606.95,6,871102.55,13,5,15,8,True
5323305,1271,0,30,8169,279145349,1,0,0,607.16,8,870495.39,23,5,22,8,True
5537823,1401,1,10,1298,279145349,1,0,0,606.77,0,871102.16,24,3,13,8,True
5940132,548,2,20,4847,279145349,1,0,0,606.98,5,870495.18,17,2,7,9,True
6156164,168,0,10,2860,279145349,1,0,0,607.08,6,871102.26,24,6,9,9,True
6226814,851,1,451,1298,279145349,1,0,0,607.07,7,870495.19,5,2,6,9,False
6546458,857,1,10,3172,279145349,1,0,0,607.36,6,871102.55,24,3,13,10,True
6632579,373,1,451,4847,279145349,1,0,0,607.15,7,870495.4,25,0,1,11,True
6674635,373,1,30,5743,279145349,1,0,0,606.81,8,869888.59,25,2,1,11,True
6679161,373,1,25,3172,279145349,1,0,0,606.95,8,869281.64,25,1,4,12,True
6808182,544,3,-1,2378,279145349,1,1,0,606.92,4,869281.64,17,2,13,12,True
6955459,1271,0,451,7938,279145349,1,0,0,607.01,7,868674.63,23,2,17,2,True
7223689,1476,0,20,5743,279145349,1,0,0,607.05,5,868067.58,24,2,21,2,True
7591624,1238,0,20,2378,279145349,1,0,0,607.16,3,867460.42,18,3,17,2,True
7684742,302,1,10,2382,279145349,1,0,0,606.88,0,868067.3,4,0,12,3,True
7851113,135,2,-1,1719,279145349,1,1,0,607.06,4,868067.3,18,0,15,3,True
8119221,544,3,451,5880,279145349,1,0,0,607.03,7,867460.27,17,0,15,4,True
8473347,135,2,451,2378,279145349,1,0,0,607.1,7,866853.17,18,1,21,5,True
8720742,123,0,20,5743,279145349,1,0,0,607.22,3,866245.95,18,1,5,7,True
8951192,373,1,30,6514,279145349,1,0,0,607.13,8,865638.82,25,3,12,7,True
8996860,1112,1,10,3915,279145349,1,0,0,606.9,6,866245.72,0,0,11,7,True
9028101,96,0,30,2860,279145349,1,0,0,606.97,8,865638.75,1,5,0,9,True
9028870,1429,0,20,7938,279145349,1,0,0,606.94,5,865031.81,24,5,1,10,True
9590839,564,0,10,7938,279145349,1,0,0,607.0,0,865638.81,17,2,23,10,True
9809905,1271,0,451,2382,279145349,1,0,0,606.86,7,865031.95,23,1,10,11,False
9860477,851,1,30,6015,279145349,1,0,0,606.96,8,864424.99,5,5,2,11,True
1355503,1001,4,30,8719,474184902,1,0,0,1099.94,8,130314.06,26,5,11,2,True
1597817,869,2,20,4315,474184902,1,0,0,1100.02,5,129214.04,24,2,14,3,True
1610263,227,4,-1,7665,474184902,1,1,0,1099.9,4,129214.04,26,5,13,4,True
1674106,1277,2,20,3119,474184902,1,0,0,1099.84,5,128114.2,24,4,14,4,True
1686233,1001,4,30,1678,474184902,1,0,0,1099.86,8,127014.34,26,1,4,4,True
1711627,163,4,451,5623,474184902,1,0,0,1099.96,7,125914.38,24,1,10,6,True
1769335,531,0,30,4315,474184902,1,0,0,1100.11,8,124814.27,18,0,5,6,True
2114364,1434,0,-1,4666,474184902,1,1,0,1099.85,1,124814.27,24,0,14,7,True
2708891,665,2,20,6062,474184902,1,0,0,1100.25,5,123714.02,18,6,23,7,True
2791660,1434,0,451,7555,474184902,1,0,0,1099.88,7,122614.14,24,0,4,8,True
2921193,1170,0,10,8945,474184902,1,0,0,1100.35,6,123714.49,24,4,11,8,True
3155819,1001,4,-1,7555,474184902,1,1,0,1100.06,4,123714.49,26,5,6,8,True
3426855,372,0,451,1678,474184902,1,0,0,1100.0,7,122614.49,25,3,16,9,True
3529655,644,0,10,3119,474184902,1,0,0,1100.13,0,123714.62,24,5,3,11,True
3573120,372,0,-1,6108,474184902,1,1,0,1099.94,4,123714.62,25,0,11,11,True
3616459,227,4,30,8719,474184902,1,0,0,1100.22,8,122614.4,26,1,15,11,True
3724941,531,0,-1,3119,474184902,1,1,0,1099.9,4,122614.4,18,0,15,12,True
3762949,1001,4,451,7665,474184902,1,0,0,1100.15,7,121514.25,26,4,2,12,True
4105699,227,4,451,4315,474184902,1,0,0,1100.19,7,120414.06,26,6,7,12,True
4200591,812,0,10,7108,474184902,1,0,0,1099.91,6,121513.97,18,3,7,1,True
4208324,531,0,30,1059,474184902,1,0,0,1099.96,8,120414.01,18,1,7,1,True
4227115,1468,1,10,7165,474184902,1,0,0,1099.96,0,121513.97,11,1,17,1,True
4314236,194,1,10,2829,474184902,1,0,0,1099.66,0,122613.63,18,4,15,2,True
4412349,163,4,25,7108,474184902,1,0,0,1100.01,8,121513.62,24,2,0,3,True
4636716,1434,0,451,6062,474184902,1,0,0,1099.96,7,120413.66,24,3,1,3,True
4772002,531,0,451,2486,474184902,1,0,0,1099.97,7,119313.69,18,5,9,4,True
4806931,530,0,10,7165,474184902,1,0,0,1099.99,6,120413.68,18,2,5,4,True
4949903,1436,0,10,8945,474184902,1,0,0,1099.83,0,121513.51,24,3,0,5,True
5009008,372,0,-1,1678,474184902,1,1,0,1099.66,4,121513.51,25,6,11,5,True
5036039,227,4,30,1678,474184902,1,0,0,1100.12,8,120413.39,26,0,14,5,True
5226880,365,0,20,6062,474184902,1,0,0,1100.18,3,119313.21,25,6,23,6,True
5591415,163,4,451,9839,474184902,1,0,0,1099.95,7,118213.26,24,0,23,7,True
5770148,372,0,30,8144,474184902,1,0,0,1100.05,8,117113.21,25,3,1,7,True
6064188,163,4,-1,1678,474184902,1,1,0,1099.88,4,117113.21,24,4,2,7,True
6834426,752,0,20,9839,474184902,1,0,0,1099.92,3,116013.29,24,6,23,9,True
6850600,551,0,10,7124,474184902,1,0,0,1099.88,0,117113.17,17,3,17,9,True
6971752,227,4,451,8945,474184902,1,0,0,1099.91,7,116013.26,26,1,2,10,True
7011124,372,0,30,5623,474184902,1,0,0,1099.81,8,114913.45,25,2,1,10,True
7157249,163,4,30,4666,474184902,1,0,0,1099.95,8,113813.5,24,4,10,10,True
7539274,1219,1,10,2829,474184902,1,0,0,1100.06,6,114913.56,24,4,4,12,True
7797852,531,0,-1,7555,474184902,1,1,0,1099.99,4,114913.56,18,6,3,12,True
7799492,372,0,451,7108,474184902,1,0,0,1099.93,7,113813.63,25,1,8,1,True
8121855,531,0,451,7124,474184902,1,0,0,1099.99,7,112713.64,18,5,8,2,True
8333542,531,0,30,1059,474184902,1,0,0,1099.91,8,111613.73,18,1,13,3,True
8346912,1001,4,25,1059,474184902,1,0,0,1099.95,8,110513.78,26,3,1,4,True
8534281,227,4,451,3550,474184902,1,0,0,1099.77,7,109414.01,26,3,5,4,True
8606253,1434,0,25,5623,474184902,1,0,0,1100.12,8,108313.89,24,6,4,5,True
8857560,51,0,20,4315,474184902,1,0,0,1099.99,5,107213.9,20,1,15,6,True
9402543,1001,4,25,7555,474184902,1,0,0,1099.8,8,106114.1,26,2,10,7,True
9553279,531,0,-1,6108,474184902,1,1,0,1099.97,4,106114.1,18,0,13,8,True
1168990,31,3,30,6364,134830786,0,0,0,816.13,8,942839.87,11,6,12,1,True
1402748,652,0,20,1096,134830786,0,0,0,816.01,5,942023.86,24,6,2,1,False
2182790,561,4,451,1096,134830786,0,0,0,815.95,7,941207.91,17,1,16,2,True
2193075,644,0,30,8669,134830786,0,0,0,816.06,8,940391.85,24,5,20,2,True
2508251,1019,0,451,2984,134830786,0,0,0,815.94,7,939575.91,26,3,16,3,False
2595516,1467,0,25,9431,134830786,0,0,0,815.95,8,938759.96,11,5,7,4,True
2761363,879,1,451,3839,134830786,0,0,0,815.82,7,937944.14,27,3,21,4,True
2785659,879,1,25,3839,134830786,0,0,0,815.75,8,937128.39,27,1,14,4,False
2814943,561,4,25,4387,134830786,0,0,0,816.17,8,936312.22,17,6,4,5,True
2836684,76,0,10,3659,134830786,0,0,0,816.15,6,937128.37,20,1,18,5,True
2877460,1140,0,10,3659,134830786,0,0,0,815.97,6,937944.34,15,6,13,6,True
2927650,711,2,20,6604,134830786,0,0,0,815.81,3,937128.53,18,4,5,6,True
2982434,561,4,451,4387,134830786,0,0,0,816.09,7,936312.44,17,3,18,7,True
3213645,799,2,-1,7807,134830786,0,1,0,815.98,4,936312.44,11,3,1,7,True
3355982,993,0,20,9431,134830786,0,0,0,816.15,5,935496.29,22,1,4,8,True
3365295,480,0,10,9431,134830786,0,0,0,816.09,6,936312.38,5,4,19,8,True
3622731,1019,0,451,2984,134830786,0,0,0,815.73,7,935496.65,26,5,15,9,True
3993561,1467,0,30,7807,134830786,0,0,0,816.18,8,934680.47,11,4,8,9,True
4272963,1467,0,451,6202,134830786,0,0,0,815.97,7,933864.5,11,2,16,9,True
4394730,644,0,25,9975,134830786,0,0,0,816.08,8,933048.42,24,4,16,9,True
4398509,211,0,10,7807,134830786,0,0,0,816.23,6,933864.65,9,6,5,10,True
4603152,879,1,451,9431,134830786,0,0,0,816.26,7,933048.39,27,0,9,12,True
4653406,879,1,25,3504,134830786,0,0,0,816.08,8,932232.31,27,4,12,1,True
5251228,297,0,20,6834,134830786,0,0,0,816.0,3,931416.31,4,0,18,3,True
5295751,799,2,-1,7807,134830786,0,1,0,815.94,4,931416.31,11,6,2,5,True
5796670,900,1,10,6604,134830786,0,0,0,815.8,6,932232.11,24,5,9,6,True
5829961,967,1,10,6364,134830786,0,0,0,815.98,6,933048.09,13,6,14,6,True
5980775,1315,0,10,3839,134830786,0,0,0,816.27,0,933864.36,5,2,8,7,True
6172810,644,0,30,6834,134830786,0,0,0,815.95,8,933048.41,24,5,14,7,True
6244638,799,2,25,2984,134830786,0,0,0,816.21,8,932232.2,11,6,3,8,True
6329292,502,0,20,6604,134830786,0,0,0,816.06,3,931416.14,12,2,9,8,True
6700872,1246,0,20,2984,134830786,0,0,0,815.92,3,930600.22,23,5,7,9,True
6809755,1019,0,451,8669,134830786,0,0,0,816.02,7,929784.2,26,0,3,10,True
6890697,1019,0,25,3504,134830786,0,0,0,815.82,8,928968.38,26,1,8,10,True
7176777,879,1,451,1064,134830786,0,0,0,815.86,7,928152.52,27,4,2,11,True
7411864,1019,0,451,1096,134830786,0,0,0,816.09,7,927336.43,26,5,16,11,True
7446101,1155,0,20,3504,134830786,0,0,0,815.95,3,926520.48,15,5,21,1,True
7600684,799,2,451,1064,134830786,0,0,0,815.74,7,925704.74,11,4,9,3,True
7699833,561,4,451,6604,134830786,0,0,0,816.04,7,924888.7,17,5,16,3,True
7882877,1429,0,10,8143,134830786,0,0,0,816.08,6,925704.78,24,6,21,3,True
7983141,31,3,30,6202,134830786,0,0,0,815.8,8,924888.98,11,6,8,4,True
8009849,1140,0,10,6364,134830786,0,0,0,816.11,6,925705.09,15,2,4,5,True
8129103,1467,0,25,8669,134830786,0,0,0,816.23,8,924888.86,11,2,2,5,True
8417721,561,4,451,3659,134830786,0,0,0,815.93,7,924072.93,17,1,20,6,True
8460894,551,0,10,8669,134830786,0,0,0,816.12,0,924889.05,17,5,7,6,True
8534917,319,0,10,7807,134830786,0,0,0,816.12,6,925705.17,11,3,13,7,True
8554232,406,1,10,9431,134830786,0,0,0,815.87,6,926521.04,10,6,7,7,True
8598805,31,3,451,7289,134830786,0,0,0,815.91,7,925705.13,11,2,9,7,True
8614375,222,2,20,4387,134830786,0,0,0,816.15,3,924888.98,26,4,21,7,True
8615714,644,0,30,1064,134830786,0,0,0,816.06,8,924072.92,24,6,18,7,True
8638013,126,1,10,6604,134830786,0,0,0,815.74,6,924888.66,18,4,23,8,True
8659300,1364,0,20,7807,134830786,0,0,0,815.95,5,924072.71,16,2,0,8,True
8786204,1413,0,10,2984,134830786,0,0,0,816.01,0,924888.72,24,1,5,8,True
8881014,913,0,10,6202,134830786,0,0,0,815.8,6,925704.52,18,0,5,9,True
9440058,627,0,10,4387,134830786,0,0,0,816.13,6,926520.65,11,2,21,9,True
9683251,1152,0,20,3504,134830786,0,0,0,816.14,5,925704.51,15,0,19,9,True
9718821,457,0,10,7807,134830786,0,0,0,816.07,6,926520.58,13,5,3,9,True
9919248,1264,0,10,7289,134830786,0,0,0,816.19,0,927336.77,23,4,20,9,True
9981273,561,4,451,3839,134830786,0,0,0,815.86,7,926520.91,17,6,22,9,True
1114333,780,0,10,9226,780398344,1,0,0,1022.15,6,511778.15,14,0,1,1,True
1321499,752,0,20,4694,780398344,1,0,0,1021.72,3,510756.43,24,3,10,1,True
1450541,199,0,451,2339,780398344,1,0,0,1021.77,7,509734.66,18,0,22,2,True
1854876,199,0,30,2895,780398344,1,0,0,1021.93,8,508712.73,18,2,2,3,True
1901935,979,0,20,2895,780398344,1,0,0,1021.94,5,507690.79,22,3,11,3,True
2077831,693,4,30,2650,780398344,1,0,0,1022.02,8,506668.77,24,2,4,6,True
2287126,783,0,10,3855,780398344,1,0,0,1022.06,6,507690.83,14,6,4,7,True
2341751,1067,4,-1,4922,780398344,1,1,0,1021.96,1,507690.83,11,4,15,8,True
2363081,249,0,30,5851,780398344,1,0,0,1022.06,8,506668.77,6,2,11,8,True
2388664,1067,4,25,8867,780398344,1,0,0,1022.02,8,505646.75,11,6,13,9,True
2485027,16,4,25,6458,780398344,1,0,0,1021.84,8,504624.91,24,4,0,9,True
2582020,693,4,25,2827,780398344,1,0,0,1021.67,8,503603.24,24,6,5,10,True
2889203,1067,4,-1,2650,780398344,1,1,0,1022.13,1,503603.24,11,0,22,10,True
2983543,497,0,20,8091,780398344,1,0,0,1022.12,3,502581.12,12,4,5,11,True
3038912,1067,4,-1,9226,780398344,1,1,0,1022.17,1,502581.12,11,2,15,11,True
3055779,599,0,10,6458,780398344,1,0,0,1021.91,0,503603.03,24,6,3,11,True
3224708,1456,4,25,1224,780398344,1,0,0,1021.98,8,502581.05,11,4,15,12,True
3302433,631,3,451,8867,780398344,1,0,0,1022.02,7,501559.03,11,3,12,1,True
3523242,249,0,451,5794,780398344,1,0,0,1021.75,7,500537.28,6,6,19,1,True
3733581,199,0,451,8808,780398344,1,0,0,1022.1,7,499515.18,18,2,18,2,True
3775579,199,0,451,1074,780398344,1,0,0,1022.14,7,498493.04,18,1,21,2,True
3778417,747,1,10,9226,780398344,1,0,0,1022.15,6,499515.19,24,0,13,2,True
4150527,693,4,-1,2339,780398344,1,1,0,1022.35,1,499515.19,24,0,9,4,True
4171800,1456,4,30,5851,780398344,1,0,0,1021.86,8,498493.33,11,3,9,5,True
4292639,1067,4,451,8867,780398344,1,0,0,1022.04,7,497471.29,11,2,4,5,True
4443160,635,2,20,3855,780398344,1,0,0,1021.9,5,496449.39,24,4,14,6,True
4537150,199,0,30,2895,780398344,1,0,0,1022.18,8,495427.21,18,6,15,6,True
4847249,631,3,451,2339,780398344,1,0,0,1022.03,7,494405.18,11,4,22,6,True
4914739,257,1,10,1074,780398344,1,0,0,1021.79,6,495426.97,6,6,8,7,True
5109522,249,0,25,4694,780398344,1,0,0,1022.12,8,494404.85,6,1,2,7,True
5116924,530,0,20,7545,780398344,1,0,0,1021.7,5,493383.15,18,6,20,7,True
5306794,1067,4,25,3855,780398344,1,0,0,1022.06,8,492361.09,11,6,21,8,True
5386660,1456,4,30,4694,780398344,1,0,0,1022.13,8,491338.96,11,3,21,8,True
5606626,249,0,25,5851,780398344,1,0,0,1022.13,8,490316.83,6,2,17,9,True
5844656,1067,4,30,5851,780398344,1,0,0,1021.93,8,489294.9,11,2,5,9,True
6071213,16,4,30,8808,780398344,1,0,0,1021.91,8,488272.99,24,5,12,10,True
6331951,568,1,10,8867,780398344,1,0,0,1022.25,0,489295.24,11,3,1,11,True
6870652,1406,0,10,2347,780398344,1,0,0,1021.88,6,490317.12,24,1,2,11,True
7108588,1132,0,10,5925,780398344,1,0,0,1021.88,6,491339.0,24,2,4,11,True
7347000,199,0,25,3225,780398344,1,0,0,1022.22,8,490316.78,18,6,3,12,True
7501266,208,0,10,9226,780398344,1,0,0,1021.98,6,491338.76,9,2,22,3,True
7682788,693,4,-1,2339,780398344,1,1,0,1022.27,1,491338.76,24,3,23,3,True
7701356,1067,4,-1,5794,780398344,1,2,0,1021.67,4,491338.76,11,3,19,4,True
7731705,199,0,451,8503,780398344,1,0,0,1022.03,7,490316.73,18,0,15,5,True
7889102,16,4,25,8503,780398344,1,0,0,1022.05,8,489294.68,24,1,11,6,True
8061201,16,4,-1,1224,780398344,1,1,0,1022.13,4,489294.68,24,6,2,6,True
8085711,693,4,25,1224,780398344,1,0,0,1022.04,8,488272.64,24,3,15,6,True
8162016,199,0,30,1074,780398344,1,0,0,1022.13,8,487250.51,18,4,11,7,True
8197742,1067,4,30,3142,780398344,1,0,0,1022.02,8,486228.49,11,0,9,7,False
8541528,1456,4,451,5925,780398344,1,0,0,1022.13,7,485206.36,11,4,22,8,False
9445682,199,0,451,3142,780398344,1,0,0,1021.92,7,484184.44,18,1,14,9,True
9484232,249,0,451,3142,780398344,1,0,0,1021.81,7,483162.63,6,2,5,10,False
9508746,1067,4,30,4058,780398344,1,0,0,1022.15,8,482140.48,11,3,1,10,True
9536992,249,0,30,4694,780398344,1,0,0,1021.82,8,481118.66,6,1,7,10,True
9597274,199,0,30,2339,780398344,1,0,0,1021.95,8,480096.71,18,0,2,10,True
9998954,16,4,451,5925,780398344,1,0,0,1022.2,7,479074.51,24,5,13,11,True
1042914,337,1,10,8005,654709929,1,0,0,202.96,0,618128.96,11,3,23,1,True
1057427,970,4,451,9614,654709929,1,0,0,202.88,7,617926.08,13,5,0,1,True
1570059,96,0,20,4835,654709929,1,0,0,203.22,5,617722.86,1,5,1,2,True
1699932,970,4,25,3321,654709929,1,0,0,202.92,8,617519.94,13,4,13,4,True
1726756,1152,0,451,1513,654709929,1,0,0,202.85,7,617317.09,15,4,13,5,True
1894613,339,4,30,1241,654709929,1,0,0,203.21,8,617113.88,11,2,1,6,True
1994962,255,2,20,8005,654709929,1,0,0,203.16,5,616910.72,6,6,4,6,True
2156155,339,4,-1,1629,654709929,1,1,0,202.84,4,616910.72,11,5,16,7,True
2236754,302,1,10,9614,654709929,1,0,0,202.93,6,617113.65,4,1,1,8,True
2379162,1477,2,20,8005,654709929,1,0,0,203.03,5,616910.62,24,1,2,8,True
2882060,970,4,30,1241,654709929,1,0,0,202.79,8,616707.83,13,5,18,8,True
3079548,318,0,20,1241,654709929,1,0,0,202.81,3,616505.02,11,6,23,9,True
3131273,655,3,451,7761,654709929,1,0,0,203.01,7,616302.01,18,1,14,10,True
3469113,78,3,-1,9614,654709929,1,1,0,203.1,4,616302.01,1,5,17,10,True
3510398,1173,1,10,7220,654709929,1,0,0,202.87,6,616504.88,24,5,21,10,True
3521835,339,4,451,8917,654709929,1,0,0,202.79,7,616302.09,11,5,21,11,True
3799658,78,3,451,9614,654709929,1,0,0,203.0,7,616099.09,1,5,17,12,True
3801732,746,4,-1,3443,654709929,1,1,0,202.86,1,616099.09,24,0,21,1,True
3931253,78,3,25,9614,654709929,1,0,0,202.95,8,615896.14,1,5,19,1,True
4102146,746,4,451,8139,654709929,1,0,0,202.79,7,615693.35,24,0,8,1,True
4251667,655,3,25,4835,654709929,1,0,0,202.85,8,615490.5,18,3,13,2,True
4386962,970,4,30,3765,654709929,1,0,0,202.85,8,615287.65,13,3,20,2,True
4496809,1075,0,20,3765,654709929,1,0,0,202.98,3,615084.67,18,3,22,2,True
4556486,1044,0,451,5924,654709929,1,0,0,202.96,7,614881.71,11,4,12,3,True
4566342,1044,0,-1,3765,654709929,1,1,0,203.13,4,614881.71,11,2,15,3,True
4847239,655,3,451,5924,654709929,1,0,0,203.09,7,614678.62,18,0,20,3,True
5018782,746,4,-1,1629,654709929,1,1,0,202.88,4,614678.62,24,5,16,4,True
5181036,1152,0,30,4835,654709929,1,0,0,203.14,8,614475.48,15,5,18,5,True
5315702,746,4,-1,2302,654709929,1,1,0,202.81,4,614475.48,24,0,5,6,True
5475520,746,4,30,7761,654709929,1,0,0,203.15,8,614272.33,24,5,1,7,True
5556989,78,3,25,1629,654709929,1,0,0,202.92,8,614069.41,1,2,5,7,True
5667145,78,3,451,8139,654709929,1,0,0,202.87,7,613866.54,1,4,17,7,True
5828683,655,3,451,1629,654709929,1,0,0,203.1,7,613663.44,18,2,17,8,True
6047561,411,2,20,1506,654709929,1,0,0,202.76,3,613460.68,18,4,12,9,True
6088340,1421,0,10,8005,654709929,1,0,0,202.93,0,613663.61,24,2,4,9,True
6273430,757,0,20,7761,654709929,1,0,0,203.03,3,613460.58,24,3,8,10,True
6311437,1137,1,10,5924,654709929,1,0,0,202.87,6,613663.45,24,1,17,10,True
6518128,970,4,30,8139,654709929,1,0,0,202.81,8,613460.64,13,1,19,10,True
6548346,1152,0,451,4140,654709929,1,0,0,203.1,7,613257.54,15,6,18,12,True
6867012,518,2,20,4835,654709929,1,0,0,203.07,5,613054.47,18,6,16,1,True
6872836,542,0,20,4071,654709929,1,0,0,202.87,3,612851.6,17,4,23,2,True
7047143,655,3,-1,3765,654709929,1,1,0,202.87,4,612851.6,18,6,3,2,True
7223282,970,4,451,2128,654709929,1,0,0,203.24,7,612648.36,13,0,17,3,True
7282061,970,4,-1,1941,654709929,1,1,0,202.95,1,612648.36,13,4,9,3,True
7319191,339,4,30,4071,654709929,1,0,0,202.87,8,612445.49,11,4,19,4,True
7342079,128,0,10,8917,654709929,1,0,0,202.95,0,612648.44,18,3,4,5,True
7435065,655,3,451,2128,654709929,1,0,0,203.11,7,612445.33,18,6,9,5,True
7958556,970,4,451,4821,654709929,1,0,0,203.02,7,612242.31,13,2,16,5,True
7964861,78,3,-1,7761,654709929,1,1,0,202.96,1,612242.31,1,6,14,6,True
8633519,339,4,451,5924,654709929,1,0,0,203.17,7,612039.14,11,2,14,7,True
9042968,970,4,-1,7761,654709929,1,1,0,203.18,1,612039.14,13,2,16,7,True
9152282,339,4,451,4140,654709929,1,0,0,202.89,7,611836.25,11,1,13,7,True
9346518,655,3,25,7761,654709929,1,0,0,203.13,8,611633.12,18,6,18,8,False
9373200,1152,0,30,4140,654709929,1,0,0,203.1,8,611430.02,15,2,1,8,True
9610933,1044,0,-1,8917,654709929,1,1,0,203.02,4,611430.02,11,4,11,9,True
9670954,147,0,20,3321,654709929,1,0,0,203.0,5,611227.02,18,3,15,10,True
9766798,339,4,451,2128,654709929,1,0,0,202.78,7,611024.24,11,0,15,11,True
9892845,1063,0,10,7761,654709929,1,0,0,203.23,6,611227.47,11,2,14,11,True
1296685,78,3,451,6852,429842896,0,0,0,364.39,7,272551.61,1,5,15,1,True
1401489,78,3,451,1157,429842896,0,0,0,364.15,7,272187.46,1,3,16,1,True
1733848,885,3,451,5437,429842896,0,0,0,363.82,7,271823.64,24,2,16,1,True
1741641,78,3,-1,4094,429842896,0,1,0,364.03,4,271823.64,1,4,20,2,False
2119677,1297,0,451,2201,429842896,0,0,0,363.81,7,271459.83,5,3,17,3,True
2215673,885,3,25,8672,429842896,0,0,0,363.72,8,271096.11,24,5,23,4,True
2233245,1159,0,10,4665,429842896,0,0,0,364.07,0,271460.18,15,3,14,4,True
2686088,78,3,-1,3886,429842896,0,1,0,364.08,4,271460.18,1,5,2,4,True
2713401,1116,0,-1,3886,429842896,0,2,0,363.71,4,271460.18,24,4,16,5,True
3105889,78,3,25,3170,429842896,0,0,0,363.94,8,271096.24,1,0,17,5,True
3179089,1116,0,451,3235,429842896,0,0,0,363.94,7,270732.3,24,1,17,5,True
3304874,597,4,451,3235,429842896,0,0,0,364.06,7,270368.24,24,5,6,6,True
3500390,597,4,451,7229,429842896,0,0,0,363.92,7,270004.32,24,5,21,6,True
3526173,792,1,10,3886,429842896,0,0,0,363.96,0,270368.28,11,0,23,7,True
3603539,78,3,25,4094,429842896,0,0,0,364.0,8,270004.28,1,0,21,7,True
3679834,78,3,-1,3170,429842896,0,1,0,364.0,1,270004.28,1,3,9,9,True
3859351,597,4,-1,2201,429842896,0,2,0,364.02,1,270004.28,24,0,13,9,True
3906238,669,2,451,3886,429842896,0,0,0,363.99,7,269640.29,18,3,22,9,True
4222861,1297,0,-1,3886,429842896,0,1,0,363.74,1,269640.29,5,0,13,10,True
4257850,1297,0,25,2690,429842896,0,0,0,363.92,8,269276.37,5,6,2,11,True
4361364,333,1,25,1673,429842896,0,0,0,364.08,8,268912.29,11,4,17,11,True
4745279,950,0,20,4094,429842896,0,0,0,364.11,5,268548.18,24,5,11,11,True
4747802,1116,0,451,1673,429842896,0,0,0,364.23,7,268183.95,24,1,3,11,True
4873167,885,3,25,4732,429842896,0,0,0,364.22,8,267819.73,24,4,1,12,True
4885302,1116,0,451,4783,429842896,0,0,0,363.92,7,267455.81,24,1,0,12,True
5305806,530,0,10,3731,429842896,0,0,0,363.84,0,267819.65,18,2,2,12,True
5374594,1231,2,20,1157,429842896,0,0,0,363.89,5,267455.76,18,2,13,2,True
5405318,989,1,10,3731,429842896,0,0,0,363.97,0,267819.73,22,1,5,2,True
6020835,597,4,-1,5437,429842896,0,1,0,363.99,1,267819.73,24,2,8,6,True
6085861,669,2,30,1974,429842896,0,0,0,364.21,8,267455.52,18,3,4,6,True
6195414,597,4,451,1157,429842896,0,0,0,364.21,7,267091.31,24,6,10,6,True
6489185,1093,0,10,7229,429842896,0,0,0,364.13,6,267455.44,18,6,0,6,True
6933012,584,0,10,6852,429842896,0,0,0,364.08,6,267819.52,11,4,7,6,True
7336993,1297,0,-1,7752,429842896,0,1,0,364.07,1,267819.52,5,2,2,8,True
7392150,669,2,30,8364,429842896,0,0,0,363.9,8,267455.62,18,1,20,8,True
7642722,1297,0,451,2690,429842896,0,0,0,364.11,7,267091.51,5,3,16,8,True
7753810,78,3,451,2000,429842896,0,0,0,363.73,7,266727.78,1,0,4,10,True
8271617,597,4,451,1974,429842896,0,0,0,364.14,7,266363.64,24,3,7,11,True
8421902,21,0,10,3170,429842896,0,0,0,363.92,6,266727.56,11,5,15,12,True
8432135,1116,0,25,7229,429842896,0,0,0,363.99,8,266363.57,24,1,11,12,True
8449669,669,2,25,2690,429842896,0,0,0,363.83,8,265999.74,18,5,11,1,True
8555029,597,4,30,2988,429842896,0,0,0,363.99,8,265635.75,24,6,13,1,True
8586896,669,2,-1,3235,429842896,0,1,0,363.91,1,265635.75,18,6,19,2,True
8640699,1065,0,20,1230,429842896,0,0,0,363.94,3,265271.81,11,2,15,3,True
8837022,1243,2,20,3886,429842896,0,0,0,363.98,5,264907.83,18,6,17,3,True
8946992,78,3,25,6436,429842896,0,0,0,363.98,8,264543.85,1,1,18,5,True
9239147,885,3,30,7752,429842896,0,0,0,364.08,8,264179.77,24,3,17,5,True
9247734,333,1,451,6852,429842896,0,0,0,364.13,7,263815.64,11,1,20,6,True
9287555,669,2,451,4665,429842896,0,0,0,363.96,7,263451.68,18,5,3,7,True
9316014,885,3,30,6436,429842896,0,0,0,363.89,8,263087.79,24,1,18,7,True
9364229,1115,1,10,8672,429842896,0,0,0,363.74,0,263451.53,0,1,22,9,True
9398510,1297,0,451,7752,429842896,0,0,0,363.99,7,263087.54,5,1,12,9,True
9469748,333,1,25,7344,429842896,0,0,0,364.15,8,262723.39,11,4,5,10,True
9769600,1307,0,10,1164,429842896,0,0,0,364.1,6,263087.49,5,0,21,10,True
1094241,975,4,30,4751,409070399,1,0,0,419.89,8,585759.11,22,1,0,1,True
1210156,1065,0,10,9671,409070399,1,0,0,419.79,6,586178.9,11,6,14,2,True
1219338,1109,4,451,5757,409070399,1,0,0,420.12,7,585758.78,0,2,0,2,True
1383479,1304,0,-1,1187,409070399,1,1,0,420.02,4,585758.78,5,3,12,2,True
1450321,219,0,20,5864,409070399,1,0,0,419.99,5,585338.79,9,3,0,2,True
1504108,975,4,-1,9671,409070399,1,1,0,419.64,1,585338.79,22,3,22,4,True
1512789,781,1,10,4374,409070399,1,0,0,419.97,6,585758.76,14,3,19,4,True
1740161,958,2,20,4374,409070399,1,0,0,419.87,3,585338.89,13,2,4,4,True
1880430,729,0,-1,5757,409070399,1,1,0,420.13,1,585338.89,11,6,22,5,True
1979919,1159,0,20,5864,409070399,1,0,0,420.06,3,584918.83,15,4,0,6,True
2083224,1122,1,10,5545,409070399,1,0,0,419.96,0,585338.79,24,4,0,6,True
2394105,1076,1,451,8741,409070399,1,0,0,420.07,7,584918.72,18,6,16,6,True
2998410,743,4,30,5545,409070399,1,0,0,419.96,8,584498.76,24,2,13,6,True
3095255,1304,0,451,6072,409070399,1,0,0,419.95,7,584078.81,5,2,23,7,True
3118795,15,4,451,5757,409070399,1,0,0,420.16,7,583658.65,24,5,1,7,True
3261811,975,4,25,3484,409070399,1,0,0,419.87,8,583238.78,22,4,4,8,True
3307427,729,0,451,6973,409070399,1,0,0,420.12,7,582818.66,11,0,18,8,True
3476632,1109,4,451,8741,409070399,1,0,0,420.16,7,582398.5,0,4,4,8,True
3746344,975,4,451,4374,409070399,1,0,0,419.76,7,581978.74,22,5,19,8,True
3816729,1090,0,10,6072,409070399,1,0,0,420.02,6,582398.76,18,5,5,8,True
3868933,729,0,451,3484,409070399,1,0,0,420.01,7,581978.75,11,2,6,9,True
3993171,15,4,-1,5749,409070399,1,1,0,420.22,4,581978.75,24,0,17,9,True
4190599,1304,0,451,5757,409070399,1,0,0,419.9,7,581558.85,5,6,17,10,True
4463296,1304,0,25,5757,409070399,1,0,0,420.06,8,581138.79,5,5,0,11,True
4738780,916,0,10,8741,409070399,1,0,0,419.84,6,581558.63,18,6,22,12,True
5191870,1109,4,-1,9671,409070399,1,1,0,419.97,4,581558.63,0,2,22,12,True
5496953,743,4,-1,3484,409070399,1,2,0,420.13,4,581558.63,24,4,0,12,True
5673198,630,0,20,8653,409070399,1,0,0,419.81,5,581138.82,11,5,23,1,True
5833127,975,4,451,5757,409070399,1,0,0,420.0,7,580718.82,22,5,0,2,True
6086724,743,4,30,3484,409070399,1,0,0,419.78,8,580299.04,24,5,6,2,True
6575852,21,0,20,4751,409070399,1,0,0,420.22,5,579878.82,11,6,21,4,True
6576003,1307,0,10,8653,409070399,1,0,0,420.2,0,580299.02,5,6,9,5,True
6585383,975,4,25,1187,409070399,1,0,0,419.89,8,579879.13,22,2,3,6,True
6890267,1109,4,30,4374,409070399,1,0,0,420.25,8,579458.88,0,3,14,6,True
6947605,656,2,20,8671,409070399,1,0,0,420.21,3,579038.67,18,2,18,6,True
7145752,1304,0,25,4751,409070399,1,0,0,420.07,8,578618.6,5,4,19,7,True
7161937,729,0,451,5749,409070399,1,0,0,420.09,7,578198.51,11,2,23,8,True
7320839,975,4,451,5545,409070399,1,0,0,419.9,7,577778.61,22,6,1,9,True
7334965,1109,4,30,5545,409070399,1,0,0,420.22,8,577358.39,0,3,22,11,True
7370598,1086,0,20,5545,409070399,1,0,0,419.82,5,576938.57,18,6,16,11,True
7530609,1076,1,30,4751,409070399,1,0,0,420.06,8,576518.51,18,3,7,12,True
7634351,416,2,20,8653,409070399,1,0,0,420.18,5,576098.33,18,4,20,1,True
7948866,1109,4,451,8741,409070399,1,0,0,419.9,7,575678.43,0,2,19,2,True
8040157,1304,0,30,5749,409070399,1,0,0,420.14,8,575258.29,5,6,11,3,False
8809734,975,4,25,1261,409070399,1,0,0,420.08,8,574838.21,22,6,6,3,True
8982138,675,2,20,1261,409070399,1,0,0,420.27,5,574417.94,24,5,20,5,True
9077549,599,0,20,4751,409070399,1,0,0,419.94,5,573998.0,24,4,1,5,True
9255043,729,0,451,3484,409070399,1,0,0,420.01,7,573577.99,11,6,16,6,True
9272633,1000,0,10,5864,409070399,1,0,0,420.13,0,573998.12,26,1,19,7,False
9399415,1109,4,25,8671,409070399,1,0,0,420.18,8,573577.94,0,6,10,7,True
9492489,729,0,-1,5749,409070399,1,1,0,420.05,4,573577.94,11,4,1,8,True
9716652,64,0,20,6072,409070399,1,0,0,420.05,3,573157.89,20,1,3,10,True
9758496,15,4,451,1261,409070399,1,0,0,419.89,7,572738.0,24,5,3,10,False
9782581,794,2,20,3484,409070399,1,0,0,420.07,3,572317.93,11,0,18,10,True
1374685,920,4,451,9349,157128422,0,0,0,923.08,7,435070.92,18,2,22,1,True
1449763,1402,4,-1,8171,157128422,0,1,0,923.12,1,435070.92,24,1,11,1,True
1521519,534,4,451,4432,157128422,0,0,0,922.98,7,434147.94,18,0,22,1,True
1602561,534,4,30,9781,157128422,0,0,0,922.84,8,433225.1,18,0,13,2,True
1699322,860,1,10,8171,157128422,0,0,0,923.04,6,434148.14,24,5,2,3,True
1972380,1402,4,451,6749,157128422,0,0,0,923.13,7,433225.01,24,6,3,3,True
1991737,502,0,10,2221,157128422,0,0,0,923.11,0,434148.12,12,3,4,3,True
2164565,865,0,10,1561,157128422,0,0,0,922.81,6,435070.93,24,0,16,4,True
2379621,534,4,-1,4432,157128422,0,1,0,923.09,4,435070.93,18,6,0,5,True
2465464,337,1,10,9349,157128422,0,0,0,923.23,0,435994.16,11,5,8,5,True
2596530,238,0,30,5971,157128422,0,0,0,923.21,8,435070.95,26,3,11,6,True
2662661,1142,2,451,6572,157128422,0,0,0,922.85,7,434148.1,15,2,0,6,False
2751553,485,1,25,9524,157128422,0,0,0,922.85,8,433225.25,5,4,10,6,True
2901921,1052,0,25,2764,157128422,0,0,0,923.05,8,432302.2,11,1,5,6,True
2916883,1402,4,451,9908,157128422,0,0,0,922.91,7,431379.29,24,0,3,8,True
3077848,1435,2,-1,8639,157128422,0,1,0,923.19,1,431379.29,24,3,10,8,True
3307839,316,2,20,4693,157128422,0,0,0,922.83,5,430456.46,4,1,1,10,True
3341024,1052,0,30,2764,157128422,0,0,0,922.94,8,429533.52,11,6,8,10,True
3501773,1402,4,451,8171,157128422,0,0,0,923.01,7,428610.51,24,6,20,10,True
3549332,485,1,-1,7108,157128422,0,1,0,922.9,4,428610.51,5,3,15,11,True
3772729,1435,2,451,3828,157128422,0,0,0,923.21,7,427687.3,24,1,3,11,True
3796811,238,0,25,1561,157128422,0,0,0,922.71,8,426764.59,26,1,15,12,True
3835801,1235,1,10,6749,157128422,0,0,0,922.9,0,427687.49,18,3,3,12,True
4019766,1435,2,30,2249,157128422,0,0,0,923.11,8,426764.38,24,3,18,12,False
4506039,238,0,-1,3828,157128422,0,1,0,922.82,4,426764.38,26,0,6,12,True
4951864,1402,4,451,7158,157128422,0,0,0,922.86,7,425841.52,24,6,16,1,True
5071525,238,0,25,3875,157128422,0,0,0,922.87,8,424918.65,26,3,3,2,True
6143869,534,4,451,8639,157128422,0,0,0,923.15,7,423995.5,18,5,13,2,True
6267746,485,1,451,8171,157128422,0,0,0,923.06,7,423072.44,5,0,12,2,True
6274624,1239,1,10,3861,157128422,0,0,0,923.04,0,423995.48,18,0,9,3,True
6275443,662,1,10,5971,157128422,0,0,0,922.95,6,424918.43,18,2,0,4,True
6615172,1435,2,-1,2221,157128422,0,1,0,922.88,1,424918.43,24,4,9,4,True
6641708,238,0,451,7614,157128422,0,0,0,922.71,7,423995.72,26,5,17,6,True
6684863,525,0,10,1035,157128422,0,0,0,923.09,6,424918.81,18,4,15,6,True
7093023,1435,2,25,9349,157128422,0,0,0,922.79,8,423996.02,24,2,15,7,True
7421916,1247,0,20,6886,157128422,0,0,0,923.03,3,423072.99,23,1,21,8,True
7450333,394,0,10,7614,157128422,0,0,0,922.94,6,423995.93,10,3,17,8,True
7557261,920,4,451,3875,157128422,0,0,0,922.76,7,423073.17,18,0,16,8,True
7698634,726,0,10,4432,157128422,0,0,0,923.01,6,423996.18,11,0,14,9,True
7777669,1142,2,25,7814,157128422,0,0,0,923.11,8,423073.07,15,5,16,9,True
7971663,1180,1,10,3936,157128422,0,0,0,922.95,6,423996.02,24,6,19,10,True
8061521,534,4,25,7158,157128422,0,0,0,922.82,8,423073.2,18,3,2,11,True
8213681,375,4,25,5971,157128422,0,0,0,923.18,8,422150.02,25,5,18,12,True
8530081,485,1,25,1576,157128422,0,0,0,923.16,8,421226.86,5,6,16,12,True
8707321,1352,1,10,7814,157128422,0,0,0,923.21,0,422150.07,24,3,18,12,False
8831938,703,0,20,1561,157128422,0,0,0,922.94,3,421227.13,18,0,7,12,True
8855764,360,0,20,2249,157128422,0,0,0,923.08,5,420304.05,24,3,12,2,True
8887493,920,4,30,7814,157128422,0,0,0,923.07,8,419380.98,18,4,11,2,True
8975678,485,1,451,4432,157128422,0,0,0,923.11,7,418457.87,5,1,4,3,True
9006224,920,4,451,9687,157128422,0,0,0,923.21,7,417534.66,18,6,4,3,True
9060094,920,4,-1,9371,157128422,0,1,0,922.89,4,417534.66,18,6,17,3,True
9207218,238,0,-1,7626,157128422,0,2,0,922.7,1,417534.66,26,1,22,3,False
9411611,1052,0,30,6572,157128422,0,0,0,923.05,8,416611.61,11,1,16,7,True
9552569,1142,2,451,7626,157128422,0,0,0,922.93,7,415688.68,15,5,10,8,True
9925712,848,2,20,1016,157128422,0,0,0,922.85,5,414765.83,5,1,21,10,True
1603121,198,0,451,9669,812115634,1,0,0,213.98,7,964900.02,18,2,22,2,True
1642290,928,3,25,3906,812115634,1,0,0,213.95,8,964686.07,18,5,7,3,True
1706365,928,3,451,4530,812115634,1,0,0,213.79,7,964472.28,18,4,12,5,True
1713871,549,1,451,7835,812115634,1,0,0,213.94,7,964258.34,17,5,23,5,True
2220130,168,0,20,8461,812115634,1,0,0,214.0,3,964044.34,24,6,11,7,True
2479899,1060,1,25,5392,812115634,1,0,0,214.19,8,963830.15,11,1,9,7,True
2797082,51,0,20,1792,812115634,1,0,0,214.2,5,963615.95,20,2,6,9,True
2879169,1060,1,451,5392,812115634,1,0,0,214.02,7,963401.93,11,5,3,10,True
2945956,1391,2,20,8427,812115634,1,0,0,214.05,5,963187.88,24,6,3,12,True
2956208,394,0,20,3906,812115634,1,0,0,214.07,3,962973.81,10,1,23,12,True
2992521,198,0,451,7560,812115634,1,0,0,214.01,7,962759.8,18,6,13,1,True
2994817,767,0,10,9669,812115634,1,0,0,214.0,0,962973.8,14,2,12,1,True
3000233,249,0,25,8427,812115634,1,0,0,214.0,8,962759.8,6,1,19,1,True
3094946,198,0,451,4930,812115634,1,0,0,214.06,7,962545.74,18,5,0,1,True
3325449,249,0,451,4930,812115634,1,0,0,213.8,7,962331.94,6,3,8,3,True
3480516,757,0,30,7695,812115634,1,0,0,213.99,8,962117.95,24,5,16,4,True
3503425,148,1,25,7533,812115634,1,0,0,214.15,8,961903.8,18,6,6,4,True
3573669,198,0,30,8427,812115634,1,0,0,214.03,8,961689.77,18,1,19,4,False
3703361,1060,1,25,5202,812115634,1,0,0,214.1,8,961475.67,11,2,14,5,True
3818546,1060,1,451,6022,812115634,1,0,0,213.84,7,961261.83,11,5,15,5,True
4021044,1060,1,-1,7835,812115634,1,1,0,213.88,4,961261.83,11,5,16,6,True
4085658,148,1,451,9669,812115634,1,0,0,213.83,7,961048.0,18,1,21,6,True
4119513,944,2,20,8461,812115634,1,0,0,214.1,5,960833.9,24,2,9,7,True
4175634,1060,1,451,6933,812115634,1,0,0,213.99,7,960619.91,11,6,3,8,True
4657220,198,0,10,5497,812115634,1,0,0,214.01,6,960833.92,18,2,16,8,True
4712578,549,1,25,1607,812115634,1,0,0,214.01,8,960619.91,17,2,11,9,True
4932312,249,0,-1,5497,812115634,1,1,0,213.88,4,960619.91,6,0,11,9,True
4976693,148,1,451,4623,812115634,1,0,0,214.41,7,960405.5,18,0,23,10,True
5160096,1461,0,10,4623,812115634,1,0,0,214.19,6,960619.69,11,5,10,11,True
5461888,198,0,25,4530,812115634,1,0,0,213.84,8,960405.85,18,3,4,11,True
5477976,579,0,451,7492,812115634,1,0,0,214.13,7,960191.72,11,1,23,12,True
5532007,549,1,25,8276,812115634,1,0,0,213.98,8,959977.74,17,4,17,12,True
5938260,1312,0,30,5392,812115634,1,0,0,214.12,8,959763.62,5,5,4,12,True
5987684,1060,1,451,4019,812115634,1,0,0,214.12,7,959549.5,11,5,9,1,True
6469402,928,3,25,4019,812115634,1,0,0,214.1,8,959335.4,18,2,21,1,True
6744378,979,0,20,7695,812115634,1,0,0,214.02,3,959121.38,22,2,13,3,True
6835790,757,0,451,8614,812115634,1,0,0,214.09,7,958907.29,24,0,10,4,True
7084333,549,1,30,7492,812115634,1,0,0,213.98,8,958693.31,17,4,13,4,True
7152374,1312,0,30,7560,812115634,1,0,0,213.85,8,958479.46,5,5,6,6,True
7169831,851,1,10,4019,812115634,1,0,0,213.92,0,958693.38,5,0,17,7,True
7478200,757,0,451,7560,812115634,1,0,0,213.77,7,958479.61,24,1,0,7,True
7524145,249,0,451,8461,812115634,1,0,0,213.74,7,958265.87,6,2,2,8,True
7748921,549,1,451,8614,812115634,1,0,0,214.0,7,958051.87,17,2,20,8,True
7955761,278,1,10,4530,812115634,1,0,0,214.16,6,958266.03,24,4,16,8,True
8558326,549,1,451,4930,812115634,1,0,0,214.03,7,958052.0,17,6,3,9,True
9407424,757,0,451,4623,812115634,1,0,0,214.01,7,957837.99,24,4,7,9,True
9494083,198,0,-1,1685,812115634,1,1,0,214.01,4,957837.99,18,6,3,9,True
9644871,1060,1,-1,2738,812115634,1,2,0,213.99,1,957837.99,11,5,2,9,True
9777383,549,1,25,7492,812115634,1,0,0,214.03,8,957623.96,17,6,23,10,True
9885354,148,1,25,5497,812115634,1,0,0,214.06,8,957409.9,18,3,1,11,True
1038094,59,0,10,4149,818202388,1,0,0,497.06,6,365403.06,20,0,19,2,True
1139567,286,1,451,7430,818202388,1,0,0,496.88,7,364906.18,24,1,3,2,True
1777653,996,0,20,1862,818202388,1,0,0,497.27,5,364408.91,26,0,21,3,True
1893301,372,0,10,6691,818202388,1,0,0,496.84,6,364905.75,25,6,17,4,True
2095086,990,0,20,7206,818202388,1,0,0,496.89,5,364408.86,22,1,10,4,True
2275477,1304,0,10,7395,818202388,1,0,0,496.83,0,364905.69,5,6,23,5,True
2683910,286,1,25,4731,818202388,1,0,0,497.12,8,364408.57,24,1,21,5,True
2953123,286,1,-1,8177,818202388,1,1,0,496.65,1,364408.57,24,6,6,6,True
3224280,286,1,30,7332,818202388,1,0,0,496.96,8,363911.61,24,6,23,6,True
3376156,996,0,10,7206,818202388,1,0,0,497.29,0,364408.9,26,1,3,7,True
3378399,920,4,30,3832,818202388,1,0,0,496.95,8,363911.95,18,3,13,7,True
4058412,1184,4,25,8177,818202388,1,0,0,497.07,8,363414.88,24,5,11,8,True
4511951,1282,2,-1,4697,818202388,1,1,0,497.0,4,363414.88,24,1,4,8,True
4625759,1282,2,20,6691,818202388,1,0,0,496.91,5,362917.97,24,1,7,10,True
4688848,512,0,30,7206,818202388,1,0,0,496.86,8,362421.11,12,3,7,10,True
4803313,962,0,10,1862,818202388,1,0,0,497.34,6,362918.45,13,6,8,10,True
4927077,550,0,451,1862,818202388,1,0,0,497.06,7,362421.39,17,2,7,10,True
4988512,512,0,451,8070,818202388,1,0,0,497.15,7,361924.24,12,4,3,10,True
5276739,1451,1,30,6512,818202388,1,0,0,496.86,8,361427.38,11,1,11,12,True
5372674,512,0,30,2712,818202388,1,0,0,497.15,8,360930.23,12,2,4,1,True
5669560,550,0,451,2712,818202388,1,0,0,497.01,7,360433.22,17,2,17,1,True
5875337,550,0,-1,4149,818202388,1,1,0,496.96,1,360433.22,17,3,13,3,False
5949300,935,1,10,6691,818202388,1,0,0,497.09,6,360930.31,24,6,4,4,True
6411890,1282,2,451,6691,818202388,1,0,0,497.11,7,360433.2,24,5,9,4,True
6785750,1282,2,451,8153,818202388,1,0,0,497.15,7,359936.05,24,5,11,4,True
6841759,286,1,451,1527,818202388,1,0,0,497.14,7,359438.91,24,6,13,7,True
6873878,1184,4,30,9466,818202388,1,0,0,497.02,8,358941.89,24,1,10,7,True
6996439,1184,4,451,6691,818202388,1,0,0,497.01,7,358444.88,24,0,23,7,True
7110818,144,1,10,8953,818202388,1,0,0,497.06,6,358941.94,18,4,11,7,True
7174148,512,0,30,4697,818202388,1,0,0,496.97,8,358444.97,12,0,10,8,True
7399542,260,0,20,8600,818202388,1,0,0,497.33,3,357947.64,6,1,10,8,True
7958801,1451,1,451,9466,818202388,1,0,0,497.07,7,357450.57,11,6,17,8,True
7992577,920,4,30,3832,818202388,1,0,0,497.32,8,356953.25,18,2,7,9,True
8112668,1451,1,30,3577,818202388,1,0,0,497.16,8,356456.09,11,5,10,9,True
8208559,512,0,451,6265,818202388,1,0,0,497.06,7,355959.03,12,0,13,10,True
8257346,1451,1,451,8600,818202388,1,0,0,497.37,7,355461.66,11,6,8,10,True
8340556,1282,2,451,5492,818202388,1,0,0,497.26,7,354964.4,24,4,3,11,True
8548324,1321,0,10,4149,818202388,1,0,0,496.81,6,355461.21,18,0,7,11,True
8678718,550,0,451,1527,818202388,1,0,0,497.05,7,354964.16,17,1,19,11,True
8811858,1111,0,10,8600,818202388,1,0,0,497.03,6,355461.19,0,0,0,12,True
8856987,1451,1,451,6265,818202388,1,0,0,496.76,7,354964.43,11,6,4,12,True
8902650,346,0,20,1548,818202388,1,0,0,496.84,5,354467.59,24,5,8,12,True
9248533,920,4,25,7206,818202388,1,0,0,497.08,8,353970.51,18,2,12,2,True
9459415,1451,1,-1,2712,818202388,1,1,0,497.4,4,353970.51,11,6,9,2,True
9469715,1282,2,451,1576,818202388,1,0,0,496.81,7,353473.7,24,6,15,6,True
9593576,1451,1,451,8953,818202388,1,0,0,497.12,7,352976.58,11,5,13,9,False
9633719,28,1,10,4164,818202388,1,0,0,496.99,6,353473.57,11,1,1,9,True
9641869,1451,1,25,3577,818202388,1,0,0,496.98,8,352976.59,11,0,11,9,True
9697546,1184,4,25,3832,818202388,1,0,0,496.95,8,352479.64,24,3,6,10,True
9712360,1282,2,451,1576,818202388,1,0,0,496.77,7,351982.87,24,4,15,11,True
9811642,1451,1,30,4164,818202388,1,0,0,496.96,8,351485.91,11,5,17,11,True
1080474,1210,0,-1,7356,508181338,1,1,0,693.83,4,623719.0,24,6,16,1,True
1224674,1102,2,20,3619,508181338,1,0,0,694.08,3,623024.92,0,6,15,1,True
1328317,1410,1,25,9732,508181338,1,0,0,693.93,8,622330.99,24,2,16,3,True
1333573,1159,0,451,5087,508181338,1,0,0,693.69,7,621637.3,15,0,19,3,True
1343306,1159,0,25,7769,508181338,1,0,0,694.08,8,620943.22,15,4,8,4,True
1484338,39,3,451,5784,508181338,1,0,0,693.92,7,620249.3,11,2,3,5,False
1947812,1210,0,30,5457,508181338,1,0,0,694.25,8,619555.05,24,2,15,6,False
2079544,950,0,451,5087,508181338,1,0,0,693.82,7,618861.23,24,0,10,7,True
2206212,950,0,30,9732,508181338,1,0,0,694.2,8,618167.03,24,2,14,7,True
2314651,650,3,451,5087,508181338,1,0,0,694.15,7,617472.88,24,6,19,7,True
2442665,200,0,10,4676,508181338,1,0,0,693.83,6,618166.71,9,5,1,8,False
2680897,1044,0,10,2931,508181338,1,0,0,694.13,0,618860.84,11,0,19,9,False
2790004,435,4,451,5087,508181338,1,0,0,694.22,7,618166.62,24,3,21,10,True
2796986,1159,0,30,6912,508181338,1,0,0,694.0,8,617472.62,15,2,23,12,True
2837690,238,0,20,6290,508181338,1,0,0,693.99,5,616778.63,26,4,6,12,True
3190530,650,3,451,5457,508181338,1,0,0,693.82,7,616084.81,24,0,6,1,True
3258952,1159,0,30,2692,508181338,1,0,0,694.03,8,615390.78,15,5,22,3,True
3483250,1210,0,451,8841,508181338,1,0,0,694.18,7,614696.6,24,4,3,3,True
3709328,1392,4,25,6478,508181338,1,0,0,694.14,8,614002.46,24,3,1,4,False
3920885,1485,0,10,9938,508181338,1,0,0,694.18,6,614696.64,24,1,7,5,True
4001104,591,0,10,8160,508181338,1,0,0,693.8,6,615390.44,24,4,23,8,True
4168908,950,0,30,2931,508181338,1,0,0,694.0,8,614696.44,24,3,8,9,True
4241439,950,0,30,6290,508181338,1,0,0,694.02,8,614002.42,24,4,3,9,True
4495182,650,3,30,7356,508181338,1,0,0,693.8,8,613308.62,24,6,13,9,True
4595319,1210,0,25,5456,508181338,1,0,0,693.71,8,612614.91,24,2,9,10,False
4665372,1210,0,30,9938,508181338,1,0,0,694.05,8,611920.86,24,5,5,10,True
4732719,950,0,30,3087,508181338,1,0,0,694.16,8,611226.7,24,4,4,11,True
4758880,319,0,20,6527,508181338,1,0,0,694.02,5,610532.68,11,0,17,11,True
4791561,205,0,20,5457,508181338,1,0,0,694.02,5,609838.66,9,0,13,11,True
4950034,1064,0,10,6527,508181338,1,0,0,693.99,6,610532.65,11,4,7,11,False
5080000,549,1,10,1184,508181338,1,0,0,693.94,0,611226.59,17,2,15,11,True
5092914,435,4,451,5784,508181338,1,0,0,694.07,7,610532.52,24,2,16,11,True
5145488,1159,0,25,3348,508181338,1,0,0,694.19,8,609838.33,15,5,20,12,True
5355959,1159,0,30,3348,508181338,1,0,0,693.94,8,609144.39,15,5,4,12,True
5523110,1392,4,25,5087,508181338,1,0,0,693.69,8,608450.7,24,4,1,1,True
5719735,1410,1,25,6527,508181338,1,0,0,694.01,8,607756.69,24,2,15,1,True
6720830,1392,4,451,8160,508181338,1,0,0,693.96,7,607062.73,24,1,1,2,True
6790874,842,2,20,9938,508181338,1,0,0,694.01,5,606368.72,5,5,3,2,True
6825290,1410,1,451,9732,508181338,1,0,0,694.11,7,605674.61,24,3,1,3,True
6954607,220,0,20,5087,508181338,1,0,0,693.95,5,604980.66,26,4,11,3,True
7038878,1410,1,30,5087,508181338,1,0,0,693.78,8,604286.88,24,6,4,4,True
7146667,39,3,25,3619,508181338,1,0,0,694.04,8,603592.84,11,2,1,4,True
7158670,1159,0,-1,9938,508181338,1,1,0,694.06,4,603592.84,15,2,16,4,True
7613259,1159,0,25,1076,508181338,1,0,0,693.94,8,602898.9,15,1,16,4,True
7618765,950,0,451,5456,508181338,1,0,0,694.04,7,602204.86,24,4,22,5,True
7817322,1410,1,451,6478,508181338,1,0,0,694.09,7,601510.77,24,5,7,5,True
7998464,1159,0,451,6290,508181338,1,0,0,693.62,7,600817.15,15,6,6,6,True
8023910,525,0,20,7931,508181338,1,0,0,694.09,5,600123.06,18,1,23,6,True
8295144,558,0,20,5784,508181338,1,0,0,694.07,3,599428.99,17,3,13,6,True
8522392,650,3,451,6478,508181338,1,0,0,694.13,7,598734.86,24,5,16,6,False
9246101,605,0,10,2623,508181338,1,0,0,693.97,6,599428.83,24,3,19,7,True
9249054,819,2,-1,6307,508181338,1,1,0,693.95,4,599428.83,18,4,4,7,True
9314024,435,4,-1,5326,508181338,1,2,0,694.14,4,599428.83,24,1,0,7,True
9765766,1034,1,10,7356,508181338,1,0,0,693.86,6,600122.69,11,6,23,8,True
9795356,503,0,10,6527,508181338,1,0,0,694.15,0,600816.84,12,3,17,8,True
9809932,783,0,10,8841,508181338,1,0,0,694.06,0,601510.9,14,4,2,9,True
9862479,1410,1,451,4676,508181338,1,0,0,694.0,7,600816.9,24,2,8,10,True
9945326,819,2,451,3348,508181338,1,0,0,694.16,7,600122.74,18,0,6,11,True
1063099,817,4,451,2982,826489252,1,0,0,207.77,7,151827.23,18,3,2,1,True
1064805,220,0,20,1546,826489252,1,0,0,208.08,5,151619.15,26,0,21,1,True
1134562,577,0,20,7255,826489252,1,0,0,207.92,5,151411.23,11,0,5,1,True
1185792,319,0,30,7900,826489252,1,0,0,207.99,8,151203.24,11,4,17,2,False
1385033,817,4,451,7510,826489252,1,0,0,207.91,7,150995.33,18,5,22,2,True
1496528,817,4,451,6983,826489252,1,0,0,208.15,7,150787.18,18,1,21,2,True
1565499,319,0,-1,5685,826489252,1,1,0,207.95,4,150787.18,11,3,18,2,True
1579613,218,0,30,2361,826489252,1,0,0,208.02,8,150579.16,9,3,19,4,True
1600472,1175,2,30,1380,826489252,1,0,0,208.21,8,150370.95,24,0,16,6,True
1779262,1459,1,10,1380,826489252,1,0,0,208.15,6,150579.1,11,2,19,6,True
1895728,927,4,25,5685,826489252,1,0,0,207.86,8,150371.24,18,5,16,7,True
1994826,817,4,-1,4053,826489252,1,1,0,207.82,1,150371.24,18,3,20,8,True
2364967,218,0,-1,1380,826489252,1,2,0,208.05,4,150371.24,9,5,20,8,True
2416560,817,4,451,8243,826489252,1,0,0,208.06,7,150163.18,18,0,11,8,False
2732372,467,0,10,6983,826489252,1,0,0,208.03,6,150371.21,5,3,16,8,True
2739240,1175,2,25,5467,826489252,1,0,0,207.97,8,150163.24,24,1,8,10,True
2921243,218,0,-1,7255,826489252,1,1,0,208.1,4,150163.24,9,1,8,11,True
3179734,147,0,20,7255,826489252,1,0,0,207.85,3,149955.39,18,6,7,12,True
3328732,1233,0,20,8243,826489252,1,0,0,207.94,5,149747.45,18,0,5,2,True
3446113,817,4,451,6983,826489252,1,0,0,208.28,7,149539.17,18,6,3,2,True
3793240,817,4,451,8449,826489252,1,0,0,208.08,7,149331.09,18,1,22,3,True
3819842,1212,0,20,5467,826489252,1,0,0,208.08,5,149123.01,24,4,14,3,True
3996772,319,0,25,1380,826489252,1,0,0,208.12,8,148914.89,11,6,10,3,True
4274876,218,0,25,6141,826489252,1,0,0,208.03,8,148706.86,9,6,15,4,True
4503884,429,0,10,6551,826489252,1,0,0,208.09,0,148914.95,24,1,10,5,True
4837025,889,0,20,4053,826489252,1,0,0,208.21,5,148706.74,27,5,3,6,True
5251121,319,0,25,9829,826489252,1,0,0,207.84,8,148498.9,11,2,11,6,True
5297848,218,0,30,4053,826489252,1,0,0,207.99,8,148290.91,9,5,3,7,True
5640541,1175,2,-1,2982,826489252,1,1,0,207.94,4,148290.91,24,0,5,7,True
6237163,927,4,451,2982,826489252,1,0,0,207.9,7,148083.01,18,4,3,9,True
6354662,1175,2,451,6551,826489252,1,0,0,208.15,7,147874.86,24,6,14,9,True
6668955,1175,2,451,6551,826489252,1,0,0,207.99,7,147666.87,24,2,23,9,True
7029786,927,4,451,2361,826489252,1,0,0,208.27,7,147458.6,18,0,10,10,True
7211785,218,0,30,6551,826489252,1,0,0,208.41,8,147250.19,9,3,11,10,True
7350622,1434,0,20,8243,826489252,1,0,0,208.12,5,147042.07,24,6,19,11,True
7770370,1175,2,25,2982,826489252,1,0,0,207.77,8,146834.3,24,5,4,12,True
8233959,817,4,451,8243,826489252,1,0,0,208.3,7,146626.0,18,3,7,12,False
8243226,1175,2,25,8449,826489252,1,0,0,207.91,8,146418.09,24,6,3,12,True
8364285,557,1,10,8243,826489252,1,0,0,208.18,6,146626.27,17,1,21,1,True
8404293,319,0,-1,6551,826489252,1,1,0,207.89,4,146626.27,11,3,13,2,True
8657013,927,4,-1,9829,826489252,1,2,0,208.03,4,146626.27,18,6,10,3,False
8744480,1175,2,25,2361,826489252,1,0,0,208.04,8,146418.23,24,5,16,3,True
8803106,817,4,25,5685,826489252,1,0,0,208.08,8,146210.15,18,1,23,5,True
8807676,218,0,451,1380,826489252,1,0,0,208.11,7,146002.04,9,3,8,5,True
9013797,319,0,30,6983,826489252,1,0,0,208.12,8,145793.92,11,3,12,5,True
9220647,1273,0,10,9448,826489252,1,0,0,208.06,6,146001.98,24,6,16,5,True
9264996,319,0,451,5685,826489252,1,0,0,207.99,7,145793.99,11,6,3,8,True
9519433,218,0,-1,6551,826489252,1,1,0,207.92,1,145793.99,9,1,21,8,True
9532378,927,4,25,2982,826489252,1,0,0,207.95,8,145586.04,18,2,7,8,True
9673305,927,4,451,1546,826489252,1,0,0,207.93,7,145378.11,18,1,13,9,True
9750494,319,0,30,9448,826489252,1,0,0,208.09,8,145170.02,11,2,18,10,True
9946697,940,1,10,8243,826489252,1,0,0,208.14,6,145378.16,24,4,19,10,False
1380962,158,2,-1,2505,323334099,0,1,0,367.89,1,85424.0,24,6,7,1,True
1946397,120,4,-1,6829,323334099,0,2,0,368.02,4,85424.0,18,5,3,2,True
1970440,120,4,451,3969,323334099,0,0,0,368.13,7,85055.87,18,6,23,5,False
2581956,120,4,25,4370,323334099,0,0,0,368.28,8,84687.59,18,4,8,6,True
2839881,393,1,10,8105,323334099,0,0,0,367.86,6,85055.45,10,2,15,7,True
2848840,1474,0,20,6401,323334099,0,0,0,367.84,3,84687.61,24,1,19,7,True
2935600,98,0,10,7457,323334099,0,0,0,367.79,6,85055.4,3,2,23,7,True
3039295,956,1,30,2505,323334099,0,0,0,367.82,8,84687.58,13,3,20,7,True
3227186,1035,0,25,6254,323334099,0,0,0,367.86,8,84319.72,11,1,4,10,True
3409037,158,2,25,1936,323334099,0,0,0,367.98,8,83951.74,24,3,5,10,True
3704509,120,4,25,2385,323334099,0,0,0,367.96,8,83583.78,18,4,2,11,True
3900894,210,4,451,6254,323334099,0,0,0,367.91,7,83215.87,9,6,15,11,True
3936436,1035,0,30,8573,323334099,0,0,0,368.0,8,82847.87,11,0,7,12,True
4097075,1483,0,20,7452,323334099,0,0,0,368.04,3,82479.83,24,2,11,1,True
4270491,120,4,451,5986,323334099,0,0,0,367.94,7,82111.89,18,5,20,1,True
4314469,1035,0,-1,8573,323334099,0,1,0,367.97,1,82111.89,11,4,11,3,True
4571337,120,4,451,6829,323334099,0,0,0,367.81,7,81744.08,18,2,9,3,True
4714308,1278,0,20,8105,323334099,0,0,0,368.0,5,81376.08,24,0,16,3,True
4990700,120,4,30,4766,323334099,0,0,0,368.11,8,81007.97,18,5,20,4,True
5267136,120,4,451,4370,323334099,0,0,0,367.83,7,80640.14,18,0,12,5,True
5381961,956,1,451,9785,323334099,0,0,0,367.94,7,80272.2,13,1,2,5,True
5553144,120,4,30,4453,323334099,0,0,0,367.98,8,79904.22,18,6,5,5,True
5558659,158,2,-1,6829,323334099,0,1,0,368.24,4,79904.22,24,5,3,6,True
5663720,158,2,451,4370,323334099,0,0,0,368.13,7,79536.09,24,6,2,6,True
5899773,956,1,451,7452,323334099,0,0,0,367.97,7,79168.12,13,5,4,6,True
6101242,312,0,20,5986,323334099,0,0,0,368.02,3,78800.1,4,5,1,8,False
6152822,120,4,451,5986,323334099,0,0,0,367.88,7,78432.22,18,4,4,8,True
6515115,1035,0,-1,8114,323334099,0,1,0,368.02,4,78432.22,11,6,13,9,True
6592180,210,4,451,6829,323334099,0,0,0,368.12,7,78064.1,9,0,12,10,True
6706366,158,2,30,3199,323334099,0,0,0,367.94,8,77696.16,24,4,21,10,True
6756856,907,0,20,6254,323334099,0,0,0,368.11,3,77328.05,2,4,22,10,True
6929855,550,0,20,1936,323334099,0,0,0,367.7,3,76960.35,17,0,3,11,True
6951997,120,4,30,5074,323334099,0,0,0,368.09,8,76592.26,18,4,0,11,True
6957950,1035,0,451,6401,323334099,0,0,0,368.14,7,76224.12,11,6,16,11,True
7065938,956,1,451,2490,323334099,0,0,0,368.17,7,75855.95,13,3,18,11,True
7101014,278,1,10,6401,323334099,0,0,0,367.64,6,76223.59,24,6,15,1,True
7223238,120,4,451,8914,323334099,0,0,0,367.73,7,75855.86,18,3,21,2,True
7328153,210,4,-1,4370,323334099,0,1,0,367.9,4,75855.86,9,3,4,3,True
7396609,158,2,451,6664,323334099,0,0,0,368.09,7,75487.77,24,0,18,4,True
7483893,120,4,451,4766,323334099,0,0,0,367.95,7,75119.82,18,6,7,4,True
7719705,210,4,30,4766,323334099,0,0,0,368.19,8,74751.63,9,1,17,4,True
7914485,1273,0,10,5170,323334099,0,0,0,367.74,0,75119.37,24,5,10,4,True
7955086,193,1,10,9785,323334099,0,0,0,367.9,0,75487.27,18,2,17,5,True
8004109,160,0,10,8896,323334099,0,0,0,368.04,6,75855.31,24,1,19,5,True
8254444,210,4,25,2505,323334099,0,0,0,367.85,8,75487.46,9,0,19,6,True
8613976,158,2,451,7452,323334099,0,0,0,367.89,7,75119.57,24,0,23,6,True
8968965,956,1,451,8573,323334099,0,0,0,367.81,7,74751.76,13,3,2,6,True
9267578,120,4,451,8573,323334099,0,0,0,367.88,7,74383.88,18,0,23,6,True
9394883,210,4,451,2505,323334099,0,0,0,368.18,7,74015.7,9,5,17,8,True
9547851,120,4,-1,6664,323334099,0,1,0,368.27,4,74015.7,18,5,4,9,True
9881432,956,1,451,6401,323334099,0,0,0,367.89,7,73647.81,13,4,14,9,True
9905885,1035,0,30,5170,323334099,0,0,0,367.79,8,73280.02,11,4,4,9,True
1347958,46,1,25,8317,843744198,1,0,0,890.1,8,655059.9,24,6,2,1,True
1382640,824,2,451,1470,843744198,1,0,0,889.76,7,654170.14,18,4,9,6,True
1543379,767,0,20,2280,843744198,1,0,0,890.01,5,653280.13,14,1,14,6,False
1739689,1101,2,451,8902,843744198,1,0,0,889.8,7,652390.33,0,3,5,6,True
1819230,78,3,25,3897,843744198,1,0,0,889.61,8,651500.72,1,5,6,7,True
1927565,78,3,25,2870,843744198,1,0,0,889.98,8,650610.74,1,1,17,8,True
2027148,78,3,25,3897,843744198,1,0,0,889.91,8,649720.83,1,2,17,8,True
2058024,1326,3,-1,3161,843744198,1,1,0,890.06,4,649720.83,18,4,22,8,True
2070865,1338,0,20,5766,843744198,1,0,0,890.05,5,648830.78,18,5,9,10,True
2373702,1101,2,25,7196,843744198,1,0,0,890.18,8,647940.6,0,0,10,10,True
2456649,46,1,-1,4628,843744198,1,1,0,889.92,4,647940.6,24,6,13,10,True
2743808,46,1,-1,9072,843744198,1,2,0,889.74,4,647940.6,24,3,21,12,True
3180554,882,0,20,3193,843744198,1,0,0,890.04,3,647050.56,27,5,23,12,True
3230085,46,1,-1,6428,843744198,1,1,0,890.0,4,647050.56,24,1,19,1,True
3518719,824,2,-1,5132,843744198,1,2,0,890.04,4,647050.56,18,6,1,4,True
3654034,46,1,30,6622,843744198,1,0,0,890.17,8,646160.39,24,6,20,5,True
3720560,46,1,-1,8478,843744198,1,1,0,889.97,1,646160.39,24,4,10,5,True
3837393,78,3,30,6021,843744198,1,0,0,889.99,8,645270.4,1,3,11,6,False
3959434,1326,3,-1,5655,843744198,1,1,0,890.05,4,645270.4,18,1,14,7,True
3999778,29,0,20,3088,843744198,1,0,0,890.0,3,644380.4,11,1,9,8,True
4075446,576,2,20,3897,843744198,1,0,0,889.86,5,643490.54,11,3,23,8,True
4233037,1101,2,30,8902,843744198,1,0,0,889.85,8,642600.69,0,0,18,11,True
4290862,1326,3,25,6102,843744198,1,0,0,890.13,8,641710.56,18,5,18,12,True
4730430,1326,3,-1,2870,843744198,1,1,0,890.13,4,641710.56,18,3,5,12,True
4764084,824,2,30,2870,843744198,1,0,0,890.29,8,640820.27,18,0,1,12,True
4894582,78,3,25,6622,843744198,1,0,0,889.93,8,639930.34,1,6,21,3,True
4978632,46,1,451,3733,843744198,1,0,0,889.97,7,639040.37,24,4,12,3,True
4986921,1210,0,20,2280,843744198,1,0,0,890.28,5,638150.09,24,2,21,4,True
5183176,998,0,10,5655,843744198,1,0,0,890.12,6,639040.21,26,0,18,5,True
5357981,1326,3,30,5172,843744198,1,0,0,889.83,8,638150.38,18,4,13,5,True
5401846,895,0,10,5655,843744198,1,0,0,890.16,6,639040.54,24,2,17,5,True
5566929,824,2,451,2870,843744198,1,0,0,889.86,7,638150.68,18,1,11,6,True
5572334,1101,2,451,2870,843744198,1,0,0,890.07,7,637260.61,0,3,11,7,True
5580279,816,0,20,6428,843744198,1,0,0,889.96,3,636370.65,18,0,12,8,True
5581439,1326,3,-1,5134,843744198,1,1,0,890.34,4,636370.65,18,2,5,9,True
5636394,824,2,-1,2887,843744198,1,2,0,890.01,4,636370.65,18,5,4,10,True
5753652,46,1,-1,8450,843744198,1,3,1,890.39,4,636370.65,24,3,14,11,True
1052565,201,1,25,9003,459293283,0,0,0,689.19,8,898616.81,9,5,2,1,True
1198986,201,1,451,6365,459293283,0,0,0,688.95,7,897927.86,9,0,14,1,True
1556046,47,1,10,6560,459293283,0,0,0,688.98,6,898616.84,24,1,6,3,True
1557004,1009,0,10,4947,459293283,0,0,0,688.94,6,899305.78,26,3,17,4,True
1911494,1495,3,30,4901,459293283,0,0,0,688.93,8,898616.85,24,5,21,4,True
2101410,654,1,10,3831,459293283,0,0,0,689.1,6,899305.95,18,3,16,5,True
2409177,1485,0,30,9003,459293283,0,0,0,688.96,8,898616.99,24,0,20,5,True
2432277,1495,3,451,5255,459293283,0,0,0,688.89,7,897928.1,24,6,6,6,True
2665845,1495,3,30,6365,459293283,0,0,0,689.11,8,897238.99,24,4,11,6,True
2858534,1485,0,25,5293,459293283,0,0,0,688.83,8,896550.16,24,4,21,6,True
2913984,201,1,30,1537,459293283,0,0,0,688.86,8,895861.3,9,0,17,7,True
3589714,1485,0,451,3021,459293283,0,0,0,688.94,7,895172.36,24,2,11,8,True
4137336,1485,0,30,8213,459293283,0,0,0,688.87,8,894483.49,24,2,13,9,True
4298532,1007,2,451,2999,459293283,0,0,0,689.11,7,893794.38,26,1,21,9,True
4456916,201,1,25,5293,459293283,0,0,0,689.21,8,893105.17,9,2,8,9,True
4864420,580,0,451,6101,459293283,0,0,0,689.14,7,892416.03,11,4,17,9,True
5040164,1485,0,25,9510,459293283,0,0,0,689.02,8,891727.01,24,0,5,10,True
5071343,1007,2,25,2999,459293283,0,0,0,689.17,8,891037.84,26,3,13,11,True
5117797,580,0,-1,6101,459293283,0,1,0,688.96,4,891037.84,11,5,21,12,True
5418147,580,0,-1,5061,459293283,0,2,0,688.93,4,891037.84,11,1,1,1,True
5663748,1325,0,10,9613,459293283,0,0,0,688.71,6,891726.55,18,3,11,4,True
6014332,580,0,451,7804,459293283,0,0,0,689.14,7,891037.41,11,0,9,5,False
6043102,1495,3,451,2761,459293283,0,0,0,689.25,7,890348.16,24,6,13,5,True
6228654,1007,2,-1,6101,459293283,0,1,0,689.26,4,890348.16,26,0,8,6,True
6335544,201,1,-1,2852,459293283,0,2,0,688.97,4,890348.16,9,6,12,6,False
6577727,673,0,20,4947,459293283,0,0,0,689.13,3,889659.03,18,4,11,6,True
6765863,201,1,25,6101,459293283,0,0,0,689.17,8,888969.86,9,5,9,8,True
6864426,1338,0,20,3831,459293283,0,0,0,689.15,5,888280.71,18,3,21,9,True
7007991,1485,0,25,4947,459293283,0,0,0,689.23,8,887591.48,24,5,12,11,True
7044306,1495,3,25,9510,459293283,0,0,0,688.95,8,886902.53,24,3,6,11,True
7235393,1105,2,20,5147,459293283,0,0,0,688.87,5,886213.66,0,5,1,12,True
7769089,1495,3,30,4901,459293283,0,0,0,688.97,8,885524.69,24,1,12,12,True
7835990,219,0,20,3346,459293283,0,0,0,689.03,5,884835.66,9,3,14,1,True
7918578,201,1,451,5293,459293283,0,0,0,689.09,7,884146.57,9,5,0,1,True
8048107,585,2,20,5255,459293283,0,0,0,688.83,5,883457.74,11,2,11,2,True
8182402,201,1,-1,5147,459293283,0,1,0,689.17,4,883457.74,9,6,3,3,True
8183037,580,0,30,4190,459293283,0,0,0,689.01,8,882768.73,11,4,6,4,True
8395904,580,0,-1,2999,459293283,0,1,0,688.89,1,882768.73,11,3,0,4,True
8444458,1429,0,10,7556,459293283,0,0,0,688.94,6,883457.67,24,5,6,5,True
8482092,1007,2,-1,2999,459293283,0,1,0,688.84,4,883457.67,26,1,15,6,True
8662581,580,0,30,1537,459293283,0,0,0,688.88,8,882768.79,11,3,1,6,True
8984362,1105,2,20,7804,459293283,0,0,0,689.35,3,882079.44,0,5,14,6,True
9099372,1495,3,451,2761,459293283,0,0,0,689.04,7,881390.4,24,3,10,7,True
9103502,201,1,30,7556,459293283,0,0,0,688.99,8,880701.41,9,4,12,7,True
9117588,580,0,451,5147,459293283,0,0,0,689.01,7,880012.4,11,6,22,7,True
9526769,1495,3,451,7804,459293283,0,0,0,688.88,7,879323.52,24,2,8,7,True
9626652,1495,3,30,3831,459293283,0,0,0,688.9,8,878634.62,24,6,13,9,True
9703933,940,1,10,5746,459293283,0,0,0,689.05,6,879323.67,24,1,21,9,True
9713667,201,1,-1,7804,459293283,0,1,0,688.81,4,879323.67,9,3,5,9,True
9893678,1007,2,451,3346,459293283,0,0,0,689.06,7,878634.61,26,2,10,10,True
9906406,1495,3,451,9546,459293283,0,0,0,689.07,7,877945.54,24,5,18,11,True
9940712,201,1,451,4591,459293283,0,0,0,689.04,7,877256.5,9,0,3,11,True
1113288,425,4,30,5996,671273475,0,0,0,1143.93,8,625466.07,18,3,20,1,True
1151066,425,4,451,4293,671273475,0,0,0,1143.79,7,624322.28,18,2,8,1,True
1287602,729,0,10,6166,671273475,0,0,0,1144.34,6,625466.62,11,6,2,1,True
1482974,835,4,25,4281,671273475,0,0,0,1144.35,8,624322.27,5,4,14,3,True
1753237,425,4,30,1954,671273475,0,0,0,1144.04,8,623178.23,18,4,17,3,True
1969572,425,4,-1,5204,671273475,0,1,0,1144.18,1,623178.23,18,0,10,4,True
2026953,854,0,20,5996,671273475,0,0,0,1144.14,5,622034.09,24,3,23,5,True
2069600,381,4,25,1877,671273475,0,0,0,1143.84,8,620890.25,25,2,12,5,True
2479250,167,2,451,6888,671273475,0,0,0,1144.14,7,619746.11,24,5,16,5,True
2505635,224,3,30,1954,671273475,0,0,0,1143.99,8,618602.12,26,1,13,7,True
2916126,381,4,-1,1051,671273475,0,1,0,1144.16,4,618602.12,25,0,23,8,True
2964653,835,4,25,8204,671273475,0,0,0,1144.03,8,617458.09,5,4,17,9,True
3047336,425,4,451,5335,671273475,0,0,0,1143.88,7,616314.21,18,4,14,10,True
3170712,835,4,25,5185,671273475,0,0,0,1143.94,8,615170.27,5,1,9,10,True
3246080,224,3,30,6888,671273475,0,0,0,1144.08,8,614026.19,26,1,19,10,True
3554964,579,0,10,5262,671273475,0,0,0,1144.12,0,615170.31,11,3,11,10,True
3667446,224,3,-1,9960,671273475,0,1,0,1143.99,4,615170.31,26,2,8,12,True
3691421,425,4,25,5116,671273475,0,0,0,1144.08,8,614026.23,18,0,10,1,True
3802630,224,3,451,5335,671273475,0,0,0,1143.96,7,612882.27,26,6,4,3,True
3819934,224,3,451,5996,671273475,0,0,0,1144.1,7,611738.17,26,4,23,3,True
3955944,224,3,451,8204,671273475,0,0,0,1143.83,7,610594.34,26,5,18,4,True
4271464,1212,0,20,5204,671273475,0,0,0,1144.16,3,609450.18,24,1,17,5,True
4444147,498,0,20,5262,671273475,0,0,0,1144.02,5,608306.16,12,3,3,5,True
4682762,1044,0,20,4293,671273475,0,0,0,1143.99,5,607162.17,11,0,7,5,True
4695361,381,4,25,4293,671273475,0,0,0,1144.09,8,606018.08,25,6,0,6,True
4732680,224,3,-1,4293,671273475,0,1,0,1144.03,4,606018.08,26,4,3,6,True
4925086,224,3,25,6888,671273475,0,0,0,1144.08,8,604874.0,26,4,16,9,True
4962055,425,4,25,8204,671273475,0,0,0,1143.82,8,603730.18,18,6,1,9,True
5159157,381,4,-1,4293,671273475,0,1,0,1144.02,4,603730.18,25,1,18,9,True
5239149,502,0,20,5204,671273475,0,0,0,1144.0,3,602586.18,12,4,6,9,True
5378999,424,1,10,1370,671273475,0,0,0,1144.29,6,603730.47,18,6,23,10,True
5533300,835,4,25,9804,671273475,0,0,0,1144.06,8,602586.41,5,1,10,10,True
5573882,835,4,30,6166,671273475,0,0,0,1144.0,8,601442.41,5,4,6,11,True
5647296,224,3,-1,9804,671273475,0,1,0,1144.21,4,601442.41,26,0,12,11,True
5815361,381,4,25,8717,671273475,0,0,0,1144.04,8,600298.37,25,1,16,1,True
5883401,167,2,25,5204,671273475,0,0,0,1143.98,8,599154.39,24,2,16,1,True
5926865,1247,0,10,8204,671273475,0,0,0,1144.01,6,600298.4,23,1,16,2,True
5941555,835,4,451,8204,671273475,0,0,0,1144.06,7,599154.34,5,0,12,2,True
6164264,835,4,451,8717,671273475,0,0,0,1144.19,7,598010.15,5,0,14,2,True
6311415,381,4,451,8018,671273475,0,0,0,1144.03,7,596866.12,25,2,14,3,True
6759535,341,0,10,5185,671273475,0,0,0,1143.91,6,598010.03,24,2,14,3,True
6808973,835,4,30,1877,671273475,0,0,0,1144.25,8,596865.78,5,5,17,3,True
7026961,381,4,-1,6230,671273475,0,1,0,1144.0,4,596865.78,25,5,22,3,True
7044955,381,4,-1,8717,671273475,0,2,0,1144.17,1,596865.78,25,5,18,4,True
7083909,381,4,25,5996,671273475,0,0,0,1144.16,8,595721.62,25,0,16,4,False
7237242,835,4,451,8607,671273475,0,0,0,1143.87,7,594577.75,5,1,2,5,True
7240790,381,4,451,8204,671273475,0,0,0,1143.93,7,593433.82,25,3,7,5,False
7846069,947,2,20,8293,671273475,0,0,0,1144.12,5,592289.7,24,0,20,6,True
7869204,835,4,451,5996,671273475,0,0,0,1144.08,7,591145.62,5,2,7,7,True
8064169,425,4,25,1877,671273475,0,0,0,1143.82,8,590001.8,18,6,13,8,True
8121792,167,2,25,1370,671273475,0,0,0,1144.15,8,588857.65,24,1,18,8,True
8322193,167,2,30,1370,671273475,0,0,0,1143.78,8,587713.87,24,3,14,9,True
8513259,835,4,25,1051,671273475,0,0,0,1143.88,8,586569.99,5,6,6,9,True
8874722,224,3,30,8293,671273475,0,0,0,1144.24,8,585425.75,26,0,4,9,True
9405127,381,4,451,5996,671273475,0,0,0,1143.91,7,584281.84,25,6,22,10,True
9474408,167,2,30,1239,671273475,0,0,0,1143.92,8,583137.92,24,6,21,10,True
9481070,167,2,451,1877,671273475,0,0,0,1143.94,7,581993.98,24,2,4,11,True
9804224,1053,1,10,4293,671273475,0,0,0,1143.78,0,583137.76,11,0,21,11,True
1005258,1334,3,-1,4697,758283706,0,1,0,1179.81,4,282038.0,18,2,21,1,True
1026736,982,4,30,1229,758283706,0,0,0,1180.09,8,280857.91,22,5,19,1,True
1224822,982,4,30,2573,758283706,0,0,0,1180.01,8,279677.9,22,6,6,2,True
1734486,1036,1,25,1913,758283706,0,0,0,1180.02,8,278497.88,11,1,3,3,True
1840306,982,4,25,9913,758283706,0,0,0,1180.02,8,277317.86,22,3,1,3,True
2010700,1036,1,25,7892,758283706,0,0,0,1180.08,8,276137.78,11,6,14,4,True
2559961,1334,3,451,3096,758283706,0,0,0,1179.84,7,274957.94,18,5,11,4,True
2623836,608,4,25,1229,758283706,0,0,0,1179.79,8,273778.15,24,0,8,6,True
3088815,1110,0,20,7922,758283706,0,0,0,1180.1,5,272598.05,0,6,14,7,True
3140296,167,2,25,9883,758283706,0,0,0,1179.89,8,271418.16,24,3,3,7,True
3431461,608,4,30,7892,758283706,0,0,0,1180.11,8,270238.05,24,6,21,7,True
3922389,982,4,-1,7134,758283706,0,1,0,1179.93,4,270238.05,22,1,9,8,True
4419590,167,2,451,7929,758283706,0,0,0,1180.25,7,269057.8,24,3,1,8,True
4442790,1036,1,25,7929,758283706,0,0,0,1180.35,8,267877.45,11,2,13,11,True
4503694,608,4,30,1229,758283706,0,0,0,1180.04,8,266697.41,24,6,1,1,True
4552427,1485,0,20,9913,758283706,0,0,0,1179.98,3,265517.43,24,0,18,2,True
4569592,1007,2,20,7134,758283706,0,0,0,1180.21,5,264337.22,26,2,11,2,True
4673567,1036,1,-1,9913,758283706,0,1,0,1180.12,4,264337.22,11,5,22,3,True
4679479,1461,0,10,5751,758283706,0,0,0,1179.91,6,265517.13,11,4,9,3,True
4755479,20,0,10,9883,758283706,0,0,0,1180.17,0,266697.3,24,6,8,4,True
4803242,851,1,10,1229,758283706,0,0,0,1179.91,0,267877.21,5,5,4,4,True
4811279,1378,3,30,2573,758283706,0,0,0,1180.04,8,266697.17,16,0,23,4,True
4895563,167,2,30,4781,758283706,0,0,0,1179.97,8,265517.2,24,3,0,4,True
4902344,1450,4,-1,1229,758283706,0,1,0,1179.73,1,265517.2,11,5,18,5,True
5031720,1169,0,10,7892,758283706,0,0,0,1179.8,0,266697.0,24,3,22,6,True
5088808,608,4,30,6257,758283706,0,0,0,1179.96,8,265517.04,24,5,20,6,True
5613763,260,0,10,1913,758283706,0,0,0,1180.08,0,266697.12,6,1,14,7,True
6351579,1334,3,30,6470,758283706,0,0,0,1179.93,8,265517.19,18,0,12,7,True
6825934,982,4,-1,1377,758283706,0,1,0,1180.48,4,265517.19,22,2,0,8,True
7016845,1380,0,20,3955,758283706,0,0,0,1180.15,3,264337.04,16,2,6,9,True
7059468,898,1,25,4781,758283706,0,0,0,1180.12,8,263156.92,24,6,19,9,True
7094654,1450,4,30,3955,758283706,0,0,0,1180.03,8,261976.89,11,3,15,10,True
7216661,1450,4,25,8073,758283706,0,0,0,1179.93,8,260796.96,11,3,5,10,True
7608421,1416,4,-1,7142,758283706,0,1,0,1180.1,4,260796.96,24,5,13,10,True
7630697,1036,1,451,7142,758283706,0,0,0,1179.85,7,259617.11,11,2,20,10,True
7894524,1036,1,451,3955,758283706,0,0,0,1179.8,7,258437.31,11,1,20,11,True
8013752,376,0,20,3096,758283706,0,0,0,1179.97,3,257257.34,25,0,16,11,True
8020559,1416,4,-1,4697,758283706,0,1,0,1180.13,4,257257.34,24,3,14,11,True
8055260,785,0,10,3955,758283706,0,0,0,1179.76,6,258437.1,14,3,15,12,True
8101623,167,2,451,3096,758283706,0,0,0,1180.08,7,257257.02,24,5,12,12,True
8198734,898,1,-1,9913,758283706,0,1,0,1180.08,4,257257.02,24,1,18,1,True
8322969,898,1,30,7134,758283706,0,0,0,1179.97,8,256077.05,24,0,3,3,True
8591173,608,4,451,7929,758283706,0,0,0,1179.8,7,254897.25,24,2,23,4,True
8801286,608,4,25,8073,758283706,0,0,0,1180.06,8,253717.19,24,6,19,4,True
8960040,1450,4,30,9913,758283706,0,0,0,1180.05,8,252537.14,11,6,3,5,True
9062457,608,4,-1,9883,758283706,0,1,0,1179.68,1,252537.14,24,2,4,5,True
9254166,608,4,25,9913,758283706,0,0,0,1180.11,8,251357.03,24,1,21,7,True
9298157,1159,0,20,4781,758283706,0,0,0,1180.29,5,250176.74,15,0,15,9,True
9465671,406,1,10,9913,758283706,0,0,0,1180.22,6,251356.96,10,1,18,9,True
9491549,608,4,451,7580,758283706,0,0,0,1180.0,7,250176.96,24,3,16,9,True
9741303,1134,1,10,7268,758283706,0,0,0,1179.97,0,251356.93,24,0,18,10,True
9898971,1036,1,25,7580,758283706,0,0,0,1179.88,8,250177.05,11,2,4,11,True
1012261,139,4,30,6126,167165799,1,0,0,141.05,8,520021.95,18,6,1,1,True
1366466,1284,2,20,3401,167165799,1,0,0,140.85,5,519881.1,24,6,21,1,True
1485210,529,2,30,8726,167165799,1,0,0,140.83,8,519740.27,18,3,17,3,True
2003880,1379,3,451,3530,167165799,1,0,0,140.63,7,519599.64,16,3,10,4,True
2091300,529,2,451,7714,167165799,1,0,0,140.93,7,519458.71,18,3,7,4,True
2169273,1379,3,-1,1637,167165799,1,1,0,140.9,1,519458.71,16,5,11,4,True
2307791,704,3,25,7487,167165799,1,0,0,140.88,8,519317.83,18,3,17,5,True
2347274,1379,3,25,8377,167165799,1,0,0,140.88,8,519176.95,16,2,17,6,True
2450859,637,4,25,2108,167165799,1,0,0,141.1,8,519035.85,24,6,12,7,True
2540728,637,4,30,1065,167165799,1,0,0,141.23,8,518894.62,24,4,19,8,True
2615810,823,4,451,6126,167165799,1,0,0,140.92,7,518753.7,18,0,2,8,False
3026539,1278,0,25,3312,167165799,1,0,0,140.89,8,518612.81,24,0,4,8,True
3103531,1278,0,451,1441,167165799,1,0,0,141.06,7,518471.75,24,0,21,8,True
3425603,637,4,451,7487,167165799,1,0,0,140.94,7,518330.81,24,6,12,8,True
3571281,850,1,30,9392,167165799,1,0,0,140.64,8,518190.17,5,6,16,8,True
3789977,1090,0,10,2108,167165799,1,0,0,140.99,0,518331.16,18,2,6,9,True
3805038,1217,0,10,5082,167165799,1,0,0,141.07,0,518472.23,24,4,7,10,True
3893354,529,2,25,1710,167165799,1,0,0,140.96,8,518331.27,18,4,8,10,True
4112188,857,1,10,3548,167165799,1,0,0,140.87,6,518472.14,24,6,22,10,True
4415276,704,3,-1,3573,167165799,1,1,0,141.14,4,518472.14,18,3,9,10,True
4774210,850,1,451,7714,167165799,1,0,0,140.99,7,518331.15,5,1,11,11,True
4807873,637,4,25,2946,167165799,1,0,0,140.83,8,518190.32,24,1,17,2,True
4991424,139,4,30,1710,167165799,1,0,0,141.35,8,518048.97,18,6,19,3,True
5062161,823,4,451,6080,167165799,1,0,0,141.26,7,517907.71,18,5,0,4,False
5170877,850,1,451,5082,167165799,1,0,0,140.78,7,517766.93,5,6,17,4,True
5356936,1093,0,20,6080,167165799,1,0,0,141.2,5,517625.73,18,3,6,5,True
5548651,139,4,451,6080,167165799,1,0,0,140.99,7,517484.74,18,1,16,5,True
5574479,1278,0,-1,6126,167165799,1,1,0,140.89,1,517484.74,24,4,10,5,True
5964247,529,2,451,3312,167165799,1,0,0,141.18,7,517343.56,18,4,18,5,True
6171368,139,4,451,6126,167165799,1,0,0,140.92,7,517202.64,18,4,6,6,True
6263259,482,1,10,8726,167165799,1,0,0,140.79,0,517343.43,5,4,16,6,True
6281782,568,1,10,3312,167165799,1,0,0,140.85,6,517484.28,11,3,3,7,True
6446425,850,1,451,3548,167165799,1,0,0,141.25,7,517343.03,5,2,5,7,True
6633058,823,4,-1,1113,167165799,1,1,0,141.1,4,517343.03,18,5,8,9,True
6696303,1278,0,30,1065,167165799,1,0,0,141.08,8,517201.95,24,1,22,9,True
6868860,529,2,30,1710,167165799,1,0,0,141.19,8,517060.76,18,2,21,9,True
6979103,529,2,25,3530,167165799,1,0,0,140.81,8,516919.95,18,3,10,9,True
7047671,823,4,451,8163,167165799,1,0,0,141.04,7,516778.91,18,0,9,9,True
7500965,1278,0,30,5082,167165799,1,0,0,140.9,8,516638.01,24,5,10,10,True
7539632,1278,0,451,1065,167165799,1,0,0,140.98,7,516497.03,24,6,8,10,True
7562136,1379,3,451,3312,167165799,1,0,0,140.99,7,516356.04,16,4,9,11,True
7974966,1278,0,451,3573,167165799,1,0,0,140.96,7,516215.08,24,3,10,11,True
8262468,871,0,10,7714,167165799,1,0,0,140.8,6,516355.88,24,3,17,11,True
8385430,1379,3,451,3312,167165799,1,0,0,141.0,7,516214.88,16,3,4,12,True
8506577,1379,3,451,1441,167165799,1,0,0,141.17,7,516073.71,16,0,13,12,True
8780221,1379,3,451,5106,167165799,1,0,0,141.11,7,515932.6,16,3,11,12,True
8919222,529,2,30,8726,167165799,1,0,0,141.25,8,515791.35,18,3,17,12,True
9085843,47,1,10,9549,167165799,1,0,0,140.97,6,515932.32,24,3,3,1,True
9086278,304,0,10,2108,167165799,1,0,0,140.99,0,516073.31,4,0,1,3,False
9088966,139,4,-1,5106,167165799,1,1,0,141.2,4,516073.31,18,4,9,4,True
9193017,139,4,451,8377,167165799,1,0,0,140.79,7,515932.52,18,0,22,4,True
9588126,139,4,451,3312,167165799,1,0,0,140.89,7,515791.63,18,2,6,5,True
9588689,139,4,-1,7487,167165799,1,1,0,141.03,1,515791.63,18,2,18,6,True
9784652,823,4,451,6126,167165799,1,0,0,141.15,7,515650.48,18,6,9,6,False
9870534,139,4,30,9392,167165799,1,0,0,141.3,8,515509.18,18,0,5,7,True
1002208,168,0,10,3396,968196121,1,0,0,241.92,0,650887.92,24,6,3,2,True
1468398,847,3,-1,7323,968196121,1,1,0,242.0,4,650887.92,5,3,6,2,True
1504907,168,0,30,8866,968196121,1,0,0,242.04,8,650645.88,24,3,12,2,True
1565323,630,0,20,8322,968196121,1,0,0,241.9,5,650403.98,11,2,15,4,True
1989934,97,0,20,1542,968196121,1,0,0,242.0,5,650161.98,3,3,17,4,True
2012116,1445,2,20,5949,968196121,1,0,0,242.11,3,649919.87,24,3,0,4,True
2026499,712,0,25,8037,968196121,1,0,0,241.86,8,649678.01,18,2,8,5,True
2236209,712,0,-1,1542,968196121,1,1,0,241.76,4,649678.01,18,5,21,5,True
2364769,866,0,20,5446,968196121,1,0,0,242.27,5,649435.74,24,6,1,6,True
3045056,712,0,451,5982,968196121,1,0,0,242.33,7,649193.41,18,0,17,6,True
3108966,712,0,25,5982,968196121,1,0,0,242.07,8,648951.34,18,3,5,6,True
3343933,712,0,451,8185,968196121,1,0,0,241.98,7,648709.36,18,2,22,6,True
4007444,105,3,-1,3396,968196121,1,1,0,241.97,1,648709.36,3,6,19,7,True
4387556,879,1,10,5949,968196121,1,0,0,241.87,6,648951.23,27,5,7,8,False
4412626,792,1,10,3806,968196121,1,0,0,241.99,6,649193.22,11,1,18,9,True
4469871,996,0,25,4628,968196121,1,0,0,241.57,8,648951.65,26,2,19,9,False
4604079,681,2,20,4628,968196121,1,0,0,242.21,3,648709.44,24,0,0,9,True
4641485,1264,0,10,8037,968196121,1,0,0,242.14,0,648951.58,23,1,5,11,True
5172728,1173,1,10,7323,968196121,1,0,0,242.42,6,649194.0,24,2,3,12,False
5390258,29,0,-1,1234,968196121,1,1,0,242.0,1,649194.0,11,1,20,1,False
5756550,42,2,20,8322,968196121,1,0,0,241.86,3,648952.14,24,6,8,2,True
6052702,998,0,20,8322,968196121,1,0,0,242.18,3,648709.96,26,4,8,3,True
6061537,267,0,20,7417,968196121,1,0,0,242.14,5,648467.82,6,0,10,3,True
6158960,761,2,20,8289,968196121,1,0,0,242.12,5,648225.7,24,0,4,3,True
6180549,589,1,10,7323,968196121,1,0,0,241.94,0,648467.64,24,4,9,4,True
6265623,168,0,30,3285,968196121,1,0,0,241.77,8,648225.87,24,4,21,4,True
6303338,1311,2,20,8866,968196121,1,0,0,241.8,5,647984.07,5,1,18,6,True
6354263,1289,1,451,3285,968196121,1,0,0,241.93,7,647742.14,24,5,16,7,True
6636923,996,0,-1,5949,968196121,1,1,0,241.97,4,647742.14,26,2,9,7,True
6661691,1289,1,451,3285,968196121,1,0,0,242.07,7,647500.07,24,4,8,7,True
6892739,1425,0,30,8322,968196121,1,0,0,242.01,8,647258.06,24,5,1,7,True
6941648,847,3,451,5949,968196121,1,0,0,241.77,7,647016.29,5,6,23,8,True
6976172,1065,0,10,5949,968196121,1,0,0,241.87,6,647258.16,11,6,21,9,True
7209946,463,1,10,3806,968196121,1,0,0,242.18,6,647500.34,13,4,14,9,True
7231209,712,0,-1,5982,968196121,1,1,0,241.96,1,647500.34,18,5,6,11,True
7362034,1289,1,451,3285,968196121,1,0,0,242.24,7,647258.1,24,4,3,11,True
7506456,996,0,30,7323,968196121,1,0,0,241.96,8,647016.14,26,5,0,11,True
7668305,105,3,30,8866,968196121,1,0,0,241.87,8,646774.27,3,1,0,11,True
7670934,60,4,25,7417,968196121,1,0,0,242.0,8,646532.27,20,5,15,1,True
7688577,29,0,25,3285,968196121,1,0,0,242.25,8,646290.02,11,1,12,1,True
8007617,847,3,30,8801,968196121,1,0,0,242.08,8,646047.94,5,3,6,3,True
8054983,996,0,30,4146,968196121,1,0,0,242.01,8,645805.93,26,2,5,3,True
8073739,1425,0,451,1234,968196121,1,0,0,242.03,7,645563.9,24,4,14,3,True
8401729,215,0,20,4628,968196121,1,0,0,242.15,3,645321.75,9,1,10,4,True
8829163,1169,0,10,5446,968196121,1,0,0,242.0,6,645563.75,24,1,14,5,True
9275226,847,3,30,8921,968196121,1,0,0,242.16,8,645321.59,5,6,19,5,True
9342407,376,0,10,1234,968196121,1,0,0,242.02,6,645563.61,25,4,7,6,True
9425481,564,0,10,4146,968196121,1,0,0,242.06,6,645805.67,17,0,15,7,True
9706727,29,0,-1,5949,968196121,1,1,0,242.16,4,645805.67,11,5,18,8,True
9802698,105,3,451,3806,968196121,1,0,0,241.79,7,645563.88,3,2,6,10,False
9996826,712,0,30,8866,968196121,1,0,0,242.14,8,645321.74,18,1,0,10,True
1063922,1327,4,451,6245,817600628,1,0,0,212.84,7,954312.16,18,5,1,1,True
1117652,1327,4,25,9808,817600628,1,0,0,213.01,8,954099.15,18,0,4,1,True
1206654,1471,0,451,7854,817600628,1,0,0,212.87,7,953886.28,24,5,1,1,True
1492860,1128,2,30,8325,817600628,1,0,0,213.01,8,953673.27,24,1,21,2,True
1810634,849,1,10,1124,817600628,1,0,0,212.86,6,953886.13,5,5,9,2,True
2024557,1471,0,451,8459,817600628,1,0,0,212.78,7,953673.35,24,1,8,3,True
2309938,1336,2,25,7215,817600628,1,0,0,212.94,8,953460.41,18,6,18,3,True
2348333,1336,2,-1,9808,817600628,1,1,0,213.16,1,953460.41,18,1,15,4,True
2418983,1471,0,451,7854,817600628,1,0,0,213.0,7,953247.41,24,3,16,6,True
2480009,509,0,30,7921,817600628,1,0,0,213.14,8,953034.27,12,4,3,6,True
2664317,509,0,451,4190,817600628,1,0,0,213.06,7,952821.21,12,2,8,7,True
2786114,1336,2,30,7854,817600628,1,0,0,212.87,8,952608.34,18,6,23,8,True
2964141,509,0,25,6870,817600628,1,0,0,213.04,8,952395.3,12,1,6,8,True
3130962,1128,2,-1,8325,817600628,1,1,0,213.22,4,952395.3,24,5,14,8,True
3308680,1111,0,10,9808,817600628,1,0,0,213.02,6,952608.32,0,0,11,8,True
3673258,1128,2,30,7854,817600628,1,0,0,212.9,8,952395.42,24,1,6,9,True
3973640,1471,0,30,3461,817600628,1,0,0,213.09,8,952182.33,24,4,5,9,True
4046321,454,1,10,4789,817600628,1,0,0,212.53,6,952394.86,13,6,20,9,True
4144707,480,0,20,8459,817600628,1,0,0,213.15,5,952181.71,5,2,1,9,False
4199766,1044,0,20,5556,817600628,1,0,0,213.09,5,951968.62,11,2,20,11,True
4297886,1471,0,25,9735,817600628,1,0,0,212.94,8,951755.68,24,6,2,11,True
4351925,1327,4,-1,7921,817600628,1,1,0,212.91,1,951755.68,18,0,6,12,True
4464916,1128,2,30,9808,817600628,1,0,0,213.09,8,951542.59,24,0,17,1,True
4467609,935,1,10,3461,817600628,1,0,0,212.83,6,951755.42,24,4,14,1,True
4574841,509,0,-1,8325,817600628,1,1,0,213.19,4,951755.42,12,4,18,3,True
4802712,1471,0,25,8459,817600628,1,0,0,212.9,8,951542.52,24,2,16,4,True
4833955,1128,2,451,4891,817600628,1,0,0,212.8,7,951329.72,24,4,15,4,True
4859902,1327,4,-1,8598,817600628,1,1,0,213.01,1,951329.72,18,1,16,5,True
5011281,1327,4,25,3461,817600628,1,0,0,213.17,8,951116.55,18,5,6,5,True
5102994,1336,2,30,7215,817600628,1,0,0,213.16,8,950903.39,18,0,0,5,True
5418363,1128,2,-1,2416,817600628,1,1,0,212.94,4,950903.39,24,1,10,6,False
5421236,1327,4,451,4190,817600628,1,0,0,213.13,7,950690.26,18,5,9,6,True
5645893,509,0,451,1124,817600628,1,0,0,213.26,7,950477.0,12,2,10,6,True
5685835,1336,2,25,7921,817600628,1,0,0,212.9,8,950264.1,18,0,11,7,True
5780944,509,0,20,2416,817600628,1,0,0,213.01,5,950051.09,12,1,10,7,True
5865206,996,0,20,1124,817600628,1,0,0,212.94,5,949838.15,26,0,13,7,False
6130372,509,0,-1,3461,817600628,1,1,0,213.0,1,949838.15,12,5,17,9,True
6546754,1460,2,20,7854,817600628,1,0,0,213.11,5,949625.04,11,6,18,9,True
6784266,480,0,20,8220,817600628,1,0,0,213.04,5,949412.0,5,4,21,9,True
6928431,1128,2,25,8598,817600628,1,0,0,213.02,8,949198.98,24,5,22,9,True
6961134,1327,4,30,1124,817600628,1,0,0,212.87,8,948986.11,18,3,18,10,True
7100364,1471,0,451,7854,817600628,1,0,0,212.87,7,948773.24,24,2,5,11,True
7181538,1327,4,30,5556,817600628,1,0,0,213.12,8,948560.12,18,0,3,12,True
7296534,1336,2,451,8325,817600628,1,0,0,212.9,7,948347.22,18,6,2,12,True
7403919,1128,2,25,8220,817600628,1,0,0,212.72,8,948134.5,24,2,13,1,True
7511154,509,0,-1,4190,817600628,1,1,0,212.93,1,948134.5,12,3,6,1,True
7665865,1471,0,451,8325,817600628,1,0,0,213.1,7,947921.4,24,4,17,2,True
7775978,1471,0,25,2416,817600628,1,0,0,212.69,8,947708.71,24,1,6,2,True
7856273,1336,2,451,4891,817600628,1,0,0,212.93,7,947495.78,18,6,10,3,True
7940053,594,0,10,6870,817600628,1,0,0,213.13,6,947708.91,24,4,2,5,True
8348554,509,0,30,4891,817600628,1,0,0,213.0,8,947495.91,12,0,8,6,True
8399188,802,2,20,8459,817600628,1,0,0,212.84,5,947283.07,11,1,10,8,True
8674747,580,0,10,2416,817600628,1,0,0,213.29,6,947496.36,11,3,15,9,True
8886877,1471,0,-1,5556,817600628,1,1,0,212.76,4,947496.36,24,5,22,10,True
8982917,1063,0,10,8220,817600628,1,0,0,213.15,0,947709.51,11,0,14,10,True
8990596,1128,2,25,4843,817600628,1,0,0,213.04,8,947496.47,24,1,10,10,True
9109983,1336,2,451,9532,817600628,1,0,0,213.06,7,947283.41,18,3,18,10,False
9841257,467,0,20,4891,817600628,1,0,0,212.8,3,947070.61,5,1,3,11,True
9860540,1336,2,30,4789,817600628,1,0,0,212.92,8,946857.69,18,5,12,11,True
1074354,656,2,30,4356,281169539,1,0,0,754.94,8,423213.06,18,6,20,1,False
1297930,709,3,30,1189,281169539,1,0,0,755.3,8,422457.76,18,3,10,2,True
1340558,656,2,451,2394,281169539,1,0,0,755.05,7,421702.71,18,0,2,3,True
1526830,1009,0,10,5903,281169539,1,0,0,754.82,6,422457.53,26,4,17,4,True
1743170,211,0,10,7439,281169539,1,0,0,755.12,6,423212.65,9,0,18,4,True
1876638,999,4,30,9173,281169539,1,0,0,755.1,8,422457.55,26,1,7,4,True
2193110,965,4,-1,1189,281169539,1,1,0,754.91,1,422457.55,13,5,10,7,True
2406889,656,2,451,8048,281169539,1,0,0,754.93,7,421702.62,18,3,14,8,True
2592936,709,3,30,2630,281169539,1,0,0,754.83,8,420947.79,18,5,2,8,True
2946352,999,4,-1,2630,281169539,1,1,0,755.01,1,420947.79,26,1,13,8,True
2971166,660,3,-1,8328,281169539,1,2,0,755.0,4,420947.79,18,2,21,8,True
3124379,660,3,25,6419,281169539,1,0,0,755.06,8,420192.73,18,4,10,9,True
3136931,999,4,451,2630,281169539,1,0,0,754.98,7,419437.75,26,2,15,11,True
3176622,660,3,25,6419,281169539,1,0,0,754.88,8,418682.87,18,1,11,11,True
3229789,871,0,20,5903,281169539,1,0,0,754.86,3,417928.01,24,2,7,11,True
3499758,51,0,20,8048,281169539,1,0,0,755.01,5,417173.0,20,1,5,12,True
3533886,660,3,451,5903,281169539,1,0,0,754.83,7,416418.17,18,6,20,1,True
3549562,660,3,30,7439,281169539,1,0,0,754.96,8,415663.21,18,6,0,1,True
3774552,656,2,451,2394,281169539,1,0,0,754.99,7,414908.22,18,0,5,1,True
4042900,1223,3,451,8048,281169539,1,0,0,755.23,7,414152.99,24,5,9,2,True
4079523,656,2,451,5903,281169539,1,0,0,754.88,7,413398.11,18,5,15,2,False
4100005,1223,3,25,2630,281169539,1,0,0,755.13,8,412642.98,24,0,4,3,True
4246992,999,4,451,3556,281169539,1,0,0,754.99,7,411887.99,26,2,20,3,True
4644781,962,0,10,1189,281169539,1,0,0,754.83,6,412642.82,13,3,12,4,True
4726164,999,4,451,8048,281169539,1,0,0,755.23,7,411887.59,26,1,2,5,True
4966980,1436,0,20,4314,281169539,1,0,0,755.05,5,411132.54,24,4,0,6,True
5261251,709,3,25,5403,281169539,1,0,0,755.01,8,410377.53,18,2,15,7,True
5340077,965,4,30,1189,281169539,1,0,0,754.7,8,409622.83,13,2,0,7,True
5425176,639,4,451,6419,281169539,1,0,0,755.18,7,408867.65,24,3,13,7,True
5538774,137,2,20,5403,281169539,1,0,0,754.91,5,408112.74,18,4,9,7,True
5720163,656,2,30,3567,281169539,1,0,0,755.14,8,407357.6,18,1,11,7,True
5761844,1119,0,10,2630,281169539,1,0,0,754.92,6,408112.52,24,5,14,7,True
6006632,999,4,30,8048,281169539,1,0,0,754.9,8,407357.62,26,0,5,7,True
6278288,588,0,20,2394,281169539,1,0,0,754.83,5,406602.79,24,6,14,9,True
6375102,965,4,25,8897,281169539,1,0,0,755.13,8,405847.66,13,6,2,9,True
6793242,1223,3,451,2630,281169539,1,0,0,754.83,7,405092.83,24,0,5,10,True
6794132,656,2,30,1189,281169539,1,0,0,755.15,8,404337.68,18,4,7,10,True
6806312,281,1,10,4356,281169539,1,0,0,754.8,6,405092.48,24,1,17,12,True
6897346,1223,3,451,6419,281169539,1,0,0,754.92,7,404337.56,24,0,15,1,True
6986401,709,3,30,4314,281169539,1,0,0,754.9,8,403582.66,18,6,5,1,True
7173896,394,0,10,8390,281169539,1,0,0,754.78,0,404337.44,10,1,2,1,True
7178164,660,3,30,4314,281169539,1,0,0,755.11,8,403582.33,18,3,14,1,True
7195197,999,4,451,4356,281169539,1,0,0,754.97,7,402827.36,26,5,16,2,True
7256798,1223,3,-1,7439,281169539,1,1,0,755.13,1,402827.36,24,5,20,3,True
7257630,656,2,30,2394,281169539,1,0,0,755.14,8,402072.22,18,6,17,3,True
7971140,639,4,-1,2430,281169539,1,1,0,755.26,1,402072.22,24,2,12,4,True
8173599,883,0,10,8048,281169539,1,0,0,754.9,0,402827.12,24,4,1,5,True
8242367,965,4,25,1189,281169539,1,0,0,755.07,8,402072.05,13,0,1,5,True
8420654,1223,3,30,8048,281169539,1,0,0,755.09,8,401316.96,24,1,1,5,True
8535645,656,2,30,9173,281169539,1,0,0,755.0,8,400561.96,18,3,17,7,True
8739408,660,3,30,2394,281169539,1,0,0,755.05,8,399806.91,18,1,5,7,True
9058562,999,4,451,2394,281169539,1,0,0,754.79,7,399052.12,26,5,20,7,True
9070587,709,3,451,8328,281169539,1,0,0,755.11,7,398297.01,18,6,3,8,True
9116015,709,3,451,5403,281169539,1,0,0,755.27,7,397541.74,18,0,12,8,True
9174154,866,0,20,3556,281169539,1,0,0,755.28,3,396786.46,24,2,22,8,True
9458076,1339,2,20,3567,281169539,1,0,0,754.96,5,396031.5,18,6,2,10,True
9951384,656,2,451,4356,281169539,1,0,0,755.02,7,395276.48,18,2,19,11,True
1364807,1180,1,25,9701,594143142,1,0,0,305.84,8,306548.16,24,1,18,2,True
1695635,419,4,451,4296,594143142,1,0,0,305.98,7,306242.18,18,2,1,3,True
1729734,419,4,451,4749,594143142,1,0,0,306.27,7,305935.91,18,1,8,3,True
2093685,729,0,451,3873,594143142,1,0,0,305.92,7,305629.99,11,2,8,6,True
2289493,599,0,10,4809,594143142,1,0,0,306.11,6,305936.1,24,2,0,6,True
2341098,1455,2,25,4296,594143142,1,0,0,305.7,8,305630.4,11,1,6,8,True
2533289,419,4,-1,4296,594143142,1,1,0,305.93,4,305630.4,18,3,23,8,True
2555398,729,0,451,9701,594143142,1,0,0,305.94,7,305324.46,11,0,14,8,False
3058661,602,4,-1,8575,594143142,1,1,0,306.17,4,305324.46,24,1,16,8,True
3235745,729,0,30,1373,594143142,1,0,0,305.88,8,305018.58,11,3,2,9,True
3247511,525,0,10,1432,594143142,1,0,0,306.27,0,305324.85,18,6,4,9,True
3666055,950,0,20,5506,594143142,1,0,0,306.04,5,305018.81,24,0,21,9,True
3826596,1455,2,30,1265,594143142,1,0,0,305.99,8,304712.82,11,6,10,9,True
3910018,729,0,-1,1373,594143142,1,1,0,305.96,4,304712.82,11,2,21,9,True
4150550,759,0,10,1432,594143142,1,0,0,306.07,6,305018.89,24,1,1,11,True
4535196,729,0,30,1373,594143142,1,0,0,306.05,8,304712.84,11,1,14,12,True
4548733,1272,0,25,3873,594143142,1,0,0,305.79,8,304407.05,24,6,14,1,True
4867312,1180,1,25,4809,594143142,1,0,0,306.12,8,304100.93,24,4,6,1,True
5184163,419,4,451,8575,594143142,1,0,0,306.16,7,303794.77,18,3,12,2,True
5315400,602,4,25,9086,594143142,1,0,0,306.09,8,303488.68,24,4,12,2,True
5520520,1468,1,10,9086,594143142,1,0,0,305.76,0,303794.44,11,2,21,2,True
5745326,1338,0,20,1432,594143142,1,0,0,306.07,5,303488.37,18,3,13,3,True
5835654,1272,0,451,9086,594143142,1,0,0,305.89,7,303182.48,24,5,2,3,True
5847416,1180,1,451,9142,594143142,1,0,0,305.9,7,302876.58,24,5,13,4,True
5896968,1272,0,-1,1373,594143142,1,1,0,305.92,4,302876.58,24,0,2,4,True
6037545,1455,2,-1,5506,594143142,1,2,0,305.82,4,302876.58,11,5,15,4,True
6068785,602,4,30,8052,594143142,1,0,0,305.98,8,302570.6,24,2,14,5,True
6222414,729,0,451,8575,594143142,1,0,0,305.87,7,302264.73,11,2,18,6,True
6346341,1460,2,20,9701,594143142,1,0,0,305.99,5,301958.74,11,6,2,8,True
6454897,1272,0,30,4749,594143142,1,0,0,306.13,8,301652.61,24,0,4,8,True
6533500,1455,2,25,1373,594143142,1,0,0,306.09,8,301346.52,11,2,6,9,True
6839889,419,4,451,1373,594143142,1,0,0,305.8,7,301040.72,18,4,10,9,True
6983239,993,0,10,4809,594143142,1,0,0,305.82,6,301346.54,22,5,17,9,True
7253741,419,4,25,2492,594143142,1,0,0,306.04,8,301040.5,18,2,0,10,True
7328434,560,2,20,2492,594143142,1,0,0,305.74,5,300734.76,17,6,1,2,True
7890346,1272,0,30,8575,594143142,1,0,0,305.75,8,300429.01,24,4,6,3,True
8211954,1180,1,25,4809,594143142,1,0,0,306.14,8,300122.87,24,3,23,3,True
8241684,729,0,30,9086,594143142,1,0,0,306.19,8,299816.68,11,2,0,4,True
8256051,1426,1,10,1373,594143142,1,0,0,306.13,6,300122.81,24,1,20,5,True
8434660,602,4,-1,3448,594143142,1,1,0,306.03,4,300122.81,24,5,12,6,True
8541724,1180,1,451,9086,594143142,1,0,0,306.14,7,299816.67,24,5,5,8,True
8587313,1272,0,451,9701,594143142,1,0,0,305.73,7,299510.94,24,2,10,8,True
8608716,1272,0,25,3448,594143142,1,0,0,305.92,8,299205.02,24,2,12,8,True
8914420,787,0,10,4296,594143142,1,0,0,305.95,0,299510.97,14,5,12,8,True
9021614,1160,0,10,4296,594143142,1,0,0,306.38,0,299817.35,15,0,1,8,True
9029694,1180,1,-1,9142,594143142,1,1,0,306.1,4,299817.35,24,0,14,9,True
9227735,419,4,30,9142,594143142,1,0,0,306.01,8,299511.34,18,3,1,10,True
9499227,538,0,10,9086,594143142,1,0,0,305.87,6,299817.21,18,2,4,10,True
9530714,834,0,20,5506,594143142,1,0,0,306.13,5,299511.08,5,4,22,10,True
9873038,1272,0,-1,8575,594143142,1,1,0,306.11,4,299511.08,24,0,22,11,True
1396701,840,3,451,7491,705241788,0,0,0,531.92,7,881277.08,5,5,2,2,True
1516043,39,3,30,1728,705241788,0,0,0,532.09,8,880744.99,11,4,16,2,True
2206148,278,1,451,2679,705241788,0,0,0,531.92,7,880213.07,24,5,6,2,True
2229854,854,0,10,2812,705241788,0,0,0,532.01,6,880745.08,24,0,22,3,False
2335981,1380,0,451,8118,705241788,0,0,0,532.05,7,880213.03,16,5,3,4,True
2360339,1366,4,25,2871,705241788,0,0,0,532.35,8,879680.68,16,0,2,5,True
2573584,1007,2,451,8118,705241788,0,0,0,532.02,7,879148.66,26,3,21,5,True
2675162,1366,4,-1,5364,705241788,0,1,0,531.97,1,879148.66,16,3,19,5,True
2805740,278,1,30,2871,705241788,0,0,0,532.03,8,878616.63,24,0,20,6,True
2903613,1007,2,451,9647,705241788,0,0,0,532.18,7,878084.45,26,1,18,7,True
3023727,869,2,20,1728,705241788,0,0,0,531.86,5,877552.59,24,6,19,8,True
3069615,39,3,-1,5021,705241788,0,1,0,531.76,1,877552.59,11,3,21,9,True
3727447,360,0,10,5452,705241788,0,0,0,532.14,6,878084.73,24,2,2,10,True
3913762,1366,4,30,6517,705241788,0,0,0,531.99,8,877552.74,16,0,2,11,True
3944585,448,0,20,1728,705241788,0,0,0,531.79,5,877020.95,13,1,2,11,True
4038725,1352,1,25,2679,705241788,0,0,0,532.17,8,876488.78,24,4,11,2,True
4144946,278,1,451,2812,705241788,0,0,0,532.12,7,875956.66,24,5,22,2,True
4248433,1380,0,451,5452,705241788,0,0,0,532.11,7,875424.55,16,4,19,3,True
4457972,1284,2,20,5586,705241788,0,0,0,532.11,5,874892.44,24,5,6,4,False
4546699,53,0,10,3668,705241788,0,0,0,532.44,6,875424.88,20,2,0,4,True
4662199,547,4,451,8439,705241788,0,0,0,531.67,7,874893.21,17,2,3,4,False
4700976,840,3,451,5716,705241788,0,0,0,532.01,7,874361.2,5,1,15,5,True
4824840,1352,1,451,2679,705241788,0,0,0,532.06,7,873829.14,24,5,0,5,False
4847733,1007,2,451,6517,705241788,0,0,0,531.68,7,873297.46,26,3,7,6,True
4921066,547,4,451,5716,705241788,0,0,0,531.94,7,872765.52,17,2,8,7,True
4924939,840,3,-1,7491,705241788,0,1,0,531.99,4,872765.52,5,2,11,7,True
4933936,1380,0,451,8439,705241788,0,0,0,532.25,7,872233.27,16,0,6,7,True
5019221,1366,4,451,8439,705241788,0,0,0,532.04,7,871701.23,16,1,16,8,True
5216247,1380,0,-1,5021,705241788,0,1,0,531.95,4,871701.23,16,5,8,9,True
5638366,1380,0,25,5364,705241788,0,0,0,531.72,8,871169.51,16,0,9,10,True
5661960,278,1,30,5452,705241788,0,0,0,531.69,8,870637.82,24,1,10,10,True
6052550,300,0,10,9308,705241788,0,0,0,531.98,6,871169.8,4,3,0,10,True
6352537,840,3,30,8486,705241788,0,0,0,532.01,8,870637.79,5,0,0,10,True
6392209,1380,0,30,5452,705241788,0,0,0,531.88,8,870105.91,16,2,4,11,True
6407218,39,3,25,8118,705241788,0,0,0,531.59,8,869574.32,11,5,6,12,True
6427076,1007,2,25,7491,705241788,0,0,0,532.17,8,869042.15,26,6,10,12,True
6614273,1366,4,451,7491,705241788,0,0,0,531.92,7,868510.23,16,6,1,12,True
6768121,1352,1,451,2679,705241788,0,0,0,531.98,7,867978.25,24,1,22,1,True
6899870,1111,0,20,1728,705241788,0,0,0,531.98,5,867446.27,0,0,17,1,True
7004529,1399,0,10,8183,705241788,0,0,0,531.77,6,867978.04,24,6,7,3,True
7040886,1380,0,451,8486,705241788,0,0,0,531.99,7,867446.05,16,1,1,3,True
7153450,1352,1,451,3668,705241788,0,0,0,531.94,7,866914.11,24,0,17,4,True
7173654,471,0,10,5924,705241788,0,0,0,531.77,0,867445.88,5,3,23,4,True
7370199,840,3,-1,5586,705241788,0,1,0,532.08,4,867445.88,5,5,16,4,True
7580924,1380,0,451,5364,705241788,0,0,0,531.94,7,866913.94,16,3,10,5,True
8301398,715,0,20,6517,705241788,0,0,0,531.93,5,866382.01,18,0,8,5,True
8547999,605,0,10,5364,705241788,0,0,0,532.12,6,866914.13,24,4,6,6,True
8763254,1449,0,20,2807,705241788,0,0,0,531.88,3,866382.25,11,6,18,7,True
8787861,1007,2,451,1011,705241788,0,0,0,531.9,7,865850.35,26,6,21,7,True
8847518,1090,0,20,3668,705241788,0,0,0,531.84,5,865318.51,18,4,7,7,True
9076778,860,1,10,8183,705241788,0,0,0,532.1,0,865850.61,24,0,9,8,True
9129830,1007,2,451,6517,705241788,0,0,0,532.17,7,865318.44,26,5,15,9,True
9298646,995,1,10,8183,705241788,0,0,0,531.86,6,865850.3,22,5,1,10,True
9537003,1285,1,10,5364,705241788,0,0,0,532.01,6,866382.31,24,0,0,10,True
9701042,1352,1,30,5716,705241788,0,0,0,531.9,8,865850.41,24,3,9,10,True
9722436,1380,0,451,5716,705241788,0,0,0,531.95,7,865318.46,16,4,13,11,True
9843688,1352,1,451,5452,705241788,0,0,0,532.1,7,864786.36,24,3,23,11,True
1168954,961,4,-1,3473,179629363,0,1,0,894.0,4,939969.0,13,3,0,1,True
1322765,191,3,451,7183,179629363,0,0,0,893.91,7,939075.09,18,0,18,1,True
1411741,201,1,451,9719,179629363,0,0,0,893.98,7,938181.11,9,0,9,2,True
1579744,429,0,10,5553,179629363,0,0,0,893.96,0,939075.07,24,0,8,2,True
1838577,603,0,-1,5527,179629363,0,1,0,894.11,1,939075.07,24,6,12,2,True
2868722,80,4,30,5783,179629363,0,0,0,894.25,8,938180.82,1,2,6,3,True
2970809,1094,0,25,1745,179629363,0,0,0,893.89,8,937286.93,0,4,18,4,True
3113430,887,2,20,5527,179629363,0,0,0,893.86,5,936393.07,27,4,19,7,True
3125052,1209,4,-1,5527,179629363,0,1,0,894.13,4,936393.07,24,2,19,7,True
3313428,130,0,10,9844,179629363,0,0,0,894.08,6,937287.15,18,5,2,10,True
3569326,80,4,25,4294,179629363,0,0,0,893.88,8,936393.27,1,1,21,12,True
3728693,898,1,10,6659,179629363,0,0,0,893.85,0,937287.12,24,6,23,12,True
3826782,961,4,451,8021,179629363,0,0,0,894.12,7,936393.0,13,0,5,12,True
3877494,429,0,30,1775,179629363,0,0,0,893.99,8,935499.01,24,2,20,12,True
4085326,85,2,20,2817,179629363,0,0,0,893.96,5,934605.05,1,4,13,1,True
4213516,961,4,-1,6027,179629363,0,1,0,894.02,1,934605.05,13,3,19,1,True
4375838,191,3,25,6869,179629363,0,0,0,893.78,8,933711.27,18,2,2,2,True
4426472,1209,4,451,4288,179629363,0,0,0,893.99,7,932817.28,24,6,19,3,True
4516720,191,3,30,1535,179629363,0,0,0,894.07,8,931923.21,18,3,20,3,True
4569225,20,0,20,5326,179629363,0,0,0,893.85,5,931029.36,24,1,13,5,False
4662989,297,0,10,7777,179629363,0,0,0,894.31,6,931923.67,4,0,0,5,True
4824024,961,4,451,3182,179629363,0,0,0,894.03,7,931029.64,13,3,13,6,True
5262132,429,0,451,5783,179629363,0,0,0,894.0,7,930135.64,24,4,8,6,True
5550073,728,1,10,9844,179629363,0,0,0,893.97,6,931029.61,11,4,6,6,True
5586797,80,4,451,6565,179629363,0,0,0,893.82,7,930135.79,1,6,7,6,True
6087517,1483,0,10,1498,179629363,0,0,0,894.17,6,931029.96,24,6,15,7,True
6156054,1094,0,-1,5326,179629363,0,1,0,893.97,4,931029.96,0,6,23,8,True
6161586,1162,2,20,1225,179629363,0,0,0,893.76,3,930136.2,24,4,9,9,True
6360507,201,1,30,9988,179629363,0,0,0,893.99,8,929242.21,9,5,4,9,True
6891542,1209,4,451,5783,179629363,0,0,0,894.01,7,928348.2,24,5,21,10,True
7261115,1094,0,30,6019,179629363,0,0,0,893.77,8,927454.43,0,6,1,10,True
7458938,80,4,25,3794,179629363,0,0,0,893.87,8,926560.56,1,0,16,10,True
7524129,429,0,451,3363,179629363,0,0,0,893.9,7,925666.66,24,3,17,11,True
7877265,289,4,-1,7777,179629363,0,1,0,893.89,4,925666.66,24,2,6,11,True
7890998,1110,0,10,9719,179629363,0,0,0,893.92,6,926560.58,0,1,20,1,True
8236944,81,0,20,8271,179629363,0,0,0,894.26,5,925666.32,1,2,0,1,True
8373944,961,4,-1,9844,179629363,0,1,0,894.01,1,925666.32,13,2,15,2,True
8410252,1094,0,25,1775,179629363,0,0,0,893.62,8,924772.7,0,6,8,3,True
8412140,80,4,25,9988,179629363,0,0,0,893.88,8,923878.82,1,0,23,3,True
8481600,681,2,20,3281,179629363,0,0,0,894.2,5,922984.62,24,2,22,3,True
8637687,80,4,-1,3794,179629363,0,1,0,894.15,4,922984.62,1,2,10,4,True
8740028,1209,4,30,6027,179629363,0,0,0,894.06,8,922090.56,24,0,19,4,True
9084585,289,4,451,1225,179629363,0,0,0,893.84,7,921196.72,24,6,12,5,True
9228708,1094,0,451,5326,179629363,0,0,0,894.05,7,920302.67,0,6,22,5,True
9228796,1094,0,-1,1535,179629363,0,1,0,893.92,1,920302.67,0,2,23,5,True
9284078,201,1,25,7218,179629363,0,0,0,893.95,8,919408.72,9,1,16,7,True
9380817,603,0,25,1225,179629363,0,0,0,894.21,8,918514.51,24,6,20,9,True
9461514,429,0,20,7218,179629363,0,0,0,893.84,5,917620.67,24,4,13,9,True
9842498,128,0,20,5326,179629363,0,0,0,894.2,5,916726.47,18,3,19,11,True
9899945,429,0,451,7890,179629363,0,0,0,893.88,7,915832.59,24,6,10,11,True
1067389,931,0,20,5446,588992915,0,0,0,553.94,5,420555.06,24,1,13,2,True
1098908,1176,4,25,5137,588992915,0,0,0,553.99,8,420001.07,24,5,10,3,True
1137609,550,0,-1,2066,588992915,0,1,0,553.83,4,420001.07,17,4,7,3,True
1302021,1063,0,10,4560,588992915,0,0,0,553.95,0,420555.02,11,5,12,4,True
1446944,791,3,25,6158,588992915,0,0,0,554.36,8,420000.66,11,3,6,4,True
1523047,1093,0,451,1113,588992915,0,0,0,553.88,7,419446.78,18,2,21,6,True
1610501,517,4,30,4287,588992915,0,0,0,554.07,8,418892.71,12,0,0,7,True
1686130,695,2,20,4560,588992915,0,0,0,553.95,3,418338.76,24,3,22,8,True
1912635,550,0,30,3595,588992915,0,0,0,554.11,8,417784.65,17,2,17,9,True
1992896,222,2,451,5137,588992915,0,0,0,554.09,7,417230.56,26,6,8,9,True
2230863,550,0,25,2066,588992915,0,0,0,554.31,8,416676.25,17,6,7,10,True
2245299,1176,4,-1,6532,588992915,0,1,0,554.17,1,416676.25,24,1,15,11,True
2667534,348,0,10,5252,588992915,0,0,0,554.01,6,417230.26,24,1,2,11,True
2773495,791,3,451,5252,588992915,0,0,0,554.14,7,416676.12,11,2,6,11,True
2832396,304,0,20,5252,588992915,0,0,0,554.09,3,416122.03,4,2,16,12,True
3025834,222,2,451,9929,588992915,0,0,0,554.01,7,415568.02,26,0,1,12,True
3184103,1179,0,30,6158,588992915,0,0,0,553.72,8,415014.3,24,1,21,12,True
3256257,550,0,30,2066,588992915,0,0,0,554.29,8,414460.01,17,0,22,1,True
3258458,194,1,10,5137,588992915,0,0,0,554.01,0,415014.02,18,1,21,1,True
3540842,23,0,10,9472,588992915,0,0,0,554.16,6,415568.18,11,6,14,1,True
3541882,517,4,25,2066,588992915,0,0,0,554.1,8,415014.08,12,4,9,2,True
3697324,550,0,25,1724,588992915,0,0,0,554.17,8,414459.91,17,2,9,2,True
3826709,732,0,10,3448,588992915,0,0,0,553.73,0,415013.64,11,2,18,4,True
3855931,781,1,10,9472,588992915,0,0,0,553.76,0,415567.4,14,4,11,4,True
4054338,1176,4,451,9929,588992915,0,0,0,554.05,7,415013.35,24,6,17,4,True
4354608,791,3,25,5137,588992915,0,0,0,554.12,8,414459.23,11,4,9,4,True
4723209,1176,4,-1,5137,588992915,0,1,0,554.07,4,414459.23,24,0,10,5,True
4828671,330,3,30,2901,588992915,0,0,0,553.95,8,413905.28,11,3,5,5,True
4938347,222,2,-1,2847,588992915,0,1,0,554.08,4,413905.28,26,0,20,7,True
4980566,585,2,20,3595,588992915,0,0,0,553.93,5,413351.35,11,6,17,8,True
5101649,630,0,20,7675,588992915,0,0,0,554.21,3,412797.14,11,3,5,9,True
5113902,1075,0,10,6532,588992915,0,0,0,554.25,6,413351.39,18,4,15,10,True
5117444,550,0,451,2066,588992915,0,0,0,554.13,7,412797.26,17,4,13,10,True
5321014,550,0,451,2847,588992915,0,0,0,554.07,7,412243.19,17,2,18,11,True
5838294,1086,0,10,5137,588992915,0,0,0,553.96,6,412797.15,18,0,19,11,True
5963116,1176,4,-1,8120,588992915,0,1,0,553.95,4,412797.15,24,2,14,11,True
6458154,330,3,30,8798,588992915,0,0,0,553.96,8,412243.19,11,5,10,12,True
6666224,517,4,-1,9929,588992915,0,1,0,553.87,4,412243.19,12,5,20,12,True
6848956,362,0,20,1113,588992915,0,0,0,553.82,5,411689.37,24,5,6,12,True
7077541,1176,4,451,5137,588992915,0,0,0,553.88,7,411135.49,24,5,11,1,True
7166469,330,3,-1,2847,588992915,0,1,0,554.07,4,411135.49,11,6,5,1,True
7271490,791,3,30,5137,588992915,0,0,0,553.97,8,410581.52,11,1,5,4,True
9124915,759,0,10,1113,588992915,0,0,0,554.14,0,411135.66,24,6,2,5,True
9323058,791,3,30,2901,588992915,0,0,0,554.13,8,410581.53,11,4,18,5,True
9488656,518,2,20,1724,588992915,0,0,0,554.11,5,410027.42,18,0,0,5,True
9593143,616,1,10,5446,588992915,0,0,0,554.09,6,410581.51,11,4,3,6,True
9593575,791,3,25,1113,588992915,0,0,0,554.18,8,410027.33,11,6,12,6,True
9641659,1093,0,25,8798,588992915,0,0,0,553.99,8,409473.34,18,1,11,7,True
9655802,403,0,10,2066,588992915,0,0,0,554.25,6,410027.59,10,3,0,8,True
9808839,517,4,-1,5446,588992915,0,1,0,553.82,4,410027.59,12,2,20,8,True
9899675,330,3,451,6158,588992915,0,0,0,553.63,7,409473.96,11,5,16,10,True
9901420,222,2,25,3448,588992915,0,0,0,553.84,8,408920.12,26,6,20,10,True
9978323,791,3,451,8798,588992915,0,0,0,553.8,7,408366.32,11,3,7,11,True
1045403,68,0,20,9929,947936095,1,0,0,914.97,3,308157.03,20,1,9,2,True
1568355,1119,0,10,7172,947936095,1,0,0,914.98,6,309072.01,24,1,23,3,True
1795415,1325,0,30,5433,947936095,1,0,0,915.18,8,308156.83,18,5,3,4,True
2129352,147,0,25,8051,947936095,1,0,0,914.83,8,307242.0,18,4,11,4,True
2278305,429,0,451,6978,947936095,1,0,0,914.92,7,306327.08,24,1,7,5,True
2322521,1377,0,451,2061,947936095,1,0,0,914.89,7,305412.19,16,1,20,5,True
2418775,1377,0,-1,6563,947936095,1,1,0,915.11,4,305412.19,16,2,3,5,False
2661671,147,0,451,9929,947936095,1,0,0,914.67,7,304497.52,18,5,20,5,True
3012488,1108,1,30,7172,947936095,1,0,0,914.85,8,303582.67,0,0,10,5,True
3206647,147,0,25,4566,947936095,1,0,0,914.77,8,302667.9,18,0,20,6,True
3366903,1377,0,25,4257,947936095,1,0,0,914.99,8,301752.91,16,0,2,7,True
3587500,1493,4,451,6563,947936095,1,0,0,915.13,7,300837.78,24,3,6,7,True
4147435,844,1,10,2627,947936095,1,0,0,915.13,0,301752.91,5,2,0,7,True
4160836,1493,4,451,5048,947936095,1,0,0,915.03,7,300837.88,24,5,17,7,True
4510881,642,0,20,4566,947936095,1,0,0,915.06,3,299922.82,24,1,13,8,True
4664241,1108,1,25,4566,947936095,1,0,0,914.81,8,299008.01,0,1,17,8,True
4813707,429,0,30,6337,947936095,1,0,0,915.18,8,298092.83,24,0,15,11,True
5075535,1108,1,30,2061,947936095,1,0,0,914.97,8,297177.86,0,0,18,11,True
5451258,1307,0,20,2061,947936095,1,0,0,915.15,3,296262.71,5,1,16,11,True
5521661,1493,4,-1,2627,947936095,1,1,0,914.96,4,296262.71,24,1,8,12,True
5629729,1476,0,20,9929,947936095,1,0,0,914.96,5,295347.75,24,4,2,2,True
5683709,147,0,451,7172,947936095,1,0,0,914.93,7,294432.82,18,3,11,3,True
5753237,1493,4,30,7172,947936095,1,0,0,915.2,8,293517.62,24,2,17,3,False
6584709,215,0,20,9929,947936095,1,0,0,914.95,3,292602.67,9,2,13,4,True
6802873,1108,1,-1,1147,947936095,1,1,0,915.17,4,292602.67,0,2,20,4,True
6826201,1493,4,30,4566,947936095,1,0,0,914.94,8,291687.73,24,4,1,4,True
6889447,1325,0,25,7172,947936095,1,0,0,914.91,8,290772.82,18,6,14,4,True
7104965,429,0,451,3158,947936095,1,0,0,915.01,7,289857.81,24,6,3,4,True
7411077,182,1,10,6563,947936095,1,0,0,914.79,6,290772.6,18,1,13,5,False
7640146,429,0,30,7172,947936095,1,0,0,915.21,8,289857.39,24,1,23,5,True
7757212,1325,0,451,6978,947936095,1,0,0,915.17,7,288942.22,18,1,21,6,True
7967048,260,0,20,1222,947936095,1,0,0,914.79,3,288027.43,6,3,20,7,True
8020069,584,0,20,1147,947936095,1,0,0,914.98,5,287112.45,11,3,21,8,True
8115413,996,0,20,4257,947936095,1,0,0,914.84,5,286197.61,26,3,22,10,True
8219275,1377,0,451,4566,947936095,1,0,0,915.19,7,285282.42,16,4,15,10,True
8249090,1377,0,30,2627,947936095,1,0,0,915.03,8,284367.39,16,4,1,11,True
8249219,1485,0,20,6551,947936095,1,0,0,914.9,5,283452.49,24,1,5,11,True
8307829,362,0,20,6551,947936095,1,0,0,914.92,5,282537.57,24,2,9,12,True
8330530,147,0,30,7172,947936095,1,0,0,915.08,8,281622.49,18,5,2,12,True
8496091,429,0,451,1147,947936095,1,0,0,915.07,7,280707.42,24,0,1,1,True
8542972,1493,4,451,2061,947936095,1,0,0,915.1,7,279792.32,24,1,22,2,True
8619491,147,0,30,4257,947936095,1,0,0,915.01,8,278877.31,18,4,2,2,True
8666530,1206,0,10,5048,947936095,1,0,0,915.05,6,279792.36,24,0,2,3,True
8955133,1325,0,30,2627,947936095,1,0,0,914.88,8,278877.48,18,6,19,3,True
8985197,929,0,20,6551,947936095,1,0,0,914.99,5,277962.49,18,0,12,3,True
9119249,1108,1,451,6551,947936095,1,0,0,914.95,7,277047.54,0,6,5,5,True
9155814,1108,1,451,7172,947936095,1,0,0,915.07,7,276132.47,0,4,20,5,True
9245811,58,2,20,2061,947936095,1,0,0,915.19,3,275217.28,20,2,6,6,True
9379600,747,1,10,5048,947936095,1,0,0,915.12,0,276132.4,24,4,9,7,True
9440662,429,0,25,2061,947936095,1,0,0,915.11,8,275217.29,24,5,13,7,True
9449423,147,0,-1,9929,947936095,1,1,0,914.89,4,275217.29,18,4,11,7,True
9649325,68,0,20,9929,947936095,1,0,0,914.89,5,274302.4,20,5,15,9,True
9657448,807,0,20,5048,947936095,1,0,0,914.88,3,273387.52,11,4,23,9,True
9676887,1493,4,451,4257,947936095,1,0,0,914.94,7,272472.58,24,1,21,10,True
9774948,1108,1,451,6551,947936095,1,0,0,915.24,7,271557.34,0,6,20,11,True
9976379,1377,0,451,4257,947936095,1,0,0,914.82,7,270642.52,16,0,2,11,True
1017057,339,4,30,8723,389918035,1,0,0,728.97,8,163445.03,11,1,19,1,True
1196848,339,4,-1,8259,389918035,1,1,0,729.13,4,163445.03,11,4,17,2,True
1268264,1328,4,30,1008,389918035,1,0,0,729.13,8,162715.9,18,1,15,2,True
1624766,180,0,10,3247,389918035,1,0,0,729.12,0,163445.02,18,2,5,3,True
1953737,339,4,451,3247,389918035,1,0,0,728.81,7,162716.21,11,6,13,5,True
2120927,1324,4,30,4412,389918035,1,0,0,728.78,8,161987.43,18,0,22,5,True
2261336,333,1,451,8586,389918035,1,0,0,728.85,7,161258.58,11,2,5,6,True
2357290,1324,4,-1,7409,389918035,1,1,0,728.89,4,161258.58,18,5,19,8,True
2434421,184,0,20,7409,389918035,1,0,0,729.06,5,160529.52,18,0,19,8,True
2635751,303,0,20,3598,389918035,1,0,0,729.05,5,159800.47,4,2,20,8,True
2703750,100,4,25,2015,389918035,1,0,0,729.12,8,159071.35,3,1,6,10,True
2982464,144,1,10,3090,389918035,1,0,0,728.99,6,159800.34,18,2,9,10,True
3234676,1328,4,30,6817,389918035,1,0,0,729.05,8,159071.29,18,6,12,11,True
3328772,339,4,451,5683,389918035,1,0,0,729.05,7,158342.24,11,3,14,11,True
3469025,339,4,30,5501,389918035,1,0,0,729.11,8,157613.13,11,5,6,12,True
3541968,689,0,20,8723,389918035,1,0,0,728.96,3,156884.17,24,0,4,1,True
3643221,1324,4,451,6817,389918035,1,0,0,729.04,7,156155.13,18,0,4,2,True
3917234,1324,4,-1,5501,389918035,1,1,0,729.15,4,156155.13,18,2,4,4,True
4396107,406,1,10,8723,389918035,1,0,0,729.1,6,156884.23,10,4,10,6,True
4535471,1328,4,-1,8259,389918035,1,1,0,729.12,4,156884.23,18,6,8,7,False
4803772,100,4,-1,5977,389918035,1,2,0,728.94,4,156884.23,3,4,17,8,True
4892103,537,0,20,4238,389918035,1,0,0,729.04,5,156155.19,18,5,22,9,True
5296192,1324,4,451,5977,389918035,1,0,0,728.93,7,155426.26,18,3,16,10,True
5698545,1467,0,20,6817,389918035,1,0,0,729.02,3,154697.24,11,6,3,10,False
5767141,1328,4,30,6861,389918035,1,0,0,729.05,8,153968.19,18,0,1,11,True
6017100,1328,4,451,2015,389918035,1,0,0,729.02,7,153239.17,18,3,7,11,True
6353933,806,1,10,3310,389918035,1,0,0,728.83,0,153968.0,11,1,12,1,True
6426973,100,4,25,3310,389918035,1,0,0,729.04,8,153238.96,3,2,17,2,True
6796374,1324,4,-1,3310,389918035,1,1,0,728.8,1,153238.96,18,0,20,4,True
6815287,1324,4,30,8723,389918035,1,0,0,728.92,8,152510.04,18,2,4,4,True
7110646,333,1,25,3343,389918035,1,0,0,728.85,8,151781.19,11,6,6,8,True
7252413,627,0,10,7990,389918035,1,0,0,729.09,6,152510.28,11,5,2,8,True
7328799,339,4,-1,5583,389918035,1,1,0,728.91,4,152510.28,11,1,7,9,True
7589180,1328,4,-1,7409,389918035,1,2,0,729.05,1,152510.28,18,0,1,9,True
7602957,333,1,-1,3768,389918035,1,3,1,728.83,4,152510.28,11,5,23,11,True
1108589,1238,0,25,6081,359051066,0,0,0,370.22,8,922419.78,18,1,17,1,True
1165896,488,3,30,4807,359051066,0,0,0,369.76,8,922050.02,12,2,14,2,True
1220290,522,0,30,2159,359051066,0,0,0,370.02,8,921680.0,18,2,21,3,True
1284022,1238,0,25,6470,359051066,0,0,0,369.88,8,921310.12,18,3,0,6,True
1301018,318,0,-1,3912,359051066,0,1,0,369.78,1,921310.12,11,2,23,6,True
1302099,723,1,451,3088,359051066,0,0,0,369.86,7,920940.26,11,3,10,6,True
1442336,86,4,25,9763,359051066,0,0,0,369.74,8,920570.52,1,0,9,7,True
1771638,588,0,10,3912,359051066,0,0,0,370.15,6,920940.67,24,4,16,7,True
1844421,937,0,20,7703,359051066,0,0,0,369.99,5,920570.68,24,5,16,8,True
2023697,318,0,451,4807,359051066,0,0,0,370.04,7,920200.64,11,0,12,9,True
2208487,203,0,10,4807,359051066,0,0,0,370.04,6,920570.68,9,6,19,9,True
2216683,318,0,451,6124,359051066,0,0,0,369.98,7,920200.7,11,2,3,10,True
2321491,715,0,20,8318,359051066,0,0,0,369.87,5,919830.83,18,5,22,10,True
2359895,1242,4,30,6304,359051066,0,0,0,370.22,8,919460.61,18,5,10,11,True
2404254,419,4,-1,3912,359051066,0,1,0,370.06,4,919460.61,18,6,11,11,True
2432048,318,0,451,2465,359051066,0,0,0,369.9,7,919090.71,11,5,3,11,True
2650663,86,4,-1,9208,359051066,0,1,0,369.8,4,919090.71,1,5,7,11,True
2671320,86,4,451,2074,359051066,0,0,0,370.04,7,918720.67,1,1,16,12,True
2907768,522,0,-1,6124,359051066,0,1,0,370.15,4,918720.67,18,6,6,1,True
2910757,318,0,451,1363,359051066,0,0,0,369.99,7,918350.68,11,4,6,2,True
2995703,488,3,25,6470,359051066,0,0,0,369.88,8,917980.8,12,1,14,2,True
3083894,1027,0,20,1697,359051066,0,0,0,370.12,3,917610.68,11,4,1,4,True
3134710,522,0,451,6304,359051066,0,0,0,370.09,7,917240.59,18,4,7,6,True
3926755,1311,2,20,3088,359051066,0,0,0,369.81,3,916870.78,5,5,8,6,True
4029794,574,2,20,9479,359051066,0,0,0,370.14,3,916500.64,11,4,15,7,True
4126860,86,4,30,1010,359051066,0,0,0,370.03,8,916130.61,1,0,20,7,True
4185091,723,1,451,1010,359051066,0,0,0,370.1,7,915760.51,11,2,7,8,False
4512988,86,4,451,6301,359051066,0,0,0,370.14,7,915390.37,1,5,11,8,True
4758184,276,0,10,2877,359051066,0,0,0,370.05,6,915760.42,24,3,18,8,True
4921364,1242,4,-1,2877,359051066,0,1,0,369.91,1,915760.42,18,6,9,8,True
5029924,723,1,451,4807,359051066,0,0,0,370.3,7,915390.12,11,5,18,9,True
5394810,723,1,451,4807,359051066,0,0,0,369.83,7,915020.29,11,4,2,10,True
5567728,1242,4,451,9177,359051066,0,0,0,369.86,7,914650.43,18,0,21,1,True
5727398,318,0,25,2877,359051066,0,0,0,369.97,8,914280.46,11,5,1,2,True
6089744,394,0,20,9177,359051066,0,0,0,369.92,5,913910.54,10,6,16,2,True
6217207,20,0,10,2159,359051066,0,0,0,370.07,0,914280.61,24,3,12,2,True
6238084,327,0,20,3088,359051066,0,0,0,370.1,3,913910.51,11,6,15,3,True
6706710,1238,0,30,1697,359051066,0,0,0,370.16,8,913540.35,18,0,3,4,True
6804046,1238,0,-1,9177,359051066,0,1,0,370.05,1,913540.35,18,2,2,5,True
6844610,687,0,10,3335,359051066,0,0,0,370.37,6,913910.72,24,5,17,5,True
7039520,1238,0,451,9763,359051066,0,0,0,370.06,7,913540.66,18,0,10,5,True
7103800,1242,4,30,9763,359051066,0,0,0,370.11,8,913170.55,18,4,6,7,True
7330207,1238,0,-1,3088,359051066,0,1,0,370.02,4,913170.55,18,4,22,7,True
7371079,610,0,10,2465,359051066,0,0,0,369.84,6,913540.39,11,1,9,7,True
7529301,318,0,25,2155,359051066,0,0,0,370.01,8,913170.38,11,4,18,8,True
8314763,485,1,10,9208,359051066,0,0,0,370.13,6,913540.51,5,1,7,9,True
8381799,522,0,25,6124,359051066,0,0,0,370.01,8,913170.5,18,6,17,9,True
8399280,488,3,30,9208,359051066,0,0,0,370.03,8,912800.47,12,0,12,9,True
8650605,419,4,451,6470,359051066,0,0,0,369.79,7,912430.68,18,3,0,9,True
8770864,318,0,25,3088,359051066,0,0,0,370.09,8,912060.59,11,5,0,9,True
8863314,688,0,10,3088,359051066,0,0,0,370.1,0,912430.69,24,2,11,10,True
9050669,1242,4,30,2159,359051066,0,0,0,369.72,8,912060.97,18,0,21,10,True
9196205,1264,0,10,2074,359051066,0,0,0,370.07,0,912431.04,23,3,19,11,True
1107462,898,1,451,1305,689776833,1,0,0,226.89,7,617255.11,24,3,23,1,True
1450879,1287,4,30,1305,689776833,1,0,0,227.08,8,617028.03,24,0,23,2,True
1519955,228,0,-1,9995,689776833,1,1,0,226.99,4,617028.03,26,4,7,5,True
1900148,687,0,10,5476,689776833,1,0,0,227.0,0,617255.03,24,3,7,5,True
1962488,687,0,10,8534,689776833,1,0,0,226.96,0,617481.99,24,0,0,7,True
2547420,228,0,30,5619,689776833,1,0,0,227.26,8,617254.73,26,6,9,7,True
2961813,1047,3,451,9995,689776833,1,0,0,226.66,7,617028.07,11,0,17,8,True
3018053,228,0,451,8604,689776833,1,0,0,226.84,7,616801.23,26,5,5,9,True
3237776,118,2,20,3594,689776833,1,0,0,226.94,5,616574.29,18,6,2,9,True
3360170,228,0,-1,5540,689776833,1,1,0,226.99,1,616574.29,26,1,9,10,True
3647168,1047,3,451,5540,689776833,1,0,0,226.93,7,616347.36,11,5,19,10,True
3844526,169,4,-1,5217,689776833,1,1,0,226.9,1,616347.36,24,0,20,10,True
3897114,723,1,10,1305,689776833,1,0,0,227.07,6,616574.43,11,0,13,12,True
3996050,1047,3,451,1569,689776833,1,0,0,227.16,7,616347.27,11,4,8,12,True
4006682,1354,0,25,1781,689776833,1,0,0,227.07,8,616120.2,24,0,15,1,True
4081092,1047,3,25,8247,689776833,1,0,0,226.97,8,615893.23,11,0,8,1,True
4464697,1345,2,20,8534,689776833,1,0,0,226.99,5,615666.24,24,6,21,2,True
4491919,898,1,451,3594,689776833,1,0,0,226.98,7,615439.26,24,5,7,2,True
4544994,1354,0,-1,7514,689776833,1,1,0,226.97,4,615439.26,24,1,22,2,True
4595451,444,2,20,7514,689776833,1,0,0,227.08,5,615212.18,24,3,2,3,True
4692736,1119,0,20,9995,689776833,1,0,0,227.06,5,614985.12,24,1,16,3,True
4698420,1287,4,25,9335,689776833,1,0,0,226.89,8,614758.23,24,0,7,3,True
4953785,898,1,451,9335,689776833,1,0,0,226.9,7,614531.33,24,3,11,4,True
5155671,466,4,451,5540,689776833,1,0,0,226.82,7,614304.51,13,2,11,5,True
5326349,466,4,451,9335,689776833,1,0,0,226.96,7,614077.55,13,5,0,5,True
5339891,1477,2,20,3594,689776833,1,0,0,227.16,5,613850.39,24,6,15,5,True
5578615,1047,3,30,8604,689776833,1,0,0,226.98,8,613623.41,11,5,13,5,True
5690667,1455,2,20,2404,689776833,1,0,0,226.79,5,613396.62,11,6,9,7,True
5708588,1354,0,25,5217,689776833,1,0,0,226.91,8,613169.71,24,5,4,8,True
5762377,257,1,10,1781,689776833,1,0,0,226.98,6,613396.69,6,4,14,8,False
5790714,1354,0,25,5180,689776833,1,0,0,226.95,8,613169.74,24,2,2,10,True
5867725,1287,4,-1,1569,689776833,1,1,0,226.98,4,613169.74,24,3,10,10,True
5905755,889,0,20,9335,689776833,1,0,0,227.15,5,612942.59,27,3,5,10,True
5932582,466,4,-1,3769,689776833,1,1,0,227.08,4,612942.59,13,6,14,10,True
5972626,169,4,30,7404,689776833,1,0,0,226.9,8,612715.69,24,1,1,12,True
6249429,466,4,25,1305,689776833,1,0,0,227.08,8,612488.61,13,6,1,12,True
6273611,228,0,30,7514,689776833,1,0,0,227.14,8,612261.47,26,1,19,1,True
6331394,403,0,20,8604,689776833,1,0,0,226.79,3,612034.68,10,2,7,1,True
6778700,466,4,-1,8604,689776833,1,1,0,227.02,4,612034.68,13,1,8,2,True
6792768,158,2,20,3769,689776833,1,0,0,227.02,3,611807.66,24,3,12,5,True
7140081,898,1,30,3007,689776833,1,0,0,227.18,8,611580.48,24,6,13,6,True
7185127,1047,3,30,9335,689776833,1,0,0,227.09,8,611353.39,11,1,23,6,True
7210056,1064,0,20,8534,689776833,1,0,0,226.78,3,611126.61,11,6,23,6,True
7422047,1354,0,30,1569,689776833,1,0,0,227.06,8,610899.55,24,4,9,6,True
7471375,1152,0,10,8604,689776833,1,0,0,226.9,6,611126.45,15,3,23,6,True
7813453,1213,2,20,2404,689776833,1,0,0,227.08,5,610899.37,24,0,13,7,True
7919297,587,2,20,7514,689776833,1,0,0,226.89,3,610672.48,24,1,15,7,True
8486306,1354,0,451,5051,689776833,1,0,0,226.8,7,610445.68,24,6,2,7,True
8568058,1047,3,25,7090,689776833,1,0,0,227.01,8,610218.67,11,2,8,8,True
8628468,1354,0,451,9335,689776833,1,0,0,227.07,7,609991.6,24,4,0,8,True
8718242,466,4,-1,7514,689776833,1,1,0,227.04,1,609991.6,13,6,7,8,True
8869468,1264,0,10,5619,689776833,1,0,0,226.84,6,610218.44,23,3,16,9,True
9112889,466,4,30,3594,689776833,1,0,0,227.15,8,609991.29,13,0,11,9,True
9250428,1287,4,25,3594,689776833,1,0,0,227.08,8,609764.21,24,5,19,9,True
9751057,1047,3,451,3594,689776833,1,0,0,226.94,7,609537.27,11,3,17,11,True
1071345,178,4,-1,2592,335869622,1,1,0,694.08,4,398072.0,24,5,17,1,True
1247183,1180,1,451,8669,335869622,1,0,0,694.14,7,397377.86,24,4,16,1,True
1538321,291,3,25,9815,335869622,1,0,0,693.88,8,396683.98,24,6,23,1,False
1684907,372,0,451,6255,335869622,1,0,0,694.01,7,395989.97,25,6,4,2,True
1789124,1180,1,-1,8634,335869622,1,1,0,694.14,4,395989.97,24,5,18,3,False
1838398,1342,3,25,5926,335869622,1,0,0,694.11,8,395295.86,24,1,11,3,True
1847300,1342,3,451,9099,335869622,1,0,0,694.1,7,394601.76,24,4,7,5,True
1904977,372,0,25,8230,335869622,1,0,0,693.97,8,393907.79,25,5,21,6,True
2271929,673,0,10,7322,335869622,1,0,0,693.94,6,394601.73,18,2,19,7,True
2403812,471,0,10,1480,335869622,1,0,0,694.04,0,395295.77,5,5,0,7,True
2459490,1419,1,451,1480,335869622,1,0,0,694.07,7,394601.7,24,1,8,8,True
2488640,291,3,451,8669,335869622,1,0,0,694.16,7,393907.54,24,4,4,8,True
2652733,1342,3,451,6627,335869622,1,0,0,693.99,7,393213.55,24,6,4,8,True
3054733,178,4,-1,1451,335869622,1,1,0,693.9,4,393213.55,24,4,16,10,True
3230892,1419,1,30,2592,335869622,1,0,0,693.89,8,392519.66,24,4,22,11,True
3598311,1419,1,451,5926,335869622,1,0,0,694.03,7,391825.63,24,6,4,2,True
3682292,291,3,25,8634,335869622,1,0,0,694.21,8,391131.42,24,1,5,3,True
4095250,1180,1,25,2671,335869622,1,0,0,693.85,8,390437.57,24,0,2,5,True
4492599,182,1,10,7979,335869622,1,0,0,694.18,6,391131.75,18,1,19,5,True
4621794,178,4,451,8230,335869622,1,0,0,694.11,7,390437.64,24,3,14,6,False
4909322,1305,2,20,4687,335869622,1,0,0,693.87,5,389743.77,5,6,22,7,True
5243051,1419,1,451,5568,335869622,1,0,0,693.77,7,389050.0,24,5,7,7,True
5299345,372,0,451,4792,335869622,1,0,0,694.22,7,388355.78,25,5,20,7,True
5359688,1000,0,20,9099,335869622,1,0,0,694.2,5,387661.58,26,2,16,8,True
5361217,291,3,451,7979,335869622,1,0,0,694.08,7,386967.5,24,2,18,9,True
5611775,291,3,451,1451,335869622,1,0,0,693.82,7,386273.68,24,3,13,9,True
5616164,796,2,20,4792,335869622,1,0,0,694.05,5,385579.63,11,1,10,10,True
5629888,291,3,25,8634,335869622,1,0,0,694.17,8,384885.46,24,2,19,11,True
5652211,372,0,-1,1480,335869622,1,1,0,694.04,4,384885.46,25,4,23,11,True
6414746,605,0,10,2671,335869622,1,0,0,693.82,0,385579.28,24,6,14,11,True
6467410,342,0,10,2592,335869622,1,0,0,694.08,6,386273.36,24,2,13,11,True
6567668,291,3,-1,2592,335869622,1,1,0,694.17,1,386273.36,24,2,0,12,True
6649979,300,0,20,8046,335869622,1,0,0,694.07,5,385579.29,4,3,1,12,True
6705250,1342,3,25,1991,335869622,1,0,0,694.0,8,384885.29,24,3,16,12,True
6793612,807,0,20,8046,335869622,1,0,0,693.97,5,384191.32,11,4,7,1,True
6811494,372,0,25,6627,335869622,1,0,0,693.91,8,383497.41,25,2,22,1,True
6933324,372,0,25,4792,335869622,1,0,0,693.88,8,382803.53,25,4,16,2,True
7050782,1342,3,30,5050,335869622,1,0,0,694.0,8,382109.53,24,0,16,2,True
7157895,787,0,10,8669,335869622,1,0,0,693.65,6,382803.18,14,0,19,2,True
7285851,1180,1,30,7317,335869622,1,0,0,694.06,8,382109.12,24,4,4,3,True
7375208,1419,1,-1,1991,335869622,1,1,0,694.07,1,382109.12,24,6,12,3,True
7443364,291,3,451,2592,335869622,1,0,0,693.86,7,381415.26,24,0,11,5,True
7525302,1342,3,451,3193,335869622,1,0,0,693.89,7,380721.37,24,6,22,5,True
7559847,1180,1,451,6627,335869622,1,0,0,694.05,7,380027.32,24,1,5,6,True
8543304,1086,0,10,3193,335869622,1,0,0,694.32,6,380721.64,18,4,16,6,True
8659011,372,0,25,1480,335869622,1,0,0,694.2,8,380027.44,25,6,15,6,True
8780960,1180,1,451,8669,335869622,1,0,0,694.14,7,379333.3,24,1,7,8,True
8824618,178,4,451,7317,335869622,1,0,0,694.14,7,378639.16,24,4,12,9,True
8959214,178,4,30,7322,335869622,1,0,0,694.13,8,377945.03,24,1,3,10,True
9057781,372,0,30,5926,335869622,1,0,0,694.08,8,377250.95,25,1,6,10,True
9313054,1180,1,-1,7317,335869622,1,1,0,693.75,4,377250.95,24,1,4,10,True
9602581,291,3,25,3086,335869622,1,0,0,694.05,8,376556.9,24,0,20,10,True
1042877,159,2,30,5264,419690295,1,0,0,257.15,8,834439.85,24,4,17,2,True
1119113,1010,0,20,6973,419690295,1,0,0,256.67,3,834183.18,26,4,3,2,True
1172583,643,4,-1,4800,419690295,1,1,0,256.89,1,834183.18,24,4,12,2,True
1176924,218,0,20,1999,419690295,1,0,0,257.01,5,833926.17,9,4,2,3,True
1205434,110,4,-1,7316,419690295,1,1,0,257.13,1,833926.17,3,6,19,3,True
1254884,820,1,30,7108,419690295,1,0,0,256.98,8,833669.19,18,5,4,3,True
1521493,673,0,10,7316,419690295,1,0,0,257.13,0,833926.32,18,6,21,5,True
1629784,747,1,-1,3942,419690295,1,1,0,257.16,4,833926.32,24,2,16,5,True
2229407,1015,0,20,8773,419690295,1,0,0,257.15,3,833669.17,26,0,23,5,True
2241286,180,0,20,8255,419690295,1,0,0,256.68,3,833412.49,18,2,16,5,True
2508385,1174,3,-1,3412,419690295,1,1,0,257.03,4,833412.49,24,6,11,6,True
2512533,1174,3,451,8773,419690295,1,0,0,257.18,7,833155.31,24,6,15,6,True
2517440,535,0,20,1685,419690295,1,0,0,256.84,5,832898.47,18,2,9,7,True
2637166,643,4,30,6973,419690295,1,0,0,256.78,8,832641.69,24,6,8,7,True
2637874,1174,3,30,4730,419690295,1,0,0,256.9,8,832384.79,24,4,20,9,True
2698672,509,0,10,6973,419690295,1,0,0,257.08,0,832641.87,12,5,1,9,True
2959554,994,4,30,7859,419690295,1,0,0,256.8,8,832385.07,22,3,7,9,True
3503819,820,1,-1,7557,419690295,1,1,0,257.28,1,832385.07,18,4,7,10,True
3779829,1174,3,25,8773,419690295,1,0,0,256.98,8,832128.09,24,1,4,11,True
3852981,820,1,451,5313,419690295,1,0,0,256.99,7,831871.1,18,6,10,11,True
4090536,110,4,25,8255,419690295,1,0,0,257.13,8,831613.97,3,0,14,12,True
4229035,820,1,451,7108,419690295,1,0,0,256.91,7,831357.06,18,4,19,12,False
4324708,110,4,451,8773,419690295,1,0,0,256.91,7,831100.15,3,6,4,1,True
4568082,110,4,25,2557,419690295,1,0,0,257.01,8,830843.14,3,3,23,1,True
4668885,820,1,-1,4730,419690295,1,1,0,256.78,1,830843.14,18,4,15,1,True
4758117,994,4,451,5264,419690295,1,0,0,257.06,7,830586.08,22,3,1,3,True
4815572,1174,3,451,7859,419690295,1,0,0,257.2,7,830328.88,24,1,23,3,True
4836329,159,2,451,7316,419690295,1,0,0,256.82,7,830072.06,24,2,17,3,True
4842774,159,2,30,4074,419690295,1,0,0,257.2,8,829814.86,24,2,0,3,True
5774631,110,4,25,4935,419690295,1,0,0,256.79,8,829558.07,3,0,17,3,True
5805512,466,4,451,7298,419690295,1,0,0,257.06,7,829301.01,13,5,9,4,True
6017214,1212,0,10,5516,419690295,1,0,0,257.22,6,829558.23,24,0,19,5,True
6164156,643,4,30,4935,419690295,1,0,0,256.9,8,829301.33,24,5,20,6,True
6181926,747,1,451,2557,419690295,1,0,0,257.18,7,829044.15,24,5,7,6,True
6715540,329,1,10,4965,419690295,1,0,0,257.0,0,829301.15,11,1,5,6,True
6777949,643,4,-1,6973,419690295,1,1,0,257.08,4,829301.15,24,3,16,6,True
6861637,276,0,20,3839,419690295,1,0,0,256.89,5,829044.26,24,2,16,7,True
7022894,110,4,-1,7298,419690295,1,1,0,257.04,4,829044.26,3,2,17,9,True
7045038,466,4,451,8255,419690295,1,0,0,256.99,7,828787.27,13,5,23,9,True
7046154,564,0,10,9883,419690295,1,0,0,256.94,0,829044.21,17,1,11,10,True
7079356,643,4,451,4074,419690295,1,0,0,256.78,7,828787.43,24,0,2,11,True
7680603,58,2,20,5516,419690295,1,0,0,256.77,5,828530.66,20,2,12,1,True
7922982,747,1,451,4074,419690295,1,0,0,257.09,7,828273.57,24,0,17,2,True
7967721,820,1,451,6412,419690295,1,0,0,256.84,7,828016.73,18,3,12,3,True
8028491,1174,3,-1,5516,419690295,1,1,0,256.97,4,828016.73,24,0,11,4,True
8147317,110,4,451,3942,419690295,1,0,0,256.85,7,827759.88,3,1,2,4,True
8319067,994,4,25,1899,419690295,1,0,0,256.97,8,827502.91,22,1,18,4,True
8408246,747,1,25,5313,419690295,1,0,0,257.02,8,827245.89,24,2,0,5,True
8434226,466,4,451,3839,419690295,1,0,0,256.88,7,826989.01,13,5,7,5,True
8653949,325,0,20,6412,419690295,1,0,0,257.05,5,826731.96,11,4,19,5,True
8820324,1152,0,20,7298,419690295,1,0,0,256.91,5,826475.05,15,2,1,6,True
9032323,466,4,451,3942,419690295,1,0,0,256.94,7,826218.11,13,3,13,6,True
9394512,747,1,451,6973,419690295,1,0,0,257.29,7,825960.82,24,2,4,6,True
9548218,184,0,10,9423,419690295,1,0,0,256.89,6,826217.71,18,5,23,6,True
9655868,643,4,451,9948,419690295,1,0,0,257.38,7,825960.33,24,6,1,7,True
9690172,643,4,-1,4800,419690295,1,1,0,256.89,4,825960.33,24,4,22,8,True
9814458,820,1,-1,7440,419690295,1,2,0,257.17,4,825960.33,18,6,20,10,True
9936610,228,0,20,5516,419690295,1,0,0,257.06,5,825703.27,26,5,14,10,True
1107483,376,0,10,9534,101648380,0,0,0,506.24,6,802028.24,25,2,17,2,True
1132931,394,0,451,6735,101648380,0,0,0,505.87,7,801522.37,10,0,19,2,True
1297102,175,3,451,7349,101648380,0,0,0,505.74,7,801016.63,24,1,4,3,True
1338602,1425,0,10,9618,101648380,0,0,0,506.09,6,801522.72,24,5,19,3,False
1338948,1213,2,20,2440,101648380,0,0,0,505.77,3,801016.95,24,5,2,4,True
1617998,418,4,-1,6250,101648380,0,1,0,506.01,1,801016.95,18,3,4,4,True
1936204,394,0,30,4899,101648380,0,0,0,505.85,8,800511.1,10,5,8,5,True
1968039,18,4,451,8852,101648380,0,0,0,505.99,7,800005.11,24,4,3,7,True
2214005,594,0,-1,9618,101648380,0,1,0,505.99,4,800005.11,24,3,10,8,True
2256247,1470,4,30,8852,101648380,0,0,0,505.91,8,799499.2,11,2,3,8,False
2357188,1116,0,10,6250,101648380,0,0,0,506.07,0,800005.27,24,1,15,9,True
2359093,594,0,451,7500,101648380,0,0,0,506.02,7,799499.25,24,6,9,10,True
3111883,394,0,451,6735,101648380,0,0,0,506.31,7,798992.94,10,2,2,11,True
3374509,46,1,10,2998,101648380,0,0,0,505.88,6,799498.82,24,5,2,12,True
3418405,18,4,451,8909,101648380,0,0,0,505.88,7,798992.94,24,3,6,1,True
3654366,18,4,-1,7041,101648380,0,1,0,506.11,4,798992.94,24,3,0,2,True
4276797,358,4,451,4899,101648380,0,0,0,505.57,7,798487.37,24,6,9,3,True
4359399,394,0,10,6776,101648380,0,0,0,506.06,6,798993.43,10,0,22,4,True
4630203,358,4,-1,6776,101648380,0,1,0,506.03,4,798993.43,24,2,17,4,True
4807117,998,0,20,6964,101648380,0,0,0,506.16,5,798487.27,26,0,8,6,True
4922857,1470,4,-1,6035,101648380,0,1,0,505.99,4,798487.27,11,0,23,7,True
5052276,594,0,-1,6558,101648380,0,2,0,505.79,4,798487.27,24,3,11,9,False
5132879,394,0,451,8909,101648380,0,0,0,505.91,7,797981.36,10,4,1,9,True
5251425,18,4,451,3945,101648380,0,0,0,506.1,7,797475.26,24,0,3,9,True
5847829,175,3,25,4439,101648380,0,0,0,506.16,8,796969.1,24,4,1,10,True
5872795,18,4,451,8852,101648380,0,0,0,506.17,7,796462.93,24,5,0,10,True
6021051,1470,4,30,9308,101648380,0,0,0,506.01,8,795956.92,11,3,23,11,True
6192670,594,0,30,6035,101648380,0,0,0,505.91,8,795451.01,24,1,21,11,True
6274081,175,3,451,9534,101648380,0,0,0,506.03,7,794944.98,24,3,11,11,True
6357708,18,4,451,1314,101648380,0,0,0,506.12,7,794438.86,24,6,13,12,True
6598167,594,0,25,2440,101648380,0,0,0,506.11,8,793932.75,24,3,7,1,True
6604379,1014,1,10,4470,101648380,0,0,0,506.09,6,794438.84,26,1,5,1,True
6717750,334,0,20,4470,101648380,0,0,0,506.05,5,793932.79,11,5,1,1,True
6787911,418,4,30,6776,101648380,0,0,0,506.27,8,793426.52,18,1,15,1,True
6873614,594,0,-1,3945,101648380,0,1,0,505.77,4,793426.52,24,2,14,1,True
7016147,394,0,451,4470,101648380,0,0,0,506.17,7,792920.35,10,5,14,2,True
7508470,18,4,451,1314,101648380,0,0,0,505.99,7,792414.36,24,5,10,3,True
7521429,53,0,20,6017,101648380,0,0,0,505.96,5,791908.4,20,0,1,4,True
7701435,27,0,10,4899,101648380,0,0,0,505.81,6,792414.21,11,2,2,4,True
7909168,175,3,30,3945,101648380,0,0,0,505.86,8,791908.35,24,4,13,4,True
7983038,1246,0,20,9787,101648380,0,0,0,506.0,5,791402.35,23,5,19,5,True
8000106,175,3,25,6035,101648380,0,0,0,505.74,8,790896.61,24,2,5,5,True
8206600,1470,4,25,4899,101648380,0,0,0,505.98,8,790390.63,11,3,2,6,True
8365766,175,3,25,5432,101648380,0,0,0,505.96,8,789884.67,24,0,15,9,True
8408787,394,0,25,9787,101648380,0,0,0,506.39,8,789378.28,10,2,8,10,True
8919251,644,0,20,7594,101648380,0,0,0,505.94,5,788872.34,24,2,20,10,True
9767466,594,0,30,8731,101648380,0,0,0,505.94,8,788366.4,24,6,7,10,True
9910432,418,4,30,6558,101648380,0,0,0,506.03,8,787860.37,18,6,4,11,True
9949623,594,0,25,6250,101648380,0,0,0,506.01,8,787354.36,24,3,9,11,True
9971565,418,4,451,2042,101648380,0,0,0,506.14,7,786848.22,18,5,11,11,True
1043492,867,0,30,6839,673793436,0,0,0,1036.88,8,428197.12,24,0,12,1,True
1072047,413,4,-1,3838,673793436,0,1,0,1036.68,1,428197.12,18,3,6,2,True
1256376,131,4,451,2011,673793436,0,0,0,1036.85,7,427160.27,18,3,7,3,True
1600508,1190,3,30,5069,673793436,0,0,0,1037.22,8,426123.05,24,2,6,3,True
2099683,867,0,25,5533,673793436,0,0,0,1037.08,8,425085.97,24,2,0,3,True
2434322,537,0,10,1508,673793436,0,0,0,1037.14,6,426123.11,18,1,23,3,True
2751536,1170,0,451,2008,673793436,0,0,0,1036.9,7,425086.21,24,2,8,6,True
2771929,1170,0,30,9825,673793436,0,0,0,1037.14,8,424049.07,24,1,1,6,True
2941371,413,4,-1,4630,673793436,0,1,0,1036.85,4,424049.07,18,2,18,6,True
2943260,898,1,10,5069,673793436,0,0,0,1036.98,6,425086.05,24,0,14,7,True
3692192,613,4,25,4332,673793436,0,0,0,1036.92,8,424049.13,11,5,3,8,True
3717233,732,0,20,4630,673793436,0,0,0,1037.08,5,423012.05,11,2,6,9,True
3823058,1190,3,451,2008,673793436,0,0,0,1037.05,7,421975.0,24,2,22,9,True
3909143,613,4,451,1418,673793436,0,0,0,1037.13,7,420937.87,11,5,15,10,True
4150853,1190,3,25,6839,673793436,0,0,0,1036.97,8,419900.9,24,6,2,11,True
4218650,1369,3,-1,5295,673793436,0,1,0,1037.19,1,419900.9,16,0,10,11,True
4559108,579,0,20,3661,673793436,0,0,0,1037.34,5,418863.56,11,6,22,12,True
4598762,613,4,-1,3661,673793436,0,1,0,1037.13,4,418863.56,11,3,21,12,True
4798752,867,0,451,9600,673793436,0,0,0,1036.74,7,417826.82,24,3,20,1,True
5050963,1190,3,-1,3661,673793436,0,1,0,1037.09,1,417826.82,24,6,18,1,True
5420460,613,4,451,8947,673793436,0,0,0,1037.34,7,416789.48,11,5,9,1,True
5678992,1369,3,-1,1418,673793436,0,1,0,1037.03,4,416789.48,16,6,9,1,True
5780723,1170,0,25,1012,673793436,0,0,0,1036.86,8,415752.62,24,5,13,2,True
5840910,1190,3,-1,5295,673793436,0,1,0,1037.28,4,415752.62,24,6,8,2,True
5872652,738,2,20,9825,673793436,0,0,0,1037.03,5,414715.59,11,1,16,4,True
6076955,413,4,451,4663,673793436,0,0,0,1036.93,7,413678.66,18,4,13,5,True
6285329,1369,3,-1,1871,673793436,0,1,0,1037.03,1,413678.66,16,5,17,5,True
6317566,867,0,-1,5533,673793436,0,2,0,1036.75,4,413678.66,24,2,23,5,True
6562615,1190,3,451,5295,673793436,0,0,0,1036.8,7,412641.86,24,3,3,6,True
6634263,867,0,451,2011,673793436,0,0,0,1036.95,7,411604.91,24,1,0,7,True
6761242,613,4,30,3273,673793436,0,0,0,1037.01,8,410567.9,11,4,3,8,False
6925844,1075,0,20,5533,673793436,0,0,0,1037.08,3,409530.82,18,3,20,8,True
7002186,1318,0,20,5567,673793436,0,0,0,1037.12,3,408493.7,18,2,12,9,False
7110309,413,4,451,5292,673793436,0,0,0,1037.19,7,407456.51,18,1,11,10,True
7128362,1369,3,30,5567,673793436,0,0,0,1037.16,8,406419.35,16,6,12,11,True
7537650,1170,0,451,4630,673793436,0,0,0,1036.95,7,405382.4,24,0,1,12,True
7603393,867,0,30,4663,673793436,0,0,0,1036.85,8,404345.55,24,3,16,12,True
7662195,1142,2,20,1508,673793436,0,0,0,1037.29,5,403308.26,15,0,10,1,True
7857642,613,4,25,4630,673793436,0,0,0,1037.18,8,402271.08,11,5,5,1,True
8082523,1369,3,30,2008,673793436,0,0,0,1036.93,8,401234.15,16,0,21,1,True
8106559,1190,3,30,5533,673793436,0,0,0,1036.93,8,400197.22,24,5,20,2,True
8107455,867,0,25,4630,673793436,0,0,0,1037.09,8,399160.13,24,2,1,2,True
8260156,1170,0,-1,1508,673793436,0,1,0,1037.1,4,399160.13,24,2,13,3,True
8331309,148,1,10,4663,673793436,0,0,0,1037.01,6,400197.14,18,5,22,3,True
8495519,1369,3,-1,5533,673793436,0,1,0,1036.87,4,400197.14,16,5,16,4,True
8499750,1260,0,20,5292,673793436,0,0,0,1037.31,5,399159.83,23,1,2,4,True
8624082,1190,3,451,9600,673793436,0,0,0,1037.17,7,398122.66,24,2,20,5,True
8928079,630,0,10,2423,673793436,0,0,0,1037.01,6,399159.67,11,4,22,6,True
9051994,867,0,451,3425,673793436,0,0,0,1036.91,7,398122.76,24,6,17,7,True
9145745,649,0,10,5292,673793436,0,0,0,1036.89,6,399159.65,24,2,5,7,True
9461319,131,4,30,4630,673793436,0,0,0,1036.96,8,398122.69,18,3,3,8,True
9587801,413,4,30,1418,673793436,0,0,0,1036.84,8,397085.85,18,3,13,9,True
9682406,131,4,30,9084,673793436,0,0,0,1036.95,8,396048.9,18,0,2,9,True
9689971,131,4,30,6839,673793436,0,0,0,1036.93,8,395011.97,18,0,22,10,True
9794148,1190,3,451,5069,673793436,0,0,0,1036.84,7,393975.13,24,3,12,10,True
9881862,613,4,25,3838,673793436,0,0,0,1036.98,8,392938.15,11,2,16,10,True
9987337,131,4,451,6839,673793436,0,0,0,1036.98,7,391901.17,18,4,11,11,True
1331717,34,1,-1,7473,398537125,0,1,0,479.97,4,540490.0,11,1,7,1,True
2123106,326,4,451,9805,398537125,0,0,0,480.11,7,540009.89,11,5,4,2,True
2278291,23,0,451,7877,398537125,0,0,0,480.12,7,539529.77,11,6,16,2,True
2546753,1226,2,20,2617,398537125,0,0,0,480.13,5,539049.64,18,5,3,3,True
2553176,553,1,25,3993,398537125,0,0,0,480.0,8,538569.64,17,6,20,4,True
2746323,553,1,25,5275,398537125,0,0,0,479.94,8,538089.7,17,2,18,4,True
2906705,1218,4,451,5059,398537125,0,0,0,480.11,7,537609.59,24,2,5,5,True
3086689,523,2,25,4673,398537125,0,0,0,479.99,8,537129.6,18,5,13,5,True
3211921,23,0,451,4168,398537125,0,0,0,479.88,7,536649.72,11,4,7,5,True
3311923,523,2,451,1980,398537125,0,0,0,480.21,7,536169.51,18,5,21,5,True
3785098,95,2,20,3993,398537125,0,0,0,480.04,5,535689.47,1,5,14,7,True
3965592,553,1,451,5059,398537125,0,0,0,480.14,7,535209.33,17,2,21,7,True
3968901,1112,1,10,9805,398537125,0,0,0,479.69,6,535689.02,0,1,9,11,True
4018585,326,4,-1,3882,398537125,0,1,0,480.02,4,535689.02,11,6,15,12,True
4074737,1272,0,25,7877,398537125,0,0,0,480.01,8,535209.01,24,4,8,12,True
4086991,572,0,20,4168,398537125,0,0,0,480.12,3,534728.89,11,0,5,1,True
4123750,1180,1,10,5650,398537125,0,0,0,480.19,6,535209.08,24,0,22,1,True
4180461,522,0,10,2190,398537125,0,0,0,479.99,6,535689.07,18,4,10,3,True
4217582,34,1,25,7981,398537125,0,0,0,479.95,8,535209.12,11,4,3,3,True
4274367,850,1,10,9805,398537125,0,0,0,480.18,6,535689.3,5,3,5,4,True
4521787,1240,4,30,9805,398537125,0,0,0,480.09,8,535209.21,18,2,13,4,True
4699725,457,0,10,4839,398537125,0,0,0,479.92,6,535689.13,13,6,0,4,True
4988831,476,1,10,4673,398537125,0,0,0,480.29,0,536169.42,5,2,11,4,True
5239191,635,2,20,2617,398537125,0,0,0,479.97,5,535689.45,24,6,7,4,True
5273341,23,0,451,5650,398537125,0,0,0,480.05,7,535209.4,11,0,8,5,True
5579255,23,0,451,5275,398537125,0,0,0,480.0,7,534729.4,11,2,1,6,True
5687659,553,1,451,7981,398537125,0,0,0,480.12,7,534249.28,17,1,12,6,True
5743957,1272,0,25,4839,398537125,0,0,0,479.98,8,533769.3,24,2,7,7,True
5768445,1218,4,451,4673,398537125,0,0,0,480.01,7,533289.29,24,1,10,7,True
6155785,23,0,30,2190,398537125,0,0,0,480.0,8,532809.29,11,4,16,10,True
6324003,818,1,10,5275,398537125,0,0,0,480.03,6,533289.32,18,0,3,10,False
6465231,34,1,451,2190,398537125,0,0,0,480.02,7,532809.3,11,4,15,10,True
6767221,326,4,30,3576,398537125,0,0,0,480.15,8,532329.15,11,5,17,10,True
6777352,523,2,451,2946,398537125,0,0,0,480.12,7,531849.03,18,0,12,11,True
6916271,34,1,25,9805,398537125,0,0,0,480.31,8,531368.72,11,2,23,11,True
6936974,326,4,451,4839,398537125,0,0,0,480.19,7,530888.53,11,5,6,11,True
6954699,1218,4,-1,3882,398537125,0,1,0,479.74,4,530888.53,24,3,8,11,True
7093355,879,1,10,2617,398537125,0,0,0,479.95,6,531368.48,27,3,14,12,True
7212018,326,4,30,6455,398537125,0,0,0,480.29,8,530888.19,11,2,12,2,True
7314708,1169,0,10,3882,398537125,0,0,0,479.74,0,531367.93,24,2,4,3,True
7419090,1338,0,10,9805,398537125,0,0,0,480.06,6,531847.99,18,5,6,3,True
7611360,34,1,451,2190,398537125,0,0,0,480.1,7,531367.89,11,1,18,5,True
7694011,1272,0,451,5275,398537125,0,0,0,479.87,7,530888.02,24,0,12,6,True
8192125,34,1,25,2190,398537125,0,0,0,479.97,8,530408.05,11,2,12,6,True
8393309,23,0,30,7981,398537125,0,0,0,479.86,8,529928.19,11,1,14,6,True
8555058,553,1,30,7877,398537125,0,0,0,480.01,8,529448.18,17,1,2,7,True
8870013,470,1,10,4839,398537125,0,0,0,479.85,6,529928.03,5,5,13,7,True
9129869,1272,0,451,7473,398537125,0,0,0,480.37,7,529447.66,24,3,16,9,True
9184618,1218,4,-1,7473,398537125,0,1,0,479.8,4,529447.66,24,6,10,9,True
9735951,1218,4,30,4168,398537125,0,0,0,480.08,8,528967.58,24,2,10,10,True
9784892,34,1,25,3993,398537125,0,0,0,479.99,8,528487.59,11,3,6,10,True
9819993,34,1,-1,5275,398537125,0,1,0,480.31,4,528487.59,11,3,14,11,True
9950904,502,0,10,3993,398537125,0,0,0,480.07,0,528967.66,12,1,23,11,True
1055211,1076,1,10,8985,347085095,1,0,0,1190.03,6,668770.03,18,4,23,2,True
1288324,1415,4,25,3090,347085095,1,0,0,1190.05,8,667579.98,24,1,18,3,True
1486256,739,1,30,9158,347085095,1,0,0,1189.92,8,666390.06,24,2,10,3,True
1764573,1438,4,451,1132,347085095,1,0,0,1190.16,7,665199.9,24,2,12,4,True
2010338,1438,4,25,5810,347085095,1,0,0,1189.99,8,664009.91,24,1,21,4,True
2105437,1438,4,30,4942,347085095,1,0,0,1189.98,8,662819.93,24,4,0,4,True
2105953,187,4,451,8471,347085095,1,0,0,1190.02,7,661629.91,18,6,6,5,True
2108432,911,3,-1,8471,347085095,1,1,0,1190.17,4,661629.91,18,0,22,5,True
2172417,1160,0,10,6722,347085095,1,0,0,1190.05,6,662819.96,15,1,4,5,True
2301505,1438,4,451,5621,347085095,1,0,0,1190.12,7,661629.84,24,4,21,6,True
2743350,739,1,-1,3896,347085095,1,1,0,1190.1,4,661629.84,24,6,15,6,True
2983584,228,0,20,5810,347085095,1,0,0,1190.21,5,660439.63,26,1,1,6,True
3211486,739,1,451,1015,347085095,1,0,0,1189.76,7,659249.87,24,6,14,7,True
3319923,1438,4,25,8062,347085095,1,0,0,1189.94,8,658059.93,24,6,20,8,True
3396282,911,3,30,9128,347085095,1,0,0,1190.01,8,656869.92,18,1,10,9,True
3410759,911,3,451,3090,347085095,1,0,0,1190.3,7,655679.62,18,4,3,10,True
3414632,1438,4,-1,6117,347085095,1,1,0,1190.19,4,655679.62,24,3,6,11,True
3478664,1465,4,30,9128,347085095,1,0,0,1190.06,8,654489.56,11,1,17,11,True
3735560,1465,4,451,4283,347085095,1,0,0,1190.03,7,653299.53,11,5,1,12,True
3739302,267,0,20,6722,347085095,1,0,0,1190.14,5,652109.39,6,0,18,1,True
3739673,739,1,451,6722,347085095,1,0,0,1189.88,7,650919.51,24,2,22,2,True
3777065,187,4,451,5810,347085095,1,0,0,1189.94,7,649729.57,18,3,0,3,True
3813931,1438,4,30,1898,347085095,1,0,0,1189.91,8,648539.66,24,1,20,5,True
3816990,158,2,20,5412,347085095,1,0,0,1189.96,5,647349.7,24,4,9,5,True
3861196,1339,2,20,4942,347085095,1,0,0,1189.81,3,646159.89,18,5,8,5,True
3937603,1415,4,451,8985,347085095,1,0,0,1190.02,7,644969.87,24,2,20,5,False
3954840,1465,4,25,1015,347085095,1,0,0,1190.11,8,643779.76,11,3,18,6,True
4044731,1152,0,20,9158,347085095,1,0,0,1189.98,3,642589.78,15,1,5,7,True
4295473,1438,4,25,9158,347085095,1,0,0,1189.92,8,641399.86,24,3,18,8,True
4616627,573,0,20,8062,347085095,1,0,0,1189.94,5,640209.92,11,1,2,9,True
4811779,732,0,20,6117,347085095,1,0,0,1190.03,5,639019.89,11,1,0,9,True
4904781,911,3,25,2567,347085095,1,0,0,1190.04,8,637829.85,18,4,18,10,True
5186100,1415,4,451,3090,347085095,1,0,0,1190.09,7,636639.76,24,6,9,10,True
5469423,1465,4,-1,8062,347085095,1,1,0,1189.94,4,636639.76,11,4,0,10,True
5477465,1113,1,10,4942,347085095,1,0,0,1189.88,0,637829.64,0,3,14,11,True
5687102,1438,4,451,2567,347085095,1,0,0,1189.89,7,636639.75,24,4,4,12,True
5794853,257,1,10,5621,347085095,1,0,0,1190.09,0,637829.84,6,5,7,12,True
5938624,1465,4,451,4283,347085095,1,0,0,1190.07,7,636639.77,11,1,9,1,True
5973190,1415,4,451,6722,347085095,1,0,0,1190.11,7,635449.66,24,0,14,1,True
6248543,1465,4,451,9128,347085095,1,0,0,1189.78,7,634259.88,11,0,1,1,True
6946285,1415,4,25,1898,347085095,1,0,0,1190.03,8,633069.85,24,1,23,2,True
7017532,187,4,-1,1132,347085095,1,1,0,1189.86,1,633069.85,18,3,11,2,True
7145916,187,4,451,5621,347085095,1,0,0,1189.98,7,631879.87,18,2,6,4,True
7394491,1465,4,-1,4283,347085095,1,1,0,1190.01,1,631879.87,11,1,5,4,True
7554134,911,3,451,6117,347085095,1,0,0,1190.18,7,630689.69,18,2,12,5,True
7587421,738,2,20,8985,347085095,1,0,0,1190.0,5,629499.69,11,5,8,5,True
7823393,1438,4,451,6722,347085095,1,0,0,1189.97,7,628309.72,24,0,13,5,True
7968631,911,3,451,6117,347085095,1,0,0,1190.16,7,627119.56,18,0,6,5,True
7996708,662,1,10,5412,347085095,1,0,0,1190.16,0,628309.72,18,3,0,5,True
8352607,739,1,451,8062,347085095,1,0,0,1190.2,7,627119.52,24,2,16,6,True
8581807,187,4,30,5621,347085095,1,0,0,1189.84,8,625929.68,18,4,10,7,True
8661542,911,3,451,5621,347085095,1,0,0,1190.12,7,624739.56,18,2,19,7,True
8664737,1465,4,451,1898,347085095,1,0,0,1190.02,7,623549.54,11,2,20,7,True
8677027,739,1,25,4942,347085095,1,0,0,1190.02,8,622359.52,24,3,19,7,True
9251580,1415,4,25,1015,347085095,1,0,0,1189.97,8,621169.55,24,0,1,7,True
9364837,1075,0,20,1898,347085095,1,0,0,1189.79,5,619979.76,18,1,5,10,True
9670495,1438,4,-1,8471,347085095,1,1,0,1189.78,4,619979.76,24,2,4,10,True
9893884,739,1,-1,1898,347085095,1,2,0,1190.07,1,619979.76,24,1,12,11,True
1163484,220,0,10,7400,748595117,1,0,0,514.87,6,863203.87,26,2,21,1,True
1842357,728,1,10,6630,748595117,1,0,0,514.95,6,863718.82,11,5,21,1,True
1861005,866,0,-1,2348,748595117,1,1,0,514.93,4,863718.82,24,6,18,1,True
1912040,967,1,30,1484,748595117,1,0,0,515.14,8,863203.68,13,0,21,2,True
2032243,866,0,30,9263,748595117,1,0,0,515.13,8,862688.55,24,2,15,2,False
2081013,90,4,451,3209,748595117,1,0,0,515.14,7,862173.41,1,6,4,2,False
2119355,90,4,30,2348,748595117,1,0,0,514.97,8,861658.44,1,4,5,3,True
2237466,1284,2,20,7400,748595117,1,0,0,515.08,3,861143.36,24,6,9,5,False
2267110,90,4,-1,3209,748595117,1,1,0,514.87,1,861143.36,1,1,5,7,True
2280734,594,0,10,3999,748595117,1,0,0,514.95,6,861658.31,24,6,13,8,True
2333493,90,4,30,3209,748595117,1,0,0,514.74,8,861143.57,1,5,17,9,True
2418526,900,1,25,6730,748595117,1,0,0,515.02,8,860628.55,24,6,16,9,False
2511837,1399,0,10,6630,748595117,1,0,0,515.01,0,861143.56,24,3,15,9,True
2564798,158,2,25,9399,748595117,1,0,0,514.85,8,860628.71,24,1,7,10,True
2723198,90,4,30,1484,748595117,1,0,0,515.02,8,860113.69,1,0,20,10,True
2794885,967,1,25,9399,748595117,1,0,0,514.83,8,859598.86,13,2,8,12,True
2814786,1388,1,10,9399,748595117,1,0,0,515.02,0,860113.88,24,5,21,12,True
2959344,39,3,451,8975,748595117,1,0,0,515.43,7,859598.45,11,0,17,12,True
3058560,866,0,451,7400,748595117,1,0,0,515.24,7,859083.21,24,4,16,1,True
3159797,900,1,451,7848,748595117,1,0,0,514.88,7,858568.33,24,1,22,1,True
3566879,967,1,30,5025,748595117,1,0,0,514.89,8,858053.44,13,1,10,1,True
3567124,866,0,451,8975,748595117,1,0,0,514.94,7,857538.5,24,4,18,2,True
3605549,866,0,30,2276,748595117,1,0,0,515.08,8,857023.42,24,0,9,3,True
3831732,967,1,451,7430,748595117,1,0,0,514.87,7,856508.55,13,1,0,3,True
4102673,39,3,451,6730,748595117,1,0,0,514.94,7,855993.61,11,4,23,4,True
4123799,866,0,30,1030,748595117,1,0,0,514.92,8,855478.69,24,3,20,5,True
4370147,471,0,10,1740,748595117,1,0,0,514.92,6,855993.61,5,0,21,5,False
4430195,39,3,30,2348,748595117,1,0,0,514.83,8,855478.78,11,4,13,6,True
4492609,804,0,20,9263,748595117,1,0,0,515.05,5,854963.73,11,1,11,8,False
4955746,900,1,25,7400,748595117,1,0,0,515.13,8,854448.6,24,5,4,9,True
5183881,160,0,20,7195,748595117,1,0,0,515.26,5,853933.34,24,5,17,9,True
5243418,90,4,451,8254,748595117,1,0,0,515.1,7,853418.24,1,5,18,9,True
5430227,1477,2,20,8975,748595117,1,0,0,514.97,5,852903.27,24,2,10,10,True
5491859,1112,1,10,2523,748595117,1,0,0,515.03,6,853418.3,0,0,8,11,True
5562137,728,1,10,8254,748595117,1,0,0,515.09,6,853933.39,11,3,8,11,True
5631446,90,4,451,2348,748595117,1,0,0,515.3,7,853418.09,1,4,23,12,True
6312160,940,1,10,8254,748595117,1,0,0,515.24,0,853933.33,24,6,13,12,True
6798456,39,3,451,2348,748595117,1,0,0,514.94,7,853418.39,11,3,2,2,True
7249389,1072,0,20,3838,748595117,1,0,0,515.3,3,852903.09,18,0,1,4,True
7372673,502,0,20,2348,748595117,1,0,0,515.04,5,852388.05,12,4,1,4,True
7589439,1134,1,10,7430,748595117,1,0,0,515.11,6,852903.16,24,3,22,5,True
7945246,537,0,10,1484,748595117,1,0,0,514.78,0,853417.94,18,4,0,5,True
8126366,90,4,30,3999,748595117,1,0,0,514.89,8,852903.05,1,6,1,6,True
8138414,866,0,30,6191,748595117,1,0,0,514.91,8,852388.14,24,2,2,7,True
8355763,158,2,25,3838,748595117,1,0,0,514.8,8,851873.34,24,1,4,7,True
8502347,39,3,30,6730,748595117,1,0,0,514.81,8,851358.53,11,4,13,8,True
8611748,58,2,20,6630,748595117,1,0,0,515.04,5,850843.49,20,5,7,8,True
8765481,967,1,451,6630,748595117,1,0,0,514.99,7,850328.5,13,6,4,9,True
8867355,39,3,451,7400,748595117,1,0,0,514.78,7,849813.72,11,0,10,9,True
9263969,90,4,451,6730,748595117,1,0,0,514.91,7,849298.81,1,5,12,9,True
9407779,538,0,10,7195,748595117,1,0,0,515.3,6,849814.11,18,3,2,9,True
9516287,866,0,-1,3999,748595117,1,1,0,514.69,1,849814.11,24,1,23,10,True
9548832,34,1,10,5025,748595117,1,0,0,514.9,0,850329.01,11,6,21,10,True
9698768,900,1,-1,7400,748595117,1,1,0,514.96,1,850329.01,24,1,20,10,True
9885041,535,0,20,1030,748595117,1,0,0,514.78,5,849814.23,18,3,8,10,True
9992113,900,1,30,1030,748595117,1,0,0,514.8,8,849299.43,24,3,15,11,True
1094065,654,1,30,3470,514625615,0,0,0,460.1,8,617220.9,18,2,13,2,True
1118207,414,4,30,8686,514625615,0,0,0,459.8,8,616761.1,18,3,13,3,True
1119646,251,4,30,3545,514625615,0,0,0,460.21,8,616300.89,6,5,14,4,False
1154519,1166,2,-1,9068,514625615,0,1,0,459.91,1,616300.89,24,0,5,4,True
1353858,435,4,30,6742,514625615,0,0,0,459.98,8,615840.91,24,4,2,4,True
1562091,220,0,10,8686,514625615,0,0,0,459.7,6,616300.61,26,3,7,5,True
1600354,929,0,20,9648,514625615,0,0,0,459.71,3,615840.9,18,3,19,5,True
1921330,414,4,451,4818,514625615,0,0,0,460.22,7,615380.68,18,5,18,5,False
2515706,251,4,451,3545,514625615,0,0,0,460.01,7,614920.67,6,3,8,5,True
2527029,1166,2,-1,9959,514625615,0,1,0,460.02,1,614920.67,24,5,14,5,True
2768744,414,4,451,4468,514625615,0,0,0,459.95,7,614460.72,18,0,9,6,True
2991572,980,1,30,4818,514625615,0,0,0,459.91,8,614000.81,22,2,17,7,False
3036319,1411,0,20,5754,514625615,0,0,0,460.23,5,613540.58,24,4,8,7,False
3187733,567,1,10,9648,514625615,0,0,0,459.9,0,614000.48,11,6,13,8,True
3323686,435,4,451,5754,514625615,0,0,0,460.08,7,613540.4,24,2,17,10,True
3327449,654,1,25,6742,514625615,0,0,0,460.05,8,613080.35,18,3,23,10,True
3406491,435,4,451,5754,514625615,0,0,0,460.02,7,612620.33,24,5,15,11,True
3668451,729,0,20,6742,514625615,0,0,0,460.03,3,612160.3,11,5,12,12,True
3771911,1212,0,10,1658,514625615,0,0,0,459.63,6,612619.93,24,2,10,12,True
3881944,654,1,451,3470,514625615,0,0,0,459.91,7,612160.02,18,4,7,2,True
4024211,1310,4,30,1667,514625615,0,0,0,459.92,8,611700.1,5,1,12,2,True
4177481,512,0,20,1560,514625615,0,0,0,459.94,5,611240.16,12,2,3,5,True
4185165,414,4,451,8686,514625615,0,0,0,460.16,7,610780.0,18,3,7,6,True
4259884,251,4,30,4263,514625615,0,0,0,460.12,8,610319.88,6,0,13,6,False
4677262,464,1,10,4263,514625615,0,0,0,460.06,0,610779.94,13,5,13,7,True
5360607,53,0,20,4468,514625615,0,0,0,460.15,5,610319.79,20,1,16,7,True
5733682,1116,0,10,9959,514625615,0,0,0,459.81,6,610779.6,24,3,19,7,False
5771947,251,4,30,9959,514625615,0,0,0,460.06,8,610319.54,6,4,12,7,True
6096055,414,4,451,9648,514625615,0,0,0,460.11,7,609859.43,18,1,11,8,True
6196454,251,4,451,9648,514625615,0,0,0,460.05,7,609399.38,6,0,17,9,True
6536499,1166,2,451,9648,514625615,0,0,0,459.89,7,608939.49,24,2,4,10,True
6642759,1166,2,-1,8686,514625615,0,1,0,460.23,4,608939.49,24,5,10,10,True
6733095,435,4,25,8232,514625615,0,0,0,460.08,8,608479.41,24,6,19,12,True
6798044,20,0,20,6742,514625615,0,0,0,460.22,3,608019.19,24,4,12,12,True
6812701,251,4,30,7540,514625615,0,0,0,459.89,8,607559.3,6,0,4,1,True
7214738,929,0,10,1667,514625615,0,0,0,460.06,6,608019.36,18,0,17,1,True
7352273,1206,0,20,9496,514625615,0,0,0,459.8,3,607559.56,24,1,13,2,True
7362042,1041,0,10,9648,514625615,0,0,0,460.14,6,608019.7,11,5,9,2,True
7484691,736,1,10,4263,514625615,0,0,0,459.89,6,608479.59,11,0,5,2,True
8097028,435,4,451,9496,514625615,0,0,0,459.77,7,608019.82,24,1,19,4,True
8261203,1310,4,-1,1667,514625615,0,1,0,459.68,4,608019.82,5,3,18,5,True
8707359,476,1,10,3545,514625615,0,0,0,459.94,0,608479.76,5,5,5,5,True
9284753,1488,0,20,3545,514625615,0,0,0,460.06,3,608019.7,24,1,7,6,False
9292289,435,4,451,1560,514625615,0,0,0,460.05,7,607559.65,24,3,13,6,True
9438701,414,4,-1,8686,514625615,0,1,0,460.05,4,607559.65,18,4,20,7,True
9554191,1166,2,-1,3470,514625615,0,2,0,460.18,4,607559.65,24,4,16,7,True
9574816,251,4,451,1658,514625615,0,0,0,459.85,7,607099.8,6,4,23,8,True
9607816,1072,0,20,5754,514625615,0,0,0,459.75,3,606640.05,18,1,23,9,True
9751091,980,1,-1,6742,514625615,0,1,0,459.74,1,606640.05,22,3,16,9,True
9763142,1166,2,451,6742,514625615,0,0,0,459.98,7,606180.07,24,4,21,9,True
9855514,34,1,10,6742,514625615,0,0,0,460.13,6,606640.2,11,4,21,10,True
1314141,498,0,451,4673,417752575,1,0,0,729.78,7,939771.22,12,3,7,1,True
1529987,488,3,-1,9871,417752575,1,1,0,730.04,1,939771.22,12,6,10,1,True
1655581,462,4,25,8831,417752575,1,0,0,729.96,8,939041.26,13,2,17,2,True
1775552,1321,0,20,1486,417752575,1,0,0,729.98,5,938311.28,18,5,8,2,True
2301986,498,0,-1,1251,417752575,1,1,0,730.0,4,938311.28,12,1,10,3,True
2320327,297,0,10,2025,417752575,1,0,0,730.18,0,939041.46,4,2,3,3,True
2327891,488,3,-1,5136,417752575,1,1,0,729.74,4,939041.46,12,2,15,3,True
2384978,462,4,-1,5136,417752575,1,2,0,730.28,4,939041.46,13,1,14,3,True
2430580,467,0,10,8946,417752575,1,0,0,729.94,6,939771.4,5,4,4,4,True
2434666,655,3,25,4290,417752575,1,0,0,730.09,8,939041.31,18,6,8,5,True
3048096,462,4,451,5436,417752575,1,0,0,729.74,7,938311.57,13,2,13,5,True
3168200,1284,2,30,4326,417752575,1,0,0,729.93,8,937581.64,24,3,1,5,True
4068070,488,3,451,4326,417752575,1,0,0,730.11,7,936851.53,12,0,9,6,True
4070177,462,4,451,4465,417752575,1,0,0,729.9,7,936121.63,13,6,0,7,True
4520641,611,0,10,7457,417752575,1,0,0,730.02,6,936851.65,11,5,23,7,True
4543383,655,3,451,1528,417752575,1,0,0,729.99,7,936121.66,18,0,23,10,True
4566537,498,0,451,9871,417752575,1,0,0,730.22,7,935391.44,12,3,4,10,True
4606874,542,0,20,5436,417752575,1,0,0,729.94,5,934661.5,17,5,11,10,False
4627133,655,3,30,2529,417752575,1,0,0,730.0,8,933931.5,18,2,18,11,True
4747793,488,3,25,9871,417752575,1,0,0,730.12,8,933201.38,12,1,17,11,True
4864765,488,3,30,1486,417752575,1,0,0,730.16,8,932471.22,12,6,16,1,True
4901748,1284,2,30,7518,417752575,1,0,0,729.78,8,931741.44,24,0,4,2,True
4924269,488,3,25,7457,417752575,1,0,0,729.7,8,931011.74,12,5,16,3,True
4981299,27,0,10,5092,417752575,1,0,0,730.16,6,931741.9,11,3,19,6,True
5302080,655,3,451,4673,417752575,1,0,0,729.85,7,931012.05,18,1,2,6,True
5319636,488,3,451,1568,417752575,1,0,0,730.02,7,930282.03,12,5,15,6,True
5638735,498,0,451,9408,417752575,1,0,0,729.94,7,929552.09,12,0,2,6,True
5669941,130,0,20,2025,417752575,1,0,0,730.23,5,928821.86,18,5,22,7,True
5841898,655,3,451,6658,417752575,1,0,0,730.15,7,928091.71,18,0,9,8,True
6122726,767,0,10,9871,417752575,1,0,0,730.06,0,928821.77,14,2,12,8,True
6158957,488,3,30,3221,417752575,1,0,0,730.15,8,928091.62,12,6,19,9,True
6218264,1436,0,10,8157,417752575,1,0,0,729.98,0,928821.6,24,4,17,9,True
6243466,21,0,20,4290,417752575,1,0,0,729.85,5,928091.75,11,6,20,10,True
6375514,462,4,30,8831,417752575,1,0,0,730.02,8,927361.73,13,2,11,10,True
6704918,1284,2,-1,4326,417752575,1,1,0,729.79,1,927361.73,24,2,22,10,True
6858844,655,3,25,5706,417752575,1,0,0,729.99,8,926631.74,18,2,20,12,True
6872394,488,3,-1,2529,417752575,1,1,0,729.91,1,926631.74,12,0,7,12,True
6988826,655,3,451,6088,417752575,1,0,0,729.96,7,925901.78,18,0,10,1,True
6998845,570,2,20,3221,417752575,1,0,0,730.0,3,925171.78,11,6,8,2,True
7080586,498,0,25,7560,417752575,1,0,0,730.11,8,924441.67,12,0,19,3,True
7286109,488,3,25,9408,417752575,1,0,0,729.83,8,923711.84,12,4,11,3,False
7417152,1284,2,25,1528,417752575,1,0,0,729.9,8,922981.94,24,4,18,5,True
7841998,498,0,451,8157,417752575,1,0,0,730.18,7,922251.76,12,6,11,5,True
7872995,488,3,451,4454,417752575,1,0,0,730.13,7,921521.63,12,2,21,5,True
8031593,462,4,25,3427,417752575,1,0,0,729.85,8,920791.78,13,4,18,6,True
8262291,488,3,30,6092,417752575,1,0,0,730.08,8,920061.7,12,3,6,7,True
8418394,1284,2,451,8157,417752575,1,0,0,730.07,7,919331.63,24,5,8,7,False
8508929,910,0,10,7895,417752575,1,0,0,729.87,6,920061.5,18,1,14,7,True
8675906,655,3,-1,5092,417752575,1,1,0,729.97,1,920061.5,18,4,0,7,True
8995159,498,0,451,2025,417752575,1,0,0,730.09,7,919331.41,12,2,15,7,True
9491083,498,0,25,4326,417752575,1,0,0,730.22,8,918601.19,12,3,6,9,True
9589911,1391,2,20,2025,417752575,1,0,0,729.93,5,917871.26,24,2,11,10,True
9640859,916,0,20,7457,417752575,1,0,0,730.1,5,917141.16,18,2,12,10,True
9761153,655,3,30,6088,417752575,1,0,0,729.94,8,916411.22,18,3,6,10,True
1135064,859,2,20,4652,852977477,0,0,0,108.31,3,545218.69,24,5,4,1,True
1225420,648,3,451,2725,852977477,0,0,0,107.95,7,545110.74,24,0,18,2,True
1395431,1482,3,-1,2693,852977477,0,1,0,107.71,4,545110.74,24,3,1,2,True
1398067,467,0,451,9842,852977477,0,0,0,107.93,7,545002.81,5,4,22,3,True
1462812,860,1,10,7813,852977477,0,0,0,107.78,0,545110.59,24,4,19,3,True
1786411,787,0,10,2725,852977477,0,0,0,108.01,6,545218.6,14,6,10,3,True
2019187,1391,2,-1,6066,852977477,0,1,0,108.18,4,545218.6,24,6,23,3,True
2132529,1314,2,20,7665,852977477,0,0,0,108.16,5,545110.44,5,2,19,5,True
2418658,467,0,451,4889,852977477,0,0,0,108.4,7,545002.04,5,6,22,5,True
2857927,1482,3,25,3860,852977477,0,0,0,108.02,8,544894.02,24,4,22,6,True
3103452,1482,3,451,4391,852977477,0,0,0,108.0,7,544786.02,24,3,3,6,True
3300935,212,4,25,2519,852977477,0,0,0,107.75,8,544678.27,9,1,9,7,True
3620348,350,0,20,4391,852977477,0,0,0,108.01,3,544570.26,24,2,21,8,True
3852095,1482,3,-1,3636,852977477,0,1,0,107.7,4,544570.26,24,0,11,10,True
3958013,467,0,451,3254,852977477,0,0,0,107.83,7,544462.43,5,6,22,10,True
4191014,648,3,451,4652,852977477,0,0,0,108.1,7,544354.33,24,3,0,12,True
4286207,147,0,20,4670,852977477,0,0,0,108.02,3,544246.31,18,2,10,12,True
4308559,1482,3,-1,5552,852977477,0,1,0,108.11,4,544246.31,24,5,8,12,True
4364245,688,0,25,7665,852977477,0,0,0,107.83,8,544138.48,24,2,5,2,True
4671570,688,0,25,9650,852977477,0,0,0,107.98,8,544030.5,24,2,22,2,True
4886628,1109,4,25,6527,852977477,0,0,0,108.18,8,543922.32,0,2,20,3,False
4988030,732,0,20,9842,852977477,0,0,0,108.16,3,543814.16,11,6,19,3,True
5047688,1075,0,10,4719,852977477,0,0,0,108.01,6,543922.17,18,4,13,3,True
5255928,670,0,451,2693,852977477,0,0,0,108.19,7,543813.98,18,6,20,4,True
5430799,212,4,-1,7813,852977477,0,1,0,108.36,4,543813.98,9,6,10,4,False
5666710,732,0,10,4655,852977477,0,0,0,107.99,6,543921.97,11,5,15,5,True
5682603,648,3,451,6066,852977477,0,0,0,108.13,7,543813.84,24,1,21,5,True
5773165,1109,4,-1,8300,852977477,0,1,0,108.21,4,543813.84,0,4,23,5,True
6058590,670,0,451,3636,852977477,0,0,0,107.81,7,543706.03,18,5,5,5,True
6286954,648,3,30,3254,852977477,0,0,0,108.14,8,543597.89,24,6,7,6,True
6379918,688,0,-1,4655,852977477,0,1,0,107.97,4,543597.89,24,3,16,6,True
6621742,212,4,30,4391,852977477,0,0,0,107.89,8,543490.0,9,6,2,7,True
6764462,1391,2,451,4652,852977477,0,0,0,107.99,7,543382.01,24,2,14,7,True
6852437,393,1,10,3254,852977477,0,0,0,108.0,6,543490.01,10,3,22,7,True
6970169,688,0,451,4524,852977477,0,0,0,108.14,7,543381.87,24,5,14,7,True
7038578,1413,0,10,4889,852977477,0,0,0,108.19,6,543490.06,24,5,23,8,True
7044483,1482,3,-1,3636,852977477,0,1,0,108.07,1,543490.06,24,6,23,8,True
7080635,1109,4,451,6066,852977477,0,0,0,107.79,7,543382.27,0,2,4,11,True
7133355,253,2,20,6015,852977477,0,0,0,108.08,3,543274.19,6,2,4,11,True
7331687,688,0,451,4889,852977477,0,0,0,107.77,7,543166.42,24,5,9,12,True
7427434,467,0,451,4134,852977477,0,0,0,107.89,7,543058.53,5,0,19,1,True
8335814,1482,3,451,8578,852977477,0,0,0,107.74,7,542950.79,24,4,4,1,True
8391449,670,0,451,4889,852977477,0,0,0,107.86,7,542842.93,18,6,9,3,True
8416132,1391,2,451,5529,852977477,0,0,0,108.02,7,542734.91,24,3,14,3,True
8530888,648,3,30,4655,852977477,0,0,0,107.98,8,542626.93,24,6,9,3,True
8646556,212,4,451,9650,852977477,0,0,0,107.98,7,542518.95,9,2,0,5,True
8801570,859,2,20,9650,852977477,0,0,0,108.4,5,542410.55,24,6,12,5,True
8875254,1482,3,451,2519,852977477,0,0,0,108.05,7,542302.5,24,3,6,5,True
8979739,670,0,25,3636,852977477,0,0,0,108.11,8,542194.39,18,5,14,5,True
9037763,212,4,25,7037,852977477,0,0,0,108.12,8,542086.27,9,1,9,7,True
9263126,1391,2,451,8578,852977477,0,0,0,108.15,7,541978.12,24,5,4,8,True
9471278,467,0,25,2725,852977477,0,0,0,108.05,8,541870.07,5,0,8,8,True
9519649,1072,0,10,4493,852977477,0,0,0,108.19,6,541978.26,18,3,1,9,True
9659613,688,0,-1,6066,852977477,0,1,0,107.99,4,541978.26,24,5,19,9,True
9726884,212,4,30,4652,852977477,0,0,0,107.92,8,541870.34,9,2,8,10,True
9839726,212,4,451,1536,852977477,0,0,0,108.09,7,541762.25,9,5,13,11,True
1279109,728,1,451,4326,684918605,0,0,0,1118.28,7,120324.72,11,1,8,1,True
1407816,767,0,25,5022,684918605,0,0,0,1118.13,8,119206.59,14,0,10,2,True
1507534,728,1,451,5267,684918605,0,0,0,1118.04,7,118088.55,11,2,1,6,True
1641106,991,1,10,1090,684918605,0,0,0,1118.07,0,119206.62,22,4,18,6,True
1816169,947,2,20,3277,684918605,0,0,0,1117.87,3,118088.75,24,4,14,7,True
1834806,699,4,-1,1090,684918605,0,1,0,1117.86,1,118088.75,18,2,18,9,True
1923119,255,2,-1,5022,684918605,0,2,0,1118.08,4,118088.75,6,5,7,10,True
2274900,337,1,10,5022,684918605,0,0,0,1117.85,6,119206.6,11,2,16,10,True
2474364,1144,2,20,3277,684918605,0,0,0,1118.05,5,118088.55,15,1,2,11,True
2504872,913,0,451,9432,684918605,0,0,0,1117.99,7,116970.56,18,2,11,11,True
2537223,1276,4,-1,5022,684918605,0,1,0,1118.0,4,116970.56,24,1,4,11,True
2613131,58,2,20,6601,684918605,0,0,0,1117.9,5,115852.66,20,1,14,12,True
2687731,728,1,30,6818,684918605,0,0,0,1117.94,8,114734.72,11,2,22,12,True
3039670,255,2,20,3598,684918605,0,0,0,1118.13,3,113616.59,6,6,7,12,True
3252144,699,4,25,8558,684918605,0,0,0,1117.85,8,112498.74,18,1,21,12,True
3258722,767,0,-1,3277,684918605,0,1,0,1117.96,4,112498.74,14,3,2,1,True
3315952,1155,0,10,3277,684918605,0,0,0,1118.27,6,113617.01,15,1,15,1,True
3350600,23,0,451,9000,684918605,0,0,0,1117.99,7,112499.02,11,5,22,1,True
3376462,115,2,20,3803,684918605,0,0,0,1117.76,3,111381.26,3,6,13,2,True
3686171,1276,4,25,6818,684918605,0,0,0,1117.77,8,110263.49,24,6,20,2,True
3845015,587,2,30,8903,684918605,0,0,0,1118.0,8,109145.49,24,0,3,3,True
3847466,445,0,10,5022,684918605,0,0,0,1118.0,6,110263.49,13,4,2,5,True
4167034,1035,0,20,3277,684918605,0,0,0,1117.87,5,109145.62,11,4,0,5,True
4297024,587,2,25,8558,684918605,0,0,0,1117.72,8,108027.9,24,3,3,6,True
4490210,193,1,10,8558,684918605,0,0,0,1118.15,6,109146.05,18,0,2,6,True
4584269,457,0,10,3406,684918605,0,0,0,1117.81,6,110263.86,13,5,4,7,True
4746127,23,0,-1,5029,684918605,0,1,0,1118.11,4,110263.86,11,2,9,7,True
4901078,587,2,30,1090,684918605,0,0,0,1118.01,8,109145.85,24,0,21,7,True
5023610,145,0,20,6601,684918605,0,0,0,1117.97,5,108027.88,18,5,2,7,True
5046793,1205,0,10,6601,684918605,0,0,0,1118.03,6,109145.91,24,6,6,8,True
5128362,699,4,25,4326,684918605,0,0,0,1117.85,8,108028.06,18,5,19,11,True
5538050,1276,4,-1,1090,684918605,0,1,0,1118.12,1,108028.06,24,0,0,11,True
5618560,662,1,10,5022,684918605,0,0,0,1118.07,6,109146.13,18,6,11,11,True
5702218,1235,1,10,3277,684918605,0,0,0,1118.05,0,110264.18,18,6,21,11,True
6093609,1364,0,10,5022,684918605,0,0,0,1118.02,6,111382.2,16,3,16,11,True
6251626,699,4,25,6386,684918605,0,0,0,1117.67,8,110264.53,18,2,19,11,True
6320052,767,0,-1,1090,684918605,0,1,0,1118.05,1,110264.53,14,1,7,12,True
6493970,699,4,30,1090,684918605,0,0,0,1117.9,8,109146.63,18,4,1,12,True
6514469,23,0,451,9896,684918605,0,0,0,1118.17,7,108028.46,11,6,12,1,False
6601353,699,4,25,5029,684918605,0,0,0,1117.99,8,106910.47,18,5,12,2,True
6634705,23,0,-1,4326,684918605,0,1,0,1117.92,4,106910.47,11,1,4,3,True
7151055,728,1,451,6601,684918605,0,0,0,1118.13,7,105792.34,11,1,22,3,True
7415744,378,0,20,3406,684918605,0,0,0,1118.01,3,104674.33,25,6,13,4,True
7515954,1449,0,20,5267,684918605,0,0,0,1117.95,5,103556.38,11,0,0,4,True
7579740,198,0,20,4109,684918605,0,0,0,1118.09,5,102438.29,18,6,0,4,True
7688825,913,0,25,4109,684918605,0,0,0,1118.04,8,101320.25,18,0,10,5,True
7812169,728,1,25,6601,684918605,0,0,0,1117.76,8,100202.49,11,2,1,6,True
7820501,871,0,10,6386,684918605,0,0,0,1118.01,6,101320.5,24,0,3,7,True
8208550,699,4,30,3598,684918605,0,0,0,1118.23,8,100202.27,18,2,1,8,True
8301020,767,0,25,5022,684918605,0,0,0,1118.26,8,99084.01,14,4,6,8,True
8335369,944,2,20,9000,684918605,0,0,0,1118.13,5,97965.88,24,1,9,8,True
8795317,587,2,30,4326,684918605,0,0,0,1117.95,8,96847.93,24,1,22,8,True
8819710,587,2,451,6386,684918605,0,0,0,1117.64,7,95730.29,24,6,22,8,True
8955229,834,0,20,9000,684918605,0,0,0,1118.07,3,94612.22,5,0,14,8,True
9503233,587,2,25,6818,684918605,0,0,0,1117.74,8,93494.48,24,2,4,8,True
9568086,1272,0,20,6386,684918605,0,0,0,1117.84,5,92376.64,24,2,1,9,True
9672145,669,2,20,3803,684918605,0,0,0,1118.08,5,91258.56,18,2,8,10,True
9780720,913,0,-1,5022,684918605,0,1,0,1117.81,4,91258.56,18,1,22,11,True
1112624,730,4,451,3885,269652544,0,0,0,137.83,7,183599.17,11,0,11,1,True
1162561,730,4,451,4979,269652544,0,0,0,138.13,7,183461.04,11,6,3,2,True
1269132,512,0,20,2358,269652544,0,0,0,138.25,3,183322.79,12,3,11,2,True
1522192,900,1,-1,6578,269652544,0,1,0,137.92,4,183322.79,24,3,12,2,True
2041281,586,4,25,2358,269652544,0,0,0,138.0,8,183184.79,24,6,22,2,True
2425360,234,0,25,8347,269652544,0,0,0,138.1,8,183046.69,26,2,7,3,True
2848851,1195,1,451,4081,269652544,0,0,0,138.1,7,182908.59,24,1,22,3,True
3198891,234,0,451,2088,269652544,0,0,0,138.11,7,182770.48,26,5,5,3,True
3259401,558,0,10,9239,269652544,0,0,0,137.93,6,182908.41,17,2,8,4,True
3334088,730,4,-1,8017,269652544,0,1,0,138.23,4,182908.41,11,5,1,5,True
3478729,586,4,25,4090,269652544,0,0,0,137.86,8,182770.55,24,4,19,5,True
3688880,889,0,20,4122,269652544,0,0,0,137.85,5,182632.7,27,3,16,6,True
3805228,1195,1,30,3311,269652544,0,0,0,138.19,8,182494.51,24,4,3,7,True
4075349,730,4,451,7354,269652544,0,0,0,137.88,7,182356.63,11,5,10,8,True
4345053,962,0,30,3311,269652544,0,0,0,138.27,8,182218.36,13,1,6,10,True
4425501,945,1,10,8231,269652544,0,0,0,137.83,0,182356.19,24,4,11,10,True
4502953,180,0,20,7602,269652544,0,0,0,138.11,5,182218.08,18,6,9,12,True
4630141,1195,1,30,6580,269652544,0,0,0,137.92,8,182080.16,24,2,7,3,True
4686452,900,1,25,3311,269652544,0,0,0,137.93,8,181942.23,24,0,9,3,True
4831434,900,1,451,4122,269652544,0,0,0,138.12,7,181804.11,24,3,5,5,True
5013859,962,0,25,8017,269652544,0,0,0,138.16,8,181665.95,13,1,4,7,True
5033532,1195,1,451,4090,269652544,0,0,0,137.98,7,181527.97,24,2,13,7,True
5140623,238,0,20,3416,269652544,0,0,0,137.75,5,181390.22,26,3,1,7,True
5163363,869,2,20,2348,269652544,0,0,0,138.02,5,181252.2,24,1,14,7,True
5434242,882,0,10,8347,269652544,0,0,0,137.94,0,181390.14,27,3,17,7,False
5613945,730,4,451,6578,269652544,0,0,0,137.82,7,181252.32,11,1,16,8,True
5687324,1195,1,451,1546,269652544,0,0,0,137.98,7,181114.34,24,4,0,8,True
5970459,215,0,25,9239,269652544,0,0,0,137.9,8,180976.44,9,5,22,8,False
6053185,900,1,30,7354,269652544,0,0,0,138.01,8,180838.43,24,0,2,8,True
6082995,234,0,25,6578,269652544,0,0,0,137.74,8,180700.69,26,6,10,10,True
6117195,962,0,25,4122,269652544,0,0,0,137.88,8,180562.81,13,6,10,10,True
6242216,1195,1,30,8175,269652544,0,0,0,137.73,8,180425.08,24,1,21,10,True
6266916,900,1,451,7955,269652544,0,0,0,137.57,7,180287.51,24,2,10,1,True
6314793,824,2,20,3311,269652544,0,0,0,137.92,5,180149.59,18,6,4,1,True
6439887,538,0,-1,6580,269652544,0,1,0,137.81,4,180149.59,18,2,13,1,False
6681055,641,0,10,2348,269652544,0,0,0,138.1,6,180287.69,24,2,11,2,True
6763095,1195,1,451,6578,269652544,0,0,0,138.22,7,180149.47,24,2,17,2,False
6852083,1195,1,25,6580,269652544,0,0,0,138.19,8,180011.28,24,5,22,3,True
6859880,603,0,20,9215,269652544,0,0,0,137.99,5,179873.29,24,6,16,4,True
7055748,730,4,30,3416,269652544,0,0,0,138.01,8,179735.28,11,4,10,4,True
7333814,1412,2,20,8017,269652544,0,0,0,138.09,5,179597.19,24,1,5,4,True
7353627,1111,0,10,7955,269652544,0,0,0,138.22,0,179735.41,0,0,4,5,True
7388002,538,0,30,3884,269652544,0,0,0,137.73,8,179597.68,18,5,20,6,True
7523382,117,1,10,2096,269652544,0,0,0,137.88,6,179735.56,18,5,2,7,True
7647951,1205,0,10,1546,269652544,0,0,0,137.64,0,179873.2,24,3,2,7,True
7729173,586,4,30,2088,269652544,0,0,0,138.15,8,179735.05,24,3,21,8,True
7929508,1463,2,20,2258,269652544,0,0,0,137.83,5,179597.22,11,6,3,8,True
8375308,523,2,20,6580,269652544,0,0,0,138.17,5,179459.05,18,5,23,9,True
8668912,215,0,451,3416,269652544,0,0,0,138.16,7,179320.89,9,5,16,9,True
8764549,215,0,30,7931,269652544,0,0,0,138.1,8,179182.79,9,3,17,10,True
9226346,783,0,10,8175,269652544,0,0,0,137.78,6,179320.57,14,6,11,10,True
9478866,1072,0,20,8175,269652544,0,0,0,137.94,5,179182.63,18,3,1,10,True
9694424,1195,1,-1,1546,269652544,0,1,0,138.29,1,179182.63,24,6,0,11,True
9766316,586,4,-1,7931,269652544,0,2,0,138.09,4,179182.63,24,6,22,11,True
9825233,900,1,-1,8451,269652544,0,3,1,138.08,4,0.0,24,3,0,11,True
1046325,376,0,20,7448,239679825,0,0,0,322.18,5,101308.82,25,0,18,1,True
1070551,849,1,30,4015,239679825,0,0,0,322.09,8,100986.73,5,1,16,2,True
1204454,540,4,25,4458,239679825,0,0,0,322.01,8,100664.72,17,6,23,3,True
1236390,540,4,30,6004,239679825,0,0,0,322.2,8,100342.52,17,1,0,4,True
1288612,540,4,451,9640,239679825,0,0,0,321.87,7,100020.65,17,3,6,4,True
1668888,757,0,451,5867,239679825,0,0,0,322.04,7,99698.61,24,1,12,4,True
1685100,26,3,451,2264,239679825,0,0,0,321.97,7,99376.64,11,1,16,4,True
1837620,184,0,30,7440,239679825,0,0,0,321.99,8,99054.65,18,5,8,5,True
2061593,1214,4,30,2264,239679825,0,0,0,321.93,8,98732.72,24,4,22,6,True
2164624,26,3,30,1922,239679825,0,0,0,321.77,8,98410.95,11,5,23,6,True
2165176,869,2,20,7440,239679825,0,0,0,321.9,3,98089.05,24,0,5,7,True
2246196,1303,0,25,7514,239679825,0,0,0,322.14,8,97766.91,5,4,17,9,True
2286375,1495,3,451,2079,239679825,0,0,0,322.22,7,97444.69,24,4,10,9,True
2322817,1105,2,20,3720,239679825,0,0,0,322.12,5,97122.57,0,1,6,9,True
2499187,1477,2,20,3720,239679825,0,0,0,321.97,5,96800.6,24,0,4,10,True
2622073,849,1,-1,9119,239679825,0,1,0,321.92,1,96800.6,5,1,3,10,True
2743661,849,1,25,4105,239679825,0,0,0,322.0,8,96478.6,5,3,2,11,True
2935351,787,0,20,8020,239679825,0,0,0,322.0,3,96156.6,14,1,23,11,True
3016251,540,4,451,3934,239679825,0,0,0,322.14,7,95834.46,17,3,3,3,True
3104856,1495,3,30,1634,239679825,0,0,0,322.14,8,95512.32,24,4,13,3,True
3244691,26,3,451,6808,239679825,0,0,0,321.79,7,95190.53,11,6,17,3,True
3528291,522,0,10,9119,239679825,0,0,0,321.97,6,95512.5,18,3,5,3,True
3946089,849,1,30,7514,239679825,0,0,0,321.9,8,95190.6,5,4,7,5,True
3958245,184,0,30,2079,239679825,0,0,0,322.01,8,94868.59,18,0,19,5,True
4346677,1303,0,451,2079,239679825,0,0,0,321.78,7,94546.81,5,3,6,5,True
4642753,849,1,25,3934,239679825,0,0,0,321.89,8,94224.92,5,2,7,6,True
4773527,1315,0,20,1922,239679825,0,0,0,321.83,5,93903.09,5,0,6,7,True
5586941,522,0,30,4553,239679825,0,0,0,322.16,8,93580.93,18,0,5,7,True
5753711,540,4,25,1312,239679825,0,0,0,321.92,8,93259.01,17,3,13,8,True
6565844,184,0,451,4015,239679825,0,0,0,321.87,7,92937.14,18,6,8,8,True
6888623,849,1,25,6808,239679825,0,0,0,321.98,8,92615.16,5,1,0,8,True
6950781,184,0,-1,9119,239679825,0,1,0,321.62,1,92615.16,18,2,13,9,True
6959737,790,0,20,1634,239679825,0,0,0,322.01,3,92293.15,11,4,3,10,True
7114519,736,1,10,7514,239679825,0,0,0,321.86,0,92615.01,11,3,12,11,True
7206551,26,3,451,4105,239679825,0,0,0,321.8,7,92293.21,11,4,11,11,True
7495462,1214,4,25,1312,239679825,0,0,0,321.8,8,91971.41,24,6,13,11,True
7532528,184,0,25,4458,239679825,0,0,0,321.91,8,91649.5,18,2,2,12,True
7875156,522,0,25,6901,239679825,0,0,0,321.87,8,91327.63,18,2,16,12,True
8091173,1214,4,30,9119,239679825,0,0,0,321.95,8,91005.68,24,5,7,1,True
8120910,679,0,20,4379,239679825,0,0,0,322.15,3,90683.53,24,3,15,2,True
8155570,849,1,30,9119,239679825,0,0,0,322.2,8,90361.33,5,1,21,3,True
8279236,1288,0,20,9119,239679825,0,0,0,321.95,3,90039.38,24,1,11,6,True
8308301,26,3,451,8494,239679825,0,0,0,322.14,7,89717.24,11,4,1,6,True
8566321,184,0,30,2772,239679825,0,0,0,321.97,8,89395.27,18,0,7,6,True
8662231,26,3,30,7514,239679825,0,0,0,321.96,8,89073.31,11,1,13,6,True
8761560,341,0,10,4458,239679825,0,0,0,322.1,6,89395.41,24,3,22,7,True
9268801,522,0,25,6901,239679825,0,0,0,322.07,8,89073.34,18,6,12,7,True
9399546,1214,4,451,4458,239679825,0,0,0,322.19,7,88751.15,24,2,23,8,True
9444077,286,1,10,6004,239679825,0,0,0,321.81,6,89072.96,24,3,3,9,True
9838619,1495,3,451,9119,239679825,0,0,0,322.0,7,88750.96,24,3,17,10,True
9937748,457,0,10,8494,239679825,0,0,0,322.26,6,89073.22,13,4,11,10,True
9941248,26,3,451,2772,239679825,0,0,0,321.86,7,88751.36,11,2,8,11,True
1001603,695,2,-1,5457,764538197,1,1,0,526.84,4,646465.0,24,1,18,12,True
1085159,479,2,-1,5734,764538197,1,2,0,526.86,4,646465.0,5,0,8,3,True
1090076,1474,0,-1,1910,764538197,1,3,1,527.06,1,646465.0,24,1,8,7,True
1001506,114,0,10,9530,665447769,0,0,0,1183.93,6,686246.93,3,2,10,1,True
1013775,267,0,30,8470,665447769,0,0,0,1183.98,8,685062.95,6,0,18,1,True
1187106,1384,4,25,5061,665447769,0,0,0,1183.82,8,683879.13,24,1,23,2,True
1564883,1148,4,451,8470,665447769,0,0,0,1183.87,7,682695.26,15,0,18,3,True
1663713,267,0,-1,3970,665447769,0,1,0,1183.93,1,682695.26,6,3,11,4,True
1672360,226,4,30,9605,665447769,0,0,0,1183.7,8,681511.56,26,4,9,5,True
1820139,226,4,25,5562,665447769,0,0,0,1183.98,8,680327.58,26,4,13,5,True
2322195,689,0,10,9530,665447769,0,0,0,1183.84,6,681511.42,24,2,16,6,True
2434623,64,0,10,4559,665447769,0,0,0,1184.02,0,682695.44,20,4,16,6,True
2528107,226,4,451,6828,665447769,0,0,0,1184.02,7,681511.42,26,3,3,7,True
2599384,702,4,25,8867,665447769,0,0,0,1183.94,8,680327.48,18,1,1,7,True
2599530,267,0,30,1550,665447769,0,0,0,1184.03,8,679143.45,6,0,4,8,True
2929881,1148,4,25,9605,665447769,0,0,0,1183.78,8,677959.67,15,6,9,9,True
3154310,1311,2,20,5088,665447769,0,0,0,1183.73,3,676775.94,5,1,18,9,True
3471658,267,0,451,4559,665447769,0,0,0,1184.03,7,675591.91,6,4,20,9,True
3529285,697,3,451,6828,665447769,0,0,0,1184.09,7,674407.82,24,4,12,10,True
3678686,1189,2,20,1917,665447769,0,0,0,1183.85,5,673223.97,24,5,9,10,True
3816333,361,4,-1,3970,665447769,0,1,0,1183.77,1,673223.97,24,1,10,11,True
3869412,848,2,20,5562,665447769,0,0,0,1184.02,3,672039.95,5,2,5,11,True
4868533,267,0,451,9605,665447769,0,0,0,1183.98,7,670855.97,6,4,15,11,False
5497383,115,2,20,9304,665447769,0,0,0,1184.02,5,669671.95,3,1,15,1,True
5516008,361,4,-1,3970,665447769,0,1,0,1183.98,4,669671.95,24,2,22,1,True
5548817,697,3,-1,4068,665447769,0,2,0,1184.21,4,669671.95,24,3,12,1,True
6036505,697,3,451,4068,665447769,0,0,0,1184.38,7,668487.57,24,5,6,2,True
6161918,226,4,-1,6761,665447769,0,1,0,1183.83,1,668487.57,26,2,2,3,True
6521889,1307,0,20,5562,665447769,0,0,0,1183.78,3,667303.79,5,2,2,4,True
6621355,226,4,30,1550,665447769,0,0,0,1183.76,8,666120.03,26,6,5,4,True
6715772,1148,4,-1,4559,665447769,0,1,0,1184.12,4,666120.03,15,3,22,4,False
6984433,1384,4,25,4559,665447769,0,0,0,1183.84,8,664936.19,24,0,4,5,True
7159541,697,3,451,6828,665447769,0,0,0,1184.2,7,663751.99,24,6,4,5,False
7457483,226,4,30,9530,665447769,0,0,0,1183.9,8,662568.09,26,4,4,6,True
7583200,702,4,30,9304,665447769,0,0,0,1184.06,8,661384.03,18,4,16,7,True
7749379,860,1,10,5562,665447769,0,0,0,1183.93,6,662567.96,24,1,7,8,True
7783211,28,1,-1,8470,665447769,0,1,0,1184.16,1,662567.96,11,6,18,10,True
8174266,697,3,25,4068,665447769,0,0,0,1183.72,8,661384.24,24,1,19,10,True
8230146,1148,4,-1,8867,665447769,0,1,0,1183.89,4,661384.24,15,0,18,11,True
8309004,697,3,451,8470,665447769,0,0,0,1184.0,7,660200.24,24,4,11,11,True
8356269,267,0,451,3413,665447769,0,0,0,1183.68,7,659016.56,6,2,10,1,True
8471094,702,4,25,9605,665447769,0,0,0,1183.9,8,657832.66,18,0,4,1,True
8801112,267,0,30,9304,665447769,0,0,0,1183.96,8,656648.7,6,2,10,2,True
8836556,1148,4,451,9530,665447769,0,0,0,1183.89,7,655464.81,15,0,23,3,True
8985409,198,0,10,9012,665447769,0,0,0,1184.03,6,656648.84,18,2,4,5,True
9000721,738,2,20,2331,665447769,0,0,0,1183.93,5,655464.91,11,3,17,5,True
9264068,28,1,451,8867,665447769,0,0,0,1184.17,7,654280.74,11,2,11,5,True
9407019,1384,4,25,8431,665447769,0,0,0,1183.85,8,653096.89,24,2,11,6,True
9638593,1037,0,10,4559,665447769,0,0,0,1183.78,6,654280.67,11,5,1,7,True
9696962,1401,1,10,8470,665447769,0,0,0,1184.11,0,655464.78,24,2,20,7,True
9850212,267,0,30,6828,665447769,0,0,0,1184.1,8,654280.68,6,1,11,7,True
9901000,1384,4,30,8470,665447769,0,0,0,1184.02,8,653096.66,24,5,15,7,True
9975524,303,0,10,8470,665447769,0,0,0,1184.13,6,654280.79,4,2,4,9,True
1268776,65,3,-1,9712,182067586,0,1,0,232.12,4,315778.0,20,5,17,1,True
1292914,661,4,451,4079,182067586,0,0,0,231.91,7,315546.09,18,1,11,2,True
1297028,65,3,451,2705,182067586,0,0,0,232.01,7,315314.08,20,2,6,2,True
1304880,482,1,25,7837,182067586,0,0,0,231.84,8,315082.24,5,6,3,6,True
1337265,482,1,451,4133,182067586,0,0,0,231.9,7,314850.34,5,0,0,7,True
1708993,573,0,10,7730,182067586,0,0,0,232.02,6,315082.36,11,3,6,8,True
1714932,269,0,10,1207,182067586,0,0,0,231.8,0,315314.16,24,3,5,9,True
1729248,661,4,-1,7950,182067586,0,1,0,231.92,1,315314.16,18,0,10,9,True
1810074,482,1,25,2705,182067586,0,0,0,232.21,8,315081.95,5,0,22,9,True
1883082,65,3,-1,9192,182067586,0,1,0,231.92,4,315081.95,20,1,12,10,True
1897617,661,4,451,6750,182067586,0,0,0,232.13,7,314849.82,18,6,17,12,True
2292577,482,1,-1,4001,182067586,0,1,0,231.78,1,314849.82,5,1,5,1,True
2401785,661,4,25,6750,182067586,0,0,0,232.08,8,314617.74,18,1,20,2,True
2492135,482,1,-1,3395,182067586,0,1,0,231.8,4,314617.74,5,4,7,2,True
2927796,607,2,30,9594,182067586,0,0,0,231.96,8,314385.78,24,0,1,2,True
3324216,482,1,451,7730,182067586,0,0,0,231.81,7,314153.97,5,3,23,2,True
3324673,942,0,25,9594,182067586,0,0,0,231.7,8,313922.27,24,6,23,2,True
3488139,661,4,30,9712,182067586,0,0,0,231.81,8,313690.46,18,6,23,3,True
3790741,942,0,451,9594,182067586,0,0,0,232.08,7,313458.38,24,3,15,3,True
4159097,942,0,-1,4133,182067586,0,1,0,232.1,4,313458.38,24,2,11,3,True
4388905,1256,2,20,7843,182067586,0,0,0,232.07,3,313226.31,23,1,22,5,True
5110825,65,3,30,1003,182067586,0,0,0,231.85,8,312994.46,20,5,4,5,True
5113784,661,4,30,3395,182067586,0,0,0,232.05,8,312762.41,18,2,16,5,True
5538650,1388,1,10,7260,182067586,0,0,0,232.0,6,312994.41,24,4,18,6,True
6094585,607,2,451,2385,182067586,0,0,0,231.89,7,312762.52,24,4,1,7,True
6203959,952,0,20,4862,182067586,0,0,0,231.94,3,312530.58,13,4,13,7,True
6292061,942,0,-1,7837,182067586,0,1,0,231.95,1,312530.58,24,3,14,7,True
6465855,367,1,10,4001,182067586,0,0,0,232.18,0,312762.76,25,0,17,7,True
6553874,607,2,30,4559,182067586,0,0,0,231.99,8,312530.77,24,4,5,8,True
6793902,531,0,10,9041,182067586,0,0,0,231.94,6,312762.71,18,2,4,8,True
6813573,942,0,-1,8688,182067586,0,1,0,232.09,4,312762.71,24,3,17,8,True
7068632,482,1,30,8141,182067586,0,0,0,232.04,8,312530.67,5,6,11,8,True
7132974,286,1,10,9013,182067586,0,0,0,231.89,0,312762.56,24,0,20,9,True
7265111,661,4,30,4079,182067586,0,0,0,231.93,8,312530.63,18,2,14,9,True
7577011,942,0,451,2385,182067586,0,0,0,232.01,7,312298.62,24,4,3,12,True
7668334,661,4,451,4079,182067586,0,0,0,231.9,7,312066.72,18,1,7,12,True
7700863,942,0,451,4828,182067586,0,0,0,231.95,7,311834.77,24,3,7,12,True
7764487,787,0,20,2705,182067586,0,0,0,232.16,5,311602.61,14,5,20,1,True
7768033,482,1,30,3853,182067586,0,0,0,232.02,8,311370.59,5,4,22,1,True
8016343,942,0,25,4828,182067586,0,0,0,231.88,8,311138.71,24,1,1,3,True
8037792,661,4,30,9041,182067586,0,0,0,232.08,8,310906.63,18,6,12,3,True
8172319,607,2,451,9712,182067586,0,0,0,231.95,7,310674.68,24,2,5,4,True
8271294,910,0,20,4828,182067586,0,0,0,231.82,5,310442.86,18,4,4,5,True
8274828,1477,2,20,7908,182067586,0,0,0,231.76,3,310211.1,24,6,7,5,True
8367726,482,1,451,1587,182067586,0,0,0,232.08,7,309979.02,5,4,10,6,True
8725456,607,2,451,4133,182067586,0,0,0,231.99,7,309747.03,24,5,0,6,True
9028021,1289,1,10,8141,182067586,0,0,0,232.15,6,309979.18,24,2,3,7,True
9292142,785,0,20,3951,182067586,0,0,0,231.81,3,309747.37,14,6,9,7,True
9390725,679,0,20,3395,182067586,0,0,0,232.0,5,309515.37,24,0,2,8,True
9489779,239,1,10,7837,182067586,0,0,0,232.0,6,309747.37,26,3,21,10,True
9592507,1467,0,20,4001,182067586,0,0,0,231.91,5,309515.46,11,0,18,11,True
9667478,661,4,451,8141,182067586,0,0,0,232.3,7,309283.16,18,2,12,11,True
1319859,871,0,-1,4575,811066081,0,1,0,785.05,1,335967.0,24,4,21,2,True
1494558,1402,4,-1,3952,811066081,0,2,0,785.11,1,335967.0,24,5,9,7,True
1786783,892,4,-1,7789,811066081,0,3,1,785.1,4,0.0,24,5,14,3,True
1256385,879,1,451,7316,293824996,1,0,0,867.89,7,81654.11,27,6,0,2,True
1276308,360,0,20,5886,293824996,1,0,0,867.97,3,80786.14,24,2,18,3,True
1438163,1246,0,20,6022,293824996,1,0,0,867.89,3,79918.25,23,6,5,3,True
1785503,525,0,451,6731,293824996,1,0,0,868.35,7,79049.9,18,1,2,6,True
1914692,879,1,30,3780,293824996,1,0,0,868.1,8,78181.8,27,0,12,7,True
2004953,635,2,20,8559,293824996,1,0,0,867.96,3,77313.84,24,2,14,7,True
2182888,1256,2,451,9776,293824996,1,0,0,867.89,7,76445.95,23,0,6,8,True
2337095,529,2,20,3647,293824996,1,0,0,867.91,5,75578.04,18,6,7,9,True
2465565,879,1,451,8933,293824996,1,0,0,867.71,7,74710.33,27,6,12,9,True
2696786,525,0,30,9175,293824996,1,0,0,867.72,8,73842.61,18,2,13,9,True
2827635,525,0,-1,6977,293824996,1,1,0,868.06,4,73842.61,18,2,4,10,True
2965375,1000,0,-1,6731,293824996,1,2,0,868.35,4,73842.61,26,5,20,10,True
3070907,1000,0,25,6731,293824996,1,0,0,867.89,8,72974.72,26,6,3,10,True
3081001,1000,0,-1,7316,293824996,1,1,0,868.23,4,72974.72,26,0,13,11,True
3095804,1000,0,451,5405,293824996,1,0,0,867.93,7,72106.79,26,1,0,11,True
3766030,1256,2,25,5886,293824996,1,0,0,868.0,8,71238.79,23,5,21,11,True
3892434,1256,2,451,7773,293824996,1,0,0,868.02,7,70370.77,23,6,9,12,True
3898888,530,0,20,6555,293824996,1,0,0,868.0,5,69502.77,18,2,2,1,True
3912847,711,2,20,6619,293824996,1,0,0,867.91,3,68634.86,18,1,18,2,True
3949787,51,0,25,5886,293824996,1,0,0,867.74,8,67767.12,20,6,3,2,True
4054572,525,0,25,2903,293824996,1,0,0,867.94,8,66899.18,18,2,19,3,True
4077552,530,0,10,2635,293824996,1,0,0,867.93,6,67767.11,18,3,9,3,True
4104421,218,0,10,7992,293824996,1,0,0,868.13,0,68635.24,9,3,0,7,True
4173608,945,1,10,6022,293824996,1,0,0,867.78,6,69503.02,24,1,1,7,True
4438508,51,0,451,9776,293824996,1,0,0,867.96,7,68635.06,20,6,21,7,True
4473555,525,0,-1,8933,293824996,1,1,0,867.92,4,68635.06,18,6,4,8,True
4620409,51,0,30,8933,293824996,1,0,0,867.8,8,67767.26,20,6,21,8,True
5017576,525,0,25,8933,293824996,1,0,0,867.99,8,66899.27,18,0,3,9,True
5070794,879,1,25,6977,293824996,1,0,0,868.22,8,66031.05,27,2,14,9,True
5366558,1256,2,25,7992,293824996,1,0,0,868.16,8,65162.89,23,1,8,10,True
6040117,1000,0,30,3647,293824996,1,0,0,868.15,8,64294.74,26,6,0,11,True
6111666,51,0,30,1168,293824996,1,0,0,868.19,8,63426.55,20,0,5,11,True
6194388,1152,0,20,6731,293824996,1,0,0,867.72,5,62558.83,15,6,19,11,True
6269511,1256,2,30,9238,293824996,1,0,0,867.92,8,61690.91,23,2,9,12,True
6375177,525,0,451,9238,293824996,1,0,0,867.85,7,60823.06,18,4,10,1,True
6460966,1256,2,25,8933,293824996,1,0,0,868.12,8,59954.94,23,2,2,1,True
6526850,1256,2,25,6977,293824996,1,0,0,867.93,8,59087.01,23,2,11,1,True
6673266,1256,2,451,7773,293824996,1,0,0,868.2,7,58218.81,23,6,20,1,True
6680186,599,0,20,7992,293824996,1,0,0,867.81,3,57351.0,24,0,7,2,True
7492581,879,1,25,6022,293824996,1,0,0,867.85,8,56483.15,27,1,19,3,True
7531862,51,0,451,1168,293824996,1,0,0,868.0,7,55615.15,20,6,7,3,True
7676966,591,0,10,6555,293824996,1,0,0,867.91,0,56483.06,24,1,11,4,True
8066508,1000,0,451,5405,293824996,1,0,0,867.94,7,55615.12,26,1,19,4,True
8195178,883,0,10,9238,293824996,1,0,0,868.07,6,56483.19,24,6,0,4,True
8375942,525,0,30,7992,293824996,1,0,0,868.23,8,55614.96,18,4,13,5,True
8766725,1256,2,451,7316,293824996,1,0,0,867.94,7,54747.02,23,2,18,5,False
8931662,879,1,-1,8346,293824996,1,1,0,868.02,4,54747.02,27,1,18,5,False
9071935,51,0,451,2635,293824996,1,0,0,868.02,7,53879.0,20,2,17,6,True
9077877,525,0,-1,6731,293824996,1,1,0,868.0,4,53879.0,18,5,15,6,True
9207258,1000,0,-1,7992,293824996,1,2,0,867.94,4,53879.0,26,1,0,7,True
9265544,929,0,10,1168,293824996,1,0,0,867.9,6,54746.9,18,0,14,8,True
9422080,1227,0,10,6977,293824996,1,0,0,868.07,6,55614.97,18,3,0,8,True
9627843,879,1,451,8346,293824996,1,0,0,868.11,7,54746.86,27,3,7,9,True
9731779,318,0,10,9175,293824996,1,0,0,868.14,6,55615.0,11,1,13,10,True
9918839,525,0,30,2903,293824996,1,0,0,868.14,8,54746.86,18,1,13,10,True
9919190,525,0,-1,5405,293824996,1,1,0,867.87,4,54746.86,18,2,4,11,True
1047685,373,1,10,7718,275721560,0,0,0,745.06,6,486403.06,25,6,6,2,True
1130297,1242,4,25,7718,275721560,0,0,0,744.99,8,485658.07,18,1,1,4,True
1239374,1242,4,30,7542,275721560,0,0,0,745.26,8,484912.81,18,5,3,4,False
1274382,1116,0,-1,9963,275721560,0,1,0,745.07,4,484912.81,24,5,1,4,True
1447038,809,3,30,9991,275721560,0,0,0,744.82,8,484167.99,11,3,19,5,True
1679944,1242,4,25,4047,275721560,0,0,0,745.01,8,483422.98,18,0,3,5,True
1719993,478,4,451,8889,275721560,0,0,0,745.08,7,482677.9,5,0,3,6,True
2217197,871,0,10,4912,275721560,0,0,0,744.74,0,483422.64,24,2,22,6,True
2626084,478,4,451,7542,275721560,0,0,0,744.93,7,482677.71,5,0,14,7,True
2876464,479,2,30,9991,275721560,0,0,0,744.91,8,481932.8,5,6,12,7,True
2975079,653,1,25,9963,275721560,0,0,0,744.63,8,481188.17,24,2,7,8,True
3340599,478,4,30,8889,275721560,0,0,0,744.94,8,480443.23,5,3,13,9,True
3456947,478,4,451,4912,275721560,0,0,0,744.68,7,479698.55,5,3,15,9,True
3517794,605,0,451,8502,275721560,0,0,0,744.92,7,478953.63,24,4,20,11,True
3562548,809,3,-1,7718,275721560,0,1,0,744.88,1,478953.63,11,2,12,12,True
3901410,479,2,-1,7542,275721560,0,2,0,745.25,1,478953.63,5,3,14,12,True
4092677,1401,1,10,5885,275721560,0,0,0,744.66,0,479698.29,24,4,13,1,True
4329118,218,0,25,3410,275721560,0,0,0,744.93,8,478953.36,9,6,1,1,True
4637197,1116,0,451,8761,275721560,0,0,0,745.02,7,478208.34,24,3,3,1,True
4707790,1063,0,20,8761,275721560,0,0,0,744.8,5,477463.54,11,1,9,1,True
4727587,1242,4,30,6647,275721560,0,0,0,745.07,8,476718.47,18,5,21,2,True
4847343,809,3,25,4912,275721560,0,0,0,745.08,8,475973.39,11,3,13,2,True
4927420,809,3,451,5097,275721560,0,0,0,745.12,7,475228.27,11,1,13,2,True
5168053,479,2,25,8502,275721560,0,0,0,744.9,8,474483.37,5,5,1,3,True
5361710,218,0,451,1486,275721560,0,0,0,745.19,7,473738.18,9,2,9,4,True
5365232,653,1,30,1797,275721560,0,0,0,744.93,8,472993.25,24,2,7,4,True
5445708,653,1,30,9991,275721560,0,0,0,744.91,8,472248.34,24,2,14,5,True
5569946,1242,4,-1,1797,275721560,0,1,0,744.8,1,472248.34,18,2,4,5,True
5747356,1406,0,10,9991,275721560,0,0,0,745.0,6,472993.34,24,3,6,6,True
5835960,653,1,30,8889,275721560,0,0,0,744.69,8,472248.65,24,4,19,7,True
5850951,203,0,20,1486,275721560,0,0,0,744.9,5,471503.75,9,0,9,9,True
6174269,809,3,25,4912,275721560,0,0,0,745.02,8,470758.73,11,1,15,9,False
6185025,1250,1,10,3973,275721560,0,0,0,745.01,0,471503.74,23,5,6,11,True
6452113,218,0,-1,7718,275721560,0,1,0,745.08,4,471503.74,9,4,21,12,True
6802696,653,1,30,5097,275721560,0,0,0,744.96,8,470758.78,24,0,16,1,True
7247700,1461,0,10,8761,275721560,0,0,0,745.07,6,471503.85,11,2,20,3,True
7335456,653,1,30,6647,275721560,0,0,0,745.07,8,470758.78,24,0,10,4,True
7505632,1116,0,30,1486,275721560,0,0,0,744.95,8,470013.83,24,2,2,4,False
7548872,867,0,10,3410,275721560,0,0,0,745.34,0,470759.17,24,6,10,4,True
7626678,218,0,30,8889,275721560,0,0,0,745.22,8,470013.95,9,0,10,6,True
7698773,1382,0,10,7542,275721560,0,0,0,744.79,0,470758.74,16,2,20,7,True
8158561,479,2,-1,9963,275721560,0,1,0,745.13,4,470758.74,5,3,6,7,True
8800383,774,2,20,4047,275721560,0,0,0,744.86,5,470013.88,14,0,22,8,False
9029074,479,2,30,3410,275721560,0,0,0,745.24,8,469268.64,5,5,5,8,True
9278834,1242,4,451,1797,275721560,0,0,0,745.07,7,468523.57,18,5,5,9,True
9395770,958,2,20,1797,275721560,0,0,0,745.08,3,467778.49,13,2,6,9,True
9515458,605,0,30,6616,275721560,0,0,0,745.33,8,467033.16,24,3,14,9,True
9671546,605,0,451,7542,275721560,0,0,0,745.01,7,466288.15,24,5,3,9,True
9823001,1116,0,25,8761,275721560,0,0,0,745.07,8,465543.08,24,5,19,10,True
9935884,1242,4,-1,8889,275721560,0,1,0,744.96,1,465543.08,18,4,23,10,True
9939174,267,0,10,5885,275721560,0,0,0,745.41,6,466288.49,6,3,18,11,True
1079080,729,0,25,1055,444503121,0,0,0,938.86,8,356406.14,11,2,13,1,True
1133537,1405,4,451,1833,444503121,0,0,0,939.03,7,355467.11,24,6,7,4,True
1202816,91,4,451,1833,444503121,0,0,0,938.92,7,354528.19,1,5,23,4,True
1639723,729,0,451,7422,444503121,0,0,0,939.07,7,353589.12,11,2,9,4,True
2217131,219,0,-1,4253,444503121,0,1,0,938.98,4,353589.12,9,0,11,5,True
2443023,729,0,451,1901,444503121,0,0,0,939.08,7,352650.04,11,1,8,6,True
2473170,219,0,-1,3902,444503121,0,1,0,938.95,4,352650.04,9,6,2,7,True
2984520,819,2,451,2351,444503121,0,0,0,939.16,7,351710.88,18,5,12,7,True
3469680,1282,2,20,1055,444503121,0,0,0,938.7,3,350772.18,24,5,17,7,True
3596488,547,4,451,2766,444503121,0,0,0,938.96,7,349833.22,17,0,6,7,True
3603880,1405,4,30,6354,444503121,0,0,0,938.97,8,348894.25,24,5,1,7,True
3605599,819,2,451,6354,444503121,0,0,0,939.05,7,347955.2,18,3,17,9,True
3842904,547,4,25,7422,444503121,0,0,0,938.95,8,347016.25,17,5,22,9,True
3991776,913,0,10,3902,444503121,0,0,0,939.27,0,347955.52,18,0,19,9,True
4108816,547,4,451,5004,444503121,0,0,0,938.99,7,347016.53,17,3,21,10,True
4205026,1140,0,10,9255,444503121,0,0,0,939.22,6,347955.75,15,4,22,10,True
4233572,819,2,451,1901,444503121,0,0,0,939.07,7,347016.68,18,5,12,10,True
4587566,1072,0,20,7422,444503121,0,0,0,939.23,3,346077.45,18,5,5,10,True
4660740,819,2,25,3902,444503121,0,0,0,939.31,8,345138.14,18,0,20,11,True
4704446,819,2,30,2329,444503121,0,0,0,938.71,8,344199.43,18,5,9,11,True
4734491,498,0,10,3219,444503121,0,0,0,938.84,6,345138.27,12,6,13,12,True
4789612,201,1,10,2329,444503121,0,0,0,939.1,0,346077.37,9,2,0,1,True
4825099,1289,1,10,3219,444503121,0,0,0,938.95,0,347016.32,24,4,6,2,True
4854709,219,0,30,1055,444503121,0,0,0,939.22,8,346077.1,9,3,16,2,True
4859894,547,4,25,2329,444503121,0,0,0,939.03,8,345138.07,17,4,5,2,True
5695306,1405,4,30,4253,444503121,0,0,0,939.05,8,344199.02,24,5,10,3,True
5718226,219,0,451,1055,444503121,0,0,0,939.08,7,343259.94,9,6,18,3,True
5729378,819,2,451,6719,444503121,0,0,0,939.15,7,342320.79,18,0,9,3,True
5759107,729,0,-1,5004,444503121,0,1,0,938.86,4,342320.79,11,6,11,4,True
5943823,215,0,10,4253,444503121,0,0,0,938.92,0,343259.71,9,3,3,5,True
6269307,64,0,10,9255,444503121,0,0,0,939.11,6,344198.82,20,5,3,6,True
6432916,91,4,451,2351,444503121,0,0,0,939.18,7,343259.64,1,5,11,8,True
6478779,305,1,10,1901,444503121,0,0,0,938.93,6,344198.57,4,2,6,9,True
6846204,1064,0,10,5004,444503121,0,0,0,938.9,6,345137.47,11,5,14,9,True
6883958,342,0,20,5004,444503121,0,0,0,938.82,5,344198.65,24,4,0,9,True
7633692,687,0,10,6354,444503121,0,0,0,939.33,0,345137.98,24,5,0,9,True
7636202,219,0,25,3139,444503121,0,0,0,939.1,8,344198.88,9,4,2,10,True
7785276,91,4,25,3902,444503121,0,0,0,938.9,8,343259.98,1,5,3,10,True
7959207,547,4,25,3139,444503121,0,0,0,938.85,8,342321.13,17,4,9,11,True
8026084,819,2,30,4253,444503121,0,0,0,939.12,8,341382.01,18,0,14,11,True
8042922,1405,4,451,1833,444503121,0,0,0,939.06,7,340442.95,24,6,20,12,True
8193938,819,2,451,6719,444503121,0,0,0,939.11,7,339503.84,18,2,14,12,True
8219617,159,2,20,1833,444503121,0,0,0,938.91,5,338564.93,24,2,23,12,False
8285896,819,2,30,8231,444503121,0,0,0,939.13,8,337625.8,18,3,4,1,True
8336218,1271,0,20,5004,444503121,0,0,0,938.8,5,336687.0,23,0,18,2,True
8480112,547,4,-1,2351,444503121,0,1,0,938.86,4,336687.0,17,6,6,3,True
8574014,219,0,30,7422,444503121,0,0,0,939.0,8,335748.0,9,3,5,6,True
9309798,819,2,-1,1415,444503121,0,1,0,939.09,1,335748.0,18,0,2,6,True
9421150,547,4,451,2329,444503121,0,0,0,939.06,7,334808.94,17,0,20,7,True
9569306,729,0,30,6082,444503121,0,0,0,938.82,8,333870.12,11,5,2,8,True
9683126,547,4,25,2329,444503121,0,0,0,938.87,8,332931.25,17,1,20,8,True
9779310,1405,4,30,3219,444503121,0,0,0,939.27,8,331991.98,24,2,2,10,True
9890353,713,0,20,2351,444503121,0,0,0,939.02,3,331052.96,18,2,20,10,True
1003878,507,4,451,4070,582462393,1,0,0,789.81,7,91100.19,12,5,0,1,True
1111403,560,2,-1,2331,582462393,1,1,0,790.05,4,91100.19,17,0,6,1,True
1358142,155,1,10,7102,582462393,1,0,0,789.95,0,91890.14,18,3,0,1,True
1574606,484,0,20,8955,582462393,1,0,0,789.84,5,91100.3,5,3,22,3,True
1958630,1156,1,10,1655,582462393,1,0,0,790.04,6,91890.34,15,4,2,5,True
2391929,1086,0,451,2383,582462393,1,0,0,790.02,7,91100.32,18,1,3,7,True
2434255,53,0,10,3377,582462393,1,0,0,789.95,0,91890.27,20,4,20,8,True
2865273,402,3,-1,8955,582462393,1,1,0,789.9,4,91890.27,10,1,18,8,True
3388063,1181,2,20,5261,582462393,1,0,0,789.96,3,91100.31,24,2,1,8,True
3476015,402,3,-1,7102,582462393,1,1,0,790.24,4,91100.31,10,5,14,9,True
3746966,27,0,30,3555,582462393,1,0,0,789.68,8,90310.63,11,3,13,10,True
4016723,303,0,20,7554,582462393,1,0,0,789.89,5,89520.74,4,4,23,10,True
4095836,303,0,10,2040,582462393,1,0,0,790.07,6,90310.81,4,5,13,10,True
4128393,1401,1,10,1463,582462393,1,0,0,790.1,0,91100.91,24,1,9,11,True
4554499,999,4,25,1020,582462393,1,0,0,790.2,8,90310.71,26,5,12,11,True
4714069,402,3,451,5462,582462393,1,0,0,790.14,7,89520.57,10,4,4,12,True
4774997,218,0,10,7102,582462393,1,0,0,789.72,6,90310.29,9,4,12,12,True
5026571,1086,0,25,7954,582462393,1,0,0,790.22,8,89520.07,18,6,5,12,True
5577624,1121,3,451,8732,582462393,1,0,0,789.91,7,88730.16,24,6,12,12,True
5670672,701,2,20,1020,582462393,1,0,0,790.21,3,87939.95,18,1,11,1,True
5687912,276,0,20,3377,582462393,1,0,0,789.95,5,87150.0,24,6,7,1,True
5767472,560,2,451,1463,582462393,1,0,0,789.84,7,86360.16,17,1,8,3,True
5924782,507,4,451,1020,582462393,1,0,0,790.06,7,85570.1,12,0,5,3,True
5974850,999,4,25,3842,582462393,1,0,0,789.79,8,84780.31,26,0,10,3,True
6001866,1086,0,451,2383,582462393,1,0,0,790.09,7,83990.22,18,4,8,3,True
6125991,1086,0,451,8732,582462393,1,0,0,790.07,7,83200.15,18,0,10,4,True
6434687,1121,3,451,7102,582462393,1,0,0,789.97,7,82410.18,24,4,13,4,True
6690893,27,0,-1,1463,582462393,1,1,0,789.98,1,82410.18,11,3,21,5,True
6749928,507,4,-1,1463,582462393,1,2,0,790.0,1,82410.18,12,3,0,5,True
7166592,507,4,451,5261,582462393,1,0,0,789.95,7,81620.23,12,3,2,6,True
7232432,402,3,30,3939,582462393,1,0,0,789.97,8,80830.26,10,3,18,6,True
7344286,767,0,10,2040,582462393,1,0,0,790.15,6,81620.41,14,6,15,7,True
7549077,999,4,-1,5119,582462393,1,1,0,790.09,4,81620.41,26,0,11,8,True
7906942,402,3,30,8879,582462393,1,0,0,790.0,8,80830.41,10,4,12,9,True
7987474,1086,0,30,5462,582462393,1,0,0,789.96,8,80040.45,18,2,22,10,True
8211071,999,4,25,7102,582462393,1,0,0,789.97,8,79250.48,26,5,17,10,True
8535596,1406,0,20,6300,582462393,1,0,0,790.12,5,78460.36,24,6,4,11,True
8724405,1086,0,30,8732,582462393,1,0,0,790.01,8,77670.35,18,6,8,11,True
8733470,402,3,30,3144,582462393,1,0,0,789.9,8,76880.45,10,4,7,11,True
8825199,27,0,25,1966,582462393,1,0,0,789.76,8,76090.69,11,6,22,12,False
8860042,402,3,30,1655,582462393,1,0,0,789.63,8,75301.06,10,4,8,1,True
8968038,999,4,451,6300,582462393,1,0,0,789.65,7,74511.41,26,1,3,2,True
9130638,711,2,20,8955,582462393,1,0,0,790.01,3,73721.4,18,1,14,2,True
9324856,999,4,30,3262,582462393,1,0,0,790.1,8,72931.3,26,6,10,2,True
9475196,145,0,20,1463,582462393,1,0,0,790.0,5,72141.3,18,0,5,3,True
9506157,27,0,451,8879,582462393,1,0,0,789.94,7,71351.36,11,2,16,5,True
9612549,999,4,-1,8879,582462393,1,1,0,790.08,4,71351.36,26,0,21,5,True
9710413,701,2,451,3262,582462393,1,0,0,790.1,7,70561.26,18,1,4,7,True
9795225,507,4,-1,5261,582462393,1,1,0,790.25,1,70561.26,12,2,9,8,True
9797762,68,0,10,1463,582462393,1,0,0,790.06,6,71351.32,20,6,8,9,False
9830649,560,2,30,3555,582462393,1,0,0,789.99,8,70561.33,17,0,10,10,True
9953579,583,2,20,5119,582462393,1,0,0,789.94,5,69771.39,11,2,2,10,True
1290534,950,0,10,2274,658752573,0,0,0,1066.03,6,91185.03,24,1,10,1,True
1390277,1086,0,20,3906,658752573,0,0,0,1066.09,5,90118.94,18,5,12,1,True
1527940,1495,3,451,5234,658752573,0,0,0,1066.16,7,89052.78,24,1,5,2,True
1590195,185,1,25,1673,658752573,0,0,0,1066.03,8,87986.75,18,3,9,3,True
1824213,1495,3,451,5089,658752573,0,0,0,1065.87,7,86920.88,24,4,10,3,True
2173339,752,0,20,8420,658752573,0,0,0,1066.02,5,85854.86,24,0,7,5,True
2289387,1495,3,451,5163,658752573,0,0,0,1066.03,7,84788.83,24,0,7,5,True
2508117,185,1,451,5234,658752573,0,0,0,1066.5,7,83722.33,18,5,23,6,True
2968181,1495,3,451,6085,658752573,0,0,0,1066.11,7,82656.22,24,2,10,6,True
3245335,185,1,30,9519,658752573,0,0,0,1066.23,8,81589.99,18,2,1,7,True
3296343,675,2,20,3375,658752573,0,0,0,1065.86,5,80524.13,24,4,8,7,True
3466174,1495,3,25,8988,658752573,0,0,0,1066.12,8,79458.01,24,4,15,8,True
3832260,1495,3,30,3375,658752573,0,0,0,1066.0,8,78392.01,24,4,1,9,True
3852875,1419,1,10,9118,658752573,0,0,0,1066.35,6,79458.36,24,1,19,10,True
3939504,525,0,451,8249,658752573,0,0,0,1066.02,7,78392.34,18,1,9,11,True
4171794,525,0,-1,1414,658752573,0,1,0,1066.15,4,78392.34,18,5,5,11,True
4348789,952,0,10,3906,658752573,0,0,0,1066.07,6,79458.41,13,4,14,12,True
4455044,190,4,-1,1673,658752573,0,1,0,1066.22,4,79458.41,18,3,8,2,True
4665467,190,4,451,4315,658752573,0,0,0,1065.81,7,78392.6,18,6,23,3,True
4701747,185,1,451,4886,658752573,0,0,0,1065.86,7,77326.74,18,5,19,3,True
4980214,1495,3,30,4381,658752573,0,0,0,1065.89,8,76260.85,24,2,15,3,True
4986436,185,1,25,5932,658752573,0,0,0,1066.01,8,75194.84,18,1,16,4,True
5273906,525,0,451,9152,658752573,0,0,0,1066.13,7,74128.71,18,0,16,5,True
5388730,185,1,25,1902,658752573,0,0,0,1066.04,8,73062.67,18,6,4,6,True
5540277,525,0,451,6085,658752573,0,0,0,1066.17,7,71996.5,18,6,21,7,True
5556266,185,1,25,9892,658752573,0,0,0,1065.52,8,70930.98,18,0,6,7,False
5909978,185,1,30,6212,658752573,0,0,0,1066.07,8,69864.91,18,1,7,7,True
6229768,444,2,20,4381,658752573,0,0,0,1065.86,5,68799.05,24,0,2,8,True
6275276,1495,3,30,3740,658752573,0,0,0,1066.05,8,67733.0,24,1,9,9,True
6301063,190,4,451,1902,658752573,0,0,0,1065.73,7,66667.27,18,0,11,10,False
6302686,185,1,-1,5089,658752573,0,1,0,1066.07,1,66667.27,18,4,7,11,True
6457800,525,0,451,8249,658752573,0,0,0,1065.99,7,65601.28,18,1,19,11,True
6706363,1495,3,25,6714,658752573,0,0,0,1065.91,8,64535.37,24,1,5,12,False
6730412,190,4,451,6714,658752573,0,0,0,1065.92,7,63469.45,18,1,23,12,True
6751033,305,1,30,9892,658752573,0,0,0,1065.74,8,62403.71,4,1,9,12,False
6977595,185,1,30,5163,658752573,0,0,0,1065.87,8,61337.84,18,3,1,1,True
7077125,305,1,451,5163,658752573,0,0,0,1066.1,7,60271.74,4,1,6,1,True
7160711,656,2,20,2273,658752573,0,0,0,1066.14,5,59205.6,18,0,5,1,True
7176303,305,1,25,2754,658752573,0,0,0,1066.11,8,58139.49,4,6,11,2,True
7250518,525,0,451,6149,658752573,0,0,0,1066.33,7,57073.16,18,1,1,2,True
7335021,185,1,-1,3082,658752573,0,1,0,1065.86,1,57073.16,18,3,10,4,True
7836178,305,1,25,2274,658752573,0,0,0,1065.89,8,56007.27,4,6,12,5,True
7937314,917,0,20,1902,658752573,0,0,0,1066.23,5,54941.04,18,0,5,6,True
8030485,525,0,30,6212,658752573,0,0,0,1066.0,8,53875.04,18,4,17,6,True
8227456,302,1,10,2274,658752573,0,0,0,1065.89,6,54940.93,4,3,4,7,True
8983477,160,0,20,8249,658752573,0,0,0,1066.17,3,53874.76,24,6,1,7,True
9065038,305,1,451,5089,658752573,0,0,0,1066.13,7,52808.63,4,1,5,7,True
9071292,1113,1,10,2057,658752573,0,0,0,1065.96,6,53874.59,0,0,11,8,True
9564827,670,0,20,4381,658752573,0,0,0,1065.98,3,52808.61,18,4,22,9,True
9606251,305,1,451,3906,658752573,0,0,0,1066.05,7,51742.56,4,2,8,10,True
9691413,1495,3,30,8988,658752573,0,0,0,1066.1,8,50676.46,24,5,10,11,True
9871881,190,4,-1,1414,658752573,0,1,0,1066.03,4,50676.46,18,6,4,11,True
1110378,1041,0,-1,9275,126726893,1,1,0,952.04,1,392756.0,11,1,22,1,True
1239970,1273,0,30,8006,126726893,1,0,0,951.85,8,391804.15,24,3,1,2,True
1498981,1273,0,25,5917,126726893,1,0,0,952.14,8,390852.01,24,1,3,2,True
1499397,203,0,451,1766,126726893,1,0,0,951.97,7,389900.04,9,4,17,2,True
1618371,1273,0,30,1209,126726893,1,0,0,951.77,8,388948.27,24,1,10,3,True
1877673,1273,0,451,6010,126726893,1,0,0,952.16,7,387996.11,24,6,10,3,True
1938561,459,1,10,9275,126726893,1,0,0,952.17,6,388948.28,13,2,23,3,True
2062823,247,4,451,9152,126726893,1,0,0,952.11,7,387996.17,6,2,6,3,True
2326519,1041,0,-1,7793,126726893,1,1,0,951.95,1,387996.17,11,0,10,4,True
2346773,166,4,30,4733,126726893,1,0,0,951.81,8,387044.36,24,5,8,4,True
2349714,166,4,25,8006,126726893,1,0,0,952.03,8,386092.33,24,0,6,6,True
2549035,1041,0,25,6554,126726893,1,0,0,952.18,8,385140.15,11,6,6,6,True
2792825,166,4,451,8514,126726893,1,0,0,951.92,7,384188.23,24,3,12,7,True
3490470,677,0,10,1766,126726893,1,0,0,952.12,6,385140.35,24,1,11,7,True
4089184,247,4,451,7638,126726893,1,0,0,952.12,7,384188.23,6,6,1,8,True
4093782,1273,0,-1,1209,126726893,1,1,0,951.89,1,384188.23,24,6,10,9,True
4176695,605,0,10,7638,126726893,1,0,0,951.85,6,385140.08,24,6,20,9,True
4299747,247,4,451,8514,126726893,1,0,0,952.05,7,384188.03,6,4,1,9,True
4406883,166,4,30,5917,126726893,1,0,0,951.84,8,383236.19,24,5,11,10,True
4677209,1273,0,451,8514,126726893,1,0,0,952.11,7,382284.08,24,3,18,11,True
4788122,166,4,30,5380,126726893,1,0,0,951.95,8,381332.13,24,0,20,1,True
5709863,247,4,451,8006,126726893,1,0,0,952.35,7,380379.78,6,3,13,1,True
5727431,1041,0,25,1342,126726893,1,0,0,952.11,8,379427.67,11,3,5,2,True
5931164,1273,0,-1,6010,126726893,1,1,0,952.07,1,379427.67,24,0,10,4,True
6170063,378,0,20,1342,126726893,1,0,0,952.23,3,378475.44,25,5,12,5,True
6266982,644,0,20,8006,126726893,1,0,0,952.0,3,377523.44,24,4,13,5,True
6395638,1041,0,30,1342,126726893,1,0,0,952.03,8,376571.41,11,3,7,6,True
6481652,1041,0,25,8006,126726893,1,0,0,952.06,8,375619.35,11,4,15,7,True
6528694,115,2,20,1209,126726893,1,0,0,951.82,5,374667.53,3,3,1,7,True
6672042,166,4,451,1209,126726893,1,0,0,951.91,7,373715.62,24,1,14,8,True
6693493,203,0,-1,1766,126726893,1,1,0,951.94,4,373715.62,9,1,10,8,True
6763491,247,4,451,6010,126726893,1,0,0,951.97,7,372763.65,6,2,3,8,True
6849118,166,4,-1,7793,126726893,1,1,0,951.91,4,372763.65,24,3,3,8,True
7075885,1325,0,10,1766,126726893,1,0,0,951.95,6,373715.6,18,2,7,8,True
7293995,166,4,30,2644,126726893,1,0,0,951.92,8,372763.68,24,2,21,8,True
7307410,203,0,-1,4733,126726893,1,1,0,951.7,4,372763.68,9,0,7,9,True
7308228,1210,0,20,5917,126726893,1,0,0,952.06,5,371811.62,24,4,10,10,True
7379358,378,0,451,2644,126726893,1,0,0,952.15,7,370859.47,25,4,1,11,True
7547165,247,4,30,4733,126726893,1,0,0,952.04,8,369907.43,6,0,20,11,True
7601605,1273,0,-1,7993,126726893,1,1,0,951.82,4,369907.43,24,3,1,11,True
7610118,1041,0,30,4733,126726893,1,0,0,952.02,8,368955.41,11,4,6,12,True
7680075,1485,0,10,8514,126726893,1,0,0,951.65,0,369907.06,24,6,13,1,True
7691259,166,4,25,1342,126726893,1,0,0,952.07,8,368954.99,24,4,8,1,True
8135758,267,0,20,4733,126726893,1,0,0,951.9,5,368003.09,6,1,7,1,True
8233726,1273,0,25,9275,126726893,1,0,0,951.68,8,367051.41,24,6,19,2,True
8241355,1041,0,451,8006,126726893,1,0,0,951.77,7,366099.64,11,1,9,3,True
8288354,1426,1,10,4733,126726893,1,0,0,951.85,6,367051.49,24,1,21,4,False
8391888,1273,0,451,9152,126726893,1,0,0,952.02,7,366099.47,24,4,20,6,True
8401411,337,1,10,8006,126726893,1,0,0,952.22,0,367051.69,11,0,18,7,True
8465116,1273,0,30,6010,126726893,1,0,0,951.79,8,366099.9,24,1,14,8,True
8536212,1205,0,10,4733,126726893,1,0,0,952.1,0,367052.0,24,4,5,8,False
8744216,203,0,451,4733,126726893,1,0,0,952.06,7,366099.94,9,5,8,8,True
9021222,1273,0,30,2644,126726893,1,0,0,951.6,8,365148.34,24,1,20,8,True
9220792,1273,0,25,2644,126726893,1,0,0,952.04,8,364196.3,24,5,1,10,False
9239636,378,0,451,8006,126726893,1,0,0,952.08,7,363244.22,25,6,14,10,True
9588689,1273,0,-1,6554,126726893,1,1,0,951.99,4,363244.22,24,3,9,10,False
9675707,203,0,451,8006,126726893,1,0,0,952.15,7,362292.07,9,3,19,11,True
9738967,378,0,451,9275,126726893,1,0,0,951.84,7,361340.23,25,2,7,11,True
1290829,799,2,25,5806,126186952,0,0,0,313.26,8,316655.74,11,6,14,2,True
1343245,159,2,20,1361,126186952,0,0,0,312.88,3,316342.86,24,6,3,3,True
1556205,14,2,30,1361,126186952,0,0,0,312.8,8,316030.06,24,1,7,3,True
1946965,1124,0,20,9270,126186952,0,0,0,312.99,3,315717.07,24,6,16,3,True
2172110,799,2,30,1275,126186952,0,0,0,313.03,8,315404.04,11,1,20,3,True
2258669,857,1,451,5524,126186952,0,0,0,312.92,7,315091.12,24,2,1,4,True
2393259,1232,1,10,5524,126186952,0,0,0,312.58,0,315403.7,18,3,12,4,True
2494115,711,2,20,5806,126186952,0,0,0,313.06,5,315090.64,18,1,20,6,True
2502741,857,1,25,8339,126186952,0,0,0,313.08,8,314777.56,24,1,10,6,True
2693386,857,1,451,5219,126186952,0,0,0,312.91,7,314464.65,24,3,22,6,True
2720182,621,2,20,4534,126186952,0,0,0,312.9,5,314151.75,11,4,20,7,True
2732975,316,2,20,6401,126186952,0,0,0,313.38,3,313838.37,4,0,8,7,True
3044250,799,2,25,6401,126186952,0,0,0,312.91,8,313525.46,11,3,21,9,True
3602922,47,1,10,6737,126186952,0,0,0,312.95,6,313838.41,24,1,2,9,True
3764934,857,1,451,1224,126186952,0,0,0,313.13,7,313525.28,24,3,5,9,True
3974888,857,1,-1,2978,126186952,0,1,0,312.93,4,313525.28,24,5,0,10,True
4108792,167,2,20,3174,126186952,0,0,0,313.06,5,313212.22,24,3,7,12,True
4131813,1403,4,451,7518,126186952,0,0,0,312.98,7,312899.24,24,2,20,3,True
4224760,1152,0,20,6287,126186952,0,0,0,313.24,5,312586.0,15,2,2,3,True
4262661,587,2,20,6127,126186952,0,0,0,312.76,5,312273.24,24,3,1,4,True
4597145,703,0,20,1631,126186952,0,0,0,312.92,5,311960.32,18,3,7,4,True
4702966,307,4,30,1275,126186952,0,0,0,313.0,8,311647.32,4,4,8,4,True
4856753,799,2,-1,5219,126186952,0,1,0,312.91,4,311647.32,11,4,6,4,True
4887588,1436,0,10,8339,126186952,0,0,0,313.01,6,311960.33,24,0,13,5,False
5157781,307,4,451,5806,126186952,0,0,0,312.92,7,311647.41,4,5,20,6,True
5239833,350,0,10,5806,126186952,0,0,0,313.15,0,311960.56,24,0,4,7,False
5256143,857,1,451,6401,126186952,0,0,0,313.23,7,311647.33,24,5,7,7,False
5718810,799,2,451,2978,126186952,0,0,0,313.05,7,311334.28,11,1,18,8,True
5728450,307,4,30,1224,126186952,0,0,0,313.1,8,311021.18,4,3,19,8,True
6122972,14,2,-1,5524,126186952,0,1,0,313.0,4,311021.18,24,4,15,9,True
6324809,147,0,20,6287,126186952,0,0,0,313.08,5,310708.1,18,4,4,10,True
6405994,627,0,10,6127,126186952,0,0,0,313.07,6,311021.17,11,6,3,10,True
6794765,799,2,30,2978,126186952,0,0,0,312.69,8,310708.48,11,4,3,11,True
6962037,599,0,20,9270,126186952,0,0,0,313.04,5,310395.44,24,3,0,12,True
7171849,799,2,25,1361,126186952,0,0,0,312.92,8,310082.52,11,2,22,2,True
7280954,14,2,30,5806,126186952,0,0,0,312.69,8,309769.83,24,3,21,2,False
7413972,307,4,30,5806,126186952,0,0,0,313.03,8,309456.8,4,2,21,4,False
7682970,1403,4,451,4534,126186952,0,0,0,313.0,7,309143.8,24,0,1,4,True
7692945,895,0,20,8339,126186952,0,0,0,313.53,3,308830.27,24,2,12,4,True
7815967,1403,4,30,1361,126186952,0,0,0,313.06,8,308517.21,24,4,11,4,True
7868216,307,4,25,1631,126186952,0,0,0,313.16,8,308204.05,4,3,10,5,True
8001615,799,2,-1,1224,126186952,0,1,0,312.98,4,308204.05,11,4,5,7,False
8138111,1027,0,10,6737,126186952,0,0,0,313.06,0,308517.11,11,6,3,7,True
8226998,857,1,451,1361,126186952,0,0,0,312.99,7,308204.12,24,4,17,7,False
8496518,14,2,25,8339,126186952,0,0,0,312.67,8,307891.45,24,6,16,7,True
8722321,799,2,25,5524,126186952,0,0,0,312.96,8,307578.49,11,0,14,7,True
9244231,307,4,451,5467,126186952,0,0,0,312.72,7,307265.77,4,6,20,8,True
9365825,307,4,451,5467,126186952,0,0,0,312.98,7,306952.79,4,6,3,8,True
9698085,1403,4,451,7518,126186952,0,0,0,312.93,7,306639.86,24,6,9,9,True
9778963,857,1,30,5219,126186952,0,0,0,312.95,8,306326.91,24,1,19,9,True
1125881,238,0,-1,6893,997093996,1,1,0,196.91,4,864897.0,26,2,11,1,True
1134737,238,0,451,3470,997093996,1,0,0,197.08,7,864699.92,26,2,7,2,True
1346523,667,4,451,1464,997093996,1,0,0,196.61,7,864503.31,18,3,21,2,True
1633127,823,4,451,1414,997093996,1,0,0,196.71,7,864306.6,18,3,23,2,True
1751530,129,0,20,6597,997093996,1,0,0,197.08,5,864109.52,18,4,7,2,True
1810965,238,0,25,3860,997093996,1,0,0,197.07,8,863912.45,26,1,20,5,True
2249349,438,1,30,3860,997093996,1,0,0,196.86,8,863715.59,24,4,22,5,True
2382196,938,4,30,2145,997093996,1,0,0,197.02,8,863518.57,24,2,14,6,True
2509147,938,4,30,4087,997093996,1,0,0,196.84,8,863321.73,24,4,13,8,True
2736067,76,0,-1,3596,997093996,1,1,0,196.59,4,863321.73,20,4,13,8,True
2840363,1228,4,25,4087,997093996,1,0,0,196.92,8,863124.81,18,1,20,9,True
2989796,438,1,-1,7910,997093996,1,1,0,197.07,4,863124.81,24,4,1,9,True
3049549,667,4,451,6560,997093996,1,0,0,196.89,7,862927.92,18,3,6,10,True
3407824,76,0,451,3596,997093996,1,0,0,196.93,7,862730.99,20,0,5,10,True
3408372,1228,4,30,3596,997093996,1,0,0,197.07,8,862533.92,18,1,21,11,True
3476007,76,0,451,7910,997093996,1,0,0,197.01,7,862336.91,20,4,14,11,True
3833616,1228,4,30,1414,997093996,1,0,0,197.15,8,862139.76,18,5,9,12,True
3971850,1089,0,20,3860,997093996,1,0,0,197.1,5,861942.66,18,6,0,12,True
4429340,1228,4,451,7831,997093996,1,0,0,197.08,7,861745.58,18,6,13,2,True
4448260,344,3,-1,3019,997093996,1,1,0,196.82,4,861745.58,24,3,20,2,True
4665254,938,4,30,5206,997093996,1,0,0,196.97,8,861548.61,24,1,6,4,True
4726753,938,4,25,8973,997093996,1,0,0,197.03,8,861351.58,24,0,3,5,True
4739793,344,3,30,7910,997093996,1,0,0,197.12,8,861154.46,24,1,7,5,True
4832924,438,1,30,7831,997093996,1,0,0,196.85,8,860957.61,24,3,1,7,True
4836393,938,4,-1,7831,997093996,1,1,0,196.92,4,860957.61,24,2,17,8,True
4909058,734,0,20,7910,997093996,1,0,0,197.25,5,860760.36,11,0,12,8,True
4936035,344,3,25,8973,997093996,1,0,0,197.22,8,860563.14,24,6,8,10,True
4980049,266,2,20,5734,997093996,1,0,0,197.11,3,860366.03,6,0,1,11,True
5090542,438,1,25,1414,997093996,1,0,0,196.75,8,860169.28,24,0,12,12,True
5115009,667,4,25,3860,997093996,1,0,0,197.0,8,859972.28,18,3,2,1,True
5361518,667,4,-1,6067,997093996,1,1,0,196.79,1,859972.28,18,1,19,1,True
5581763,823,4,25,2145,997093996,1,0,0,196.63,8,859775.65,18,6,13,2,True
5851921,860,1,10,7831,997093996,1,0,0,196.99,6,859972.64,24,0,2,2,True
6062329,438,1,451,5491,997093996,1,0,0,197.06,7,859775.58,24,0,16,3,True
6174578,1162,2,20,6305,997093996,1,0,0,196.76,3,859578.82,24,4,20,3,True
6253294,1025,1,10,5491,997093996,1,0,0,197.16,6,859775.98,11,4,11,4,True
6662348,938,4,451,5347,997093996,1,0,0,197.0,7,859578.98,24,4,21,4,True
6724047,287,0,10,4468,997093996,1,0,0,197.06,6,859776.04,24,6,19,4,False
6750890,774,2,20,3596,997093996,1,0,0,196.99,3,859579.05,14,1,3,5,True
7009088,238,0,451,6560,997093996,1,0,0,197.03,7,859382.02,26,0,0,5,True
7345537,823,4,25,3470,997093996,1,0,0,196.93,8,859185.09,18,6,12,6,True
7578201,667,4,25,3470,997093996,1,0,0,197.14,8,858987.95,18,6,23,6,True
8208570,667,4,451,4468,997093996,1,0,0,197.09,7,858790.86,18,4,17,8,True
8292942,1108,1,10,3596,997093996,1,0,0,196.95,0,858987.81,0,2,16,9,False
8714592,667,4,30,6874,997093996,1,0,0,197.03,8,858790.78,18,6,9,9,True
8792634,438,1,25,6893,997093996,1,0,0,197.04,8,858593.74,24,5,15,10,False
8908729,76,0,451,3470,997093996,1,0,0,197.13,7,858396.61,20,2,1,10,True
9571070,76,0,30,6597,997093996,1,0,0,196.98,8,858199.63,20,2,1,10,True
9689267,667,4,25,3470,997093996,1,0,0,196.92,8,858002.71,18,5,11,11,True
9843164,823,4,451,5491,997093996,1,0,0,196.97,7,857805.74,18,6,22,11,True
1322123,854,0,10,7689,774581627,0,0,0,208.88,6,231984.88,24,1,4,1,True
1673622,642,0,10,6093,774581627,0,0,0,208.83,0,232193.71,24,4,17,2,False
1735335,1183,4,451,9495,774581627,0,0,0,209.29,7,231984.42,24,3,18,3,True
1809195,1169,0,25,6962,774581627,0,0,0,209.0,8,231775.42,24,6,10,4,True
1895599,1383,4,30,6093,774581627,0,0,0,208.95,8,231566.47,16,5,7,5,False
2127173,1227,0,10,5349,774581627,0,0,0,209.33,6,231775.8,18,2,22,5,True
2428037,1314,2,-1,4477,774581627,0,1,0,208.87,4,231775.8,5,0,22,5,True
2490707,774,2,30,6866,774581627,0,0,0,208.98,8,231566.82,14,4,0,6,True
2905792,857,1,10,9671,774581627,0,0,0,209.04,6,231775.86,24,6,8,6,True
3207230,1169,0,30,9812,774581627,0,0,0,208.69,8,231567.17,24,3,4,7,True
3302688,1169,0,25,4477,774581627,0,0,0,208.89,8,231358.28,24,5,5,9,True
3314921,1383,4,25,7430,774581627,0,0,0,208.92,8,231149.36,16,3,22,11,True
3441226,1124,0,10,7924,774581627,0,0,0,208.92,6,231358.28,24,4,4,12,True
3479903,1183,4,25,1185,774581627,0,0,0,208.92,8,231149.36,24,2,2,1,True
3900910,832,3,451,6093,774581627,0,0,0,209.2,7,230940.16,5,2,15,1,True
4019430,832,3,30,6797,774581627,0,0,0,208.81,8,230731.35,5,4,1,2,True
4176988,774,2,451,9812,774581627,0,0,0,208.93,7,230522.42,14,3,1,4,True
4418128,774,2,25,7110,774581627,0,0,0,208.83,8,230313.59,14,2,14,5,True
4712190,832,3,30,7430,774581627,0,0,0,209.18,8,230104.41,5,1,12,5,True
4844292,1169,0,451,6093,774581627,0,0,0,208.81,7,229895.6,24,1,6,6,True
5026108,832,3,30,2096,774581627,0,0,0,208.91,8,229686.69,5,1,9,6,True
5151008,752,0,10,7110,774581627,0,0,0,208.92,6,229895.61,24,2,1,7,True
5159332,355,1,10,7430,774581627,0,0,0,209.1,6,230104.71,24,3,6,8,True
5210912,369,1,10,7430,774581627,0,0,0,208.92,6,230313.63,25,6,12,8,True
5573511,832,3,451,6700,774581627,0,0,0,209.11,7,230104.52,5,5,7,8,True
5670190,14,2,20,6797,774581627,0,0,0,209.17,3,229895.35,24,6,18,9,True
5792549,1169,0,451,6093,774581627,0,0,0,208.64,7,229686.71,24,1,5,10,True
5887145,1169,0,30,6866,774581627,0,0,0,209.18,8,229477.53,24,2,11,10,True
6387115,343,1,10,6148,774581627,0,0,0,209.09,0,229686.62,24,2,20,10,True
6404213,1169,0,451,6148,774581627,0,0,0,209.16,7,229477.46,24,1,8,10,True
6433567,1383,4,30,2072,774581627,0,0,0,208.95,8,229268.51,16,1,16,11,True
6524323,1169,0,451,6093,774581627,0,0,0,209.12,7,229059.39,24,4,21,12,True
6707151,1383,4,25,6866,774581627,0,0,0,208.9,8,228850.49,16,2,13,12,True
6733606,1314,2,451,6148,774581627,0,0,0,209.02,7,228641.47,5,3,16,12,True
6846599,1169,0,451,6866,774581627,0,0,0,208.85,7,228432.62,24,5,0,12,True
6867411,1382,0,20,2031,774581627,0,0,0,209.19,5,228223.43,16,0,19,12,False
6911025,1277,2,20,7374,774581627,0,0,0,209.21,5,228014.22,24,2,9,1,True
7027824,1383,4,30,7689,774581627,0,0,0,209.14,8,227805.08,16,0,1,1,True
7032015,774,2,451,7430,774581627,0,0,0,209.15,7,227595.93,14,0,16,1,True
7726429,1383,4,25,7063,774581627,0,0,0,209.02,8,227386.91,16,0,0,2,True
7803595,1383,4,451,4398,774581627,0,0,0,208.85,7,227178.06,16,4,21,3,True
8382497,832,3,-1,8663,774581627,0,1,0,209.02,1,227178.06,5,5,13,3,True
8552845,774,2,25,6986,774581627,0,0,0,208.98,8,226969.08,14,0,1,3,True
8624071,1132,0,20,1185,774581627,0,0,0,208.99,5,226760.09,24,2,10,3,True
8637034,325,0,10,7564,774581627,0,0,0,208.87,6,226968.96,11,4,13,6,True
8795392,463,1,10,1520,774581627,0,0,0,209.03,0,227177.99,13,1,3,6,True
8922044,1246,0,10,1582,774581627,0,0,0,209.2,0,227387.19,23,2,18,6,True
8964298,774,2,25,7110,774581627,0,0,0,208.93,8,227178.26,14,2,10,6,True
9038976,774,2,451,6962,774581627,0,0,0,209.07,7,226969.19,14,2,12,6,True
9132954,1183,4,451,4477,774581627,0,0,0,208.95,7,226760.24,24,4,3,7,True
9141870,774,2,451,1520,774581627,0,0,0,208.91,7,226551.33,14,6,10,8,True
9249539,1183,4,30,7110,774581627,0,0,0,209.34,8,226341.99,24,4,2,8,True
9537876,832,3,451,9671,774581627,0,0,0,208.81,7,226133.18,5,5,15,8,True
9577112,1063,0,10,1582,774581627,0,0,0,209.11,6,226342.29,11,5,6,9,True
9647345,1169,0,-1,1582,774581627,0,1,0,209.02,4,226342.29,24,0,6,9,True
9767424,1150,0,20,6700,774581627,0,0,0,208.72,5,226133.57,15,1,12,9,True
1039360,177,4,451,2225,454204702,0,0,0,1001.91,7,83040.09,24,1,11,1,True
1085341,429,0,20,1229,454204702,0,0,0,1001.96,5,82038.13,24,5,5,2,True
1463722,713,0,10,1229,454204702,0,0,0,1001.85,6,83039.98,18,6,22,2,True
1489061,461,4,451,9067,454204702,0,0,0,1001.78,7,82038.2,13,0,13,2,True
1780034,428,0,451,9266,454204702,0,0,0,1002.04,7,81036.16,18,1,12,3,True
1832063,177,4,451,5437,454204702,0,0,0,1001.93,7,80034.23,24,2,2,5,True
1942816,205,0,30,1229,454204702,0,0,0,1002.15,8,79032.08,9,6,1,6,True
2494536,1454,1,10,3149,454204702,0,0,0,1001.89,0,80033.97,11,0,14,7,True
2677709,182,1,10,3791,454204702,0,0,0,1001.98,6,81035.95,18,2,5,7,True
2749200,1354,0,451,6847,454204702,0,0,0,1002.25,7,80033.7,24,1,9,9,True
2827558,428,0,451,2210,454204702,0,0,0,1001.83,7,79031.87,18,1,14,9,True
2843698,735,1,10,7236,454204702,0,0,0,1002.08,0,80033.95,11,5,19,10,True
3181832,1426,1,10,1415,454204702,0,0,0,1002.08,0,81036.03,24,1,13,10,True
3182444,917,0,10,7236,454204702,0,0,0,1002.34,0,82038.37,18,5,20,10,True
3189859,580,0,20,2210,454204702,0,0,0,1002.09,5,81036.28,11,1,12,10,True
3625044,177,4,25,5284,454204702,0,0,0,1001.97,8,80034.31,24,2,11,10,True
3966768,1102,2,20,3791,454204702,0,0,0,1001.7,3,79032.61,0,1,18,11,True
4140899,205,0,25,9341,454204702,0,0,0,1002.05,8,78030.56,9,2,15,11,True
4456315,428,0,451,6609,454204702,0,0,0,1001.96,7,77028.6,18,5,6,12,True
4579089,205,0,-1,9919,454204702,0,1,0,1002.24,1,77028.6,9,6,21,1,True
4583361,461,4,30,3149,454204702,0,0,0,1002.06,8,76026.54,13,4,21,1,True
5107938,159,2,20,2210,454204702,0,0,0,1001.64,3,75024.9,24,6,4,2,True
5143556,398,0,20,5664,454204702,0,0,0,1001.88,5,74023.02,10,4,10,3,True
5341042,1273,0,10,5664,454204702,0,0,0,1002.15,6,75025.17,24,0,2,4,True
5377592,889,0,20,3149,454204702,0,0,0,1001.95,5,74023.22,27,3,20,6,True
5696676,467,0,20,6847,454204702,0,0,0,1002.2,5,73021.02,5,6,10,6,True
5903343,457,0,20,9919,454204702,0,0,0,1001.94,5,72019.08,13,3,7,6,True
6076347,726,0,10,2954,454204702,0,0,0,1001.84,6,73020.92,11,5,11,8,True
6260562,757,0,20,6847,454204702,0,0,0,1002.11,5,72018.81,24,3,23,8,True
6516151,605,0,20,2210,454204702,0,0,0,1001.95,5,71016.86,24,6,6,9,False
6648184,177,4,451,7236,454204702,0,0,0,1002.15,7,70014.71,24,5,14,9,False
6863759,630,0,10,5664,454204702,0,0,0,1002.17,6,71016.88,11,6,11,11,True
6962654,205,0,-1,7439,454204702,0,1,0,1001.83,1,71016.88,9,4,18,11,True
7097305,205,0,30,3791,454204702,0,0,0,1002.05,8,70014.83,9,3,5,12,True
7395547,461,4,-1,2210,454204702,0,1,0,1001.94,4,70014.83,13,6,1,12,True
7527720,716,0,20,6609,454204702,0,0,0,1001.75,5,69013.08,18,5,1,1,True
7758646,177,4,30,4713,454204702,0,0,0,1002.07,8,68011.01,24,5,9,1,True
7788716,1354,0,30,2954,454204702,0,0,0,1001.91,8,67009.1,24,3,3,1,True
8071493,1354,0,25,9919,454204702,0,0,0,1001.84,8,66007.26,24,6,0,1,True
8195357,1238,0,30,5023,454204702,0,0,0,1001.88,8,65005.38,18,4,15,2,True
8487900,461,4,30,1415,454204702,0,0,0,1001.94,8,64003.44,13,2,11,2,True
8597103,800,0,20,5664,454204702,0,0,0,1001.86,5,63001.58,11,6,11,2,True
8623002,1315,0,10,7236,454204702,0,0,0,1001.97,6,64003.55,5,1,15,3,True
8772543,1356,2,20,1229,454204702,0,0,0,1002.35,5,63001.2,24,2,19,3,True
8773970,428,0,451,2819,454204702,0,0,0,1001.84,7,61999.36,18,2,18,3,True
9084213,851,1,10,7439,454204702,0,0,0,1002.25,6,63001.61,5,3,13,4,True
9333237,404,1,10,9266,454204702,0,0,0,1002.16,6,64003.77,10,5,19,5,True
9356240,1119,0,20,9919,454204702,0,0,0,1002.17,3,63001.6,24,0,19,5,True
9646647,177,4,-1,5437,454204702,0,1,0,1001.73,4,63001.6,24,0,5,7,True
9672221,366,0,10,4661,454204702,0,0,0,1001.94,6,64003.54,25,3,21,7,True
9842556,461,4,25,4661,454204702,0,0,0,1002.16,8,63001.38,13,6,11,8,True
9877366,34,1,10,6609,454204702,0,0,0,1002.26,0,64003.64,11,2,3,9,True
9934839,205,0,30,9169,454204702,0,0,0,1002.19,8,63001.45,9,3,19,11,True
1240125,1483,0,20,3255,511249153,1,0,0,385.18,5,600976.82,24,2,18,1,True
1260223,620,3,451,4607,511249153,1,0,0,384.98,7,600591.84,11,2,1,1,True
1467579,429,0,20,2499,511249153,1,0,0,384.98,5,600206.86,24,2,7,2,True
1592980,228,0,10,4607,511249153,1,0,0,384.99,0,600591.85,26,2,8,2,True
1791459,642,0,20,6542,511249153,1,0,0,384.85,5,600207.0,24,0,19,3,True
2045604,1317,4,451,4607,511249153,1,0,0,384.97,7,599822.03,18,6,19,3,False
2084640,576,2,20,9100,511249153,1,0,0,384.96,3,599437.07,11,0,4,3,True
2105704,110,4,-1,5683,511249153,1,1,0,384.9,4,599437.07,3,0,12,3,True
2209847,128,0,20,2951,511249153,1,0,0,385.08,3,599051.99,18,6,5,4,True
2728547,797,3,30,3409,511249153,1,0,0,385.07,8,598666.92,11,1,4,4,False
2864919,797,3,30,9065,511249153,1,0,0,385.28,8,598281.64,11,6,9,5,True
2957935,620,3,-1,6495,511249153,1,1,0,385.21,4,598281.64,11,6,19,5,False
2972922,1426,1,451,1241,511249153,1,0,0,384.99,7,597896.65,24,6,15,5,True
3085133,1173,1,10,5328,511249153,1,0,0,384.9,0,598281.55,24,0,8,6,True
3310193,240,4,25,9307,511249153,1,0,0,384.67,8,597896.88,26,6,11,8,True
4002291,834,0,10,8470,511249153,1,0,0,384.82,6,598281.7,5,6,22,11,True
4197553,299,1,10,6052,511249153,1,0,0,385.37,6,598667.07,4,2,12,11,True
4201025,240,4,25,1559,511249153,1,0,0,385.05,8,598282.02,26,1,22,12,True
4315167,406,1,25,6471,511249153,1,0,0,385.13,8,597896.89,10,0,12,12,True
4482016,620,3,30,4953,511249153,1,0,0,385.09,8,597511.8,11,3,5,12,True
4611070,1317,4,451,8654,511249153,1,0,0,384.93,7,597126.87,18,1,13,1,True
4713827,1317,4,30,1241,511249153,1,0,0,384.83,8,596742.04,18,5,19,1,True
5025146,1426,1,451,6324,511249153,1,0,0,385.11,7,596356.93,24,4,20,1,True
5093690,1152,0,20,9841,511249153,1,0,0,385.09,5,595971.84,15,4,18,2,False
5346647,1426,1,451,9841,511249153,1,0,0,384.83,7,595587.01,24,1,6,2,True
5491702,620,3,451,8470,511249153,1,0,0,384.96,7,595202.05,11,2,10,2,True
5500584,240,4,30,9100,511249153,1,0,0,385.19,8,594816.86,26,4,17,2,True
5637644,797,3,25,8470,511249153,1,0,0,385.04,8,594431.82,11,3,13,3,True
5652297,51,0,20,4953,511249153,1,0,0,385.03,5,594046.79,20,1,0,3,False
5690989,797,3,25,1241,511249153,1,0,0,385.08,8,593661.71,11,2,2,4,True
5851397,110,4,25,3731,511249153,1,0,0,385.0,8,593276.71,3,1,19,5,True
5873241,406,1,30,8330,511249153,1,0,0,384.93,8,592891.78,10,4,15,5,True
5915050,1212,0,10,6542,511249153,1,0,0,384.97,6,593276.75,24,5,20,5,True
6098746,240,4,25,8470,511249153,1,0,0,384.82,8,592891.93,26,1,8,7,True
6181385,205,0,10,3767,511249153,1,0,0,385.04,0,593276.97,9,4,22,8,True
6593060,797,3,451,3608,511249153,1,0,0,384.97,7,592892.0,11,0,0,9,True
7089542,1449,0,20,1286,511249153,1,0,0,385.18,5,592506.82,11,1,15,10,True
7198031,240,4,30,8470,511249153,1,0,0,384.98,8,592121.84,26,5,17,11,True
7915097,797,3,451,6495,511249153,1,0,0,385.13,7,591736.71,11,4,18,12,True
8277772,577,0,20,3767,511249153,1,0,0,384.98,5,591351.73,11,4,13,12,True
8365696,110,4,25,6290,511249153,1,0,0,385.06,8,590966.67,3,6,9,12,True
8388325,240,4,25,3073,511249153,1,0,0,385.16,8,590581.51,26,6,23,12,True
8420575,1317,4,25,1559,511249153,1,0,0,385.02,8,590196.49,18,3,13,1,True
8562653,620,3,451,4607,511249153,1,0,0,385.04,7,589811.45,11,0,19,1,True
8567808,797,3,25,5683,511249153,1,0,0,384.77,8,589426.68,11,3,15,2,True
8725496,110,4,25,3767,511249153,1,0,0,385.01,8,589041.67,3,6,10,3,True
8830066,797,3,451,3255,511249153,1,0,0,384.97,7,588656.7,11,0,3,4,True
9428400,1317,4,-1,9100,511249153,1,1,0,385.19,1,588656.7,18,3,20,4,True
9513229,1426,1,451,3767,511249153,1,0,0,384.65,7,588272.05,24,1,12,4,True
9828703,1317,4,25,3767,511249153,1,0,0,384.96,8,587887.09,18,5,15,7,True
9829411,110,4,25,4953,511249153,1,0,0,384.85,8,587502.24,3,4,22,7,True
9861721,1317,4,-1,4607,511249153,1,1,0,385.08,1,587502.24,18,4,0,8,True
9873707,1201,0,10,4607,511249153,1,0,0,385.23,0,587887.47,24,6,10,10,True
1010766,195,1,25,6690,742779127,1,0,0,409.46,8,421463.54,18,6,2,1,True
1150799,195,1,451,4959,742779127,1,0,0,408.92,7,421054.62,18,1,14,2,True
1294057,587,2,-1,8155,742779127,1,1,0,409.1,4,421054.62,24,4,6,3,True
1303119,558,0,25,8155,742779127,1,0,0,408.89,8,420645.73,17,4,10,4,True
1400114,71,1,30,8277,742779127,1,0,0,409.02,8,420236.71,20,6,6,5,True
1538541,394,0,20,7141,742779127,1,0,0,409.08,5,419827.63,10,1,23,6,True
1576490,1146,2,20,7141,742779127,1,0,0,408.74,5,419418.89,15,4,11,6,True
1747370,1287,4,30,8004,742779127,1,0,0,408.76,8,419010.13,24,4,2,6,True
1914107,71,1,-1,1456,742779127,1,1,0,409.24,4,419010.13,20,4,18,7,True
2271005,1287,4,451,5541,742779127,1,0,0,409.15,7,418600.98,24,2,16,7,True
2326849,71,1,451,5826,742779127,1,0,0,409.11,7,418191.87,20,3,13,8,True
2408459,195,1,451,9343,742779127,1,0,0,408.84,7,417783.03,18,6,14,9,True
2964517,1336,2,20,5826,742779127,1,0,0,409.0,5,417374.03,18,1,15,9,True
3000880,558,0,30,6804,742779127,1,0,0,408.81,8,416965.22,17,2,2,9,True
3055941,585,2,20,5782,742779127,1,0,0,408.92,3,416556.3,11,3,11,9,False
3417730,234,0,10,5608,742779127,1,0,0,409.13,0,416965.43,26,6,22,10,False
3475230,587,2,-1,7245,742779127,1,1,0,409.09,4,416965.43,24,6,8,11,True
3959502,394,0,25,3968,742779127,1,0,0,409.05,8,416556.38,10,1,21,11,True
4853812,869,2,20,8007,742779127,1,0,0,409.2,3,416147.18,24,5,13,11,True
5084283,498,0,20,5782,742779127,1,0,0,409.22,3,415737.96,12,3,19,1,True
5157221,587,2,451,7245,742779127,1,0,0,408.75,7,415329.21,24,6,14,2,True
5216010,195,1,451,6690,742779127,1,0,0,408.91,7,414920.3,18,1,17,2,True
5249572,195,1,451,5608,742779127,1,0,0,408.86,7,414511.44,18,4,16,2,True
5316915,195,1,10,7141,742779127,1,0,0,408.95,0,414920.39,18,6,17,4,True
5613877,394,0,451,5541,742779127,1,0,0,409.25,7,414511.14,10,6,12,4,True
5618144,195,1,-1,2711,742779127,1,1,0,409.12,1,414511.14,18,0,3,4,True
5869882,558,0,451,8277,742779127,1,0,0,408.98,7,414102.16,17,3,18,5,True
5955113,1287,4,30,3783,742779127,1,0,0,409.37,8,413692.79,24,2,2,6,True
6056846,944,2,20,5541,742779127,1,0,0,409.08,3,413283.71,24,0,21,7,True
6119046,394,0,30,6804,742779127,1,0,0,408.98,8,412874.73,10,3,16,8,True
6182471,967,1,10,7245,742779127,1,0,0,409.29,6,413284.02,13,3,22,8,True
6283952,444,2,20,8178,742779127,1,0,0,409.17,5,412874.85,24,3,22,9,True
6380531,1391,2,20,8277,742779127,1,0,0,409.09,5,412465.76,24,2,12,9,True
6599660,1443,4,30,8007,742779127,1,0,0,408.92,8,412056.84,24,6,20,10,True
6613778,251,4,25,3968,742779127,1,0,0,409.11,8,411647.73,6,4,21,11,True
6815084,71,1,25,6804,742779127,1,0,0,409.11,8,411238.62,20,2,22,11,True
7060689,587,2,451,9630,742779127,1,0,0,409.0,7,410829.62,24,5,8,12,True
7141799,1287,4,30,9343,742779127,1,0,0,409.06,8,410420.56,24,2,0,1,True
7169775,503,0,20,5608,742779127,1,0,0,409.06,5,410011.5,12,2,23,1,True
7479920,394,0,-1,4416,742779127,1,1,0,408.73,4,410011.5,10,1,14,2,True
7501127,71,1,30,2711,742779127,1,0,0,409.08,8,409602.42,20,4,18,2,True
7699458,251,4,451,3968,742779127,1,0,0,409.26,7,409193.16,6,2,23,3,True
7916728,1443,4,30,2711,742779127,1,0,0,409.1,8,408784.06,24,2,22,3,True
8210593,394,0,-1,5782,742779127,1,1,0,408.91,1,408784.06,10,6,8,5,True
8427711,467,0,10,5608,742779127,1,0,0,409.04,0,409193.1,5,6,1,5,True
8479841,1443,4,30,1456,742779127,1,0,0,408.87,8,408784.23,24,5,16,5,True
8520636,71,1,25,9630,742779127,1,0,0,409.23,8,408375.0,20,2,21,7,False
8614376,558,0,25,8277,742779127,1,0,0,408.92,8,407966.08,17,4,19,8,True
8691342,1063,0,20,3783,742779127,1,0,0,409.18,5,407556.9,11,1,6,8,True
8812797,195,1,451,7141,742779127,1,0,0,409.24,7,407147.66,18,1,12,9,True
8913011,251,4,-1,8178,742779127,1,1,0,408.68,1,407147.66,6,1,7,9,True
9622181,1425,0,20,2466,742779127,1,0,0,408.91,3,406738.75,24,3,5,10,False
9725265,587,2,451,7245,742779127,1,0,0,409.04,7,406329.71,24,1,0,10,False
9946612,1287,4,451,2796,742779127,1,0,0,408.93,7,405920.78,24,3,1,11,True
1122237,728,1,10,3825,481348272,0,0,0,183.12,6,637737.12,11,0,20,1,True
1223857,503,0,20,4492,481348272,0,0,0,183.23,5,637553.89,12,3,19,2,False
1259309,1316,3,451,9969,481348272,0,0,0,183.1,7,637370.79,5,0,0,2,True
1318029,305,1,30,7907,481348272,0,0,0,183.06,8,637187.73,4,3,3,2,True
1402435,732,0,20,9969,481348272,0,0,0,182.86,3,637004.87,11,0,6,3,True
1436318,945,1,10,1197,481348272,0,0,0,183.07,6,637187.94,24,4,10,3,True
1573667,89,3,451,8168,481348272,0,0,0,182.98,7,637004.96,1,0,15,3,True
1616748,927,4,30,4492,481348272,0,0,0,183.02,8,636821.94,18,6,1,4,True
1698427,927,4,451,7010,481348272,0,0,0,183.03,7,636638.91,18,2,16,4,True
1739089,1028,4,30,3954,481348272,0,0,0,183.11,8,636455.8,11,1,19,4,True
1889049,927,4,30,7010,481348272,0,0,0,183.14,8,636272.66,18,1,2,5,True
2161024,1028,4,25,3686,481348272,0,0,0,182.84,8,636089.82,11,2,8,6,True
2641869,834,0,20,9339,481348272,0,0,0,183.22,5,635906.6,5,3,11,7,True
2963436,305,1,25,4492,481348272,0,0,0,183.16,8,635723.44,4,6,17,7,True
3115058,927,4,-1,4679,481348272,0,1,0,182.97,4,635723.44,18,6,11,8,True
3331005,1354,0,10,9339,481348272,0,0,0,183.09,0,635906.53,24,5,8,8,True
3498456,1028,4,30,3825,481348272,0,0,0,182.95,8,635723.58,11,1,5,9,False
3626966,927,4,451,5234,481348272,0,0,0,183.23,7,635540.35,18,0,7,9,True
3945984,1399,0,451,9518,481348272,0,0,0,183.01,7,635357.34,24,0,0,10,True
3960104,1028,4,-1,3954,481348272,0,1,0,183.04,4,635357.34,11,1,4,11,True
4136045,1399,0,30,8168,481348272,0,0,0,182.85,8,635174.49,24,5,14,12,True
4207765,203,0,10,9969,481348272,0,0,0,183.01,0,635357.5,9,2,23,12,True
4408738,1316,3,451,8168,481348272,0,0,0,182.97,7,635174.53,5,6,21,12,True
4511209,128,0,10,8168,481348272,0,0,0,183.45,6,635357.98,18,2,3,12,True
4799125,1476,0,20,1459,481348272,0,0,0,183.2,5,635174.78,24,3,21,1,True
4989623,1316,3,25,4461,481348272,0,0,0,182.89,8,634991.89,5,0,18,1,True
5001141,1399,0,25,9339,481348272,0,0,0,182.98,8,634808.91,24,0,10,2,True
5423663,703,0,20,6419,481348272,0,0,0,183.08,5,634625.83,18,4,23,2,True
5644443,1316,3,30,8970,481348272,0,0,0,182.94,8,634442.89,5,5,22,4,True
5691715,23,0,10,7735,481348272,0,0,0,183.21,6,634626.1,11,1,22,4,True
5705236,927,4,451,4461,481348272,0,0,0,182.88,7,634443.22,18,1,23,5,True
5926845,89,3,25,1459,481348272,0,0,0,183.05,8,634260.17,1,3,3,5,True
6151064,406,1,25,1372,481348272,0,0,0,183.12,8,634077.05,10,1,11,5,True
6391608,148,1,10,2783,481348272,0,0,0,183.1,0,634260.15,18,1,13,6,True
6451946,203,0,10,1725,481348272,0,0,0,182.85,0,634443.0,9,4,16,8,True
6494504,145,0,10,5396,481348272,0,0,0,183.11,6,634626.11,18,3,15,9,True
6574798,689,0,20,7006,481348272,0,0,0,183.07,5,634443.04,24,5,21,9,True
6987544,967,1,10,1459,481348272,0,0,0,182.99,6,634626.03,13,6,23,9,True
7143502,1316,3,25,6419,481348272,0,0,0,182.88,8,634443.15,5,6,15,10,True
7583501,406,1,30,8168,481348272,0,0,0,183.12,8,634260.03,10,4,4,11,True
7673411,532,4,25,7006,481348272,0,0,0,182.72,8,634077.31,18,2,11,11,True
7796992,781,1,10,4679,481348272,0,0,0,182.83,6,634260.14,14,0,23,12,True
7815055,1399,0,-1,8168,481348272,0,1,0,182.92,4,634260.14,24,5,14,1,True
8092574,927,4,30,8168,481348272,0,0,0,182.98,8,634077.16,18,1,21,2,True
8136628,532,4,451,7735,481348272,0,0,0,183.41,7,633893.75,18,0,9,4,True
8381896,305,1,30,4492,481348272,0,0,0,183.07,8,633710.68,4,5,22,4,True
8512351,406,1,451,9339,481348272,0,0,0,183.08,7,633527.6,10,2,4,5,True
8582752,406,1,451,2783,481348272,0,0,0,183.13,7,633344.47,10,0,7,6,True
8783437,567,1,10,3686,481348272,0,0,0,183.16,6,633527.63,11,4,22,6,True
8848877,1028,4,25,9969,481348272,0,0,0,183.0,8,633344.63,11,6,23,6,False
9376128,1316,3,30,2783,481348272,0,0,0,182.91,8,633161.72,5,4,11,6,True
9663624,573,0,20,4461,481348272,0,0,0,182.87,3,632978.85,11,5,14,7,False
9783986,532,4,30,2783,481348272,0,0,0,183.09,8,632795.76,18,5,0,8,True
9838100,1311,2,20,8098,481348272,0,0,0,182.97,5,632612.79,5,1,12,10,True
9866601,305,1,451,7006,481348272,0,0,0,182.8,7,632429.99,4,5,23,11,True
1397168,914,2,20,8914,129575167,0,0,0,883.27,5,796542.73,18,1,11,1,True
1568352,614,4,30,2660,129575167,0,0,0,882.89,8,795659.84,11,2,13,1,True
2191973,982,4,451,2636,129575167,0,0,0,882.98,7,794776.86,22,0,17,1,True
2233811,204,0,20,8227,129575167,0,0,0,882.9,3,793893.96,9,3,12,2,True
2350365,312,0,10,3135,129575167,0,0,0,882.93,6,794776.89,4,2,9,3,True
2410777,1325,0,30,2660,129575167,0,0,0,882.86,8,793894.03,18,3,21,3,True
2449470,614,4,451,8748,129575167,0,0,0,883.03,7,793011.0,11,0,1,3,True
2743416,329,1,10,8227,129575167,0,0,0,883.1,6,793894.1,11,2,4,3,True
3003792,269,0,20,1880,129575167,0,0,0,883.3,3,793010.8,24,0,11,4,True
3043575,1325,0,-1,5553,129575167,0,1,0,882.74,4,793010.8,18,2,21,5,True
3060914,533,2,20,4961,129575167,0,0,0,882.98,5,792127.82,18,2,6,6,True
3248911,982,4,-1,5276,129575167,0,1,0,883.09,1,792127.82,22,5,13,6,True
3497578,223,2,20,4961,129575167,0,0,0,883.07,5,791244.75,26,0,19,6,True
3499587,1172,3,451,5553,129575167,0,0,0,883.4,7,790361.35,24,5,13,7,True
3554767,982,4,451,4377,129575167,0,0,0,883.12,7,789478.23,22,1,9,7,True
3644919,1172,3,451,2169,129575167,0,0,0,882.94,7,788595.29,24,0,21,8,True
3810821,1298,0,20,8227,129575167,0,0,0,882.75,5,787712.54,5,3,13,8,True
4140699,1325,0,30,5276,129575167,0,0,0,882.8,8,786829.74,18,1,18,8,True
4177151,497,0,10,4961,129575167,0,0,0,883.06,6,787712.8,12,5,7,9,True
4366749,1483,0,10,5553,129575167,0,0,0,883.07,6,788595.87,24,2,12,10,True
4400681,1325,0,30,3135,129575167,0,0,0,883.0,8,787712.87,18,4,8,10,True
4569316,796,2,20,5276,129575167,0,0,0,883.22,5,786829.65,11,0,2,10,True
4899739,300,0,-1,7315,129575167,0,1,0,882.97,1,786829.65,4,4,1,11,True
4922137,1459,1,10,2169,129575167,0,0,0,882.85,6,787712.5,11,1,16,11,True
5036988,958,2,20,5276,129575167,0,0,0,883.03,3,786829.47,13,3,12,1,True
5038007,1325,0,-1,7315,129575167,0,1,0,883.08,4,786829.47,18,6,21,2,True
5058030,198,0,20,1848,129575167,0,0,0,882.97,3,785946.5,18,4,19,3,True
5164473,982,4,-1,2519,129575167,0,1,0,883.12,4,785946.5,22,6,4,3,True
5292008,1323,4,451,8914,129575167,0,0,0,882.78,7,785063.72,18,0,0,3,True
5364709,1325,0,451,2519,129575167,0,0,0,883.32,7,784180.4,18,2,23,4,True
5854184,300,0,30,2519,129575167,0,0,0,882.89,8,783297.51,4,6,1,5,True
5882847,614,4,451,7925,129575167,0,0,0,882.65,7,782414.86,11,4,14,6,True
5935862,982,4,451,7315,129575167,0,0,0,882.85,7,781532.01,22,6,9,6,True
5999640,1226,2,20,4961,129575167,0,0,0,882.86,5,780649.15,18,2,1,6,False
6080712,300,0,25,1880,129575167,0,0,0,883.16,8,779765.99,4,2,12,6,True
6097047,982,4,25,3135,129575167,0,0,0,882.88,8,778883.11,22,4,10,6,True
6262748,1325,0,451,3135,129575167,0,0,0,882.98,7,778000.13,18,4,17,9,True
6535634,300,0,25,7315,129575167,0,0,0,882.95,8,777117.18,4,1,22,9,True
6574371,1288,0,20,4961,129575167,0,0,0,883.06,5,776234.12,24,3,17,10,True
6739044,1172,3,451,4377,129575167,0,0,0,883.24,7,775350.88,24,0,3,11,True
6751749,614,4,451,2519,129575167,0,0,0,883.25,7,774467.63,11,5,16,12,True
6960231,939,0,10,2169,129575167,0,0,0,883.17,0,775350.8,24,6,7,12,True
6990502,614,4,30,1848,129575167,0,0,0,882.89,8,774467.91,11,2,22,3,True
7060880,300,0,25,8227,129575167,0,0,0,883.04,8,773584.87,4,6,21,3,True
7189792,1413,0,10,3135,129575167,0,0,0,882.88,0,774467.75,24,1,6,4,True
7594408,300,0,25,3135,129575167,0,0,0,883.16,8,773584.59,4,2,12,5,True
7700081,1172,3,25,8914,129575167,0,0,0,883.09,8,772701.5,24,3,7,6,True
7799187,1201,0,10,4961,129575167,0,0,0,883.24,0,773584.74,24,0,20,7,True
7937459,424,1,10,2169,129575167,0,0,0,883.06,6,774467.8,18,2,4,7,True
8431733,300,0,451,2169,129575167,0,0,0,882.99,7,773584.81,4,3,12,8,False
8475089,300,0,25,7925,129575167,0,0,0,883.09,8,772701.72,4,2,3,8,True
8828859,1323,4,30,1848,129575167,0,0,0,882.91,8,771818.81,18,4,16,9,True
8874148,1323,4,25,8227,129575167,0,0,0,883.19,8,770935.62,18,3,20,10,True
9094995,300,0,25,4377,129575167,0,0,0,883.09,8,770052.53,4,5,4,10,True
9475277,349,2,20,3135,129575167,0,0,0,883.01,5,769169.52,24,5,19,11,True
9638646,1408,1,10,2519,129575167,0,0,0,883.32,6,770052.84,24,2,10,11,True
1003476,413,4,25,8438,108703643,0,0,0,323.04,8,959003.96,18,1,17,2,True
1311992,413,4,25,6095,108703643,0,0,0,322.92,8,958681.04,18,0,20,3,True
1357952,1460,2,20,8158,108703643,0,0,0,323.05,5,958357.99,11,0,1,3,True
1972951,974,3,451,2651,108703643,0,0,0,323.2,7,958034.79,22,2,1,3,True
2056915,155,1,25,4249,108703643,0,0,0,323.16,8,957711.63,18,5,7,4,True
2067634,974,3,30,4196,108703643,0,0,0,323.16,8,957388.47,22,2,9,4,True
2111668,413,4,-1,6095,108703643,0,1,0,323.03,4,957388.47,18,0,4,5,True
2284242,1377,0,451,4196,108703643,0,0,0,323.09,7,957065.38,16,3,12,5,True
2509692,719,4,30,2060,108703643,0,0,0,323.11,8,956742.27,11,6,6,6,True
2739782,413,4,451,7374,108703643,0,0,0,323.08,7,956419.19,18,3,12,6,True
2887798,883,0,20,7815,108703643,0,0,0,322.69,5,956096.5,24,5,5,6,True
3038394,719,4,30,6095,108703643,0,0,0,323.19,8,955773.31,11,1,8,6,True
3156346,1249,2,30,8158,108703643,0,0,0,323.03,8,955450.28,23,4,4,7,True
3242813,1377,0,30,2651,108703643,0,0,0,323.15,8,955127.13,16,5,8,7,True
3248108,155,1,30,8006,108703643,0,0,0,323.02,8,954804.11,18,0,4,7,True
3290314,719,4,30,2091,108703643,0,0,0,323.13,8,954480.98,11,0,9,7,True
3299722,1035,0,10,4196,108703643,0,0,0,322.9,0,954803.88,11,0,0,8,True
4056570,1027,0,20,6095,108703643,0,0,0,323.01,5,954480.87,11,1,22,8,True
4116261,1249,2,30,1876,108703643,0,0,0,323.0,8,954157.87,23,1,6,8,True
4257934,471,0,10,1298,108703643,0,0,0,323.0,6,954480.87,5,1,10,9,True
4470281,974,3,30,2651,108703643,0,0,0,323.06,8,954157.81,22,1,21,11,True
4585079,249,0,10,6095,108703643,0,0,0,323.02,6,954480.83,6,6,7,11,True
4658356,974,3,451,7715,108703643,0,0,0,322.92,7,954157.91,22,2,17,11,True
4832207,1379,3,451,7715,108703643,0,0,0,322.73,7,953835.18,16,2,14,12,True
5227685,974,3,30,2060,108703643,0,0,0,323.02,8,953512.16,22,3,21,1,True
5531248,974,3,30,4249,108703643,0,0,0,322.92,8,953189.24,22,4,14,1,True
5656872,1379,3,451,7374,108703643,0,0,0,323.2,7,952866.04,16,0,7,2,True
5794521,155,1,-1,2091,108703643,0,1,0,322.83,4,952866.04,18,1,13,2,True
5794598,413,4,451,8438,108703643,0,0,0,323.24,7,952542.8,18,4,18,2,True
5809260,719,4,451,8438,108703643,0,0,0,323.02,7,952219.78,11,4,22,4,True
5812162,834,0,10,4971,108703643,0,0,0,322.84,6,952542.62,5,4,1,5,True
6213402,1410,1,10,8006,108703643,0,0,0,322.73,6,952865.35,24,1,7,5,True
6414274,1377,0,451,4800,108703643,0,0,0,323.07,7,952542.28,16,0,2,5,True
6428453,819,2,20,8006,108703643,0,0,0,323.0,3,952219.28,18,5,8,6,True
7305819,1105,2,20,9264,108703643,0,0,0,323.1,5,951896.18,0,0,3,6,True
7537969,480,0,20,2091,108703643,0,0,0,322.93,5,951573.25,5,2,8,7,True
7650034,71,1,10,1298,108703643,0,0,0,322.98,0,951896.23,20,3,17,7,True
7664821,1249,2,451,4249,108703643,0,0,0,322.83,7,951573.4,23,3,12,9,True
7723637,97,0,10,8198,108703643,0,0,0,323.23,6,951896.63,3,1,22,10,True
7812115,812,0,20,1876,108703643,0,0,0,323.05,3,951573.58,18,0,14,1,True
8343606,1159,0,10,8006,108703643,0,0,0,322.84,6,951896.42,15,5,20,1,True
8359921,1249,2,25,7715,108703643,0,0,0,322.91,8,951573.51,23,5,10,3,True
8387473,974,3,25,1876,108703643,0,0,0,323.24,8,951250.27,22,2,16,3,True
8444124,155,1,25,7815,108703643,0,0,0,323.13,8,950927.14,18,3,15,3,True
8502573,1379,3,451,4800,108703643,0,0,0,323.06,7,950604.08,16,6,19,3,True
8648763,1379,3,451,1298,108703643,0,0,0,323.08,7,950281.0,16,1,7,4,True
8797268,1379,3,-1,1298,108703643,0,1,0,323.05,1,950281.0,16,5,3,4,True
8809259,719,4,25,1876,108703643,0,0,0,323.15,8,949957.85,11,1,5,5,True
8906091,1150,0,20,6095,108703643,0,0,0,323.02,5,949634.83,15,5,13,5,True
9050593,719,4,30,2866,108703643,0,0,0,322.98,8,949311.85,11,1,17,5,True
9053975,1377,0,-1,4800,108703643,0,1,0,322.93,4,949311.85,16,2,4,6,True
9066277,1249,2,25,2651,108703643,0,0,0,322.84,8,948989.01,23,3,5,7,True
9232495,413,4,451,4800,108703643,0,0,0,323.16,7,948665.85,18,2,3,8,True
9337263,1249,2,-1,2060,108703643,0,1,0,323.17,4,948665.85,23,1,3,9,True
9399644,1249,2,451,8198,108703643,0,0,0,322.85,7,948343.0,23,6,22,9,True
9412167,1379,3,30,2060,108703643,0,0,0,323.12,8,948019.88,16,3,2,9,True
9517672,413,4,25,9264,108703643,0,0,0,322.96,8,947696.92,18,2,7,10,True
9638688,1379,3,25,8006,108703643,0,0,0,323.17,8,947373.75,16,1,6,10,True
9870373,509,0,20,4971,108703643,0,0,0,322.96,5,947050.79,12,0,14,11,True
1328947,709,3,-1,8753,826647770,0,1,0,756.98,1,298917.0,18,6,7,3,True
1350652,709,3,451,1371,826647770,0,0,0,757.05,7,298159.95,18,1,17,4,True
1418236,292,1,10,9599,826647770,0,0,0,756.97,6,298916.92,4,6,0,4,True
1445433,709,3,25,4681,826647770,0,0,0,756.9,8,298160.02,18,3,13,5,True
1487050,1009,0,20,4681,826647770,0,0,0,756.98,5,297403.04,26,6,0,5,True
1666584,947,2,20,1973,826647770,0,0,0,757.13,5,296645.91,24,5,7,5,True
2305888,991,1,10,6425,826647770,0,0,0,756.94,0,297402.85,22,6,5,5,True
2361483,292,1,10,9833,826647770,0,0,0,757.04,6,298159.89,4,6,11,5,True
2503143,220,0,25,2317,826647770,0,0,0,756.97,8,297402.92,26,3,17,5,True
2547656,713,0,20,9399,826647770,0,0,0,757.02,5,296645.9,18,0,1,5,True
2561161,370,4,25,1939,826647770,0,0,0,756.72,8,295889.18,25,0,13,5,True
2662071,709,3,30,1973,826647770,0,0,0,757.1,8,295132.08,18,0,2,7,True
2729626,1004,4,25,1624,826647770,0,0,0,756.93,8,294375.15,26,0,23,7,True
2747869,1004,4,451,4381,826647770,0,0,0,757.0,7,293618.15,26,1,6,8,True
3230962,220,0,451,7576,826647770,0,0,0,757.01,7,292861.14,26,1,7,8,True
3404288,709,3,25,5715,826647770,0,0,0,756.87,8,292104.27,18,5,2,8,True
3596812,48,4,25,8295,826647770,0,0,0,757.04,8,291347.23,24,5,16,9,True
3767945,709,3,-1,7576,826647770,0,1,0,756.95,4,291347.23,18,1,15,10,True
3854992,1127,0,10,8753,826647770,0,0,0,757.13,6,292104.36,24,5,0,10,True
4530995,220,0,451,6425,826647770,0,0,0,756.98,7,291347.38,26,1,8,11,True
4537577,220,0,30,9599,826647770,0,0,0,757.18,8,290590.2,26,5,14,11,True
4579107,1004,4,451,3937,826647770,0,0,0,757.1,7,289833.1,26,2,8,11,True
4746278,947,2,30,9399,826647770,0,0,0,757.0,8,289076.1,24,2,11,1,True
5148076,709,3,451,5715,826647770,0,0,0,756.83,7,288319.27,18,0,18,1,True
5201309,220,0,451,4934,826647770,0,0,0,757.14,7,287562.13,26,1,14,2,True
6090630,370,4,451,5232,826647770,0,0,0,757.07,7,286805.06,25,2,4,3,True
6135643,220,0,-1,7333,826647770,0,1,0,756.99,4,286805.06,26,3,4,3,True
6258121,370,4,25,5432,826647770,0,0,0,756.89,8,286048.17,25,5,10,7,True
6364876,370,4,30,4381,826647770,0,0,0,757.06,8,285291.11,25,6,9,7,True
6748976,947,2,451,3937,826647770,0,0,0,756.92,7,284534.19,24,5,15,7,True
7215009,220,0,25,9623,826647770,0,0,0,757.12,8,283777.07,26,0,16,8,False
7526122,278,1,10,9575,826647770,0,0,0,757.1,0,284534.17,24,6,14,8,True
7666512,1061,2,20,7878,826647770,0,0,0,757.13,5,283777.04,11,5,18,9,True
7674636,370,4,30,1973,826647770,0,0,0,757.09,8,283019.95,25,1,5,9,True
7690537,220,0,25,7333,826647770,0,0,0,756.91,8,282263.04,26,1,18,11,True
7720390,220,0,30,4934,826647770,0,0,0,757.0,8,281506.04,26,0,11,11,True
7906574,370,4,25,4381,826647770,0,0,0,757.07,8,280748.97,25,1,4,11,True
8170421,947,2,30,4681,826647770,0,0,0,756.86,8,279992.11,24,5,14,12,True
8196194,1004,4,25,6425,826647770,0,0,0,756.9,8,279235.21,26,1,20,1,True
8330513,220,0,30,1624,826647770,0,0,0,757.17,8,278478.04,26,4,19,1,False
8461467,709,3,451,7824,826647770,0,0,0,757.04,7,277721.0,18,5,6,1,False
8506272,1111,0,10,1371,826647770,0,0,0,757.03,6,278478.03,0,6,21,1,True
8514156,947,2,25,8753,826647770,0,0,0,757.14,8,277720.89,24,2,1,1,True
8718697,370,4,451,8753,826647770,0,0,0,757.21,7,276963.68,25,6,5,2,True
8841856,48,4,30,9564,826647770,0,0,0,757.06,8,276206.62,24,2,5,3,True
9013373,1152,0,10,7576,826647770,0,0,0,757.05,0,276963.67,15,2,0,5,True
9199813,48,4,-1,9623,826647770,0,1,0,756.83,4,276963.67,24,4,14,5,True
9281155,709,3,-1,9564,826647770,0,2,0,756.91,1,276963.67,18,0,20,7,True
9521030,947,2,451,9575,826647770,0,0,0,756.96,7,276206.71,24,1,23,8,True
9788444,48,4,451,9575,826647770,0,0,0,757.17,7,275449.54,24,0,14,9,True
9811010,220,0,25,9833,826647770,0,0,0,756.74,8,274692.8,26,1,7,11,True
1132537,102,4,25,5891,461642181,1,0,0,357.8,8,667212.2,3,2,5,1,True
1138240,504,4,-1,9056,461642181,1,1,0,357.94,4,667212.2,12,2,5,1,True
1201089,616,1,-1,6340,461642181,1,2,0,357.85,1,667212.2,11,3,22,2,True
2041706,302,1,10,7849,461642181,1,0,0,357.91,0,667570.11,4,5,21,2,True
2044423,102,4,451,9945,461642181,1,0,0,357.82,7,667212.29,3,6,20,2,True
2114236,52,4,25,3852,461642181,1,0,0,358.13,8,666854.16,20,3,2,3,True
2189029,299,1,10,7549,461642181,1,0,0,357.91,0,667212.07,4,0,2,3,True
2202723,1307,0,10,7849,461642181,1,0,0,357.94,6,667570.01,5,5,3,4,False
2319280,628,0,20,7697,461642181,1,0,0,357.85,5,667212.16,11,3,20,5,True
2473033,124,3,451,9575,461642181,1,0,0,357.78,7,666854.38,18,6,18,7,True
2630537,1486,2,-1,4033,461642181,1,1,0,357.83,1,666854.38,24,0,18,8,True
2891670,1321,0,10,1170,461642181,1,0,0,357.95,6,667212.33,18,4,5,8,True
2997601,487,4,30,3525,461642181,1,0,0,358.02,8,666854.31,12,0,16,8,True
3079141,1486,2,25,4033,461642181,1,0,0,358.03,8,666496.28,24,6,9,9,True
3376640,1029,0,10,4033,461642181,1,0,0,357.96,0,666854.24,11,2,9,9,True
3420132,1282,2,20,7697,461642181,1,0,0,358.08,3,666496.16,24,1,10,10,True
3437949,487,4,25,8193,461642181,1,0,0,358.03,8,666138.13,12,2,9,10,True
3595403,52,4,30,4264,461642181,1,0,0,357.97,8,665780.16,20,3,0,10,True
3605780,124,3,451,8193,461642181,1,0,0,357.88,7,665422.28,18,0,22,10,True
3806397,504,4,30,9575,461642181,1,0,0,357.91,8,665064.37,12,4,3,11,True
3838520,670,0,20,3525,461642181,1,0,0,357.85,5,664706.52,18,4,10,12,True
4392671,616,1,25,8623,461642181,1,0,0,357.93,8,664348.59,11,6,23,1,True
4638550,1336,2,20,7549,461642181,1,0,0,358.28,5,663990.31,18,0,5,1,True
4766131,1486,2,25,5891,461642181,1,0,0,357.68,8,663632.63,24,5,13,1,True
5034267,102,4,25,7697,461642181,1,0,0,357.76,8,663274.87,3,6,5,1,True
5195668,124,3,451,7549,461642181,1,0,0,358.11,7,662916.76,18,2,16,5,True
5206740,1345,2,20,6463,461642181,1,0,0,358.25,5,662558.51,24,4,17,6,True
5316248,962,0,10,4033,461642181,1,0,0,357.91,6,662916.42,13,2,19,6,True
5473666,1486,2,30,9632,461642181,1,0,0,358.26,8,662558.16,24,5,10,7,True
5588946,102,4,25,4264,461642181,1,0,0,357.89,8,662200.27,3,3,7,8,True
5589702,1483,0,20,1582,461642181,1,0,0,358.17,5,661842.1,24,4,15,8,True
5600145,52,4,30,9632,461642181,1,0,0,358.13,8,661483.97,20,5,22,9,False
5600582,1176,4,451,9575,461642181,1,0,0,357.92,7,661126.05,24,2,0,9,True
6096434,504,4,-1,6169,461642181,1,1,0,357.97,4,661126.05,12,3,8,10,True
6096988,95,2,20,9056,461642181,1,0,0,357.9,5,660768.15,1,1,23,12,True
6296269,124,3,-1,9575,461642181,1,1,0,357.93,1,660768.15,18,3,23,12,False
6415453,1486,2,30,7697,461642181,1,0,0,357.8,8,660410.35,24,2,7,1,True
6548901,200,0,10,9028,461642181,1,0,0,357.96,0,660768.31,9,0,10,1,False
6913402,1176,4,-1,9632,461642181,1,1,0,358.0,1,660768.31,24,4,5,1,True
6993179,939,0,10,1275,461642181,1,0,0,357.78,6,661126.09,24,0,19,1,True
7190815,102,4,451,7549,461642181,1,0,0,357.64,7,660768.45,3,4,7,3,True
7438397,1486,2,451,3852,461642181,1,0,0,358.06,7,660410.39,24,4,2,3,True
8015423,102,4,25,3090,461642181,1,0,0,357.75,8,660052.64,3,6,22,3,True
8295270,124,3,30,9028,461642181,1,0,0,358.02,8,659694.62,18,0,15,3,True
8480129,926,4,25,6463,461642181,1,0,0,357.83,8,659336.79,18,1,8,5,True
8949114,124,3,-1,4033,461642181,1,1,0,358.15,4,659336.79,18,5,1,6,True
9111460,1034,1,10,7697,461642181,1,0,0,357.98,0,659694.77,11,4,1,6,True
9122124,504,4,451,7849,461642181,1,0,0,357.97,7,659336.8,12,5,14,8,True
9144307,1176,4,451,3090,461642181,1,0,0,357.92,7,658978.88,24,4,9,10,True
9389920,1486,2,-1,8193,461642181,1,1,0,358.08,4,658978.88,24,5,8,10,True
9711007,52,4,451,6169,461642181,1,0,0,357.9,7,658620.98,20,0,13,10,True
9715395,537,0,10,9056,461642181,1,0,0,357.99,6,658978.97,18,2,10,10,True
9716235,1137,1,10,9984,461642181,1,0,0,358.2,0,659337.17,24,3,22,10,True
9828014,1162,2,20,6330,461642181,1,0,0,357.9,5,658979.27,24,5,13,11,True
9914494,1486,2,30,6463,461642181,1,0,0,358.1,8,658621.17,24,6,17,11,True
1219493,191,3,-1,9932,485922618,0,1,0,992.81,4,611905.0,18,3,1,1,False
1781322,182,1,30,4504,485922618,0,0,0,993.09,8,610911.91,18,2,22,1,True
2082130,168,0,10,8180,485922618,0,0,0,993.12,6,611905.03,24,0,8,3,True
2404841,1061,2,20,6631,485922618,0,0,0,993.13,5,610911.9,11,5,11,3,True
2980670,935,1,10,4344,485922618,0,0,0,993.01,6,611904.91,24,3,15,4,True
3073792,1090,0,25,7668,485922618,0,0,0,992.93,8,610911.98,18,6,16,4,True
3527950,182,1,30,3710,485922618,0,0,0,992.81,8,609919.17,18,4,15,4,True
3582415,191,3,25,5460,485922618,0,0,0,993.17,8,608926.0,18,6,3,6,True
4030644,1045,4,30,4569,485922618,0,0,0,992.85,8,607933.15,11,2,8,6,True
4276644,1471,0,20,7668,485922618,0,0,0,993.15,3,606940.0,24,4,17,7,True
4522718,191,3,-1,4344,485922618,0,1,0,992.83,4,606940.0,18,4,18,7,True
4545299,1045,4,30,9563,485922618,0,0,0,993.15,8,605946.85,11,6,14,8,True
4754468,1142,2,20,7292,485922618,0,0,0,993.25,3,604953.6,15,3,10,8,True
4777948,1045,4,25,9934,485922618,0,0,0,992.81,8,603960.79,11,6,18,10,True
4858917,738,2,30,4344,485922618,0,0,0,992.93,8,602967.86,11,0,10,10,True
4888818,200,0,20,6631,485922618,0,0,0,992.98,5,601974.88,9,3,1,11,True
4904012,1045,4,30,8180,485922618,0,0,0,992.86,8,600982.02,11,5,12,11,True
4960794,1045,4,451,5953,485922618,0,0,0,993.02,7,599989.0,11,6,12,1,True
5060151,1090,0,30,5460,485922618,0,0,0,993.03,8,598995.97,18,4,9,2,True
5400753,738,2,-1,8615,485922618,0,1,0,992.86,4,598995.97,11,3,22,2,True
5402149,211,0,10,1319,485922618,0,0,0,993.13,6,599989.1,9,3,23,2,True
5639754,191,3,-1,9926,485922618,0,1,0,993.16,1,599989.1,18,5,15,3,True
5644179,1090,0,451,7044,485922618,0,0,0,992.77,7,598996.33,18,0,13,4,True
5671306,1238,0,10,7044,485922618,0,0,0,992.85,6,599989.18,18,5,21,4,True
5719943,1090,0,25,1319,485922618,0,0,0,992.87,8,598996.31,18,0,0,5,True
5904824,880,1,10,4504,485922618,0,0,0,993.01,6,599989.32,27,2,20,5,True
6148875,1090,0,25,8180,485922618,0,0,0,993.11,8,598996.21,18,5,4,5,True
6284110,1045,4,451,8810,485922618,0,0,0,993.03,7,598003.18,11,2,11,5,True
6349140,689,0,20,5460,485922618,0,0,0,992.77,3,597010.41,24,6,1,6,True
6531215,182,1,451,3710,485922618,0,0,0,993.07,7,596017.34,18,3,2,8,True
6843749,588,0,10,9563,485922618,0,0,0,993.22,6,597010.56,24,2,0,8,True
7025893,738,2,30,4504,485922618,0,0,0,992.92,8,596017.64,11,2,23,8,True
7254864,738,2,451,4344,485922618,0,0,0,992.91,7,595024.73,11,6,11,9,True
7446650,1045,4,30,4569,485922618,0,0,0,992.73,8,594032.0,11,2,8,9,True
7451624,1045,4,451,9451,485922618,0,0,0,993.24,7,593038.76,11,5,20,9,True
7458918,297,0,451,7850,485922618,0,0,0,993.11,7,592045.65,4,6,1,9,True
7648088,118,2,20,7894,485922618,0,0,0,992.92,5,591052.73,18,3,21,10,True
7814546,1119,0,20,3395,485922618,0,0,0,993.03,5,590059.7,24,0,8,10,True
8168287,191,3,-1,4569,485922618,0,1,0,992.84,4,590059.7,18,4,1,11,True
8336878,577,0,10,1319,485922618,0,0,0,992.6,6,591052.3,11,3,2,1,True
8510286,297,0,30,8180,485922618,0,0,0,993.09,8,590059.21,4,0,23,2,True
8714075,998,0,10,9724,485922618,0,0,0,993.16,6,591052.37,26,4,0,3,True
8984653,182,1,451,8810,485922618,0,0,0,992.87,7,590059.5,18,4,21,3,True
9062565,446,1,10,2971,485922618,0,0,0,993.03,6,591052.53,13,2,20,4,True
9242154,182,1,451,7292,485922618,0,0,0,992.92,7,590059.61,18,0,19,5,True
9345201,1476,0,20,3395,485922618,0,0,0,992.93,5,589066.68,24,6,7,7,True
9550737,1473,4,451,8763,485922618,0,0,0,992.87,7,588073.81,24,4,11,8,True
9653014,1045,4,451,7292,485922618,0,0,0,993.15,7,587080.66,11,4,23,9,True
9795525,191,3,451,5953,485922618,0,0,0,992.89,7,586087.77,18,3,7,9,True
9906113,738,2,451,7292,485922618,0,0,0,993.19,7,585094.58,11,3,12,11,True
1126948,819,2,451,3155,379947848,0,0,0,914.23,7,337413.77,18,4,16,1,True
1510477,779,4,451,5580,379947848,0,0,0,913.91,7,336499.86,14,0,0,2,True
1662307,16,4,25,8917,379947848,0,0,0,914.18,8,335585.68,24,4,17,3,True
1684757,1298,0,451,6882,379947848,0,0,0,914.15,7,334671.53,5,2,11,4,True
1696467,819,2,25,6882,379947848,0,0,0,914.01,8,333757.52,18,3,20,5,True
1713462,1404,2,-1,3509,379947848,0,1,0,913.68,4,333757.52,24,4,20,5,True
1776616,34,1,10,9899,379947848,0,0,0,914.04,0,334671.56,11,1,19,5,False
1838241,1050,4,30,6882,379947848,0,0,0,913.78,8,333757.78,11,2,0,6,True
1889105,26,3,451,3390,379947848,0,0,0,914.0,7,332843.78,11,3,12,6,True
2130284,1404,2,25,7819,379947848,0,0,0,913.97,8,331929.81,24,3,20,6,True
2375319,340,4,30,4062,379947848,0,0,0,913.88,8,331015.93,24,0,8,6,True
2391897,1404,2,451,9871,379947848,0,0,0,913.77,7,330102.16,24,0,12,7,True
2598071,1050,4,30,8126,379947848,0,0,0,913.95,8,329188.21,11,3,12,7,True
2969881,1404,2,30,8126,379947848,0,0,0,914.0,8,328274.21,24,0,3,8,True
2988433,1298,0,25,3390,379947848,0,0,0,913.94,8,327360.27,5,4,22,8,True
3067329,1050,4,451,4062,379947848,0,0,0,914.06,7,326446.21,11,5,2,8,True
3137504,1298,0,25,4508,379947848,0,0,0,914.0,8,325532.21,5,4,3,9,True
3571081,1156,1,10,3155,379947848,0,0,0,913.72,0,326445.93,15,4,7,9,True
3690519,497,0,10,5138,379947848,0,0,0,913.92,6,327359.85,12,4,9,9,True
3848044,1404,2,30,9899,379947848,0,0,0,914.05,8,326445.8,24,5,10,9,True
3936285,831,1,30,3390,379947848,0,0,0,914.13,8,325531.67,5,2,6,1,True
4305592,831,1,-1,7819,379947848,0,1,0,914.02,4,325531.67,5,4,10,2,True
4743611,1050,4,-1,1666,379947848,0,2,0,913.98,4,325531.67,11,4,12,2,True
4988420,1050,4,451,3155,379947848,0,0,0,913.95,7,324617.72,11,2,4,3,True
5039745,26,3,451,4830,379947848,0,0,0,913.88,7,323703.84,11,0,21,3,True
5045474,16,4,-1,3509,379947848,0,1,0,914.02,4,323703.84,24,6,7,5,True
5174943,1127,0,20,3155,379947848,0,0,0,913.95,5,322789.89,24,2,18,5,True
5216439,1298,0,30,9899,379947848,0,0,0,913.92,8,321875.97,5,4,18,5,True
5280146,1404,2,25,5491,379947848,0,0,0,913.96,8,320962.01,24,0,21,5,True
5313457,641,0,20,3949,379947848,0,0,0,914.06,5,320047.95,24,5,12,6,True
5363623,1061,2,20,5580,379947848,0,0,0,913.91,3,319134.04,11,2,5,6,True
5519664,819,2,451,6882,379947848,0,0,0,914.14,7,318219.9,18,5,1,7,True
5540752,340,4,25,4830,379947848,0,0,0,914.03,8,317305.87,24,5,14,7,True
5701230,819,2,451,1666,379947848,0,0,0,914.01,7,316391.86,18,6,20,8,True
6360345,340,4,25,6882,379947848,0,0,0,913.97,8,315477.89,24,2,3,8,True
6632680,1093,0,20,5025,379947848,0,0,0,914.11,3,314563.78,18,2,10,8,True
6825170,1115,1,10,8126,379947848,0,0,0,913.97,6,315477.75,0,6,11,9,True
6968433,1050,4,30,4508,379947848,0,0,0,914.01,8,314563.74,11,0,15,10,True
7113886,205,0,20,4508,379947848,0,0,0,914.3,3,313649.44,9,3,18,11,True
7212399,779,4,30,9899,379947848,0,0,0,913.97,8,312735.47,14,1,19,11,True
7218876,26,3,451,4508,379947848,0,0,0,913.93,7,311821.54,11,3,16,11,True
7292198,26,3,30,3155,379947848,0,0,0,913.88,8,310907.66,11,2,13,12,True
7385971,1260,0,20,3390,379947848,0,0,0,913.87,3,309993.79,23,0,13,1,True
7416624,831,1,25,3509,379947848,0,0,0,914.27,8,309079.52,5,1,5,1,True
7746626,211,0,20,8795,379947848,0,0,0,913.99,5,308165.53,9,4,18,2,True
7785029,715,0,10,9899,379947848,0,0,0,913.74,0,309079.27,18,6,16,5,True
7919787,819,2,451,4508,379947848,0,0,0,914.18,7,308165.09,18,6,11,5,True
8001505,346,0,10,4830,379947848,0,0,0,913.84,6,309078.93,24,5,19,5,True
8022947,340,4,451,3509,379947848,0,0,0,914.05,7,308164.88,24,5,18,6,True
8578826,1050,4,451,5138,379947848,0,0,0,913.83,7,307251.05,11,0,4,6,False
8836923,518,2,20,4062,379947848,0,0,0,914.1,3,306336.95,18,6,12,6,True
8991321,373,1,10,4830,379947848,0,0,0,914.03,0,307250.98,25,0,12,7,True
9339420,695,2,20,5138,379947848,0,0,0,913.95,5,306337.03,24,1,8,8,True
9519366,779,4,-1,1666,379947848,0,1,0,914.21,1,306337.03,14,3,15,9,True
9524508,1298,0,451,5138,379947848,0,0,0,913.9,7,305423.13,5,3,2,10,True
9747129,779,4,-1,6882,379947848,0,1,0,913.9,4,305423.13,14,0,23,11,True
1218774,282,2,30,1639,336424105,1,0,0,191.11,8,808940.89,24,2,0,1,True
1671510,874,4,451,1725,336424105,1,0,0,190.97,7,808749.92,24,5,6,1,True
1808586,1159,0,10,7925,336424105,1,0,0,190.87,6,808940.79,15,2,12,1,True
1969004,282,2,30,4493,336424105,1,0,0,191.0,8,808749.79,24,0,7,2,True
2195187,238,0,10,1100,336424105,1,0,0,190.82,6,808940.61,26,0,15,3,True
2752463,1378,3,451,3628,336424105,1,0,0,190.98,7,808749.63,16,0,19,3,True
2779239,1378,3,30,7453,336424105,1,0,0,190.91,8,808558.72,16,6,6,4,True
3108110,1026,4,451,3939,336424105,1,0,0,190.98,7,808367.74,11,5,4,4,True
3399031,260,0,20,6396,336424105,1,0,0,191.19,5,808176.55,6,0,0,5,True
3490756,156,4,25,6997,336424105,1,0,0,191.36,8,807985.19,18,0,20,5,True
3798420,1483,0,451,4699,336424105,1,0,0,190.95,7,807794.24,24,4,0,5,True
3799927,695,2,451,8847,336424105,1,0,0,190.94,7,807603.3,24,0,6,5,True
3867716,309,0,20,7132,336424105,1,0,0,190.66,5,807412.64,4,2,21,6,True
3941679,1483,0,-1,8154,336424105,1,1,0,190.82,4,807412.64,24,5,22,7,True
4042307,64,0,10,9496,336424105,1,0,0,190.89,0,807603.53,20,6,0,7,True
4077453,1026,4,25,1302,336424105,1,0,0,191.15,8,807412.38,11,2,14,8,True
4122904,1378,3,451,1930,336424105,1,0,0,191.11,7,807221.27,16,4,19,9,True
4273536,727,0,10,8154,336424105,1,0,0,190.98,6,807412.25,11,6,3,10,True
4333198,156,4,451,4407,336424105,1,0,0,190.93,7,807221.32,18,6,14,11,True
4357742,1428,1,10,4699,336424105,1,0,0,190.94,6,807412.26,24,4,12,12,True
4383723,413,4,-1,8888,336424105,1,1,0,191.09,4,807412.26,18,2,12,1,True
4414709,1378,3,451,8888,336424105,1,0,0,190.9,7,807221.36,16,0,6,1,True
5080686,1378,3,451,1725,336424105,1,0,0,191.03,7,807030.33,16,1,15,1,True
5943148,1483,0,30,9568,336424105,1,0,0,190.97,8,806839.36,24,0,1,2,True
6072869,1150,0,20,6396,336424105,1,0,0,190.89,5,806648.47,15,3,7,2,True
6088108,156,4,-1,4240,336424105,1,1,0,191.13,4,806648.47,18,3,3,4,True
6125389,1421,0,10,1639,336424105,1,0,0,191.08,0,806839.55,24,6,8,4,True
6185533,1026,4,25,3264,336424105,1,0,0,190.81,8,806648.74,11,4,19,5,True
6192284,1250,1,10,7453,336424105,1,0,0,190.88,6,806839.62,23,1,17,6,True
6618292,1364,0,20,6997,336424105,1,0,0,190.9,5,806648.72,16,4,15,7,True
6922055,558,0,20,9568,336424105,1,0,0,191.03,5,806457.69,17,2,21,8,True
7141627,1026,4,451,9496,336424105,1,0,0,191.05,7,806266.64,11,1,1,8,True
7157518,1026,4,25,8403,336424105,1,0,0,191.06,8,806075.58,11,6,14,9,True
7181096,325,0,10,3862,336424105,1,0,0,190.96,0,806266.54,11,5,22,9,True
7215339,282,2,25,1930,336424105,1,0,0,190.97,8,806075.57,24,5,16,9,True
7363078,118,2,20,7132,336424105,1,0,0,190.87,5,805884.7,18,6,2,10,True
7563662,464,1,10,9568,336424105,1,0,0,191.14,6,806075.84,13,3,15,11,True
7567055,282,2,30,4699,336424105,1,0,0,191.0,8,805884.84,24,5,21,11,False
7931696,1026,4,451,8154,336424105,1,0,0,191.01,7,805693.83,11,0,10,1,True
8194379,889,0,20,1357,336424105,1,0,0,190.85,5,805502.98,27,0,3,1,True
8403145,1378,3,25,1100,336424105,1,0,0,191.01,8,805311.97,16,1,1,3,True
8625734,1429,0,20,1100,336424105,1,0,0,191.15,3,805120.82,24,3,0,3,True
8739205,282,2,451,8847,336424105,1,0,0,190.85,7,804929.97,24,3,2,3,True
8744698,413,4,-1,3862,336424105,1,1,0,191.11,4,804929.97,18,6,17,5,True
8871025,1378,3,451,8888,336424105,1,0,0,190.81,7,804739.16,16,4,18,5,True
8931187,874,4,451,1930,336424105,1,0,0,190.99,7,804548.17,24,4,5,8,True
9026293,895,0,10,8847,336424105,1,0,0,191.09,6,804739.26,24,3,12,8,True
9107475,645,0,10,1302,336424105,1,0,0,190.82,6,804930.08,24,4,4,9,True
9231626,1026,4,-1,7925,336424105,1,1,0,190.97,4,804930.08,11,6,12,9,True
9276857,413,4,451,4420,336424105,1,0,0,191.19,7,804738.89,18,0,10,9,True
9424945,413,4,30,4407,336424105,1,0,0,191.1,8,804547.79,18,0,8,11,True
9794981,695,2,20,1302,336424105,1,0,0,191.06,3,804356.73,24,1,0,11,True
9797082,282,2,451,8847,336424105,1,0,0,191.14,7,804165.59,24,1,16,11,True
1422481,488,3,25,5906,864966934,0,0,0,1084.99,8,860107.01,12,4,9,1,True
1573199,131,4,25,2463,864966934,0,0,0,1084.92,8,859022.09,18,4,11,1,True
1630883,603,0,30,3539,864966934,0,0,0,1085.3,8,857936.79,24,4,22,2,True
1690458,603,0,451,2138,864966934,0,0,0,1084.94,7,856851.85,24,1,21,2,True
1709692,1294,4,-1,2138,864966934,0,1,0,1085.22,1,856851.85,24,4,4,2,True
1917649,488,3,30,5167,864966934,0,0,0,1084.76,8,855767.09,12,6,5,3,True
2312665,819,2,451,2421,864966934,0,0,0,1084.93,7,854682.16,18,3,1,4,True
2350908,131,4,25,9344,864966934,0,0,0,1084.84,8,853597.32,18,0,11,4,True
2439982,819,2,-1,5167,864966934,0,1,0,1085.08,4,853597.32,18,4,21,5,True
2466023,131,4,-1,7340,864966934,0,2,0,1085.18,4,853597.32,18,2,3,6,True
2494879,488,3,30,5493,864966934,0,0,0,1084.93,8,852512.39,12,3,23,6,True
2499475,444,2,451,5167,864966934,0,0,0,1085.08,7,851427.31,24,1,14,7,True
2641352,234,0,20,2138,864966934,0,0,0,1084.8,5,850342.51,26,3,4,7,True
2785651,819,2,451,3539,864966934,0,0,0,1084.82,7,849257.69,18,3,9,9,True
2826880,819,2,451,3539,864966934,0,0,0,1084.6,7,848173.09,18,5,22,9,True
2840162,488,3,30,5493,864966934,0,0,0,1085.28,8,847087.81,12,3,22,11,True
2854521,603,0,30,1239,864966934,0,0,0,1085.21,8,846002.6,24,5,0,11,True
2990977,883,0,10,2959,864966934,0,0,0,1085.09,0,847087.69,24,3,0,12,True
3067823,703,0,20,7659,864966934,0,0,0,1085.0,5,846002.69,18,6,12,1,True
3268581,783,0,10,2421,864966934,0,0,0,1085.18,0,847087.87,14,5,16,2,True
3524785,444,2,451,2421,864966934,0,0,0,1085.03,7,846002.84,24,1,19,2,True
3555772,1294,4,25,7340,864966934,0,0,0,1085.01,8,844917.83,24,5,18,2,True
3565435,444,2,30,5167,864966934,0,0,0,1085.19,8,843832.64,24,0,9,2,True
3762756,131,4,30,5493,864966934,0,0,0,1085.09,8,842747.55,18,0,1,3,True
3815459,1294,4,30,5167,864966934,0,0,0,1085.08,8,841662.47,24,2,23,4,True
4054385,488,3,25,4803,864966934,0,0,0,1084.9,8,840577.57,12,0,6,4,True
4296027,488,3,451,2421,864966934,0,0,0,1084.85,7,839492.72,12,2,8,4,True
4357481,488,3,-1,2959,864966934,0,1,0,1085.01,4,839492.72,12,6,22,4,True
4522804,603,0,451,9747,864966934,0,0,0,1085.32,7,838407.4,24,6,2,7,True
4571805,1294,4,451,9747,864966934,0,0,0,1085.11,7,837322.29,24,0,16,9,True
5410726,444,2,-1,1239,864966934,0,1,0,1084.89,1,837322.29,24,5,14,9,True
5480235,488,3,451,7340,864966934,0,0,0,1085.04,7,836237.25,12,4,22,11,True
5710967,131,4,-1,2959,864966934,0,1,0,1084.86,1,836237.25,18,5,9,11,True
6032489,488,3,451,7659,864966934,0,0,0,1085.03,7,835152.22,12,4,16,11,True
6102850,131,4,451,5906,864966934,0,0,0,1085.01,7,834067.21,18,1,22,12,True
6140468,1294,4,451,4803,864966934,0,0,0,1085.24,7,832981.97,24,2,13,12,False
6722043,444,2,451,5167,864966934,0,0,0,1084.94,7,831897.03,24,0,20,12,True
6805979,131,4,30,5167,864966934,0,0,0,1085.03,8,830812.0,18,4,3,1,True
6923019,1159,0,20,5774,864966934,0,0,0,1085.26,5,829726.74,15,5,11,1,True
7075469,603,0,25,1239,864966934,0,0,0,1084.9,8,828641.84,24,6,18,1,True
7190274,444,2,451,7659,864966934,0,0,0,1084.88,7,827556.96,24,4,5,6,True
7613086,488,3,25,2138,864966934,0,0,0,1085.23,8,826471.73,12,2,2,6,True
7759941,603,0,-1,2421,864966934,0,1,0,1085.07,4,826471.73,24,1,10,7,True
7766254,1381,4,30,5493,864966934,0,0,0,1084.69,8,825387.04,16,1,23,7,True
8124858,1294,4,451,2463,864966934,0,0,0,1085.0,7,824302.04,24,4,13,8,True
8380865,482,1,10,9747,864966934,0,0,0,1084.95,6,825386.99,5,3,0,9,True
8938244,603,0,451,5167,864966934,0,0,0,1084.75,7,824302.24,24,5,13,9,True
9189334,1381,4,30,2421,864966934,0,0,0,1084.71,8,823217.53,16,3,20,9,True
9251859,444,2,451,4803,864966934,0,0,0,1085.27,7,822132.26,24,2,16,10,True
9446482,480,0,10,5493,864966934,0,0,0,1084.73,6,823216.99,5,1,11,10,True
9917314,603,0,451,5167,864966934,0,0,0,1085.13,7,822131.86,24,2,22,11,True
1156117,780,0,25,9235,549295747,0,0,0,1073.14,8,814969.86,14,1,21,1,True
1192110,1191,4,451,4539,549295747,0,0,0,1073.08,7,813896.78,24,0,4,2,True
1277253,260,0,20,5329,549295747,0,0,0,1072.9,3,812823.88,6,4,11,3,True
1966012,1128,2,20,1462,549295747,0,0,0,1073.05,3,811750.83,24,4,11,4,True
2319014,780,0,25,3594,549295747,0,0,0,1073.11,8,810677.72,14,6,0,4,True
2363798,780,0,-1,2615,549295747,0,1,0,1073.02,4,810677.72,14,0,17,4,True
2656676,257,1,25,3294,549295747,0,0,0,1073.11,8,809604.61,6,0,14,4,True
2921665,274,1,10,6270,549295747,0,0,0,1072.9,6,810677.51,24,5,17,4,True
3633991,1191,4,-1,4231,549295747,0,1,0,1072.77,1,810677.51,24,3,20,9,True
4284238,1137,1,10,3594,549295747,0,0,0,1072.6,6,811750.11,24,3,23,10,True
4377779,618,3,30,2209,549295747,0,0,0,1073.12,8,810676.99,11,0,15,10,True
4382408,618,3,-1,5329,549295747,0,1,0,1072.86,4,810676.99,11,3,15,11,True
4952493,549,1,10,7244,549295747,0,0,0,1073.03,6,811750.02,17,5,2,12,True
5270721,780,0,-1,8617,549295747,0,1,0,1073.19,4,811750.02,14,6,12,12,True
5299612,618,3,-1,8964,549295747,0,2,0,1072.97,1,811750.02,11,3,18,12,True
5488018,1110,0,20,9558,549295747,0,0,0,1072.85,5,810677.17,0,0,5,1,True
5488205,167,2,20,8964,549295747,0,0,0,1073.14,5,809604.03,24,5,19,1,True
5505460,1352,1,10,2209,549295747,0,0,0,1072.88,0,810676.91,24,0,19,2,True
5585527,257,1,25,4539,549295747,0,0,0,1073.11,8,809603.8,6,0,11,3,True
5748350,529,2,30,3594,549295747,0,0,0,1072.99,8,808530.81,18,3,19,4,True
5912978,1191,4,30,8617,549295747,0,0,0,1073.01,8,807457.8,24,6,13,4,True
6030583,780,0,451,6292,549295747,0,0,0,1072.84,7,806384.96,14,1,6,5,True
6118353,366,0,20,8918,549295747,0,0,0,1073.07,3,805311.89,25,5,20,5,True
6151451,257,1,25,6270,549295747,0,0,0,1072.93,8,804238.96,6,1,18,6,True
6378396,709,3,25,9235,549295747,0,0,0,1072.96,8,803166.0,18,6,6,6,True
6413380,257,1,451,8918,549295747,0,0,0,1073.03,7,802092.97,6,3,23,6,True
6472338,709,3,25,9281,549295747,0,0,0,1072.96,8,801020.01,18,5,13,7,True
6663943,529,2,30,8617,549295747,0,0,0,1073.03,8,799946.98,18,3,8,7,True
6719145,780,0,451,1462,549295747,0,0,0,1072.98,7,798874.0,14,3,14,8,True
6829443,709,3,25,9996,549295747,0,0,0,1072.87,8,797801.13,18,2,18,9,True
6965240,1119,0,10,1462,549295747,0,0,0,1072.86,0,798873.99,24,2,3,10,True
7045137,257,1,451,8918,549295747,0,0,0,1073.09,7,797800.9,6,5,4,10,True
7192902,780,0,25,7270,549295747,0,0,0,1072.95,8,796727.95,14,3,9,11,True
7372079,1191,4,451,6292,549295747,0,0,0,1072.97,7,795654.98,24,6,22,12,True
7443213,529,2,25,4261,549295747,0,0,0,1072.94,8,794582.04,18,2,3,1,True
7657707,529,2,30,6270,549295747,0,0,0,1073.08,8,793508.96,18,1,11,2,True
7724229,257,1,25,4261,549295747,0,0,0,1072.83,8,792436.13,6,5,4,2,True
7800913,780,0,451,1462,549295747,0,0,0,1073.07,7,791363.06,14,1,12,2,True
7803565,709,3,25,4231,549295747,0,0,0,1072.63,8,790290.43,18,0,20,3,True
7854837,962,0,10,9558,549295747,0,0,0,1073.13,6,791363.56,13,2,12,4,True
7989609,780,0,30,6292,549295747,0,0,0,1072.99,8,790290.57,14,1,9,4,True
7992153,780,0,451,8321,549295747,0,0,0,1073.04,7,789217.53,14,3,8,5,True
8053787,780,0,30,7244,549295747,0,0,0,1073.15,8,788144.38,14,0,0,6,True
8117349,529,2,451,8918,549295747,0,0,0,1073.04,7,787071.34,18,0,5,7,True
8362773,529,2,451,2209,549295747,0,0,0,1073.02,7,785998.32,18,1,22,7,True
8421287,709,3,451,9281,549295747,0,0,0,1072.85,7,784925.47,18,1,12,8,True
8463171,398,0,20,4261,549295747,0,0,0,1072.78,3,783852.69,10,0,10,9,True
8546945,257,1,-1,2209,549295747,0,1,0,1072.81,4,783852.69,6,2,20,9,True
8730748,1191,4,30,4346,549295747,0,0,0,1073.22,8,782779.47,24,4,22,9,True
9004344,618,3,451,5329,549295747,0,0,0,1073.27,7,781706.2,11,6,16,9,True
9041336,1012,0,20,5161,549295747,0,0,0,1073.23,5,780632.97,26,5,21,9,True
9171120,780,0,451,4261,549295747,0,0,0,1073.34,7,779559.63,14,1,7,10,True
9686775,780,0,30,3594,549295747,0,0,0,1073.08,8,778486.55,14,2,2,10,True
9762711,1108,1,10,1016,549295747,0,0,0,1073.1,0,779559.65,0,0,12,11,True
9856726,257,1,25,9235,549295747,0,0,0,1073.1,8,778486.55,6,4,11,11,True
9870106,709,3,-1,5161,549295747,0,1,0,1073.07,4,778486.55,18,0,0,11,True
9937978,780,0,30,5329,549295747,0,0,0,1072.98,8,777413.57,14,5,4,11,True
1697038,751,4,451,9805,921592575,0,0,0,489.18,7,578062.82,24,6,16,1,True
1770850,812,0,-1,5644,921592575,0,1,0,489.19,1,578062.82,18,1,4,1,True
1789855,716,0,-1,9805,921592575,0,2,0,488.91,1,578062.82,18,2,11,1,True
1814555,1244,4,451,6757,921592575,0,0,0,489.12,7,577573.7,18,4,15,1,True
1847648,751,4,-1,7980,921592575,0,1,0,489.23,4,577573.7,24,4,11,4,True
1882083,716,0,451,6428,921592575,0,0,0,489.04,7,577084.66,18,3,13,4,True
1966631,448,0,10,5644,921592575,0,0,0,489.09,6,577573.75,13,3,6,4,True
2286642,303,0,20,6428,921592575,0,0,0,489.09,3,577084.66,4,6,16,5,True
2368498,1244,4,-1,7672,921592575,0,1,0,489.0,1,577084.66,18,2,2,5,True
2641606,1244,4,25,1898,921592575,0,0,0,489.27,8,576595.39,18,5,20,5,True
2788988,424,1,10,8664,921592575,0,0,0,489.07,6,577084.46,18,0,10,5,True
3101020,1278,0,25,7561,921592575,0,0,0,488.89,8,576595.57,24,1,4,5,True
3286378,995,1,25,9264,921592575,0,0,0,489.04,8,576106.53,22,3,0,6,True
3493448,962,0,30,8664,921592575,0,0,0,489.03,8,575617.5,13,5,5,7,True
3545361,1244,4,30,3273,921592575,0,0,0,488.98,8,575128.52,18,0,14,8,True
3757544,1312,0,20,7561,921592575,0,0,0,488.88,3,574639.64,5,5,13,9,True
4311927,751,4,-1,9798,921592575,0,1,0,488.93,4,574639.64,24,2,15,9,True
4420405,467,0,20,6757,921592575,0,0,0,488.82,3,574150.82,5,4,20,11,True
4575364,1244,4,25,5243,921592575,0,0,0,489.08,8,573661.74,18,2,3,1,True
4593974,812,0,25,6428,921592575,0,0,0,489.06,8,573172.68,18,3,2,1,True
4775135,1000,0,20,9805,921592575,0,0,0,488.96,5,572683.72,26,3,13,1,True
5123974,580,0,20,5644,921592575,0,0,0,488.88,5,572194.84,11,5,12,1,True
5137522,995,1,-1,7403,921592575,0,1,0,489.04,1,572194.84,22,6,22,4,True
5171461,320,1,10,2166,921592575,0,0,0,488.98,6,572683.82,11,0,20,4,True
5212634,253,2,20,6863,921592575,0,0,0,489.19,5,572194.63,6,4,18,5,True
5383066,81,0,10,7403,921592575,0,0,0,488.88,6,572683.51,1,0,23,5,True
5595020,1278,0,451,3273,921592575,0,0,0,489.23,7,572194.28,24,0,15,6,True
5760709,716,0,451,7234,921592575,0,0,0,489.34,7,571704.94,18,1,4,7,True
5796046,1076,1,-1,4941,921592575,0,1,0,488.94,4,571704.94,18,4,20,7,True
6231922,995,1,25,7234,921592575,0,0,0,488.88,8,571216.06,22,3,0,9,True
6407574,415,4,451,8644,921592575,0,0,0,489.17,7,570726.89,18,3,6,10,True
6686895,751,4,451,7980,921592575,0,0,0,488.88,7,570238.01,24,3,20,10,True
6784105,415,4,30,7980,921592575,0,0,0,489.11,8,569748.9,18,1,10,10,True
7020308,1288,0,20,4941,921592575,0,0,0,488.89,5,569260.01,24,3,23,10,True
7187367,208,0,20,6757,921592575,0,0,0,489.04,5,568770.97,9,5,19,10,True
7244467,962,0,451,5644,921592575,0,0,0,488.89,7,568282.08,13,6,17,10,True
7418277,1076,1,25,9725,921592575,0,0,0,488.82,8,567793.26,18,0,17,11,True
7531410,328,0,10,3273,921592575,0,0,0,489.14,6,568282.4,11,2,7,11,True
7785140,415,4,451,6428,921592575,0,0,0,488.71,7,567793.69,18,5,9,11,True
7918733,415,4,451,5060,921592575,0,0,0,489.19,7,567304.5,18,0,15,12,True
8060329,415,4,-1,5644,921592575,0,1,0,489.21,4,567304.5,18,2,6,12,True
8205264,415,4,451,9805,921592575,0,0,0,488.77,7,566815.73,18,6,15,2,True
8262689,603,0,20,8664,921592575,0,0,0,489.02,3,566326.71,24,0,1,2,True
8568303,716,0,-1,8265,921592575,0,1,0,489.11,4,566326.71,18,5,10,2,True
8584554,1278,0,30,7913,921592575,0,0,0,488.96,8,565837.75,24,5,8,3,True
8716660,1382,0,10,8644,921592575,0,0,0,488.99,6,566326.74,16,4,0,3,False
8849294,812,0,451,7403,921592575,0,0,0,488.98,7,565837.76,18,5,2,5,True
8975470,751,4,30,3273,921592575,0,0,0,489.33,8,565348.43,24,6,5,5,True
8975754,1076,1,25,8644,921592575,0,0,0,488.98,8,564859.45,18,2,3,5,True
9176559,1244,4,451,8265,921592575,0,0,0,488.79,7,564370.66,18,4,16,6,True
9211037,1278,0,30,9264,921592575,0,0,0,489.06,8,563881.6,24,1,23,7,True
9240119,1014,1,10,9798,921592575,0,0,0,489.14,6,564370.74,26,3,12,7,True
9388641,362,0,10,2166,921592575,0,0,0,488.91,0,564859.65,24,6,19,7,True
9623318,962,0,451,5644,921592575,0,0,0,488.98,7,564370.67,13,4,18,7,True
9781420,962,0,30,5644,921592575,0,0,0,489.07,8,563881.6,13,6,18,8,True
9852426,444,2,20,7561,921592575,0,0,0,488.91,5,563392.69,24,2,11,9,True
9864043,1244,4,451,1898,921592575,0,0,0,488.95,7,562903.74,18,6,16,11,True
1149144,1267,2,20,2409,889260016,1,0,0,222.0,5,428854.0,23,6,22,1,True
1514836,591,0,30,2549,889260016,1,0,0,221.75,8,428632.25,24,5,17,1,True
1520459,1271,0,30,2768,889260016,1,0,0,221.94,8,428410.31,23,5,23,1,True
1660773,78,3,451,3950,889260016,1,0,0,221.77,7,428188.54,1,1,22,1,True
2022305,930,3,451,1197,889260016,1,0,0,221.82,7,427966.72,18,6,5,2,True
2060141,334,0,10,2768,889260016,1,0,0,222.05,0,428188.77,11,1,12,3,True
2218595,591,0,30,8495,889260016,1,0,0,221.9,8,427966.87,24,3,17,3,True
2359286,498,0,20,2409,889260016,1,0,0,222.28,3,427744.59,12,2,5,3,True
2561741,208,0,10,2549,889260016,1,0,0,222.23,0,427966.82,9,4,15,4,False
2665311,437,4,451,8173,889260016,1,0,0,222.07,7,427744.75,24,6,19,5,True
2746367,930,3,451,2768,889260016,1,0,0,221.89,7,427522.86,18,1,16,5,False
2799402,1140,0,20,8900,889260016,1,0,0,221.88,3,427300.98,15,3,13,6,True
2902560,654,1,10,2409,889260016,1,0,0,221.79,6,427522.77,18,6,7,6,False
2917428,890,4,451,8343,889260016,1,0,0,221.83,7,427300.94,24,1,8,8,True
3038351,930,3,25,1197,889260016,1,0,0,221.97,8,427078.97,18,2,10,8,True
3068109,437,4,30,3337,889260016,1,0,0,222.22,8,426856.75,24,5,17,8,True
3403371,890,4,30,2409,889260016,1,0,0,221.57,8,426635.18,24,1,13,8,True
3554259,591,0,30,6595,889260016,1,0,0,222.02,8,426413.16,24,5,17,9,True
3685459,890,4,451,8495,889260016,1,0,0,221.96,7,426191.2,24,0,11,10,True
3725420,1246,0,10,3337,889260016,1,0,0,222.08,6,426413.28,23,1,17,10,True
4327498,998,0,-1,2768,889260016,1,1,0,222.01,4,426413.28,26,4,8,10,True
4367052,1271,0,451,7532,889260016,1,0,0,221.87,7,426191.41,23,6,11,10,True
4689648,890,4,25,8173,889260016,1,0,0,221.85,8,425969.56,24,5,7,11,True
4808478,998,0,30,3328,889260016,1,0,0,222.33,8,425747.23,26,0,12,12,True
5042816,930,3,30,8495,889260016,1,0,0,222.32,8,425524.91,18,2,22,2,True
5081500,78,3,451,8495,889260016,1,0,0,222.16,7,425302.75,1,5,6,2,False
5184055,698,4,30,3337,889260016,1,0,0,221.9,8,425080.85,18,5,11,2,True
5425444,694,2,20,5746,889260016,1,0,0,222.14,5,424858.71,24,2,5,3,True
5546064,325,0,10,2549,889260016,1,0,0,221.83,0,425080.54,11,4,23,3,True
5737306,818,1,10,6595,889260016,1,0,0,222.04,0,425302.58,18,1,21,4,True
5953970,167,2,20,9981,889260016,1,0,0,221.96,5,425080.62,24,4,9,4,True
5993318,78,3,451,8495,889260016,1,0,0,222.07,7,424858.55,1,6,8,5,True
6293028,890,4,30,5746,889260016,1,0,0,222.01,8,424636.54,24,4,5,6,True
6492236,1119,0,10,9981,889260016,1,0,0,221.79,6,424858.33,24,1,5,6,True
7120155,998,0,30,8173,889260016,1,0,0,222.16,8,424636.17,26,5,23,7,True
7138463,78,3,-1,2549,889260016,1,1,0,221.92,4,424636.17,1,5,7,7,True
7155091,437,4,-1,3337,889260016,1,2,0,222.2,4,424636.17,24,4,16,9,True
7175567,698,4,30,2409,889260016,1,0,0,222.07,8,424414.1,18,0,6,10,True
7266826,930,3,451,6595,889260016,1,0,0,222.13,7,424191.97,18,5,19,12,True
7346724,1271,0,30,3328,889260016,1,0,0,222.05,8,423969.92,23,2,14,1,True
7762552,698,4,-1,5746,889260016,1,1,0,221.82,1,423969.92,18,4,6,2,True
7828713,1271,0,30,8900,889260016,1,0,0,222.01,8,423747.91,23,1,2,3,True
7948824,20,0,10,8173,889260016,1,0,0,222.05,0,423969.96,24,3,6,3,True
8042807,698,4,30,5340,889260016,1,0,0,222.06,8,423747.9,18,6,7,3,True
8087657,591,0,451,8900,889260016,1,0,0,221.75,7,423526.15,24,0,13,5,True
8153866,790,0,20,3337,889260016,1,0,0,221.94,3,423304.21,11,5,8,6,True
8369533,437,4,451,7532,889260016,1,0,0,221.63,7,423082.58,24,4,3,8,True
8636772,890,4,451,8173,889260016,1,0,0,222.18,7,422860.4,24,6,9,8,True
9058818,591,0,-1,2549,889260016,1,1,0,222.17,1,422860.4,24,2,0,9,False
9254796,78,3,30,6595,889260016,1,0,0,222.02,8,422638.38,1,1,23,10,True
9331252,524,1,10,5746,889260016,1,0,0,222.3,0,422860.68,18,2,8,10,True
9508826,78,3,30,3950,889260016,1,0,0,222.12,8,422638.56,1,5,10,10,True
9944332,890,4,30,8495,889260016,1,0,0,222.09,8,422416.47,24,4,11,10,True
1013071,1391,2,451,8956,114796321,0,0,0,908.99,7,126386.01,24,6,14,1,True
1072002,739,1,25,3874,114796321,0,0,0,908.94,8,125477.07,24,6,20,1,True
1680217,1145,4,451,3194,114796321,0,0,0,909.04,7,124568.03,15,0,13,1,False
1725509,317,4,25,3194,114796321,0,0,0,909.25,8,123658.78,4,1,10,1,False
1737848,1145,4,451,7864,114796321,0,0,0,909.15,7,122749.63,15,4,5,1,True
1778553,600,4,30,2358,114796321,0,0,0,908.99,8,121840.64,24,6,15,3,True
1872386,600,4,451,3268,114796321,0,0,0,908.99,7,120931.65,24,6,14,4,True
1971085,317,4,25,3268,114796321,0,0,0,908.79,8,120022.86,4,0,6,4,True
2268856,630,0,-1,7236,114796321,0,1,0,909.11,4,120022.86,11,0,11,4,True
2386069,480,0,20,1186,114796321,0,0,0,908.86,5,119114.0,5,0,3,4,True
2959378,496,1,10,3194,114796321,0,0,0,908.89,6,120022.89,12,3,3,5,True
3103884,297,0,10,9351,114796321,0,0,0,909.03,6,120931.92,4,3,17,6,True
3196288,967,1,10,8739,114796321,0,0,0,908.98,0,121840.9,13,1,4,6,True
3374418,1391,2,30,9704,114796321,0,0,0,908.89,8,120932.01,24,2,3,6,True
3407053,1145,4,451,4698,114796321,0,0,0,909.16,7,120022.85,15,5,22,7,True
3573614,747,1,10,4955,114796321,0,0,0,908.88,6,120931.73,24,6,19,8,True
3782148,630,0,25,3826,114796321,0,0,0,909.05,8,120022.68,11,3,23,8,True
3997786,328,0,10,1186,114796321,0,0,0,908.71,6,120931.39,11,1,6,8,True
4067973,688,0,10,4698,114796321,0,0,0,909.03,6,121840.42,24,2,17,9,True
4321355,1068,2,20,1186,114796321,0,0,0,909.06,5,120931.36,18,3,2,9,True
4450487,1391,2,-1,9704,114796321,0,1,0,908.76,4,120931.36,24,3,16,9,True
4532860,630,0,25,7236,114796321,0,0,0,908.94,8,120022.42,11,3,9,10,True
4630981,1279,4,25,8739,114796321,0,0,0,909.07,8,119113.35,24,2,9,10,True
4688380,1160,0,20,2358,114796321,0,0,0,909.23,5,118204.12,15,1,8,11,True
4728892,53,0,20,4158,114796321,0,0,0,909.08,3,117295.04,20,1,0,11,True
4744613,1404,2,20,7236,114796321,0,0,0,909.06,3,116385.98,24,3,23,11,True
4754436,630,0,10,7864,114796321,0,0,0,908.91,6,117294.89,11,5,21,11,True
4816898,849,1,30,4158,114796321,0,0,0,908.88,8,116386.01,5,3,10,12,True
5066116,317,4,30,3826,114796321,0,0,0,909.33,8,115476.68,4,0,23,12,True
5113878,849,1,30,7236,114796321,0,0,0,908.81,8,114567.87,5,1,7,1,True
5242393,573,0,10,9704,114796321,0,0,0,909.2,0,115477.07,11,3,4,1,True
5295980,1164,0,20,1186,114796321,0,0,0,908.94,3,114568.13,24,4,22,2,True
5362061,849,1,451,3874,114796321,0,0,0,908.92,7,113659.21,5,1,22,3,True
5822144,346,0,30,4158,114796321,0,0,0,908.83,8,112750.38,24,2,11,3,True
5825461,600,4,30,7864,114796321,0,0,0,909.04,8,111841.34,24,5,17,3,True
5895246,346,0,25,4698,114796321,0,0,0,909.1,8,110932.24,24,3,6,4,True
5898107,346,0,-1,4158,114796321,0,1,0,908.9,4,110932.24,24,4,20,4,True
6040371,1279,4,25,9351,114796321,0,0,0,909.16,8,110023.08,24,3,3,6,True
6229429,849,1,30,3826,114796321,0,0,0,908.92,8,109114.16,5,2,16,7,True
6348035,820,1,10,8739,114796321,0,0,0,909.25,6,110023.41,18,6,22,7,False
6466977,346,0,451,2358,114796321,0,0,0,909.16,7,109114.25,24,2,11,9,True
6483881,860,1,10,4698,114796321,0,0,0,909.04,0,110023.29,24,0,23,11,True
6535220,346,0,-1,3874,114796321,0,1,0,909.31,4,110023.29,24,3,7,12,True
6561903,317,4,30,3826,114796321,0,0,0,908.95,8,109114.34,4,3,11,12,True
6663234,317,4,-1,8739,114796321,0,1,0,908.77,4,109114.34,4,6,9,12,True
6930685,317,4,25,1186,114796321,0,0,0,908.97,8,108205.37,4,2,16,1,True
7244439,1145,4,451,4698,114796321,0,0,0,909.0,7,107296.37,15,3,17,2,True
7433393,739,1,-1,8956,114796321,0,1,0,908.85,1,107296.37,24,5,18,2,True
7868305,346,0,451,9704,114796321,0,0,0,909.02,7,106387.35,24,4,2,3,True
7880523,739,1,30,9351,114796321,0,0,0,908.52,8,105478.83,24,5,20,3,True
8040274,1145,4,451,2358,114796321,0,0,0,908.73,7,104570.1,15,4,11,3,True
8703703,739,1,451,8956,114796321,0,0,0,909.12,7,103660.98,24,5,9,5,True
8779975,993,0,10,9704,114796321,0,0,0,908.92,6,104569.9,22,6,17,6,True
9033624,1102,2,20,4955,114796321,0,0,0,909.01,5,103660.89,0,0,5,6,True
9079061,1145,4,-1,7864,114796321,0,1,0,909.01,4,103660.89,15,3,19,8,True
9715510,317,4,451,8956,114796321,0,0,0,909.0,7,102751.89,4,6,11,10,True
9896132,849,1,451,9684,114796321,0,0,0,909.03,7,101842.86,5,4,12,10,True
9970091,739,1,451,1186,114796321,0,0,0,908.85,7,100934.01,24,1,5,10,True
1009184,1256,2,30,4994,833021140,1,0,0,445.98,8,440840.02,23,1,22,1,True
1041097,938,4,451,6623,833021140,1,0,0,445.93,7,440394.09,24,2,17,1,True
1197971,406,1,451,5089,833021140,1,0,0,446.11,7,439947.98,10,4,9,1,True
1282688,58,2,20,8591,833021140,1,0,0,445.93,3,439502.05,20,3,21,2,True
1447201,350,0,10,3685,833021140,1,0,0,446.25,6,439948.3,24,1,0,2,True
1479808,1089,0,10,8456,833021140,1,0,0,446.02,6,440394.32,18,4,9,3,True
1492124,421,3,25,3550,833021140,1,0,0,445.93,8,439948.39,18,3,17,4,True
1498379,1247,0,10,5089,833021140,1,0,0,445.74,6,440394.13,23,5,14,4,True
1995446,421,3,30,4064,833021140,1,0,0,445.96,8,439948.17,18,6,1,5,True
2220610,479,2,-1,6156,833021140,1,1,0,445.8,1,439948.17,5,1,1,5,True
2781740,406,1,-1,8456,833021140,1,2,0,445.84,4,439948.17,10,0,2,7,True
3016234,1050,4,451,7959,833021140,1,0,0,445.98,7,439502.19,11,1,13,7,True
3187488,198,0,20,1791,833021140,1,0,0,445.98,5,439056.21,18,1,9,7,True
3261531,479,2,451,9036,833021140,1,0,0,445.97,7,438610.24,5,6,22,8,True
3499430,938,4,25,4064,833021140,1,0,0,445.97,8,438164.27,24,0,5,9,True
3531030,1256,2,25,3550,833021140,1,0,0,445.98,8,437718.29,23,0,8,9,True
3656969,807,0,10,3685,833021140,1,0,0,445.84,6,438164.13,11,4,9,10,True
3737501,371,3,451,7959,833021140,1,0,0,446.0,7,437718.13,25,5,1,11,True
3860939,267,0,10,1791,833021140,1,0,0,446.14,6,438164.27,6,2,7,11,True
4028072,938,4,-1,8456,833021140,1,1,0,446.02,4,438164.27,24,2,15,12,True
4028847,421,3,451,4970,833021140,1,0,0,446.13,7,437718.14,18,6,17,3,True
4200614,371,3,451,3477,833021140,1,0,0,445.94,7,437272.2,25,1,22,3,True
4434457,371,3,25,2208,833021140,1,0,0,446.17,8,436826.03,25,3,5,5,True
4600221,98,0,10,4716,833021140,1,0,0,445.95,6,437271.98,3,4,3,5,True
4801632,938,4,451,7959,833021140,1,0,0,446.02,7,436825.96,24,3,8,7,True
5151239,1235,1,10,3550,833021140,1,0,0,445.89,0,437271.85,18,1,16,8,True
5332580,1050,4,25,3550,833021140,1,0,0,445.83,8,436826.02,11,4,4,8,True
5724222,1352,1,10,6623,833021140,1,0,0,446.07,6,437272.09,24,6,18,8,True
5870509,1127,0,10,3550,833021140,1,0,0,445.81,6,437717.9,24,6,11,8,True
5980292,406,1,25,6156,833021140,1,0,0,446.06,8,437271.84,10,0,20,9,True
6120245,1050,4,30,8456,833021140,1,0,0,446.06,8,436825.78,11,3,7,9,True
6274034,800,0,20,4970,833021140,1,0,0,446.15,5,436379.63,11,4,21,10,True
6355469,1256,2,451,6156,833021140,1,0,0,445.87,7,435933.76,23,5,13,10,True
6734438,371,3,451,4994,833021140,1,0,0,445.89,7,435487.87,25,5,23,11,True
6771841,1050,4,451,8591,833021140,1,0,0,446.05,7,435041.82,11,6,19,12,True
6845170,938,4,-1,4970,833021140,1,1,0,445.78,4,435041.82,24,3,4,12,True
6846848,421,3,451,2208,833021140,1,0,0,446.01,7,434595.81,18,5,20,1,True
6850737,479,2,30,9036,833021140,1,0,0,446.23,8,434149.58,5,2,5,1,True
6896654,1170,0,10,1791,833021140,1,0,0,446.06,6,434595.64,24,6,15,2,True
6966398,406,1,25,3477,833021140,1,0,0,445.99,8,434149.65,10,1,22,3,True
7282587,479,2,30,4994,833021140,1,0,0,445.81,8,433703.84,5,3,20,3,True
7760442,938,4,25,4970,833021140,1,0,0,446.03,8,433257.81,24,5,17,4,True
7829368,1256,2,451,2208,833021140,1,0,0,446.24,7,432811.57,23,3,6,5,True
8138459,1170,0,20,7959,833021140,1,0,0,445.83,5,432365.74,24,3,23,6,True
8142953,421,3,451,4064,833021140,1,0,0,445.93,7,431919.81,18,0,0,6,True
8279221,421,3,25,6623,833021140,1,0,0,446.12,8,431473.69,18,2,5,6,True
8316223,406,1,25,3477,833021140,1,0,0,446.03,8,431027.66,10,6,13,7,True
8473724,51,0,10,4064,833021140,1,0,0,445.78,6,431473.44,20,3,5,9,True
8571407,479,2,451,9036,833021140,1,0,0,445.95,7,431027.49,5,4,20,9,True
8734962,479,2,451,4064,833021140,1,0,0,446.06,7,430581.43,5,3,9,9,True
9104330,938,4,25,4994,833021140,1,0,0,445.76,8,430135.67,24,6,18,10,True
9227822,117,1,10,8591,833021140,1,0,0,446.25,6,430581.92,18,1,0,10,True
1071587,605,0,10,7909,122842879,0,0,0,144.27,6,631936.27,24,1,5,1,True
1099136,1334,3,30,9936,122842879,0,0,0,143.89,8,631792.38,18,1,11,4,True
1495314,1366,4,-1,5265,122842879,0,1,0,144.19,4,631792.38,16,3,7,4,True
1904049,1318,0,451,2705,122842879,0,0,0,143.94,7,631648.44,18,2,21,4,True
1948533,204,0,25,2933,122842879,0,0,0,144.11,8,631504.33,9,6,1,6,True
2305033,1318,0,-1,7909,122842879,0,1,0,143.83,1,631504.33,18,3,15,6,True
2531477,732,0,10,1937,122842879,0,0,0,144.02,6,631648.35,11,4,1,7,True
2591759,1318,0,25,8921,122842879,0,0,0,143.98,8,631504.37,18,1,15,8,True
2749138,580,0,-1,1937,122842879,0,1,0,144.13,4,631504.37,11,3,7,8,True
2868700,889,0,30,7565,122842879,0,0,0,144.08,8,631360.29,27,3,23,8,True
3028967,1318,0,451,4630,122842879,0,0,0,143.92,7,631216.37,18,6,11,8,True
3041933,580,0,451,4447,122842879,0,0,0,143.97,7,631072.4,11,1,8,9,True
3399197,558,0,10,5265,122842879,0,0,0,144.04,6,631216.44,17,6,6,10,True
3406619,535,0,20,9801,122842879,0,0,0,143.8,5,631072.64,18,5,1,10,True
3530860,204,0,30,9424,122842879,0,0,0,143.97,8,630928.67,9,0,10,10,False
3728104,204,0,451,3677,122842879,0,0,0,143.94,7,630784.73,9,6,14,11,True
3734633,1318,0,-1,1999,122842879,0,1,0,144.08,4,630784.73,18,0,22,12,True
3747194,1212,0,10,9247,122842879,0,0,0,143.77,6,630928.5,24,2,11,12,True
3962092,1334,3,-1,1937,122842879,0,1,0,144.09,4,630928.5,18,2,19,12,True
4415969,204,0,451,2933,122842879,0,0,0,144.03,7,630784.47,9,0,5,1,True
4531903,129,0,10,4630,122842879,0,0,0,143.98,0,630928.45,18,3,8,1,True
4646541,889,0,-1,1970,122842879,0,1,0,143.96,4,630928.45,27,2,14,2,True
4711554,1382,0,20,7909,122842879,0,0,0,143.85,5,630784.6,16,5,0,4,True
4844616,1027,0,10,2933,122842879,0,0,0,143.84,6,630928.44,11,0,17,4,True
5255728,1018,4,25,8921,122842879,0,0,0,143.88,8,630784.56,26,5,23,5,True
5322694,1366,4,-1,4447,122842879,0,1,0,143.96,4,630784.56,16,4,15,6,True
5346462,929,0,20,7909,122842879,0,0,0,143.91,3,630640.65,18,3,22,7,True
5597482,464,1,10,4630,122842879,0,0,0,144.04,0,630784.69,13,1,9,7,True
5626172,1155,0,30,7565,122842879,0,0,0,144.02,8,630640.67,15,6,4,8,True
5635173,1334,3,25,1970,122842879,0,0,0,144.21,8,630496.46,18,4,20,8,True
5751212,889,0,451,3677,122842879,0,0,0,144.18,7,630352.28,27,4,4,9,True
5883006,1155,0,30,5265,122842879,0,0,0,144.17,8,630208.11,15,3,5,10,True
6066057,1205,0,20,2933,122842879,0,0,0,144.17,5,630063.94,24,5,22,10,True
6286121,1063,0,20,9247,122842879,0,0,0,144.24,5,629919.7,11,5,23,10,True
6407008,314,0,20,9936,122842879,0,0,0,144.1,3,629775.6,4,3,17,10,True
6428118,889,0,451,9247,122842879,0,0,0,143.96,7,629631.64,27,1,20,11,True
6566819,204,0,451,2933,122842879,0,0,0,143.95,7,629487.69,9,4,10,11,True
7106582,1334,3,451,2143,122842879,0,0,0,144.2,7,629343.49,18,2,4,12,True
7138358,1018,4,451,8508,122842879,0,0,0,144.09,7,629199.4,26,2,7,1,True
7167120,204,0,451,4379,122842879,0,0,0,144.03,7,629055.37,9,3,13,1,True
7202997,1488,0,20,5265,122842879,0,0,0,143.91,3,628911.46,24,2,1,2,True
7601408,935,1,10,1999,122842879,0,0,0,143.78,0,629055.24,24,4,23,2,True
7664625,1155,0,25,7909,122842879,0,0,0,143.94,8,628911.3,15,1,0,3,True
7990483,889,0,-1,2770,122842879,0,1,0,143.96,1,628911.3,27,3,6,3,True
8019336,509,0,10,3677,122842879,0,0,0,143.91,6,629055.21,12,3,20,3,True
8197360,1334,3,30,5265,122842879,0,0,0,143.94,8,628911.27,18,1,10,4,True
8317691,1018,4,451,2705,122842879,0,0,0,143.91,7,628767.36,26,2,4,5,True
8620322,580,0,25,9801,122842879,0,0,0,143.89,8,628623.47,11,0,10,5,True
8760082,204,0,451,3677,122842879,0,0,0,143.87,7,628479.6,9,3,2,6,True
8945177,871,0,25,1999,122842879,0,0,0,143.85,8,628335.75,24,5,11,6,True
8996769,1366,4,451,7565,122842879,0,0,0,144.27,7,628191.48,16,5,7,6,True
9015709,889,0,451,9801,122842879,0,0,0,144.14,7,628047.34,27,5,14,7,True
9050980,1272,0,10,1937,122842879,0,0,0,143.82,6,628191.16,24,4,0,7,True
9055655,1272,0,20,9424,122842879,0,0,0,144.08,3,628047.08,24,0,13,8,True
9565423,1366,4,-1,7565,122842879,0,1,0,143.91,4,628047.08,16,6,20,8,False
9645901,1334,3,451,4630,122842879,0,0,0,144.09,7,627902.99,18,0,4,9,True
9647875,530,0,10,1150,122842879,0,0,0,144.0,6,628046.99,18,5,7,9,True
9934491,360,0,20,9247,122842879,0,0,0,143.97,5,627903.02,24,5,13,11,False
1032763,533,2,451,5404,564490757,1,0,0,900.11,7,232437.89,18,0,14,1,True
1052351,1195,1,-1,2868,564490757,1,1,0,899.96,4,232437.89,24,2,10,1,True
1073617,1119,0,30,2682,564490757,1,0,0,900.12,8,231537.77,24,3,2,1,True
1105001,533,2,451,3512,564490757,1,0,0,900.04,7,230637.73,18,0,8,1,True
1113309,1459,1,10,3512,564490757,1,0,0,899.88,6,231537.61,11,2,1,3,True
1132723,1485,0,20,8909,564490757,1,0,0,900.06,5,230637.55,24,1,16,3,True
1419133,605,0,10,5404,564490757,1,0,0,899.99,6,231537.54,24,4,2,4,True
1539454,542,0,10,1679,564490757,1,0,0,899.97,6,232437.51,17,1,6,4,True
1564053,900,1,10,6702,564490757,1,0,0,900.24,6,233337.75,24,4,2,5,True
1686248,1195,1,25,1757,564490757,1,0,0,899.52,8,232438.23,24,1,15,6,True
1801356,1364,0,20,1296,564490757,1,0,0,900.12,5,231538.11,16,3,15,8,True
1854669,1446,1,10,4839,564490757,1,0,0,900.02,6,232438.13,24,2,19,8,True
1937307,406,1,10,3512,564490757,1,0,0,900.03,6,233338.16,10,2,19,8,True
2630122,130,0,10,8969,564490757,1,0,0,899.92,0,234238.08,18,0,5,9,True
2684611,1012,0,10,2682,564490757,1,0,0,899.76,6,235137.84,26,0,12,9,True
2902626,1119,0,451,8969,564490757,1,0,0,899.91,7,234237.93,24,6,11,10,True
3218220,688,0,25,8909,564490757,1,0,0,900.09,8,233337.84,24,4,2,10,True
3308660,1195,1,-1,3512,564490757,1,1,0,900.11,1,233337.84,24,1,16,11,True
4010551,1195,1,25,3681,564490757,1,0,0,899.82,8,232438.02,24,6,21,11,True
4258513,533,2,30,4947,564490757,1,0,0,900.18,8,231537.84,18,4,3,12,True
4338661,1195,1,451,2682,564490757,1,0,0,900.04,7,230637.8,24,2,13,12,True
4387449,1488,0,10,6702,564490757,1,0,0,899.79,6,231537.59,24,6,8,1,True
5240219,247,4,30,8845,564490757,1,0,0,900.18,8,230637.41,6,1,7,2,True
5356944,1119,0,25,4947,564490757,1,0,0,900.17,8,229737.24,24,2,4,3,True
5487002,1119,0,25,2868,564490757,1,0,0,900.13,8,228837.11,24,1,16,3,True
5545451,688,0,25,5421,564490757,1,0,0,900.2,8,227936.91,24,4,0,5,True
5766522,1119,0,25,4528,564490757,1,0,0,900.2,8,227036.71,24,0,22,5,True
6182952,247,4,25,1679,564490757,1,0,0,900.08,8,226136.63,6,4,14,5,True
6302612,247,4,-1,3390,564490757,1,1,0,900.06,4,226136.63,6,3,20,6,True
6411736,1119,0,451,2868,564490757,1,0,0,900.61,7,225236.02,24,2,14,6,True
6508337,907,0,20,4839,564490757,1,0,0,899.88,5,224336.14,2,6,2,7,True
6673521,1119,0,30,8845,564490757,1,0,0,899.99,8,223436.15,24,4,6,9,True
6738548,1195,1,30,5421,564490757,1,0,0,899.92,8,222536.23,24,5,10,9,True
6922798,533,2,25,8909,564490757,1,0,0,900.02,8,221636.21,18,6,16,9,True
7290408,688,0,30,8845,564490757,1,0,0,900.05,8,220736.16,24,5,14,9,True
7418778,1195,1,25,5421,564490757,1,0,0,900.07,8,219836.09,24,0,22,10,True
7543786,688,0,-1,4528,564490757,1,1,0,899.75,4,219836.09,24,0,9,10,True
7569170,1195,1,451,2868,564490757,1,0,0,899.97,7,218936.12,24,2,9,11,True
7619446,247,4,-1,6660,564490757,1,1,0,900.22,4,218936.12,6,5,3,11,True
7736776,931,0,20,3681,564490757,1,0,0,900.14,5,218035.98,24,6,7,12,True
7781843,533,2,451,2009,564490757,1,0,0,900.0,7,217135.98,18,1,20,1,True
8006265,1119,0,451,6652,564490757,1,0,0,899.76,7,216236.22,24,2,7,1,True
8101574,1485,0,10,2009,564490757,1,0,0,899.86,6,217136.08,24,1,1,1,True
8283490,652,0,20,1296,564490757,1,0,0,900.16,5,216235.92,24,3,6,1,True
8425159,611,0,20,7282,564490757,1,0,0,900.2,5,215335.72,11,5,4,2,True
8437009,816,0,20,5404,564490757,1,0,0,900.04,5,214435.68,18,0,7,3,True
8472844,533,2,30,8644,564490757,1,0,0,899.74,8,213535.94,18,6,1,3,True
8520638,97,0,10,6702,564490757,1,0,0,900.08,0,214436.02,3,0,3,4,True
8526083,752,0,20,1757,564490757,1,0,0,899.58,5,213536.44,24,2,18,5,True
8612701,533,2,30,3681,564490757,1,0,0,900.03,8,212636.41,18,5,6,5,True
8682539,1380,0,20,6660,564490757,1,0,0,899.98,3,211736.43,16,1,9,6,True
8740288,1119,0,25,8845,564490757,1,0,0,900.17,8,210836.26,24,0,16,6,True
8987281,247,4,-1,1296,564490757,1,1,0,900.12,4,210836.26,6,4,9,6,True
9018610,688,0,25,8644,564490757,1,0,0,900.0,8,209936.26,24,3,17,7,True
9105954,260,0,10,4947,564490757,1,0,0,900.01,6,210836.27,6,5,10,7,True
9132109,304,0,20,2009,564490757,1,0,0,900.31,5,209935.96,4,5,9,9,True
9431296,64,0,10,4528,564490757,1,0,0,900.01,0,210835.97,20,6,18,9,True
9630745,533,2,451,6660,564490757,1,0,0,899.99,7,209935.98,18,1,5,10,True
9715207,533,2,25,3390,564490757,1,0,0,900.15,8,209035.83,18,6,3,11,True
1187648,420,4,25,2619,874166633,1,0,0,1187.2,8,965814.8,18,1,14,1,True
1430719,1436,0,-1,1242,874166633,1,1,0,1187.16,4,965814.8,24,5,1,2,True
1842834,1206,0,20,7051,874166633,1,0,0,1187.26,5,964627.54,24,1,2,2,True
1906224,406,1,-1,1242,874166633,1,1,0,1187.05,1,964627.54,10,3,22,3,True
2188625,849,1,-1,6986,874166633,1,2,0,1187.04,4,964627.54,5,4,3,3,True
2253249,1170,0,20,6986,874166633,1,0,0,1187.07,5,963440.47,24,2,2,3,False
2327194,454,1,10,5183,874166633,1,0,0,1187.08,0,964627.55,13,1,17,4,True
2870803,1436,0,-1,3586,874166633,1,1,0,1187.21,1,964627.55,24,6,3,4,True
2985238,1467,0,20,8280,874166633,1,0,0,1186.94,5,963440.61,11,6,14,4,True
3026206,1436,0,-1,5141,874166633,1,1,0,1186.89,4,963440.61,24,1,6,5,True
3213758,882,0,20,5578,874166633,1,0,0,1186.92,5,962253.69,27,5,11,6,False
3215637,276,0,10,1724,874166633,1,0,0,1186.89,6,963440.58,24,6,10,7,True
3218831,479,2,451,5183,874166633,1,0,0,1186.88,7,962253.7,5,2,8,7,True
3357486,849,1,-1,8280,874166633,1,1,0,1186.93,1,962253.7,5,3,6,9,True
3463538,1436,0,451,5855,874166633,1,0,0,1186.74,7,961066.96,24,6,5,10,True
3485643,420,4,451,1242,874166633,1,0,0,1186.97,7,959879.99,18,2,19,10,True
3518015,459,1,10,7562,874166633,1,0,0,1186.95,6,961066.94,13,6,8,11,True
3574168,1245,1,10,5578,874166633,1,0,0,1187.22,6,962254.16,18,3,5,11,True
3638501,525,0,20,7769,874166633,1,0,0,1186.8,5,961067.36,18,6,1,1,True
4341270,882,0,30,4207,874166633,1,0,0,1186.79,8,959880.57,27,4,19,1,True
4354788,420,4,451,8280,874166633,1,0,0,1187.08,7,958693.49,18,3,16,2,True
4439335,260,0,20,5578,874166633,1,0,0,1186.81,3,957506.68,6,4,9,3,True
4575916,1436,0,451,5578,874166633,1,0,0,1186.98,7,956319.7,24,0,20,3,True
4713935,1436,0,25,7769,874166633,1,0,0,1187.03,8,955132.67,24,1,5,3,True
5333688,1436,0,30,7562,874166633,1,0,0,1187.4,8,953945.27,24,0,8,4,True
5513218,900,1,10,1724,874166633,1,0,0,1186.86,0,955132.13,24,3,12,4,True
5571668,882,0,451,8280,874166633,1,0,0,1187.24,7,953944.89,27,2,22,5,True
5960947,882,0,30,2619,874166633,1,0,0,1187.01,8,952757.88,27,5,20,5,True
5978928,1436,0,-1,5578,874166633,1,1,0,1186.96,1,952757.88,24,2,20,5,True
6060054,1128,2,20,8774,874166633,1,0,0,1186.79,3,951571.09,24,1,14,8,True
6123052,897,0,20,5261,874166633,1,0,0,1187.02,3,950384.07,24,2,7,9,True
6365682,1152,0,451,4345,874166633,1,0,0,1187.06,7,949197.01,15,1,10,9,True
6415148,849,1,25,7051,874166633,1,0,0,1187.1,8,948009.91,5,3,4,9,True
6666540,420,4,30,6899,874166633,1,0,0,1186.95,8,946822.96,18,5,3,11,True
6780683,497,0,10,8774,874166633,1,0,0,1187.16,0,948010.12,12,5,14,12,True
6914325,366,0,10,8280,874166633,1,0,0,1187.04,6,949197.16,25,1,0,12,True
7092135,588,0,10,7769,874166633,1,0,0,1186.99,6,950384.15,24,5,15,3,True
7332433,849,1,25,7769,874166633,1,0,0,1187.16,8,949196.99,5,2,22,4,True
7614082,643,4,451,7562,874166633,1,0,0,1187.14,7,948009.85,24,2,6,4,True
8048625,649,0,-1,3586,874166633,1,1,0,1186.83,4,948009.85,24,3,2,5,True
8696433,420,4,25,3586,874166633,1,0,0,1186.91,8,946822.94,18,4,2,6,True
8712719,1152,0,-1,7769,874166633,1,1,0,1186.9,4,946822.94,15,3,21,6,True
8723729,479,2,25,9687,874166633,1,0,0,1187.18,8,945635.76,5,3,23,7,True
8821934,649,0,25,5578,874166633,1,0,0,1186.83,8,944448.93,24,3,10,9,True
8838978,64,0,10,6986,874166633,1,0,0,1187.08,6,945636.01,20,0,1,9,True
8847140,643,4,451,5700,874166633,1,0,0,1187.01,7,944449.0,24,1,0,10,True
9278235,1152,0,25,8280,874166633,1,0,0,1187.05,8,943261.95,15,2,8,10,True
9331646,956,1,10,1242,874166633,1,0,0,1187.03,0,944448.98,13,6,18,10,True
9603186,849,1,451,9687,874166633,1,0,0,1186.97,7,943262.01,5,6,18,10,True
9839073,406,1,25,3586,874166633,1,0,0,1187.1,8,942074.91,10,4,0,11,True
9964895,406,1,25,1724,874166633,1,0,0,1186.78,8,940888.13,10,3,3,11,True
1215896,234,0,25,1122,904764417,1,0,0,103.96,8,658168.04,26,1,7,1,True
1483103,807,0,10,4571,904764417,1,0,0,104.25,6,658272.29,11,0,4,1,True
1967348,234,0,25,7786,904764417,1,0,0,104.07,8,658168.22,26,3,11,1,True
2203027,234,0,30,6828,904764417,1,0,0,104.01,8,658064.21,26,0,7,2,True
2221979,234,0,30,4123,904764417,1,0,0,104.24,8,657959.97,26,3,14,2,True
2423810,28,1,30,5500,904764417,1,0,0,104.16,8,657855.81,11,1,5,3,True
2442064,816,0,20,6082,904764417,1,0,0,103.72,5,657752.09,18,2,3,3,True
2463860,861,4,25,2995,904764417,1,0,0,104.01,8,657648.08,24,0,16,3,True
2508808,85,2,451,4603,904764417,1,0,0,104.03,7,657544.05,1,2,8,3,True
2598437,28,1,451,6560,904764417,1,0,0,103.93,7,657440.12,11,3,23,3,True
2616035,234,0,30,9399,904764417,1,0,0,103.94,8,657336.18,26,5,11,4,True
2620929,649,0,10,5811,904764417,1,0,0,104.15,6,657440.33,24,3,1,5,True
3196834,234,0,451,7786,904764417,1,0,0,104.04,7,657336.29,26,3,5,5,True
3224789,861,4,-1,1810,904764417,1,1,0,103.94,4,657336.29,24,4,11,5,True
3268544,1007,2,20,7510,904764417,1,0,0,103.97,3,657232.32,26,2,9,5,True
3986872,234,0,30,4358,904764417,1,0,0,103.91,8,657128.41,26,0,19,6,True
4032895,567,1,10,1810,904764417,1,0,0,104.31,0,657232.72,11,6,20,7,True
4063324,377,4,451,1810,904764417,1,0,0,103.87,7,657128.85,25,5,23,7,True
4174285,861,4,25,4358,904764417,1,0,0,104.0,8,657024.85,24,0,11,9,True
4647861,85,2,30,7786,904764417,1,0,0,103.99,8,656920.86,1,4,9,9,True
4852646,1126,4,451,6376,904764417,1,0,0,104.0,7,656816.86,24,1,3,10,True
5179752,861,4,451,3629,904764417,1,0,0,103.88,7,656712.98,24,0,6,11,True
5348217,42,2,20,4603,904764417,1,0,0,103.93,5,656609.05,24,5,4,12,True
5695246,861,4,30,2995,904764417,1,0,0,103.98,8,656505.07,24,4,20,1,True
5774527,1126,4,30,4123,904764417,1,0,0,103.82,8,656401.25,24,1,15,1,True
5834347,861,4,-1,2995,904764417,1,1,0,104.03,1,656401.25,24,4,6,2,True
5911659,854,0,20,7786,904764417,1,0,0,103.73,5,656297.52,24,0,11,2,True
6157056,861,4,-1,3629,904764417,1,1,0,104.0,4,656297.52,24,3,16,3,True
6177112,377,4,30,1810,904764417,1,0,0,103.66,8,656193.86,25,5,10,4,True
6214935,861,4,451,6376,904764417,1,0,0,103.92,7,656089.94,24,4,1,9,True
6252950,1126,4,30,5500,904764417,1,0,0,103.97,8,655985.97,24,6,0,9,True
6351150,861,4,-1,2995,904764417,1,1,0,104.01,1,655985.97,24,5,9,9,True
6471679,950,0,20,4123,904764417,1,0,0,103.79,5,655882.18,24,5,11,10,True
6558459,588,0,20,5482,904764417,1,0,0,104.16,3,655778.02,24,1,5,11,True
6605762,85,2,25,7510,904764417,1,0,0,103.92,8,655674.1,1,2,12,11,True
6868674,376,0,10,6560,904764417,1,0,0,103.91,6,655778.01,25,2,2,12,True
6929278,234,0,-1,6828,904764417,1,1,0,104.06,4,655778.01,26,1,1,1,True
6979927,28,1,451,9399,904764417,1,0,0,104.01,7,655674.0,11,4,15,1,True
7239693,445,0,10,6560,904764417,1,0,0,104.29,6,655778.29,13,0,6,1,True
7364512,1126,4,30,1122,904764417,1,0,0,103.94,8,655674.35,24,1,18,2,True
7765851,1311,2,20,4358,904764417,1,0,0,104.07,5,655570.28,5,3,10,2,True
7876862,377,4,25,1122,904764417,1,0,0,103.79,8,655466.49,25,0,8,2,True
7960247,85,2,25,4123,904764417,1,0,0,103.97,8,655362.52,1,6,4,3,True
8116474,1126,4,451,4571,904764417,1,0,0,104.09,7,655258.43,24,2,3,4,True
8237897,542,0,20,6560,904764417,1,0,0,104.18,3,655154.25,17,4,14,5,True
8408132,234,0,451,6376,904764417,1,0,0,104.24,7,655050.01,26,3,12,5,True
8606625,1126,4,25,3629,904764417,1,0,0,104.21,8,654945.8,24,1,23,6,True
8669905,861,4,-1,5811,904764417,1,1,0,103.91,4,654945.8,24,3,7,6,True
8728376,377,4,30,4571,904764417,1,0,0,103.82,8,654841.98,25,0,13,6,True
8734034,28,1,30,4085,904764417,1,0,0,104.1,8,654737.88,11,5,9,6,True
8744451,28,1,30,5500,904764417,1,0,0,104.06,8,654633.82,11,0,2,7,False
8807025,85,2,451,6082,904764417,1,0,0,103.75,7,654530.07,1,4,2,8,True
9859250,85,2,25,6560,904764417,1,0,0,104.0,8,654426.07,1,3,7,9,True
9930192,85,2,451,4358,904764417,1,0,0,104.1,7,654321.97,1,0,2,9,True
9974939,377,4,25,4085,904764417,1,0,0,103.71,8,654218.26,25,0,14,10,True
1110152,186,4,30,6533,417837639,0,0,0,1099.91,8,443820.09,18,1,13,2,True
1244209,951,0,451,3111,417837639,0,0,0,1099.87,7,442720.22,24,3,17,2,True
1300399,186,4,30,4411,417837639,0,0,0,1100.11,8,441620.11,18,5,3,3,True
1503249,186,4,30,1806,417837639,0,0,0,1099.91,8,440520.2,18,1,8,3,False
1588493,808,3,451,9171,417837639,0,0,0,1099.93,7,439420.27,11,5,20,5,True
1716564,808,3,30,2176,417837639,0,0,0,1100.08,8,438320.19,11,2,11,5,True
1739183,951,0,-1,6041,417837639,0,1,0,1100.14,4,438320.19,24,1,18,8,True
1951778,375,4,30,3111,417837639,0,0,0,1099.94,8,437220.25,25,4,9,10,True
2283354,1262,0,10,6041,417837639,0,0,0,1100.09,6,438320.34,23,1,11,11,True
2354075,1333,4,30,1978,417837639,0,0,0,1100.09,8,437220.25,18,5,7,11,True
2375127,1333,4,30,6664,417837639,0,0,0,1100.2,8,436120.05,18,3,20,11,True
2391812,605,0,10,2176,417837639,0,0,0,1100.05,6,437220.1,24,6,23,12,True
2638452,817,4,30,6664,417837639,0,0,0,1099.92,8,436120.18,18,6,10,12,True
3486381,175,3,451,9171,417837639,0,0,0,1100.11,7,435020.07,24,1,6,12,True
3542972,808,3,30,3111,417837639,0,0,0,1100.0,8,433920.07,11,1,20,12,True
4155700,951,0,25,1137,417837639,0,0,0,1100.06,8,432820.01,24,6,20,1,False
4247811,424,1,10,9171,417837639,0,0,0,1099.98,0,433919.99,18,0,15,2,False
4470894,1271,0,-1,3111,417837639,0,1,0,1099.74,1,433919.99,23,1,13,2,False
4564789,186,4,451,3111,417837639,0,0,0,1099.95,7,432820.04,18,0,7,3,False
4587765,1271,0,-1,6664,417837639,0,1,0,1099.84,4,432820.04,23,4,8,3,True
4858285,1245,1,10,6041,417837639,0,0,0,1099.78,6,433919.82,18,2,12,5,True
4873112,649,0,20,4411,417837639,0,0,0,1099.86,5,432819.96,24,0,8,5,True
5254743,817,4,451,9171,417837639,0,0,0,1099.97,7,431719.99,18,3,4,5,True
5360972,817,4,451,5297,417837639,0,0,0,1100.28,7,430619.71,18,1,19,5,True
5411649,1271,0,451,9171,417837639,0,0,0,1100.18,7,429519.53,23,3,13,7,True
5431069,145,0,20,6246,417837639,0,0,0,1099.66,5,428419.87,18,6,20,7,True
5523616,186,4,-1,3812,417837639,0,1,0,1100.1,4,428419.87,18,5,19,8,True
5640871,375,4,-1,2077,417837639,0,2,0,1100.12,4,428419.87,25,2,19,8,True
5679987,325,0,20,1806,417837639,0,0,0,1100.18,5,427319.69,11,5,21,8,True
5912236,1271,0,30,7607,417837639,0,0,0,1099.89,8,426219.8,23,1,18,9,True
5938481,951,0,451,3753,417837639,0,0,0,1099.86,7,425119.94,24,4,18,9,True
6085319,175,3,-1,7607,417837639,0,1,0,1100.01,1,425119.94,24,5,17,9,True
6266829,123,0,10,3171,417837639,0,0,0,1099.69,6,426219.63,18,2,10,9,True
6365317,808,3,30,1137,417837639,0,0,0,1100.05,8,425119.58,11,2,17,9,True
6489842,1063,0,20,5297,417837639,0,0,0,1100.28,3,424019.3,11,2,5,10,True
6561860,1333,4,451,2176,417837639,0,0,0,1100.17,7,422919.13,18,0,10,11,True
6664669,951,0,25,6041,417837639,0,0,0,1100.27,8,421818.86,24,2,18,11,True
6778529,653,1,10,3812,417837639,0,0,0,1099.92,0,422918.78,24,0,15,12,True
6873698,1271,0,451,2176,417837639,0,0,0,1100.04,7,421818.74,23,1,20,1,True
7332568,808,3,25,3753,417837639,0,0,0,1100.07,8,420718.67,11,1,9,1,True
7378751,375,4,-1,1806,417837639,0,1,0,1099.82,4,420718.67,25,2,21,1,True
7927524,378,0,10,1978,417837639,0,0,0,1100.21,6,421818.88,25,6,12,2,True
7938286,375,4,451,3812,417837639,0,0,0,1100.23,7,420718.65,25,3,7,2,True
8309291,808,3,25,7607,417837639,0,0,0,1099.89,8,419618.76,11,6,13,4,True
8575510,951,0,25,6041,417837639,0,0,0,1100.22,8,418518.54,24,2,11,4,True
8581278,1260,0,10,5297,417837639,0,0,0,1099.79,0,419618.33,23,0,20,4,True
8713065,951,0,30,6246,417837639,0,0,0,1100.03,8,418518.3,24,4,0,5,True
8817575,375,4,451,6533,417837639,0,0,0,1099.87,7,417418.43,25,4,17,5,True
8985563,375,4,-1,1806,417837639,0,1,0,1100.15,4,417418.43,25,6,4,6,True
9129041,186,4,25,6664,417837639,0,0,0,1100.2,8,416318.23,18,0,9,7,True
9147152,175,3,30,5297,417837639,0,0,0,1100.09,8,415218.14,24,6,22,8,True
9206766,175,3,30,3812,417837639,0,0,0,1100.0,8,414118.14,24,0,10,8,True
9437380,1486,2,20,6664,417837639,0,0,0,1100.15,5,413017.99,24,0,23,8,True
9688690,817,4,30,9171,417837639,0,0,0,1099.95,8,411918.04,18,2,22,9,True
9777840,1271,0,25,3111,417837639,0,0,0,1099.91,8,410818.13,23,4,19,11,False
1003710,1255,0,30,3803,135998778,1,0,0,1055.05,8,958306.95,23,5,8,2,True
1146230,576,2,451,3074,135998778,1,0,0,1055.28,7,957251.67,11,4,14,3,True
1329948,113,4,30,9298,135998778,1,0,0,1054.89,8,956196.78,3,2,8,3,True
1486537,797,3,25,7198,135998778,1,0,0,1055.16,8,955141.62,11,4,11,4,True
1500398,741,3,25,1412,135998778,1,0,0,1054.85,8,954086.77,24,1,22,4,True
1655657,53,0,20,2586,135998778,1,0,0,1054.64,5,953032.13,20,3,1,4,True
1703271,741,3,25,3074,135998778,1,0,0,1054.62,8,951977.51,24,2,0,5,False
2110949,741,3,451,8322,135998778,1,0,0,1055.11,7,950922.4,24,6,14,5,True
2323660,1045,4,30,9298,135998778,1,0,0,1054.73,8,949867.67,11,0,14,5,True
2389756,669,2,20,8230,135998778,1,0,0,1054.98,3,948812.69,18,5,4,6,True
2451294,741,3,30,8230,135998778,1,0,0,1054.82,8,947757.87,24,1,15,7,True
3084661,741,3,451,3971,135998778,1,0,0,1054.71,7,946703.16,24,4,13,8,True
3143489,797,3,30,7823,135998778,1,0,0,1055.02,8,945648.14,11,6,15,9,True
3400926,797,3,451,3074,135998778,1,0,0,1055.08,7,944593.06,11,1,11,9,True
3661892,113,4,30,3803,135998778,1,0,0,1055.11,8,943537.95,3,6,5,10,True
3743784,1044,0,20,7198,135998778,1,0,0,1055.28,5,942482.67,11,3,9,11,True
3885221,644,0,10,3803,135998778,1,0,0,1054.86,0,943537.53,24,5,17,11,True
3991604,797,3,451,3803,135998778,1,0,0,1054.79,7,942482.74,11,3,11,12,True
4162328,797,3,451,8230,135998778,1,0,0,1054.72,7,941428.02,11,4,9,12,True
4203389,797,3,-1,6450,135998778,1,1,0,1054.79,4,941428.02,11,6,2,12,True
4309692,797,3,30,6883,135998778,1,0,0,1054.66,8,940373.36,11,2,9,12,True
4899104,531,0,10,8322,135998778,1,0,0,1055.23,6,941428.59,18,2,13,1,True
4904060,767,0,10,5920,135998778,1,0,0,1054.67,0,942483.26,14,0,4,2,True
4977296,1045,4,25,5920,135998778,1,0,0,1054.88,8,941428.38,11,6,13,3,True
5369270,1255,0,30,3971,135998778,1,0,0,1055.34,8,940373.04,23,2,15,3,True
5725843,1035,0,20,5920,135998778,1,0,0,1055.12,3,939317.92,11,6,20,5,False
5744589,1298,0,10,1171,135998778,1,0,0,1054.93,0,940372.85,5,3,1,6,True
5793659,822,4,25,6601,135998778,1,0,0,1054.89,8,939317.96,18,6,23,7,True
5908671,113,4,25,1412,135998778,1,0,0,1054.91,8,938263.05,3,0,12,7,True
5973931,732,0,10,5463,135998778,1,0,0,1055.1,6,939318.15,11,5,16,8,True
5980154,1255,0,30,1412,135998778,1,0,0,1055.14,8,938263.01,23,0,7,8,True
6014426,797,3,25,3971,135998778,1,0,0,1055.01,8,937208.0,11,4,6,8,True
6073049,822,4,-1,7823,135998778,1,1,0,1055.16,1,937208.0,18,0,15,10,True
6191226,910,0,20,8322,135998778,1,0,0,1054.88,5,936153.12,18,3,0,11,True
6368730,1255,0,451,3803,135998778,1,0,0,1055.27,7,935097.85,23,3,1,12,True
6489054,1255,0,30,3803,135998778,1,0,0,1054.97,8,934042.88,23,4,6,12,True
6535818,576,2,25,9298,135998778,1,0,0,1055.07,8,932987.81,11,0,1,1,True
6564043,741,3,451,7198,135998778,1,0,0,1055.28,7,931932.53,24,1,3,1,True
7275494,576,2,-1,5463,135998778,1,1,0,1055.08,4,931932.53,11,6,21,3,True
7372545,797,3,-1,1412,135998778,1,2,0,1054.96,1,931932.53,11,6,21,8,True
7413753,822,4,-1,6883,135998778,1,3,1,1055.03,4,931932.53,18,2,3,11,True
1385129,440,4,25,6777,705038233,1,0,0,389.95,8,984729.05,24,5,11,1,True
1439941,319,0,10,7615,705038233,1,0,0,389.79,6,985118.84,11,4,7,2,True
1664094,1140,0,10,9694,705038233,1,0,0,390.05,6,985508.89,15,3,5,2,True
1794411,1100,4,25,7387,705038233,1,0,0,389.89,8,985119.0,0,1,2,3,True
2079444,1100,4,30,2016,705038233,1,0,0,390.04,8,984728.96,0,6,4,4,True
2130545,723,1,10,4981,705038233,1,0,0,390.09,6,985119.05,11,6,18,4,True
2279687,440,4,-1,2084,705038233,1,1,0,390.35,4,985119.05,24,5,21,4,True
2726959,1010,0,20,7387,705038233,1,0,0,390.03,3,984729.02,26,2,12,5,True
2980188,205,0,20,2825,705038233,1,0,0,389.94,3,984339.08,9,3,10,6,True
3102139,1041,0,-1,7536,705038233,1,1,0,389.95,4,984339.08,11,4,10,7,True
3150278,1041,0,451,7387,705038233,1,0,0,389.96,7,983949.12,11,5,7,7,True
3172906,440,4,-1,5061,705038233,1,1,0,389.95,4,983949.12,24,3,2,7,True
3186220,897,0,20,5061,705038233,1,0,0,389.77,5,983559.35,24,3,12,8,True
3348680,263,3,451,7615,705038233,1,0,0,390.02,7,983169.33,6,0,15,8,True
3681659,1388,1,451,9588,705038233,1,0,0,389.92,7,982779.41,24,2,18,8,True
4116767,573,0,10,6229,705038233,1,0,0,390.06,6,983169.47,11,5,4,10,True
4184011,263,3,451,5412,705038233,1,0,0,390.2,7,982779.27,6,0,4,10,True
4220635,649,0,10,6472,705038233,1,0,0,389.99,6,983169.26,24,3,7,12,True
4358445,440,4,25,4551,705038233,1,0,0,390.0,8,982779.26,24,5,21,12,True
4401798,804,0,10,6803,705038233,1,0,0,390.02,6,983169.28,11,4,5,1,True
4412646,1397,4,25,1502,705038233,1,0,0,390.13,8,982779.15,24,5,2,2,True
4460983,263,3,30,7615,705038233,1,0,0,389.96,8,982389.19,6,5,5,4,True
4561149,537,0,10,4551,705038233,1,0,0,390.16,6,982779.35,18,4,11,4,True
4613404,947,2,20,5285,705038233,1,0,0,390.02,3,982389.33,24,0,1,5,True
4723223,21,0,25,1338,705038233,1,0,0,389.73,8,981999.6,11,6,8,6,True
4830671,869,2,20,9588,705038233,1,0,0,389.87,3,981609.73,24,6,10,6,True
5156089,444,2,451,1338,705038233,1,0,0,389.85,7,981219.88,24,5,9,6,True
5207049,253,2,20,7615,705038233,1,0,0,390.11,5,980829.77,6,2,20,7,True
5234101,444,2,-1,9097,705038233,1,1,0,390.06,1,980829.77,24,3,2,7,True
5288536,21,0,25,6229,705038233,1,0,0,390.04,8,980439.73,11,4,19,7,True
5343288,645,0,20,6390,705038233,1,0,0,389.98,5,980049.75,24,5,21,7,True
5527778,1377,0,20,3893,705038233,1,0,0,390.01,3,979659.74,16,0,19,7,True
5999532,1041,0,-1,3893,705038233,1,1,0,390.06,4,979659.74,11,3,22,7,True
6742207,444,2,25,6803,705038233,1,0,0,389.91,8,979269.83,24,0,13,8,True
6863888,263,3,451,6472,705038233,1,0,0,389.74,7,978880.09,6,6,3,8,True
7006836,440,4,451,2016,705038233,1,0,0,390.05,7,978490.04,24,0,2,8,True
7316275,440,4,30,4295,705038233,1,0,0,389.95,8,978100.09,24,6,10,9,True
7361994,263,3,451,7387,705038233,1,0,0,390.04,7,977710.05,6,2,8,9,True
7465719,444,2,30,9140,705038233,1,0,0,389.9,8,977320.15,24,3,18,10,True
7589743,205,0,10,1502,705038233,1,0,0,390.04,6,977710.19,9,4,21,11,True
7658650,859,2,20,9192,705038233,1,0,0,389.88,5,977320.31,24,1,10,11,True
7793639,1100,4,-1,5412,705038233,1,1,0,389.87,1,977320.31,0,0,3,12,True
7954094,23,0,20,5285,705038233,1,0,0,389.81,5,976930.5,11,0,7,2,True
8109700,327,0,10,7387,705038233,1,0,0,389.85,6,977320.35,11,3,21,3,True
8159209,182,1,-1,6803,705038233,1,1,0,390.2,4,977320.35,18,1,19,3,True
8163833,1100,4,25,6390,705038233,1,0,0,390.07,8,976930.28,0,3,4,5,True
8165937,1140,0,20,9192,705038233,1,0,0,389.91,5,976540.37,15,3,20,7,True
8178169,444,2,451,1338,705038233,1,0,0,389.78,7,976150.59,24,3,5,8,True
8774856,917,0,10,6853,705038233,1,0,0,390.1,0,976540.69,18,0,12,8,True
8942420,182,1,451,7615,705038233,1,0,0,389.86,7,976150.83,18,6,3,9,True
9202689,735,1,10,6777,705038233,1,0,0,390.09,6,976540.92,11,2,13,9,True
9366204,882,0,10,7615,705038233,1,0,0,389.92,6,976930.84,27,4,8,9,True
9435790,1140,0,20,7615,705038233,1,0,0,389.72,5,976541.12,15,4,17,9,True
9581490,180,0,20,3267,705038233,1,0,0,389.71,3,976151.41,18,2,21,9,True
1082563,736,1,30,4382,554619072,1,0,0,881.79,8,501372.21,11,1,0,1,True
1290044,98,0,10,4382,554619072,1,0,0,882.1,0,502254.31,3,6,13,1,True
1494549,736,1,451,9976,554619072,1,0,0,882.27,7,501372.04,11,5,12,2,True
1511378,1209,4,-1,4382,554619072,1,1,0,882.14,4,501372.04,24,3,22,2,True
1552139,149,2,30,7124,554619072,1,0,0,882.06,8,500489.98,18,2,20,3,True
1956954,1256,2,451,3297,554619072,1,0,0,881.92,7,499608.06,23,0,18,3,True
2164513,652,0,20,6018,554619072,1,0,0,882.08,5,498725.98,24,3,10,3,True
2213792,1256,2,-1,9386,554619072,1,1,0,881.97,4,498725.98,23,5,11,4,True
2314158,579,0,10,6206,554619072,1,0,0,882.26,6,499608.24,11,6,18,6,True
2417943,779,4,25,9976,554619072,1,0,0,882.26,8,498725.98,14,3,22,6,True
2441726,1134,1,10,8024,554619072,1,0,0,881.98,6,499607.96,24,6,4,6,True
2469472,1474,0,10,9386,554619072,1,0,0,881.87,0,500489.83,24,3,10,10,True
2534666,1267,2,20,7124,554619072,1,0,0,881.89,5,499607.94,23,6,8,10,True
2579873,634,1,10,1905,554619072,1,0,0,882.37,6,500490.31,24,6,15,10,True
2596597,1209,4,25,9976,554619072,1,0,0,882.03,8,499608.28,24,1,15,11,True
2786794,1256,2,451,4382,554619072,1,0,0,881.98,7,498726.3,23,5,17,11,True
2826769,149,2,451,1340,554619072,1,0,0,881.75,7,497844.55,18,2,6,11,True
2852955,1206,0,10,3085,554619072,1,0,0,882.07,6,498726.62,24,2,21,12,True
2863739,53,0,451,6206,554619072,1,0,0,881.89,7,497844.73,20,1,2,1,True
3021956,1209,4,-1,8980,554619072,1,1,0,882.43,4,497844.73,24,4,10,1,True
4372133,833,4,25,9976,554619072,1,0,0,881.69,8,496963.04,5,0,12,2,True
4577850,833,4,25,7124,554619072,1,0,0,881.89,8,496081.15,5,3,23,3,True
4772781,1256,2,-1,7975,554619072,1,1,0,881.84,4,496081.15,23,3,20,3,True
4988427,833,4,451,3498,554619072,1,0,0,882.0,7,495199.15,5,3,6,4,True
5026533,149,2,25,4382,554619072,1,0,0,882.0,8,494317.15,18,5,6,4,True
5317954,1209,4,30,9976,554619072,1,0,0,881.98,8,493435.17,24,3,4,6,True
5327946,779,4,30,3498,554619072,1,0,0,882.16,8,492553.01,14,6,9,6,True
5459230,1411,0,20,9976,554619072,1,0,0,881.94,5,491671.07,24,1,23,7,True
5662797,715,0,20,6018,554619072,1,0,0,882.11,3,490788.96,18,3,0,7,True
5703150,1209,4,451,6018,554619072,1,0,0,882.12,7,489906.84,24,4,15,7,True
5773952,900,1,10,3297,554619072,1,0,0,882.1,0,490788.94,24,5,12,7,True
5955099,833,4,451,3085,554619072,1,0,0,882.01,7,489906.93,5,3,12,8,True
5957556,833,4,30,1340,554619072,1,0,0,882.2,8,489024.73,5,3,18,8,True
6019483,877,2,20,8024,554619072,1,0,0,881.83,3,488142.9,24,4,17,8,True
6458686,287,0,10,1905,554619072,1,0,0,881.82,6,489024.72,24,4,15,9,True
6617310,531,0,10,9386,554619072,1,0,0,882.17,0,489906.89,18,6,9,10,True
6786028,1304,0,20,7124,554619072,1,0,0,881.92,5,489024.97,5,1,9,10,True
6892136,736,1,25,9386,554619072,1,0,0,882.0,8,488142.97,11,1,16,10,True
7145461,53,0,30,9386,554619072,1,0,0,881.61,8,487261.36,20,4,1,10,True
7289646,1219,1,10,3969,554619072,1,0,0,881.78,6,488143.14,24,6,7,11,True
7461380,779,4,25,3384,554619072,1,0,0,882.07,8,487261.07,14,1,14,11,True
7960282,348,0,20,9386,554619072,1,0,0,881.96,3,486379.11,24,4,7,12,True
8330415,1390,0,10,5985,554619072,1,0,0,882.12,0,487261.23,24,6,23,3,True
8417036,833,4,451,7975,554619072,1,0,0,881.9,7,486379.33,5,3,23,3,True
8441660,1209,4,-1,8024,554619072,1,1,0,882.08,4,486379.33,24,1,18,4,True
8687361,779,4,-1,7975,554619072,1,2,0,882.11,4,486379.33,14,5,9,5,True
8828489,1256,2,451,8024,554619072,1,0,0,882.21,7,485497.12,23,6,9,6,True
8970610,1044,0,20,1905,554619072,1,0,0,881.91,5,484615.21,11,5,2,6,True
9317253,1209,4,-1,3297,554619072,1,1,0,882.01,4,484615.21,24,5,0,8,True
9409031,1256,2,-1,3969,554619072,1,2,0,881.91,4,484615.21,23,0,14,8,True
9719391,149,2,451,6206,554619072,1,0,0,881.91,7,483733.3,18,2,23,10,True
1112008,757,0,30,9167,327555465,0,0,0,294.84,8,950251.16,24,2,3,3,True
1182169,164,4,30,4430,327555465,0,0,0,294.68,8,949956.48,24,5,23,4,True
1249487,1203,4,451,9167,327555465,0,0,0,295.02,7,949661.46,24,4,17,4,True
1544439,22,3,25,8022,327555465,0,0,0,294.76,8,949366.7,11,6,18,6,True
1756144,114,0,20,1075,327555465,0,0,0,295.02,5,949071.68,3,1,1,6,True
1911974,1308,3,30,8600,327555465,0,0,0,294.9,8,948776.78,5,1,0,7,True
2352479,610,0,10,8588,327555465,0,0,0,295.16,0,949071.94,11,4,2,8,True
3218026,1486,2,20,9163,327555465,0,0,0,294.95,5,948776.99,24,2,2,9,True
3334774,424,1,10,5899,327555465,0,0,0,294.87,6,949071.86,18,0,5,9,True
3632417,216,4,451,4430,327555465,0,0,0,295.11,7,948776.75,9,0,19,9,True
4002259,757,0,30,8022,327555465,0,0,0,294.95,8,948481.8,24,6,18,10,False
4438497,216,4,-1,2304,327555465,0,1,0,294.92,1,948481.8,9,4,3,11,True
4486937,164,4,25,3590,327555465,0,0,0,295.19,8,948186.61,24,5,22,11,True
4506470,216,4,30,5237,327555465,0,0,0,294.7,8,947891.91,9,5,0,11,True
4515277,304,0,20,9163,327555465,0,0,0,295.05,5,947596.86,4,5,10,11,True
4592779,216,4,-1,7053,327555465,0,1,0,295.19,4,947596.86,9,6,16,12,True
4688279,22,3,451,5899,327555465,0,0,0,295.29,7,947301.57,11,6,2,12,True
4720197,652,0,25,2822,327555465,0,0,0,294.96,8,947006.61,24,4,15,1,True
4951347,269,0,20,5355,327555465,0,0,0,294.88,5,946711.73,24,3,10,1,True
5048314,652,0,25,9163,327555465,0,0,0,294.86,8,946416.87,24,2,22,2,False
5084827,729,0,10,5355,327555465,0,0,0,294.9,6,946711.77,11,4,23,3,True
5219403,757,0,451,7053,327555465,0,0,0,295.07,7,946416.7,24,3,21,4,True
5506982,1308,3,451,1281,327555465,0,0,0,295.17,7,946121.53,5,4,9,4,True
5563901,166,4,25,1075,327555465,0,0,0,294.89,8,945826.64,24,2,9,4,True
5570616,223,2,20,1482,327555465,0,0,0,294.86,5,945531.78,26,5,12,4,True
6050761,164,4,451,3302,327555465,0,0,0,295.24,7,945236.54,24,3,15,4,True
6076543,51,0,20,2200,327555465,0,0,0,294.91,3,944941.63,20,0,12,5,True
6406157,1203,4,25,2822,327555465,0,0,0,295.35,8,944646.28,24,3,23,6,True
6455227,22,3,30,4308,327555465,0,0,0,295.11,8,944351.17,11,6,9,6,True
7057299,108,2,20,3302,327555465,0,0,0,295.36,5,944055.81,3,4,2,8,True
7325154,216,4,451,9167,327555465,0,0,0,294.77,7,943761.04,9,1,7,9,True
7464741,164,4,451,5778,327555465,0,0,0,294.84,7,943466.2,24,5,7,10,True
7576021,166,4,451,6643,327555465,0,0,0,295.26,7,943170.94,24,1,20,1,True
7731488,652,0,30,2897,327555465,0,0,0,294.87,8,942876.07,24,3,4,1,True
7764433,269,0,10,3302,327555465,0,0,0,295.08,6,943171.15,24,0,12,1,True
7815194,166,4,-1,4430,327555465,0,1,0,294.86,4,943171.15,24,3,9,2,True
8079737,1141,4,25,9163,327555465,0,0,0,295.2,8,942875.95,15,6,4,3,False
8366914,1308,3,-1,2200,327555465,0,1,0,294.98,4,942875.95,5,5,0,3,True
8370208,164,4,451,2304,327555465,0,0,0,295.01,7,942580.94,24,5,23,4,False
8697181,164,4,30,7053,327555465,0,0,0,294.81,8,942286.13,24,1,10,4,True
8992706,1141,4,451,8588,327555465,0,0,0,295.03,7,941991.1,15,5,19,6,True
9065612,164,4,451,2304,327555465,0,0,0,295.18,7,941695.92,24,4,4,6,True
9329590,318,0,10,5778,327555465,0,0,0,294.79,6,941990.71,11,6,12,7,True
9438734,81,0,20,4357,327555465,0,0,0,294.81,5,941695.9,1,6,18,9,True
9608686,22,3,25,6643,327555465,0,0,0,294.85,8,941401.05,11,1,22,9,True
9618455,216,4,-1,2304,327555465,0,1,0,294.91,1,941401.05,9,5,18,10,True
9703172,1308,3,25,4430,327555465,0,0,0,295.12,8,941105.93,5,0,11,10,True
9823082,1175,2,20,5355,327555465,0,0,0,295.03,3,940810.9,24,0,0,11,True
9853089,1019,0,20,2200,327555465,0,0,0,294.92,3,940515.98,26,5,23,11,True
9901696,22,3,-1,4430,327555465,0,1,0,294.99,4,940515.98,11,1,3,11,True
1555440,502,0,20,7032,172741405,0,0,0,149.0,5,240743.0,12,5,12,1,True
1787085,376,0,-1,7017,172741405,0,1,0,148.91,4,240743.0,25,0,21,1,True
1800677,464,1,30,2790,172741405,0,0,0,149.23,8,240593.77,13,3,3,2,True
2076183,210,4,451,2916,172741405,0,0,0,148.87,7,240444.9,9,4,4,4,True
2276771,376,0,25,7451,172741405,0,0,0,148.89,8,240296.01,25,1,16,7,True
2523445,537,0,20,6892,172741405,0,0,0,148.99,5,240147.02,18,0,1,8,True
2571531,693,4,-1,7968,172741405,0,1,0,148.92,4,240147.02,24,2,19,9,True
2920370,1421,0,25,1306,172741405,0,0,0,149.11,8,239997.91,24,1,1,9,True
2990775,464,1,-1,7086,172741405,0,1,0,149.26,1,239997.91,13,4,21,9,True
3257500,800,0,20,1410,172741405,0,0,0,149.11,5,239848.8,11,1,1,9,True
3288129,376,0,451,7032,172741405,0,0,0,149.12,7,239699.68,25,1,21,9,True
3311358,550,0,10,6206,172741405,0,0,0,148.89,6,239848.57,17,3,22,9,True
3330735,693,4,451,1306,172741405,0,0,0,148.75,7,239699.82,24,3,13,10,True
3545548,210,4,25,2811,172741405,0,0,0,149.01,8,239550.81,9,1,8,11,True
3840323,464,1,30,7968,172741405,0,0,0,148.9,8,239401.91,13,1,10,11,True
3874953,205,0,10,8388,172741405,0,0,0,148.78,0,239550.69,9,5,11,12,True
3918984,464,1,451,4334,172741405,0,0,0,148.82,7,239401.87,13,1,5,12,True
3982778,210,4,30,7940,172741405,0,0,0,149.04,8,239252.83,9,0,18,1,True
4512430,464,1,451,9545,172741405,0,0,0,149.0,7,239103.83,13,0,1,1,True
4719086,522,0,20,1019,172741405,0,0,0,148.96,5,238954.87,18,2,20,2,True
4733675,1233,0,20,2790,172741405,0,0,0,149.18,5,238805.69,18,1,1,3,False
4966524,108,2,451,2916,172741405,0,0,0,149.07,7,238656.62,3,5,11,4,True
5037057,210,4,-1,7451,172741405,0,1,0,148.92,1,238656.62,9,3,8,4,True
5250699,210,4,30,1346,172741405,0,0,0,149.1,8,238507.52,9,5,5,5,True
5511414,693,4,451,7451,172741405,0,0,0,148.68,7,238358.84,24,6,10,5,True
5901855,1421,0,451,2811,172741405,0,0,0,148.98,7,238209.86,24,0,22,6,True
6199532,1116,0,20,7968,172741405,0,0,0,148.98,5,238060.88,24,1,15,6,True
6256545,376,0,451,7451,172741405,0,0,0,148.89,7,237911.99,25,4,13,6,True
6308758,376,0,25,1346,172741405,0,0,0,149.06,8,237762.93,25,5,9,6,False
6944455,376,0,451,4334,172741405,0,0,0,148.85,7,237614.08,25,5,15,7,True
7078361,712,0,10,6892,172741405,0,0,0,149.34,6,237763.42,18,4,5,8,True
7091003,726,0,10,1412,172741405,0,0,0,149.15,0,237912.57,11,6,2,8,True
7120262,548,2,20,5934,172741405,0,0,0,149.12,5,237763.45,17,2,0,8,True
7176556,464,1,451,4122,172741405,0,0,0,149.22,7,237614.23,13,5,22,9,True
7231865,1421,0,451,7940,172741405,0,0,0,149.26,7,237464.97,24,3,15,9,True
7234459,158,2,20,6892,172741405,0,0,0,149.23,3,237315.74,24,5,19,10,True
7279754,693,4,451,9545,172741405,0,0,0,149.14,7,237166.6,24,2,17,10,True
7305969,108,2,451,1968,172741405,0,0,0,149.01,7,237017.59,3,1,23,10,True
7759539,605,0,10,1968,172741405,0,0,0,149.07,0,237166.66,24,0,18,12,True
7835662,464,1,-1,4334,172741405,0,1,0,148.89,1,237166.66,13,6,21,1,True
7928501,108,2,451,2054,172741405,0,0,0,148.92,7,237017.74,3,0,4,2,True
7975408,1421,0,30,6206,172741405,0,0,0,149.01,8,236868.73,24,0,18,2,True
8028906,693,4,25,8171,172741405,0,0,0,148.83,8,236719.9,24,3,18,5,True
8068458,220,0,10,1968,172741405,0,0,0,149.18,6,236869.08,26,3,1,5,True
8083832,931,0,20,9545,172741405,0,0,0,149.0,5,236720.08,24,3,12,5,True
8532118,464,1,30,1019,172741405,0,0,0,149.06,8,236571.02,13,5,14,6,True
8797824,464,1,25,5934,172741405,0,0,0,148.95,8,236422.07,13,5,4,7,True
8857157,464,1,30,7940,172741405,0,0,0,148.96,8,236273.11,13,2,17,7,True
9007338,376,0,451,1410,172741405,0,0,0,148.96,7,236124.15,25,3,18,7,True
9014262,108,2,451,1412,172741405,0,0,0,149.02,7,235975.13,3,4,11,7,True
9124304,108,2,-1,8171,172741405,0,1,0,149.0,4,235975.13,3,1,5,9,True
9137757,688,0,20,1410,172741405,0,0,0,149.05,5,235826.08,24,3,20,9,True
9403048,1421,0,25,8171,172741405,0,0,0,149.09,8,235676.99,24,4,21,9,True
9512441,446,1,10,1968,172741405,0,0,0,148.87,0,235825.86,13,4,20,10,True
9662472,464,1,25,7032,172741405,0,0,0,149.03,8,235676.83,13,3,1,10,True
9836701,1391,2,20,2387,172741405,0,0,0,148.87,5,235527.96,24,6,0,11,True
1024797,1486,2,20,7117,472498628,1,0,0,883.97,3,523829.03,24,6,13,1,True
1382512,1361,2,-1,5205,472498628,1,1,0,883.92,4,523829.03,16,4,10,1,True
1451708,1305,2,451,3341,472498628,1,0,0,884.2,7,522944.83,5,2,17,1,True
1495675,378,0,10,2753,472498628,1,0,0,884.14,0,523828.97,25,4,23,1,True
1756933,1315,0,10,2040,472498628,1,0,0,883.8,6,524712.77,5,6,3,1,False
2126997,208,0,451,7607,472498628,1,0,0,883.97,7,523828.8,9,5,16,3,True
2184668,1361,2,451,9955,472498628,1,0,0,884.01,7,522944.79,16,2,19,3,True
2244885,208,0,25,8634,472498628,1,0,0,884.17,8,522060.62,9,3,23,4,True
2446674,1247,0,20,4084,472498628,1,0,0,884.18,3,521176.44,23,2,6,4,True
2684157,208,0,-1,5909,472498628,1,1,0,884.06,1,521176.44,9,5,0,7,True
2979487,1305,2,25,2756,472498628,1,0,0,883.82,8,520292.62,5,1,4,8,True
2987605,1305,2,451,2756,472498628,1,0,0,884.02,7,519408.6,5,1,10,8,True
3073479,1150,0,20,4473,472498628,1,0,0,884.12,3,518524.48,15,2,10,8,True
3093936,1177,4,30,9138,472498628,1,0,0,883.65,8,517640.83,24,2,14,8,True
3386448,1476,0,20,7117,472498628,1,0,0,884.33,5,516756.5,24,3,5,9,True
3529554,204,0,10,8634,472498628,1,0,0,884.03,6,517640.53,9,4,22,9,True
3707582,1017,2,20,4470,472498628,1,0,0,884.12,5,516756.41,26,0,20,9,True
4056339,1361,2,30,1613,472498628,1,0,0,884.01,8,515872.4,16,1,8,10,True
4091131,208,0,30,6196,472498628,1,0,0,884.42,8,514987.98,9,1,11,10,True
4097935,1214,4,30,7882,472498628,1,0,0,884.0,8,514103.98,24,6,14,11,True
4322225,1159,0,10,1496,472498628,1,0,0,884.16,0,514988.14,15,2,20,12,True
4427554,1214,4,451,7882,472498628,1,0,0,883.91,7,514104.23,24,6,5,1,True
4441085,1183,4,30,7688,472498628,1,0,0,884.05,8,513220.18,24,5,18,2,True
4559293,1364,0,20,4473,472498628,1,0,0,884.19,3,512335.99,16,6,14,2,True
4617200,1177,4,-1,1467,472498628,1,1,0,884.19,1,512335.99,24,4,9,4,True
4650185,1214,4,25,9138,472498628,1,0,0,883.97,8,511452.02,24,2,19,4,True
4706420,1305,2,-1,5190,472498628,1,1,0,884.02,4,511452.02,5,6,13,6,False
4727896,1183,4,25,7622,472498628,1,0,0,883.98,8,510568.04,24,2,3,8,True
4780849,1250,1,10,7882,472498628,1,0,0,883.95,0,511451.99,23,5,16,8,True
4822605,424,1,10,9955,472498628,1,0,0,884.17,0,512336.16,18,3,5,8,True
4873572,1214,4,30,9138,472498628,1,0,0,884.02,8,511452.14,24,5,4,8,True
5009090,503,0,20,4473,472498628,1,0,0,883.98,3,510568.16,12,2,15,9,True
5488037,1036,1,-1,8708,472498628,1,1,0,884.17,4,510568.16,11,0,1,10,True
5635806,1177,4,451,9138,472498628,1,0,0,884.01,7,509684.15,24,6,13,11,True
6075183,1183,4,-1,5909,472498628,1,1,0,883.95,4,509684.15,24,4,0,12,True
6076543,208,0,25,9012,472498628,1,0,0,883.89,8,508800.26,9,5,8,12,True
6215744,1214,4,25,7117,472498628,1,0,0,884.03,8,507916.23,24,3,2,12,True
6568850,1036,1,451,9071,472498628,1,0,0,883.94,7,507032.29,11,0,14,12,True
6765346,616,1,10,4404,472498628,1,0,0,883.84,6,507916.13,11,3,1,1,True
6797220,219,0,10,1613,472498628,1,0,0,883.78,6,508799.91,9,0,7,1,True
6830536,1305,2,-1,3637,472498628,1,1,0,883.92,4,508799.91,5,2,6,1,True
6912840,1214,4,25,3341,472498628,1,0,0,884.18,8,507915.73,24,2,10,3,True
7156534,1361,2,30,3723,472498628,1,0,0,883.87,8,507031.86,16,5,21,3,True
7213361,1214,4,451,3723,472498628,1,0,0,883.91,7,506147.95,24,2,15,3,True
7214832,219,0,20,1496,472498628,1,0,0,883.96,5,505263.99,9,2,18,4,True
7731010,1183,4,-1,9071,472498628,1,1,0,883.95,4,505263.99,24,5,20,4,True
7806203,1177,4,25,9955,472498628,1,0,0,884.22,8,504379.77,24,5,15,5,True
7810929,1305,2,30,8650,472498628,1,0,0,884.04,8,503495.73,5,0,23,5,True
7990323,1214,4,-1,5190,472498628,1,1,0,884.02,4,503495.73,24,0,22,6,True
8449993,1183,4,25,6196,472498628,1,0,0,884.22,8,502611.51,24,0,17,7,True
8934397,1361,2,30,3341,472498628,1,0,0,883.98,8,501727.53,16,2,17,7,True
9009558,1214,4,451,2040,472498628,1,0,0,884.11,7,500843.42,24,4,16,8,True
9016807,1183,4,-1,5909,472498628,1,1,0,884.24,4,500843.42,24,0,18,9,True
9065173,1305,2,-1,1467,472498628,1,2,0,883.68,1,500843.42,5,2,9,10,True
9131687,1305,2,451,3902,472498628,1,0,0,884.16,7,499959.26,5,2,19,10,True
9616870,1036,1,30,9138,472498628,1,0,0,884.27,8,499074.99,11,4,17,11,True
1153510,444,2,451,5091,748801252,0,0,0,765.18,7,622054.82,24,6,18,1,True
1364791,457,0,25,1781,748801252,0,0,0,765.35,8,621289.47,13,2,3,1,True
1426759,1380,0,-1,5758,748801252,0,1,0,765.0,4,621289.47,16,6,3,1,True
1477528,679,0,451,4138,748801252,0,0,0,765.01,7,620524.46,24,5,3,2,True
1708745,679,0,25,9506,748801252,0,0,0,764.93,8,619759.53,24,1,6,3,True
1888906,457,0,451,9590,748801252,0,0,0,765.01,7,618994.52,13,0,21,4,True
1926486,1128,2,20,8756,748801252,0,0,0,764.9,5,618229.62,24,3,8,4,True
2042442,741,3,-1,9605,748801252,0,1,0,764.97,4,618229.62,24,3,9,4,True
2088038,679,0,25,9606,748801252,0,0,0,764.93,8,617464.69,24,1,6,5,True
2099488,999,4,451,5160,748801252,0,0,0,764.93,7,616699.76,26,4,4,7,True
2335675,1063,0,20,7112,748801252,0,0,0,765.2,5,615934.56,11,4,22,7,True
2730955,394,0,451,1607,748801252,0,0,0,765.1,7,615169.46,10,4,16,7,True
2935527,1119,0,20,8621,748801252,0,0,0,765.26,3,614404.2,24,0,5,8,True
2936693,759,0,20,9067,748801252,0,0,0,764.94,5,613639.26,24,4,2,8,True
3207245,999,4,25,9590,748801252,0,0,0,764.97,8,612874.29,26,3,18,9,True
3288847,1380,0,30,5160,748801252,0,0,0,765.01,8,612109.28,16,3,19,10,True
3402939,741,3,25,2494,748801252,0,0,0,764.94,8,611344.34,24,4,0,11,True
3594861,1210,0,20,7547,748801252,0,0,0,764.97,5,610579.37,24,3,14,12,True
3637947,394,0,451,7958,748801252,0,0,0,764.87,7,609814.5,10,2,7,2,False
3947602,999,4,451,9529,748801252,0,0,0,764.96,7,609049.54,26,3,12,2,True
4197255,183,1,10,9729,748801252,0,0,0,765.1,6,609814.64,18,3,4,3,True
4224273,1380,0,451,4560,748801252,0,0,0,765.12,7,609049.52,16,0,12,4,True
4549725,394,0,451,6547,748801252,0,0,0,765.18,7,608284.34,10,5,20,4,True
4627879,858,1,10,4138,748801252,0,0,0,764.86,0,609049.2,24,3,2,6,True
5714331,198,0,10,8621,748801252,0,0,0,765.04,6,609814.24,18,5,10,6,True
6116011,999,4,-1,1265,748801252,0,1,0,765.11,4,609814.24,26,2,20,7,True
6126296,741,3,25,7547,748801252,0,0,0,765.3,8,609048.94,24,4,2,7,True
6158479,679,0,-1,7958,748801252,0,1,0,765.03,1,609048.94,24,4,13,7,True
6341554,457,0,30,4138,748801252,0,0,0,764.94,8,608284.0,13,4,8,8,True
6341985,348,0,20,9729,748801252,0,0,0,764.95,5,607519.05,24,6,12,9,True
6430153,999,4,451,8621,748801252,0,0,0,765.09,7,606753.96,26,5,6,9,True
6510054,457,0,25,9606,748801252,0,0,0,764.75,8,605989.21,13,1,10,12,True
6630132,1380,0,25,9761,748801252,0,0,0,764.81,8,605224.4,16,4,10,12,True
6769146,741,3,30,4824,748801252,0,0,0,764.95,8,604459.45,24,2,17,12,True
7204991,394,0,25,9529,748801252,0,0,0,764.86,8,603694.59,10,6,18,12,True
7229063,444,2,30,1781,748801252,0,0,0,764.9,8,602929.69,24,5,19,2,True
7670068,394,0,30,4138,748801252,0,0,0,764.99,8,602164.7,10,4,17,3,True
7680731,951,0,20,4560,748801252,0,0,0,765.03,5,601399.67,24,0,19,3,True
7817054,403,0,20,9590,748801252,0,0,0,765.09,5,600634.58,10,0,11,6,True
7957586,457,0,25,8756,748801252,0,0,0,765.24,8,599869.34,13,5,15,6,True
8237461,444,2,451,5758,748801252,0,0,0,765.04,7,599104.3,24,5,4,6,True
8545500,1485,0,20,4091,748801252,0,0,0,765.2,5,598339.1,24,6,0,6,True
8559321,369,1,10,5091,748801252,0,0,0,765.2,6,599104.3,25,4,13,7,True
8598947,394,0,451,7112,748801252,0,0,0,764.89,7,598339.41,10,0,23,8,True
8747606,741,3,30,6547,748801252,0,0,0,765.12,8,597574.29,24,0,7,8,True
8888075,999,4,25,7547,748801252,0,0,0,765.26,8,596809.03,26,1,15,9,True
8991277,679,0,25,8621,748801252,0,0,0,764.92,8,596044.11,24,0,0,9,True
9510437,444,2,451,7958,748801252,0,0,0,765.23,7,595278.88,24,1,5,9,True
9675549,457,0,451,5160,748801252,0,0,0,764.88,7,594514.0,13,0,21,10,True
9922293,999,4,451,9501,748801252,0,0,0,765.06,7,593748.94,26,6,7,11,True
1043339,882,0,25,8752,402579063,0,0,0,251.97,8,130220.03,27,5,23,2,True
1066690,818,1,10,8393,402579063,0,0,0,252.07,6,130472.1,18,2,3,3,True
1185987,1119,0,10,8026,402579063,0,0,0,251.86,6,130723.96,24,3,6,3,True
1271451,1246,0,451,9126,402579063,0,0,0,252.07,7,130471.89,23,6,18,4,True
1317770,1406,0,30,9377,402579063,0,0,0,252.07,8,130219.82,24,6,17,4,True
1556013,1406,0,25,5243,402579063,0,0,0,251.94,8,129967.88,24,4,3,5,True
1649964,1246,0,-1,2686,402579063,0,1,0,252.01,4,129967.88,23,4,20,5,True
1825851,1260,0,30,4718,402579063,0,0,0,252.15,8,129715.73,23,0,5,5,True
1907230,882,0,25,9377,402579063,0,0,0,251.94,8,129463.79,27,6,13,6,True
2829976,882,0,451,3125,402579063,0,0,0,252.07,7,129211.72,27,0,8,7,True
3050995,882,0,451,9377,402579063,0,0,0,251.95,7,128959.77,27,0,1,8,True
3132368,1260,0,-1,9126,402579063,0,1,0,251.91,4,128959.77,23,3,23,8,True
3205127,882,0,30,2686,402579063,0,0,0,252.11,8,128707.66,27,5,12,8,True
3566799,653,1,10,4210,402579063,0,0,0,252.04,6,128959.7,24,2,4,9,True
3687442,1246,0,-1,2931,402579063,0,1,0,252.11,4,128959.7,23,2,15,9,True
3758348,882,0,451,5243,402579063,0,0,0,252.17,7,128707.53,27,1,13,9,True
3798581,303,0,10,2686,402579063,0,0,0,252.05,6,128959.58,4,1,5,10,True
3808015,1406,0,30,8026,402579063,0,0,0,251.81,8,128707.77,24,2,23,10,True
4077290,1363,0,20,8393,402579063,0,0,0,252.08,5,128455.69,16,2,15,11,True
4291009,1246,0,451,2931,402579063,0,0,0,251.93,7,128203.76,23,2,23,11,True
4615245,1406,0,451,8071,402579063,0,0,0,252.03,7,127951.73,24,6,12,11,False
4653579,1260,0,-1,8071,402579063,0,1,0,252.08,1,127951.73,23,4,13,2,True
4797991,1260,0,25,9960,402579063,0,0,0,252.0,8,127699.73,23,0,18,2,True
5178072,823,4,451,3459,402579063,0,0,0,251.67,7,127448.06,18,1,18,3,True
5190825,81,0,10,4182,402579063,0,0,0,251.94,0,127700.0,1,6,22,4,True
5402388,1246,0,25,3859,402579063,0,0,0,252.06,8,127447.94,23,5,0,5,True
5891940,645,0,20,8071,402579063,0,0,0,252.05,5,127195.89,24,5,14,5,False
6333382,20,0,10,2931,402579063,0,0,0,252.02,6,127447.91,24,0,13,7,True
6723744,267,0,20,8530,402579063,0,0,0,252.44,3,127195.47,6,2,4,7,True
6978575,882,0,451,8026,402579063,0,0,0,252.1,7,126943.37,27,5,4,8,True
7063652,218,0,20,5542,402579063,0,0,0,251.95,5,126691.42,9,0,19,8,True
7077950,1406,0,30,8026,402579063,0,0,0,252.01,8,126439.41,24,5,7,9,True
7129075,511,1,10,7668,402579063,0,0,0,252.08,0,126691.49,12,2,10,9,True
7146338,1212,0,10,8071,402579063,0,0,0,252.03,6,126943.52,24,3,17,9,True
7335642,882,0,30,4210,402579063,0,0,0,252.06,8,126691.46,27,6,20,9,True
7402053,1406,0,25,4210,402579063,0,0,0,252.05,8,126439.41,24,0,11,9,True
7406514,1246,0,451,7200,402579063,0,0,0,251.94,7,126187.47,23,2,21,10,True
7463229,1260,0,451,4902,402579063,0,0,0,252.05,7,125935.42,23,2,3,10,True
7489175,459,1,10,8026,402579063,0,0,0,252.2,0,126187.62,13,0,2,11,False
7495899,823,4,30,8026,402579063,0,0,0,252.11,8,125935.51,18,3,23,11,True
7726885,1260,0,-1,3333,402579063,0,1,0,251.89,1,125935.51,23,6,9,1,True
7857417,807,0,20,4210,402579063,0,0,0,251.96,5,125683.55,11,3,21,2,True
7881121,1406,0,30,7668,402579063,0,0,0,252.23,8,125431.32,24,6,6,2,True
7906759,1246,0,-1,2931,402579063,0,1,0,252.0,4,125431.32,23,5,8,3,True
8008354,1260,0,-1,2686,402579063,0,2,0,251.96,1,125431.32,23,4,19,3,True
8326807,350,0,10,7200,402579063,0,0,0,251.71,6,125683.03,24,6,22,4,True
8331049,1246,0,451,7668,402579063,0,0,0,251.95,7,125431.08,23,2,11,4,True
8730094,800,0,10,2931,402579063,0,0,0,251.9,6,125682.98,11,5,19,5,True
8771503,1260,0,30,2931,402579063,0,0,0,251.97,8,125431.01,23,1,16,5,True
8841304,1406,0,30,7200,402579063,0,0,0,252.08,8,125178.93,24,2,4,6,True
9307776,882,0,30,2686,402579063,0,0,0,252.05,8,124926.88,27,2,13,7,True
9347663,1246,0,451,3125,402579063,0,0,0,251.79,7,124675.09,23,4,3,10,True
9596680,882,0,451,8071,402579063,0,0,0,252.09,7,124423.0,27,6,15,10,True
9617810,882,0,-1,8026,402579063,0,1,0,252.16,4,124423.0,27,6,18,10,True
9799990,304,0,20,7668,402579063,0,0,0,252.17,5,124170.83,4,5,3,10,True
9918356,628,0,10,4182,402579063,0,0,0,251.7,6,124422.53,11,3,0,11,True
1485129,697,3,-1,2739,149172592,1,1,0,755.03,1,324920.0,24,3,20,1,True
1498498,130,0,30,8738,149172592,1,0,0,755.11,8,324164.89,18,2,2,1,True
1872299,869,2,20,3267,149172592,1,0,0,754.9,5,323409.99,24,4,22,1,True
1899123,1341,4,25,7105,149172592,1,0,0,754.79,8,322655.2,24,6,22,1,True
2215524,49,3,-1,7208,149172592,1,1,0,754.95,4,322655.2,20,1,15,2,True
2261875,1387,1,451,6898,149172592,1,0,0,755.0,7,321900.2,24,2,21,2,True
2950826,1468,1,10,7208,149172592,1,0,0,755.01,0,322655.21,11,0,1,3,True
3030376,49,3,25,8493,149172592,1,0,0,754.95,8,321900.26,20,4,9,4,True
3364931,727,0,20,2739,149172592,1,0,0,755.02,5,321145.24,11,5,21,4,True
3565812,35,2,20,3887,149172592,1,0,0,755.05,5,320390.19,11,1,23,5,True
3581111,1284,2,20,2035,149172592,1,0,0,754.95,5,319635.24,24,0,15,5,True
3706208,1387,1,30,5686,149172592,1,0,0,755.0,8,318880.24,24,1,6,5,True
3735170,49,3,451,1084,149172592,1,0,0,754.82,7,318125.42,20,2,21,6,True
3771896,1122,1,10,8715,149172592,1,0,0,755.09,6,318880.51,24,4,12,6,True
3778590,343,1,451,2012,149172592,1,0,0,755.08,7,318125.43,24,5,12,7,True
4004827,1341,4,30,8052,149172592,1,0,0,754.88,8,317370.55,24,0,9,7,True
4105665,130,0,-1,8493,149172592,1,1,0,755.13,4,317370.55,18,0,12,7,True
4278701,130,0,25,9661,149172592,1,0,0,755.08,8,316615.47,18,5,5,7,False
4447121,1316,3,451,2035,149172592,1,0,0,754.95,7,315860.52,5,4,13,8,True
4451884,49,3,451,2012,149172592,1,0,0,754.95,7,315105.57,20,5,1,8,True
4779276,1341,4,30,8715,149172592,1,0,0,755.14,8,314350.43,24,4,18,9,False
5005566,343,1,451,5986,149172592,1,0,0,755.14,7,313595.29,24,1,10,10,True
5021387,697,3,30,2383,149172592,1,0,0,755.17,8,312840.12,24,0,20,2,True
5025134,1341,4,451,7208,149172592,1,0,0,754.89,7,312085.23,24,2,12,3,True
5359620,942,0,20,9661,149172592,1,0,0,754.82,3,311330.41,24,3,15,4,True
5510862,49,3,25,7208,149172592,1,0,0,755.1,8,310575.31,20,2,20,5,True
5523231,697,3,30,7105,149172592,1,0,0,755.11,8,309820.2,24,5,5,7,True
5665746,1341,4,30,7608,149172592,1,0,0,755.11,8,309065.09,24,6,16,7,True
5772016,130,0,30,1378,149172592,1,0,0,754.9,8,308310.19,18,2,11,8,True
6019552,350,0,10,2739,149172592,1,0,0,754.98,0,309065.17,24,2,20,8,True
6290356,130,0,30,8493,149172592,1,0,0,755.1,8,308310.07,18,3,13,8,True
6465800,228,0,20,2012,149172592,1,0,0,755.11,5,307554.96,26,0,1,9,True
6630660,378,0,20,8052,149172592,1,0,0,755.0,3,306799.96,25,1,15,10,True
6756998,130,0,25,1378,149172592,1,0,0,755.28,8,306044.68,18,0,23,11,True
7495875,697,3,30,5686,149172592,1,0,0,755.07,8,305289.61,24,0,9,12,True
7657276,49,3,30,9661,149172592,1,0,0,755.1,8,304534.51,20,6,5,12,True
7699552,343,1,-1,6898,149172592,1,1,0,754.59,4,304534.51,24,0,13,1,True
7706471,223,2,20,2012,149172592,1,0,0,755.03,5,303779.48,26,3,13,1,True
7810258,1425,0,10,2035,149172592,1,0,0,754.74,0,304534.22,24,2,21,2,True
7946870,1037,0,10,5071,149172592,1,0,0,755.12,6,305289.34,11,6,6,4,True
7951757,1341,4,451,8052,149172592,1,0,0,755.06,7,304534.28,24,5,21,4,True
7979165,1341,4,30,1084,149172592,1,0,0,755.11,8,303779.17,24,2,13,5,True
8071925,1419,1,10,6902,149172592,1,0,0,755.04,6,304534.21,24,2,14,6,True
8198150,1387,1,451,2035,149172592,1,0,0,755.13,7,303779.08,24,2,16,7,True
8292320,49,3,451,7105,149172592,1,0,0,755.03,7,303024.05,20,2,19,7,True
8343367,531,0,20,2383,149172592,1,0,0,755.22,5,302268.83,18,6,4,7,False
8758941,130,0,451,9661,149172592,1,0,0,754.8,7,301514.03,18,1,18,8,True
9115952,1387,1,25,8715,149172592,1,0,0,754.97,8,300759.06,24,1,20,8,True
9118085,1170,0,10,8715,149172592,1,0,0,754.88,6,301513.94,24,5,16,9,True
9213771,130,0,451,7105,149172592,1,0,0,755.18,7,300758.76,18,1,4,10,True
9259810,130,0,451,7608,149172592,1,0,0,754.95,7,300003.81,18,0,20,11,True
9512053,343,1,25,5686,149172592,1,0,0,755.27,8,299248.54,24,2,16,11,True
1098838,765,4,30,6187,646547518,0,0,0,274.05,8,710983.95,14,5,19,1,True
1209374,1212,0,10,8713,646547518,0,0,0,273.96,0,711257.91,24,2,11,1,True
1368039,1241,3,30,8994,646547518,0,0,0,273.82,8,710984.09,18,3,10,3,True
1385542,765,4,451,8610,646547518,0,0,0,274.02,7,710710.07,14,4,5,4,True
1569980,1298,0,30,9895,646547518,0,0,0,273.97,8,710436.1,5,3,1,4,True
1838476,1298,0,-1,4425,646547518,0,1,0,273.95,1,710436.1,5,3,5,4,True
1902246,765,4,25,8041,646547518,0,0,0,274.06,8,710162.04,14,5,16,4,True
1996410,1241,3,25,7076,646547518,0,0,0,273.92,8,709888.12,18,3,0,5,True
2265704,950,0,20,8994,646547518,0,0,0,273.8,5,709614.32,24,6,8,5,True
2394887,496,1,451,5252,646547518,0,0,0,274.06,7,709340.26,12,0,22,6,True
2570560,825,2,20,5510,646547518,0,0,0,273.93,5,709066.33,18,2,18,7,True
2608475,1141,4,25,5530,646547518,0,0,0,274.0,8,708792.33,15,2,9,7,True
2612425,1363,0,10,1487,646547518,0,0,0,274.22,6,709066.55,16,2,18,9,True
2664520,276,0,20,8610,646547518,0,0,0,274.1,5,708792.45,24,4,21,9,True
2758465,1241,3,-1,5735,646547518,0,1,0,274.06,4,708792.45,18,5,5,11,True
3013094,734,0,10,3377,646547518,0,0,0,274.02,0,709066.47,11,3,0,12,True
3072901,457,0,20,8439,646547518,0,0,0,274.17,5,708792.3,13,1,17,1,True
3202161,1411,0,20,1487,646547518,0,0,0,274.2,5,708518.1,24,6,14,1,True
3213264,1141,4,25,8610,646547518,0,0,0,273.99,8,708244.11,15,3,23,3,True
3412811,1241,3,25,8439,646547518,0,0,0,273.97,8,707970.14,18,1,22,3,True
3582087,1141,4,25,4779,646547518,0,0,0,274.18,8,707695.96,15,0,13,3,True
3596452,995,1,10,5735,646547518,0,0,0,273.77,6,707969.73,22,2,2,4,True
3661708,496,1,30,8439,646547518,0,0,0,273.94,8,707695.79,12,3,5,4,True
3750320,1241,3,30,1487,646547518,0,0,0,273.86,8,707421.93,18,6,8,4,True
4469267,945,1,10,1163,646547518,0,0,0,274.0,6,707695.93,24,5,19,5,True
4545560,1390,0,20,8713,646547518,0,0,0,273.98,5,707421.95,24,2,0,5,True
4785894,1241,3,451,5252,646547518,0,0,0,273.87,7,707148.08,18,4,0,5,True
4861039,865,0,10,5530,646547518,0,0,0,273.67,0,707421.75,24,1,11,5,True
4935749,765,4,30,8610,646547518,0,0,0,274.03,8,707147.72,14,4,22,6,True
5010658,1241,3,451,4289,646547518,0,0,0,274.09,7,706873.63,18,3,16,6,True
5591611,765,4,-1,8041,646547518,0,1,0,273.93,1,706873.63,14,6,18,6,True
5731885,1241,3,451,6902,646547518,0,0,0,274.09,7,706599.54,18,6,17,7,True
5917840,335,4,25,5510,646547518,0,0,0,274.12,8,706325.42,11,5,23,8,True
6013576,1241,3,451,5252,646547518,0,0,0,274.01,7,706051.41,18,4,1,9,True
6378525,557,1,10,1830,646547518,0,0,0,274.08,0,706325.49,17,0,21,10,True
6414509,335,4,451,6908,646547518,0,0,0,273.88,7,706051.61,11,0,15,10,True
6521336,1241,3,25,4261,646547518,0,0,0,274.0,8,705777.61,18,6,5,12,True
6581568,765,4,25,8610,646547518,0,0,0,273.82,8,705503.79,14,3,21,1,True
6885402,496,1,25,3470,646547518,0,0,0,274.04,8,705229.75,12,0,0,1,True
7426701,126,1,10,8994,646547518,0,0,0,273.92,6,705503.67,18,0,18,1,True
7470227,765,4,451,1830,646547518,0,0,0,274.05,7,705229.62,14,2,19,2,True
7626434,485,1,10,1487,646547518,0,0,0,273.84,0,705503.46,5,3,10,3,True
7851373,727,0,10,5735,646547518,0,0,0,274.25,6,705777.71,11,0,0,5,True
8993128,335,4,451,3470,646547518,0,0,0,274.03,7,705503.68,11,6,12,7,True
9209180,1241,3,451,5510,646547518,0,0,0,273.75,7,705229.93,18,5,16,7,True
9234332,335,4,-1,8439,646547518,0,1,0,273.93,1,705229.93,11,1,16,7,True
9250377,335,4,30,5735,646547518,0,0,0,273.82,8,704956.11,11,4,14,8,True
9276693,335,4,30,3377,646547518,0,0,0,274.05,8,704682.06,11,2,16,9,True
9299240,457,0,20,1830,646547518,0,0,0,274.25,5,704407.81,13,3,3,9,True
9416107,1298,0,-1,5530,646547518,0,1,0,273.59,1,704407.81,5,2,13,10,True
1143056,1224,4,30,7081,790362642,1,0,0,679.1,8,715271.9,24,5,2,1,True
1250686,1028,4,30,2389,790362642,1,0,0,679.0,8,714592.9,11,6,20,1,True
1274539,34,1,30,9319,790362642,1,0,0,678.88,8,713914.02,11,6,13,2,True
1340745,108,2,25,5520,790362642,1,0,0,678.98,8,713235.04,3,0,10,2,True
1444332,1023,2,20,3996,790362642,1,0,0,678.96,3,712556.08,11,2,4,3,True
1993802,1224,4,451,2800,790362642,1,0,0,679.29,7,711876.79,24,0,23,3,True
2878333,1028,4,25,2389,790362642,1,0,0,678.79,8,711198.0,11,5,10,4,True
3041528,1436,0,10,4055,790362642,1,0,0,679.26,0,711877.26,24,2,15,4,True
3464537,1061,2,20,7351,790362642,1,0,0,679.18,5,711198.08,11,6,18,5,True
3491075,1283,2,25,5411,790362642,1,0,0,679.41,8,710518.67,24,5,0,5,True
3565630,630,0,20,1198,790362642,1,0,0,678.96,5,709839.71,11,5,18,6,True
3622670,34,1,451,8569,790362642,1,0,0,679.08,7,709160.63,11,4,12,6,True
3743433,1224,4,451,2332,790362642,1,0,0,678.91,7,708481.72,24,2,5,6,True
3990038,631,3,-1,4055,790362642,1,1,0,679.08,1,708481.72,11,1,6,7,True
4017185,198,0,10,7100,790362642,1,0,0,679.05,6,709160.77,18,5,23,8,True
4170523,1195,1,10,3996,790362642,1,0,0,678.97,6,709839.74,24,2,6,8,True
4215137,1283,2,25,1408,790362642,1,0,0,679.03,8,709160.71,24,6,19,10,True
4227115,1093,0,20,7351,790362642,1,0,0,679.18,3,708481.53,18,4,2,10,True
4227466,1283,2,-1,1408,790362642,1,1,0,678.88,1,708481.53,24,0,4,10,True
4355827,1224,4,30,1198,790362642,1,0,0,678.86,8,707802.67,24,0,20,10,True
4640294,327,0,20,6627,790362642,1,0,0,679.16,5,707123.51,11,5,0,11,True
4802138,145,0,20,1198,790362642,1,0,0,679.23,5,706444.28,18,5,10,11,False
5100368,1140,0,20,1401,790362642,1,0,0,679.01,3,705765.27,15,4,8,11,True
5263754,1283,2,451,6627,790362642,1,0,0,679.09,7,705086.18,24,6,14,11,True
5484593,34,1,-1,4055,790362642,1,1,0,678.97,1,705086.18,11,3,22,1,True
5527610,366,0,20,6627,790362642,1,0,0,678.93,5,704407.25,25,2,7,2,True
5652330,1283,2,451,4055,790362642,1,0,0,679.11,7,703728.14,24,4,13,2,True
5750578,457,0,10,9319,790362642,1,0,0,678.93,6,704407.07,13,3,1,5,False
5843128,1224,4,25,1401,790362642,1,0,0,678.98,8,703728.09,24,5,4,5,True
5865133,34,1,25,5411,790362642,1,0,0,679.17,8,703048.92,11,1,15,6,True
6121977,34,1,-1,2875,790362642,1,1,0,678.89,1,703048.92,11,2,15,7,True
6652128,869,2,20,3996,790362642,1,0,0,679.12,3,702369.8,24,3,14,7,True
6779891,1283,2,-1,3708,790362642,1,1,0,678.93,4,702369.8,24,0,13,8,False
6785052,696,2,20,4474,790362642,1,0,0,678.84,5,701690.96,24,4,21,9,True
6852273,1283,2,25,9319,790362642,1,0,0,678.91,8,701012.05,24,5,1,9,False
7112866,108,2,30,7728,790362642,1,0,0,678.98,8,700333.07,3,3,2,11,True
7235746,1283,2,30,5411,790362642,1,0,0,679.21,8,699653.86,24,6,14,11,True
7254606,1224,4,25,8569,790362642,1,0,0,678.95,8,698974.91,24,0,8,12,False
7408683,34,1,30,7081,790362642,1,0,0,679.12,8,698295.79,11,1,22,12,True
7513751,1028,4,-1,9319,790362642,1,1,0,679.13,4,698295.79,11,4,15,1,True
7571465,1283,2,451,7728,790362642,1,0,0,679.06,7,697616.73,24,5,0,2,True
7662047,34,1,25,7081,790362642,1,0,0,678.96,8,696937.77,11,4,8,4,True
7731005,1224,4,451,2875,790362642,1,0,0,679.13,7,696258.64,24,5,11,4,True
7863520,1461,0,20,4055,790362642,1,0,0,678.91,5,695579.73,11,0,17,5,True
8069861,34,1,451,5520,790362642,1,0,0,678.92,7,694900.81,11,3,12,5,True
8137527,108,2,25,6627,790362642,1,0,0,679.28,8,694221.53,3,2,19,6,True
8144661,631,3,-1,7081,790362642,1,1,0,678.71,4,694221.53,11,3,22,6,True
8585919,1377,0,10,1198,790362642,1,0,0,678.94,0,694900.47,16,4,8,6,True
8892833,713,0,10,2332,790362642,1,0,0,679.14,0,695579.61,18,1,3,6,True
9189331,108,2,20,2875,790362642,1,0,0,679.04,5,694900.57,3,0,11,7,True
9278815,1224,4,30,3891,790362642,1,0,0,678.99,8,694221.58,24,4,7,7,True
9466541,68,0,10,1408,790362642,1,0,0,679.04,6,694900.62,20,2,17,8,True
9473125,71,1,10,3996,790362642,1,0,0,679.02,6,695579.64,20,2,19,8,True
9576021,631,3,25,1198,790362642,1,0,0,679.2,8,694900.44,11,3,15,9,True
9777073,108,2,451,7100,790362642,1,0,0,678.95,7,694221.49,3,1,10,9,True
9800043,34,1,25,2875,790362642,1,0,0,678.99,8,693542.5,11,1,19,10,True
9873339,81,0,20,8569,790362642,1,0,0,679.11,5,692863.39,1,0,0,11,True
9910072,1283,2,-1,7081,790362642,1,1,0,679.19,4,692863.39,24,4,17,11,True
1474274,1408,1,10,6793,429080525,0,0,0,457.06,0,798351.06,24,5,5,1,True
1515716,1450,4,30,3441,429080525,0,0,0,456.86,8,797894.2,11,5,21,1,True
1664138,1480,4,-1,8123,429080525,0,1,0,456.89,4,797894.2,24,6,23,1,True
1794422,1480,4,30,8007,429080525,0,0,0,456.95,8,797437.25,24,5,0,1,True
1827754,350,0,25,3628,429080525,0,0,0,457.11,8,796980.14,24,5,1,2,True
1906203,1450,4,25,2816,429080525,0,0,0,457.05,8,796523.09,11,6,16,2,True
1938248,203,0,451,7805,429080525,0,0,0,457.04,7,796066.05,9,1,6,2,True
2236157,1450,4,30,5404,429080525,0,0,0,457.06,8,795608.99,11,1,23,2,True
2244187,23,0,10,4453,429080525,0,0,0,456.96,6,796065.95,11,2,21,2,True
2264556,1480,4,-1,1960,429080525,0,1,0,456.99,4,796065.95,24,5,6,3,True
2293052,350,0,30,1960,429080525,0,0,0,457.05,8,795608.9,24,4,13,3,True
2423703,203,0,25,4128,429080525,0,0,0,457.02,8,795151.88,9,1,0,4,True
2770693,1450,4,451,6787,429080525,0,0,0,456.75,7,794695.13,11,2,6,4,True
2828383,1380,0,20,3628,429080525,0,0,0,457.14,5,794237.99,16,6,14,5,False
3089591,350,0,451,2679,429080525,0,0,0,456.96,7,793781.03,24,2,6,6,True
3145793,942,0,10,4398,429080525,0,0,0,457.07,0,794238.1,24,1,8,7,True
3531141,726,0,20,8007,429080525,0,0,0,456.92,5,793781.18,11,3,17,7,True
3970945,576,2,30,8123,429080525,0,0,0,456.86,8,793324.32,11,1,11,7,True
4809501,203,0,30,1960,429080525,0,0,0,456.96,8,792867.36,9,2,12,7,True
4930989,800,0,20,9664,429080525,0,0,0,457.22,5,792410.14,11,4,4,7,True
5289219,1480,4,30,2816,429080525,0,0,0,457.39,8,791952.75,24,0,5,8,False
5293485,1450,4,451,3441,429080525,0,0,0,456.88,7,791495.87,11,0,15,8,True
5409664,576,2,25,8007,429080525,0,0,0,457.12,8,791038.75,11,4,19,9,True
5439665,634,1,10,3441,429080525,0,0,0,457.14,6,791495.89,24,0,18,9,True
5612074,1446,1,10,9664,429080525,0,0,0,456.93,0,791952.82,24,1,5,10,True
5748337,584,0,20,3441,429080525,0,0,0,456.95,5,791495.87,11,1,5,10,True
5784163,576,2,451,2679,429080525,0,0,0,457.08,7,791038.79,11,5,8,10,False
5904291,576,2,451,9664,429080525,0,0,0,456.75,7,790582.04,11,5,1,11,False
6041832,1480,4,-1,2816,429080525,0,1,0,457.03,4,790582.04,24,4,17,12,True
6308169,350,0,25,3628,429080525,0,0,0,456.92,8,790125.12,24,5,20,12,True
6665494,641,0,20,6787,429080525,0,0,0,456.95,5,789668.17,24,4,8,2,True
6712970,576,2,25,4128,429080525,0,0,0,457.0,8,789211.17,11,6,13,2,True
6723926,599,0,10,3441,429080525,0,0,0,456.91,6,789668.08,24,6,11,4,True
6786231,203,0,30,3129,429080525,0,0,0,456.98,8,789211.1,9,3,15,8,True
6828598,576,2,25,7805,429080525,0,0,0,456.98,8,788754.12,11,1,14,9,True
6857363,1450,4,-1,3129,429080525,0,1,0,457.1,4,788754.12,11,2,11,9,True
6941454,350,0,451,4453,429080525,0,0,0,457.02,7,788297.1,24,4,4,11,True
6986015,1480,4,25,3129,429080525,0,0,0,456.98,8,787840.12,24,6,19,12,True
7106526,350,0,-1,1960,429080525,0,1,0,457.18,4,787840.12,24,6,14,12,True
7486038,1480,4,-1,4453,429080525,0,2,0,457.26,4,787840.12,24,0,5,12,True
7552337,1450,4,451,3628,429080525,0,0,0,456.97,7,787383.15,11,6,2,12,True
7987146,203,0,451,6787,429080525,0,0,0,456.84,7,786926.31,9,4,9,1,True
8501585,203,0,25,3129,429080525,0,0,0,456.99,8,786469.32,9,5,15,3,False
8608447,203,0,451,8226,429080525,0,0,0,457.0,7,786012.32,9,6,12,3,True
8649009,1450,4,30,5008,429080525,0,0,0,457.04,8,785555.28,11,4,20,4,False
8667500,350,0,451,9664,429080525,0,0,0,457.01,7,785098.27,24,5,11,5,True
8744057,1480,4,30,6793,429080525,0,0,0,457.01,8,784641.26,24,5,13,6,True
8990435,1480,4,25,2679,429080525,0,0,0,456.62,8,784184.64,24,3,22,7,True
9359289,524,1,10,6787,429080525,0,0,0,457.02,0,784641.66,18,4,9,10,True
9564550,1480,4,451,7209,429080525,0,0,0,457.05,7,784184.61,24,1,20,10,True
9689124,1483,0,20,6787,429080525,0,0,0,456.77,3,783727.84,24,0,18,10,True
9792407,220,0,20,5404,429080525,0,0,0,456.93,5,783270.91,26,6,9,11,True
1051112,1093,0,-1,8203,278959044,1,1,0,1034.68,4,284820.0,18,6,6,1,True
1073009,490,4,30,5185,278959044,1,0,0,1034.54,8,283785.46,12,5,2,2,True
1126637,531,0,20,4630,278959044,1,0,0,1035.17,3,282750.29,18,2,21,2,True
1201363,509,0,20,9663,278959044,1,0,0,1035.21,3,281715.08,12,0,17,2,False
1251539,32,3,30,6398,278959044,1,0,0,1034.9,8,280680.18,11,2,14,3,True
1382266,588,0,30,6398,278959044,1,0,0,1035.07,8,279645.11,24,3,20,5,True
1507207,1125,1,10,6195,278959044,1,0,0,1034.91,6,280680.02,24,3,12,6,True
1657378,428,0,20,8322,278959044,1,0,0,1035.07,5,279644.95,18,2,0,6,False
1709722,1312,0,30,2086,278959044,1,0,0,1035.12,8,278609.83,5,3,2,7,False
2180571,790,0,20,2947,278959044,1,0,0,1034.93,3,277574.9,11,2,16,8,True
2455817,1431,4,30,1903,278959044,1,0,0,1034.79,8,276540.11,24,3,0,8,True
2556061,588,0,-1,6827,278959044,1,1,0,1035.15,4,276540.11,24,6,13,8,False
2617069,490,4,25,9663,278959044,1,0,0,1034.96,8,275505.15,12,3,13,9,False
2618571,490,4,451,7186,278959044,1,0,0,1034.88,7,274470.27,12,3,9,10,True
2666780,32,3,-1,2947,278959044,1,1,0,1034.92,1,274470.27,11,3,22,10,True
2694105,1431,4,451,6195,278959044,1,0,0,1035.3,7,273434.97,24,2,9,11,True
2797006,1312,0,-1,6763,278959044,1,1,0,1035.23,4,273434.97,5,4,1,11,True
3264021,490,4,30,8322,278959044,1,0,0,1034.98,8,272399.99,12,4,2,12,True
3292141,942,0,30,5185,278959044,1,0,0,1035.08,8,271364.91,24,4,18,12,True
3344263,1431,4,451,5185,278959044,1,0,0,1034.93,7,270329.98,24,5,4,12,False
3449774,695,2,451,4630,278959044,1,0,0,1034.86,7,269295.12,24,5,16,12,True
4387268,1312,0,451,9663,278959044,1,0,0,1034.95,7,268260.17,5,6,22,1,True
4536873,32,3,25,8322,278959044,1,0,0,1034.86,8,267225.31,11,0,2,3,True
4569652,490,4,25,8322,278959044,1,0,0,1034.79,8,266190.52,12,0,17,3,False
4609139,424,1,10,9293,278959044,1,0,0,1035.23,6,267225.75,18,6,12,3,True
4630254,942,0,451,9293,278959044,1,0,0,1035.18,7,266190.57,24,1,6,3,True
4884347,588,0,25,6398,278959044,1,0,0,1034.87,8,265155.7,24,5,2,4,True
5300080,32,3,451,9293,278959044,1,0,0,1034.8,7,264120.9,11,5,22,4,True
5346697,942,0,451,1877,278959044,1,0,0,1035.11,7,263085.79,24,1,7,4,True
5370064,641,0,10,2331,278959044,1,0,0,1034.93,6,264120.72,24,1,0,6,False
5548066,32,3,25,5239,278959044,1,0,0,1035.09,8,263085.63,11,4,23,6,True
6287392,1431,4,451,4630,278959044,1,0,0,1034.9,7,262050.73,24,1,16,7,True
6328477,695,2,30,7186,278959044,1,0,0,1035.12,8,261015.61,24,3,0,7,False
6334481,1105,2,451,1903,278959044,1,0,0,1035.03,7,259980.58,0,3,7,7,True
6343164,1273,0,10,7498,278959044,1,0,0,1035.03,6,261015.61,24,5,10,7,True
6400737,621,2,20,1903,278959044,1,0,0,1035.06,5,259980.55,11,1,11,7,True
6416218,1431,4,451,6195,278959044,1,0,0,1034.86,7,258945.69,24,0,17,8,True
6546712,1037,0,20,2766,278959044,1,0,0,1035.22,5,257910.47,11,2,14,10,True
6702738,1093,0,30,8203,278959044,1,0,0,1034.92,8,256875.55,18,1,20,11,True
6769064,1105,2,25,9343,278959044,1,0,0,1034.95,8,255840.6,0,2,4,11,True
7071562,610,0,20,9663,278959044,1,0,0,1035.15,5,254805.45,11,1,14,3,True
7313465,588,0,-1,6195,278959044,1,1,0,1034.93,1,254805.45,24,6,16,3,True
7539056,1093,0,25,9663,278959044,1,0,0,1034.87,8,253770.58,18,1,2,5,True
7611287,1421,0,10,8322,278959044,1,0,0,1035.1,0,254805.68,24,2,4,5,True
7724889,108,2,20,7186,278959044,1,0,0,1035.06,5,253770.62,3,6,5,6,True
7790140,942,0,451,9293,278959044,1,0,0,1034.93,7,252735.69,24,3,13,7,True
7826839,1180,1,10,6195,278959044,1,0,0,1034.85,0,253770.54,24,4,21,7,True
7976247,942,0,30,2086,278959044,1,0,0,1035.02,8,252735.52,24,5,4,7,True
8394962,641,0,10,1903,278959044,1,0,0,1035.08,0,253770.6,24,0,0,7,True
8481214,588,0,25,2331,278959044,1,0,0,1035.07,8,252735.53,24,1,19,8,True
8637535,32,3,451,6763,278959044,1,0,0,1035.19,7,251700.34,11,2,4,8,True
9576468,490,4,30,7186,278959044,1,0,0,1034.92,8,250665.42,12,2,16,9,True
9641588,695,2,-1,2331,278959044,1,1,0,1035.15,4,250665.42,24,2,9,10,True
9657639,1431,4,25,9343,278959044,1,0,0,1035.21,8,249630.21,24,6,22,10,True
9730483,490,4,25,9663,278959044,1,0,0,1035.1,8,248595.11,12,2,4,10,True
9736773,695,2,30,1877,278959044,1,0,0,1035.04,8,247560.07,24,6,18,11,True
9941207,1431,4,451,7498,278959044,1,0,0,1034.98,7,246525.09,24,0,16,11,True
1054961,129,0,10,6405,473667839,0,0,0,925.24,6,292427.24,18,1,22,2,True
1656596,1088,4,-1,1656,473667839,0,1,0,924.93,4,292427.24,18,2,11,3,True
1704938,297,0,20,7036,473667839,0,0,0,925.14,5,291502.1,4,0,16,4,True
1825957,291,3,451,5172,473667839,0,0,0,925.13,7,290576.97,24,4,0,5,False
2035530,996,0,451,8657,473667839,0,0,0,924.81,7,289652.16,26,5,3,5,True
2046478,291,3,-1,9498,473667839,0,1,0,925.16,1,289652.16,24,1,5,6,True
2230766,499,3,451,4412,473667839,0,0,0,924.86,7,288727.3,12,2,6,6,True
2311006,184,0,20,5247,473667839,0,0,0,925.02,5,287802.28,18,3,20,6,True
2314722,405,4,451,1656,473667839,0,0,0,925.28,7,286877.0,10,5,9,9,True
2510556,499,3,451,6616,473667839,0,0,0,925.24,7,285951.76,12,6,18,9,True
2672792,291,3,451,9671,473667839,0,0,0,924.84,7,285026.92,24,1,19,9,False
2841365,579,0,-1,1012,473667839,0,1,0,925.01,4,285026.92,11,5,18,10,True
3024191,579,0,451,9671,473667839,0,0,0,924.86,7,284102.06,11,0,13,10,True
3080655,499,3,451,6880,473667839,0,0,0,924.74,7,283177.32,12,0,23,10,True
3253767,727,0,451,6031,473667839,0,0,0,924.96,7,282252.36,11,2,1,12,True
3344342,877,2,20,6501,473667839,0,0,0,924.61,5,281327.75,24,3,22,12,True
3462939,291,3,-1,5305,473667839,0,1,0,925.01,4,281327.75,24,4,17,12,True
3952735,405,4,451,4594,473667839,0,0,0,925.44,7,280402.31,10,2,5,12,True
4002668,579,0,-1,8223,473667839,0,1,0,924.9,1,280402.31,11,6,22,12,True
4094425,499,3,25,6405,473667839,0,0,0,924.99,8,279477.32,12,4,20,1,True
4147965,1072,0,10,9671,473667839,0,0,0,924.88,6,280402.2,18,5,16,1,True
4447088,291,3,25,9671,473667839,0,0,0,924.95,8,279477.25,24,5,13,1,True
4835542,696,2,20,9173,473667839,0,0,0,924.95,5,278552.3,24,4,1,2,True
4906615,727,0,30,3517,473667839,0,0,0,925.04,8,277627.26,11,2,14,2,True
4981009,1088,4,451,7036,473667839,0,0,0,924.98,7,276702.28,18,1,17,5,True
5184977,1454,1,10,5787,473667839,0,0,0,924.95,6,277627.23,11,6,9,5,True
5215668,1088,4,25,8652,473667839,0,0,0,925.06,8,276702.17,18,3,4,6,False
5327427,376,0,20,6501,473667839,0,0,0,924.83,3,275777.34,25,4,8,7,True
5360435,64,0,10,6616,473667839,0,0,0,925.11,6,276702.45,20,3,14,8,True
5404859,542,0,30,5037,473667839,0,0,0,925.16,8,275777.29,17,6,14,9,True
6134465,542,0,451,6616,473667839,0,0,0,924.95,7,274852.34,17,5,3,10,True
6329408,727,0,25,4664,473667839,0,0,0,925.08,8,273927.26,11,4,1,10,True
6336222,579,0,-1,5305,473667839,0,1,0,925.21,1,273927.26,11,4,12,10,True
6643566,291,3,-1,7036,473667839,0,2,0,925.03,4,273927.26,24,6,21,12,True
6688846,499,3,30,6880,473667839,0,0,0,925.18,8,273002.08,12,1,19,12,True
7140816,727,0,30,1994,473667839,0,0,0,925.23,8,272076.85,11,1,3,1,True
7423088,996,0,25,6323,473667839,0,0,0,924.98,8,271151.87,26,2,5,1,True
7424340,542,0,-1,1012,473667839,0,1,0,925.02,4,271151.87,17,5,9,2,True
7487892,1027,0,451,4978,473667839,0,0,0,925.1,7,270226.77,11,0,3,4,True
7593593,1088,4,30,6501,473667839,0,0,0,924.95,8,269301.82,18,4,13,5,True
7618017,405,4,30,6880,473667839,0,0,0,925.06,8,268376.76,10,6,3,6,True
7755044,499,3,25,5247,473667839,0,0,0,925.17,8,267451.59,12,2,18,7,True
7811889,1027,0,451,4978,473667839,0,0,0,925.01,7,266526.58,11,3,22,8,True
8053459,405,4,451,6405,473667839,0,0,0,925.52,7,265601.06,10,0,2,8,True
8119420,653,1,10,3011,473667839,0,0,0,924.78,6,266525.84,24,6,15,9,True
8599568,1474,0,10,5037,473667839,0,0,0,925.02,0,267450.86,24,6,17,9,True
8818656,1027,0,-1,6616,473667839,0,1,0,924.94,4,267450.86,11,2,22,9,True
8957996,215,0,20,4664,473667839,0,0,0,924.87,3,266525.99,9,5,18,10,True
9174243,291,3,451,5305,473667839,0,0,0,924.91,7,265601.08,24,5,5,10,True
9700880,1088,4,451,6323,473667839,0,0,0,924.95,7,264676.13,18,4,2,11,True
9772456,727,0,25,8223,473667839,0,0,0,924.76,8,263751.37,11,5,3,11,True
9958691,1270,1,10,4664,473667839,0,0,0,925.11,6,264676.48,23,6,14,11,True
1585713,819,2,30,3110,438874167,1,0,0,457.19,8,245528.81,18,5,11,1,True
1700073,1032,4,451,4740,438874167,1,0,0,456.92,7,245071.89,11,1,7,1,True
1788028,819,2,25,9532,438874167,1,0,0,456.86,8,244615.03,18,3,7,2,True
2329419,693,4,451,2318,438874167,1,0,0,456.98,7,244158.05,24,5,15,4,True
2394755,254,0,20,5605,438874167,1,0,0,456.79,5,243701.26,6,1,2,4,True
2508582,522,0,20,5605,438874167,1,0,0,456.88,3,243244.38,18,6,14,5,True
2528242,1032,4,30,3306,438874167,1,0,0,457.04,8,242787.34,11,0,12,5,True
2571762,145,0,20,8349,438874167,1,0,0,456.85,5,242330.49,18,3,3,5,True
2619000,1306,4,30,3925,438874167,1,0,0,456.99,8,241873.5,5,3,16,5,True
2916240,183,1,10,8349,438874167,1,0,0,457.06,0,242330.56,18,4,15,6,True
3298314,819,2,30,3806,438874167,1,0,0,457.07,8,241873.49,18,3,17,6,True
3453472,663,4,451,5780,438874167,1,0,0,457.07,7,241416.42,18,4,18,7,True
3483974,663,4,30,1419,438874167,1,0,0,456.91,8,240959.51,18,5,14,7,True
3724297,819,2,451,9532,438874167,1,0,0,457.2,7,240502.31,18,1,4,8,True
3998779,649,0,20,5361,438874167,1,0,0,456.99,5,240045.32,24,4,1,9,True
4349972,139,4,451,5169,438874167,1,0,0,456.96,7,239588.36,18,0,9,9,True
4382809,1034,1,25,5605,438874167,1,0,0,457.25,8,239131.11,11,2,12,10,True
4558583,693,4,451,3703,438874167,1,0,0,456.83,7,238674.28,24,3,8,11,True
4662619,1034,1,30,4740,438874167,1,0,0,457.01,8,238217.27,11,3,17,11,True
4679445,1034,1,451,4395,438874167,1,0,0,456.93,7,237760.34,11,1,13,11,True
4752308,652,0,20,4740,438874167,1,0,0,457.0,3,237303.34,24,1,8,12,True
4776412,139,4,451,1479,438874167,1,0,0,456.93,7,236846.41,18,3,15,12,True
4980728,346,0,10,1479,438874167,1,0,0,457.06,6,237303.47,24,3,10,1,True
4990581,820,1,10,2470,438874167,1,0,0,456.95,6,237760.42,18,4,4,1,True
5147866,1449,0,10,2484,438874167,1,0,0,456.87,6,238217.29,11,5,3,2,True
5194572,693,4,-1,6746,438874167,1,1,0,456.91,4,238217.29,24,3,6,3,True
5200002,819,2,25,5361,438874167,1,0,0,457.11,8,237760.18,18,4,17,3,True
5627756,1032,4,451,4395,438874167,1,0,0,457.04,7,237303.14,11,0,22,5,True
5765270,28,1,10,2470,438874167,1,0,0,457.02,6,237760.16,11,0,22,7,True
5835266,1387,1,10,7742,438874167,1,0,0,457.02,6,238217.18,24,6,14,7,True
6088949,819,2,451,5361,438874167,1,0,0,456.74,7,237760.44,18,6,23,8,True
6191972,819,2,-1,5780,438874167,1,1,0,457.02,1,237760.44,18,4,19,9,True
6323418,1363,0,20,7742,438874167,1,0,0,456.96,3,237303.48,16,4,6,9,True
6404300,139,4,25,1234,438874167,1,0,0,457.09,8,236846.39,18,1,23,10,True
6486303,645,0,30,3925,438874167,1,0,0,457.18,8,236389.21,24,4,13,10,True
7201642,1034,1,451,5605,438874167,1,0,0,457.35,7,235931.86,11,4,5,11,True
7348674,1032,4,25,2376,438874167,1,0,0,457.1,8,235474.76,11,5,17,11,True
7488575,1032,4,30,3110,438874167,1,0,0,456.9,8,235017.86,11,3,11,11,True
7706816,1262,0,-1,4740,438874167,1,1,0,457.06,4,235017.86,23,5,4,11,True
7722472,1034,1,451,5605,438874167,1,0,0,456.97,7,234560.89,11,4,14,12,True
7902902,693,4,30,4740,438874167,1,0,0,456.87,8,234104.02,24,0,21,12,True
7928293,819,2,-1,9599,438874167,1,1,0,456.81,1,234104.02,18,1,10,1,True
8135741,693,4,30,9599,438874167,1,0,0,457.3,8,233646.72,24,2,21,2,True
8229353,542,0,10,2376,438874167,1,0,0,456.94,6,234103.66,17,1,13,3,True
8277161,522,0,20,3250,438874167,1,0,0,457.05,5,233646.61,18,2,20,3,True
8294533,1146,2,20,5169,438874167,1,0,0,457.07,5,233189.54,15,0,4,4,True
8298028,139,4,-1,5605,438874167,1,1,0,457.03,4,233189.54,18,3,4,4,True
8596538,128,0,20,7742,438874167,1,0,0,456.95,5,232732.59,18,1,23,5,True
8627453,645,0,451,4989,438874167,1,0,0,456.84,7,232275.75,24,4,13,6,True
8669501,695,2,20,5169,438874167,1,0,0,456.89,3,231818.86,24,1,21,7,True
8821979,1306,4,30,2304,438874167,1,0,0,457.06,8,231361.8,5,3,6,8,True
9037369,1034,1,451,1419,438874167,1,0,0,456.7,7,230905.1,11,5,2,9,True
9597556,1034,1,451,1479,438874167,1,0,0,457.11,7,230447.99,11,5,14,9,True
9681442,1032,4,451,1419,438874167,1,0,0,456.91,7,229991.08,11,6,8,9,True
9693549,645,0,451,1479,438874167,1,0,0,457.19,7,229533.89,24,4,6,10,True
9777602,663,4,-1,3925,438874167,1,1,0,457.36,1,229533.89,18,5,16,10,True
9815234,645,0,451,3306,438874167,1,0,0,456.96,7,229076.93,24,0,2,10,True
9819667,1034,1,30,5780,438874167,1,0,0,456.89,8,228620.04,11,5,0,11,True
1164601,294,3,25,5423,966289747,0,0,0,178.03,8,404581.97,4,5,6,1,True
1218254,1093,0,10,2163,966289747,0,0,0,177.69,0,404759.66,18,3,21,2,True
1233172,1304,0,25,8530,966289747,0,0,0,177.93,8,404581.73,5,2,9,3,True
1810213,116,0,451,6886,966289747,0,0,0,178.11,7,404403.62,3,3,18,4,True
2079603,48,4,-1,6863,966289747,0,1,0,177.95,4,404403.62,24,0,23,4,True
2082608,116,0,451,9056,966289747,0,0,0,178.11,7,404225.51,3,2,13,4,True
2120408,1010,0,20,8326,966289747,0,0,0,178.06,5,404047.45,26,3,4,4,True
2495717,294,3,25,6633,966289747,0,0,0,177.84,8,403869.61,4,0,20,5,True
2518210,116,0,25,5850,966289747,0,0,0,178.01,8,403691.6,3,2,16,6,True
2662640,1035,0,20,2382,966289747,0,0,0,178.08,3,403513.52,11,1,22,6,False
2963315,1410,1,10,5850,966289747,0,0,0,178.13,6,403691.65,24,6,12,6,True
3238150,802,2,20,6863,966289747,0,0,0,178.07,5,403513.58,11,0,3,6,True
3450640,116,0,30,6889,966289747,0,0,0,177.9,8,403335.68,3,6,18,7,True
3480903,1319,1,30,6593,966289747,0,0,0,178.04,8,403157.64,18,0,20,7,True
3513560,1273,0,10,5850,966289747,0,0,0,177.82,6,403335.46,24,1,12,7,True
3743951,116,0,-1,7552,966289747,0,1,0,177.77,4,403335.46,3,3,7,7,True
3870170,534,4,30,5922,966289747,0,0,0,177.91,8,403157.55,18,3,3,8,True
3924934,770,4,30,6863,966289747,0,0,0,178.34,8,402979.21,14,3,8,10,True
4147234,534,4,451,2382,966289747,0,0,0,178.13,7,402801.08,18,6,21,10,True
4173303,48,4,30,5922,966289747,0,0,0,178.1,8,402622.98,24,6,20,12,True
4179467,294,3,30,3706,966289747,0,0,0,178.03,8,402444.95,4,0,2,12,True
4507995,337,1,10,5528,966289747,0,0,0,178.3,6,402623.25,11,2,17,12,True
4624428,770,4,451,1772,966289747,0,0,0,177.66,7,402445.59,14,3,21,1,True
4710708,393,1,10,6874,966289747,0,0,0,177.75,6,402623.34,10,5,8,1,True
4939213,1304,0,451,9056,966289747,0,0,0,178.06,7,402445.28,5,1,2,2,True
5011027,1446,1,10,5423,966289747,0,0,0,178.11,6,402623.39,24,5,20,4,True
5071849,591,0,20,6633,966289747,0,0,0,178.01,5,402445.38,24,0,10,4,True
5248207,282,2,20,5922,966289747,0,0,0,177.82,3,402267.56,24,2,9,5,True
5422924,770,4,30,7552,966289747,0,0,0,178.18,8,402089.38,14,3,7,6,True
5634312,294,3,25,8530,966289747,0,0,0,178.08,8,401911.3,4,0,4,6,True
5771873,101,3,-1,6966,966289747,0,1,0,177.99,4,401911.3,3,5,14,7,True
5897424,223,2,20,6886,966289747,0,0,0,177.69,5,401733.61,26,2,6,7,False
5942511,203,0,20,2382,966289747,0,0,0,178.07,5,401555.54,9,1,8,7,True
6238666,770,4,-1,6633,966289747,0,1,0,177.85,1,401555.54,14,4,22,8,True
6371418,116,0,25,6966,966289747,0,0,0,177.79,8,401377.75,3,4,6,10,True
6528262,48,4,30,6633,966289747,0,0,0,177.95,8,401199.8,24,2,12,10,True
6676435,48,4,30,5423,966289747,0,0,0,177.89,8,401021.91,24,2,6,11,True
6719749,294,3,30,7579,966289747,0,0,0,178.15,8,400843.76,4,6,1,12,True
7297148,294,3,30,1772,966289747,0,0,0,178.26,8,400665.5,4,2,21,12,True
7437968,1304,0,451,3706,966289747,0,0,0,177.7,7,400487.8,5,0,23,12,True
7439760,574,2,20,6889,966289747,0,0,0,178.17,3,400309.63,11,2,0,1,True
7642047,534,4,-1,5528,966289747,0,1,0,177.76,4,400309.63,18,5,21,2,True
7720391,1304,0,25,6889,966289747,0,0,0,178.13,8,400131.5,5,0,15,3,True
7837202,770,4,30,4482,966289747,0,0,0,177.95,8,399953.55,14,6,13,3,True
7990857,1319,1,451,2382,966289747,0,0,0,177.97,7,399775.58,18,0,20,3,True
8050507,534,4,25,6966,966289747,0,0,0,177.96,8,399597.62,18,1,16,4,True
8089378,1319,1,25,7579,966289747,0,0,0,178.12,8,399419.5,18,1,21,5,True
8249783,584,0,10,6886,966289747,0,0,0,177.85,0,399597.35,11,1,19,5,True
8926708,1304,0,451,4482,966289747,0,0,0,178.23,7,399419.12,5,2,11,5,True
9166386,319,0,10,6889,966289747,0,0,0,177.93,0,399597.05,11,6,7,6,True
9315689,1304,0,-1,6889,966289747,0,1,0,177.8,1,399597.05,5,4,22,6,True
9321574,589,1,10,7579,966289747,0,0,0,177.95,6,399775.0,24,6,5,8,True
9598896,551,0,20,5850,966289747,0,0,0,177.94,3,399597.06,17,6,23,8,True
9621636,652,0,20,3706,966289747,0,0,0,178.15,5,399418.91,24,3,10,8,True
9678702,1201,0,10,7552,966289747,0,0,0,178.04,6,399596.95,24,2,23,9,True
9874878,294,3,-1,6889,966289747,0,1,0,178.13,1,399596.95,4,2,15,11,True
1021320,996,0,451,5698,727589376,0,0,0,747.83,7,580204.17,26,4,21,1,True
1173614,877,2,451,7940,727589376,0,0,0,748.14,7,579456.03,24,1,18,1,True
1366122,796,2,451,4778,727589376,0,0,0,748.06,7,578707.97,11,4,19,1,True
1477138,1019,0,-1,2899,727589376,0,1,0,748.16,1,578707.97,26,3,13,2,True
1828893,877,2,30,5424,727589376,0,0,0,748.09,8,577959.88,24,1,10,2,True
2965412,300,0,10,4451,727589376,0,0,0,748.15,6,578708.03,4,5,22,2,True
3368799,796,2,451,5466,727589376,0,0,0,748.2,7,577959.83,11,3,3,3,True
3402030,796,2,30,6979,727589376,0,0,0,747.89,8,577211.94,11,4,19,3,True
3527431,538,0,20,4770,727589376,0,0,0,748.11,3,576463.83,18,6,18,3,True
3729365,1127,0,-1,7909,727589376,0,1,0,748.07,4,576463.83,24,1,18,3,True
3773069,796,2,25,7940,727589376,0,0,0,747.91,8,575715.92,11,5,12,4,True
3791045,1127,0,25,3239,727589376,0,0,0,748.29,8,574967.63,24,0,13,5,True
4266734,877,2,451,4016,727589376,0,0,0,748.18,7,574219.45,24,1,20,5,True
4285817,1019,0,30,4770,727589376,0,0,0,747.99,8,573471.46,26,6,8,6,True
4366842,877,2,30,4451,727589376,0,0,0,747.79,8,572723.67,24,4,0,7,True
4376725,796,2,25,1261,727589376,0,0,0,748.01,8,571975.66,11,2,17,7,True
4872827,448,0,20,8722,727589376,0,0,0,747.83,3,571227.83,13,5,7,7,True
5036981,996,0,30,8471,727589376,0,0,0,747.82,8,570480.01,26,1,15,7,True
5228092,471,0,10,2549,727589376,0,0,0,747.79,6,571227.8,5,1,16,7,True
5254294,792,1,451,6443,727589376,0,0,0,747.82,7,570479.98,11,1,12,8,True
5364565,591,0,20,3585,727589376,0,0,0,748.0,5,569731.98,24,0,23,8,True
5439086,792,1,25,5175,727589376,0,0,0,748.16,8,568983.82,11,4,14,10,True
5539460,1239,1,10,8471,727589376,0,0,0,748.24,0,569732.06,18,0,20,10,True
5556839,796,2,25,5698,727589376,0,0,0,748.01,8,568984.05,11,5,14,11,True
5874109,792,1,-1,5780,727589376,0,1,0,748.05,4,568984.05,11,4,3,11,True
6269478,846,3,-1,6979,727589376,0,2,0,747.92,1,568984.05,5,5,4,12,True
6363439,281,1,10,6443,727589376,0,0,0,748.03,6,569732.08,24,4,16,12,True
6364973,1111,0,20,5698,727589376,0,0,0,748.09,3,568983.99,0,0,1,1,True
6444788,350,0,10,6979,727589376,0,0,0,747.89,6,569731.88,24,5,23,1,True
6476942,792,1,25,4770,727589376,0,0,0,747.88,8,568984.0,11,4,18,3,True
6565826,1019,0,451,2086,727589376,0,0,0,747.84,7,568236.16,26,0,4,3,True
6695717,1019,0,25,7755,727589376,0,0,0,748.0,8,567488.16,26,0,20,3,True
6807795,887,2,20,6979,727589376,0,0,0,748.26,5,566739.9,27,4,9,4,True
7057567,877,2,451,3239,727589376,0,0,0,747.91,7,565991.99,24,5,4,4,True
7312643,806,1,10,2086,727589376,0,0,0,748.17,6,566740.16,11,6,5,5,True
7469014,877,2,30,3585,727589376,0,0,0,748.24,8,565991.92,24,0,20,6,True
7486967,877,2,-1,7755,727589376,0,1,0,748.33,1,565991.92,24,0,21,6,True
7495645,996,0,30,4770,727589376,0,0,0,747.85,8,565244.07,26,3,16,7,True
7599055,996,0,-1,5466,727589376,0,1,0,748.0,4,565244.07,26,2,7,9,True
7777162,319,0,10,3585,727589376,0,0,0,747.95,0,565992.02,11,0,16,10,True
7779310,846,3,451,2086,727589376,0,0,0,748.06,7,565243.96,5,1,16,1,True
7950991,1127,0,-1,5175,727589376,0,1,0,747.68,4,565243.96,24,2,13,2,True
7961917,877,2,451,3239,727589376,0,0,0,747.91,7,564496.05,24,5,9,3,True
8189868,877,2,451,4778,727589376,0,0,0,748.01,7,563748.04,24,1,15,4,True
8450377,1338,0,20,8471,727589376,0,0,0,748.06,5,562999.98,18,2,12,4,True
8700976,1019,0,25,5698,727589376,0,0,0,748.21,8,562251.77,26,1,6,6,True
8742619,1387,1,10,2549,727589376,0,0,0,747.94,6,562999.71,24,4,6,6,True
8775634,996,0,451,2549,727589376,0,0,0,747.86,7,562251.85,26,0,16,6,True
8999863,877,2,25,4782,727589376,0,0,0,748.03,8,561503.82,24,4,7,6,True
9020920,846,3,-1,7909,727589376,0,1,0,748.07,4,561503.82,5,0,22,7,True
9500637,796,2,30,5466,727589376,0,0,0,748.09,8,560755.73,11,3,19,8,True
9796801,1175,2,20,7592,727589376,0,0,0,748.05,5,560007.68,24,4,4,9,True
9861545,796,2,30,4778,727589376,0,0,0,747.9,8,559259.78,11,1,22,9,True
9862968,996,0,-1,5780,727589376,0,1,0,748.05,1,559259.78,26,6,8,11,True
1201867,1376,3,451,4522,358512450,1,0,0,473.07,7,677119.93,16,1,15,2,True
1432724,1252,4,30,6556,358512450,1,0,0,472.9,8,676647.03,23,2,21,3,True
1831840,929,0,20,5849,358512450,1,0,0,472.9,5,676174.13,18,5,14,3,True
2021548,1232,1,10,4348,358512450,1,0,0,473.07,6,676647.2,18,1,7,6,True
2134953,1205,0,30,4348,358512450,1,0,0,472.97,8,676174.23,24,0,8,6,True
2196544,603,0,10,3685,358512450,1,0,0,472.84,6,676647.07,24,0,19,6,True
2262784,773,3,-1,6556,358512450,1,1,0,473.05,4,676647.07,14,6,6,7,True
2394263,626,2,30,2523,358512450,1,0,0,473.08,8,676173.99,11,6,2,8,True
2510496,1252,4,30,4348,358512450,1,0,0,473.09,8,675700.9,23,1,12,10,False
2631511,1012,0,10,6556,358512450,1,0,0,473.15,6,676174.05,26,0,22,11,False
2707943,1376,3,-1,9431,358512450,1,1,0,472.98,4,676174.05,16,5,5,11,True
3068211,1376,3,30,5029,358512450,1,0,0,473.16,8,675700.89,16,0,13,1,True
3283924,365,0,10,5849,358512450,1,0,0,473.29,6,676174.18,25,6,6,2,True
3768378,1376,3,-1,7808,358512450,1,1,0,473.19,4,676174.18,16,5,1,2,True
4134372,525,0,20,5029,358512450,1,0,0,472.85,3,675701.33,18,3,13,3,True
4207919,550,0,-1,3474,358512450,1,1,0,473.1,4,675701.33,17,4,12,3,True
4208143,1376,3,451,4369,358512450,1,0,0,472.78,7,675228.55,16,5,7,3,True
4335019,1376,3,30,6509,358512450,1,0,0,473.11,8,674755.44,16,3,10,3,True
4570959,1376,3,-1,5029,358512450,1,1,0,472.99,4,674755.44,16,4,9,3,True
4576053,1252,4,25,5029,358512450,1,0,0,473.2,8,674282.24,23,6,8,4,True
4576401,1205,0,-1,2788,358512450,1,1,0,473.22,1,674282.24,24,3,8,5,True
4583872,851,1,10,2523,358512450,1,0,0,472.87,6,674755.11,5,0,21,5,True
4720605,550,0,451,2523,358512450,1,0,0,473.08,7,674282.03,17,6,15,6,True
4740624,1252,4,-1,6509,358512450,1,1,0,472.9,1,674282.03,23,1,9,8,True
4889951,947,2,20,3265,358512450,1,0,0,473.13,3,673808.9,24,1,21,8,False
5157823,550,0,-1,7808,358512450,1,1,0,472.95,1,673808.9,17,5,23,9,True
5247219,989,1,10,3265,358512450,1,0,0,472.99,6,674281.89,22,4,21,9,True
5452869,626,2,25,4348,358512450,1,0,0,473.14,8,673808.75,11,6,18,10,True
5497162,58,2,20,2523,358512450,1,0,0,472.93,5,673335.82,20,3,4,11,True
5554855,626,2,-1,2788,358512450,1,1,0,473.18,4,673335.82,11,4,21,12,True
5575070,550,0,30,3685,358512450,1,0,0,472.95,8,672862.87,17,3,8,1,True
5606570,802,2,20,3685,358512450,1,0,0,473.05,3,672389.82,11,4,12,2,True
6051914,1061,2,20,2523,358512450,1,0,0,473.14,5,671916.68,11,1,9,2,True
6108086,1376,3,25,4369,358512450,1,0,0,472.97,8,671443.71,16,5,3,2,True
6816506,1282,2,20,4369,358512450,1,0,0,472.92,5,670970.79,24,3,9,3,True
6826050,1252,4,30,8839,358512450,1,0,0,473.03,8,670497.76,23,6,15,3,True
6890892,773,3,-1,2788,358512450,1,1,0,473.29,1,670497.76,14,6,14,5,True
6920410,1007,2,20,7808,358512450,1,0,0,472.86,5,670024.9,26,6,8,5,True
7260505,1252,4,451,4522,358512450,1,0,0,473.08,7,669551.82,23,6,20,6,True
7815693,1376,3,25,3474,358512450,1,0,0,473.02,8,669078.8,16,4,18,6,True
7827456,1092,1,10,8839,358512450,1,0,0,473.13,6,669551.93,18,6,16,6,True
8082133,35,2,20,3685,358512450,1,0,0,473.11,5,669078.82,11,2,20,7,True
8301523,1009,0,10,3474,358512450,1,0,0,472.75,6,669551.57,26,3,14,7,True
8426042,773,3,451,8839,358512450,1,0,0,473.28,7,669078.29,14,6,7,7,True
8454391,550,0,451,4369,358512450,1,0,0,473.07,7,668605.22,17,3,17,8,True
8529404,550,0,25,3685,358512450,1,0,0,473.25,8,668131.97,17,3,19,8,True
8560578,713,0,20,8839,358512450,1,0,0,472.91,5,667659.06,18,3,21,8,True
8670117,1252,4,25,4348,358512450,1,0,0,472.93,8,667186.13,23,6,23,8,True
8717410,951,0,10,3474,358512450,1,0,0,472.95,6,667659.08,24,0,23,9,True
9263030,626,2,30,3265,358512450,1,0,0,473.05,8,667186.03,11,3,5,9,True
9647656,550,0,451,2523,358512450,1,0,0,473.0,7,666713.03,17,1,10,9,True
9690171,550,0,25,7808,358512450,1,0,0,472.92,8,666240.11,17,6,8,10,True
9746944,1205,0,25,5029,358512450,1,0,0,472.92,8,665767.19,24,6,8,10,True
9784862,297,0,10,2523,358512450,1,0,0,472.74,0,666239.93,4,1,14,10,True
9854218,200,0,10,6509,358512450,1,0,0,472.93,6,666712.86,9,6,8,11,True
9900031,1233,0,20,4369,358512450,1,0,0,472.95,5,666239.91,18,2,12,11,True
1017877,348,0,451,3386,381038574,0,0,0,654.77,7,709372.23,24,1,13,2,True
1203674,330,3,25,3247,381038574,0,0,0,655.03,8,708717.2,11,0,14,2,True
1214545,330,3,30,1192,381038574,0,0,0,654.99,8,708062.21,11,2,21,3,True
1280302,1065,0,10,6942,381038574,0,0,0,655.06,6,708717.27,11,3,4,3,True
1289826,605,0,20,3908,381038574,0,0,0,655.17,3,708062.1,24,0,1,5,True
1477884,742,4,451,6018,381038574,0,0,0,654.95,7,707407.15,24,0,6,5,True
2002046,348,0,451,1297,381038574,0,0,0,655.34,7,706751.81,24,6,1,5,True
2062611,189,4,25,3121,381038574,0,0,0,654.91,8,706096.9,18,6,15,5,True
2675462,742,4,-1,6857,381038574,0,1,0,655.11,4,706096.9,24,2,11,6,True
2702828,215,0,20,9549,381038574,0,0,0,655.11,5,705441.79,9,6,21,6,True
3168902,1399,0,451,9593,381038574,0,0,0,654.97,7,704786.82,24,2,10,6,True
3192931,348,0,25,8770,381038574,0,0,0,654.76,8,704132.06,24,1,21,6,True
3249020,148,1,10,6942,381038574,0,0,0,655.18,6,704787.24,18,5,22,7,True
3475512,189,4,451,2839,381038574,0,0,0,655.2,7,704132.04,18,2,21,7,True
3600868,428,0,25,1703,381038574,0,0,0,655.03,8,703477.01,18,4,21,8,True
3704545,444,2,20,8253,381038574,0,0,0,654.84,3,702822.17,24,0,21,9,True
3866629,742,4,25,1025,381038574,0,0,0,654.9,8,702167.27,24,1,4,9,True
4029296,428,0,30,8253,381038574,0,0,0,654.74,8,701512.53,18,3,23,9,True
4213362,1250,1,10,1192,381038574,0,0,0,655.14,0,702167.67,23,0,12,9,False
4407447,330,3,451,4818,381038574,0,0,0,655.07,7,701512.6,11,3,0,9,True
4453389,189,4,451,3247,381038574,0,0,0,655.01,7,700857.59,18,0,5,11,True
4645470,330,3,-1,4818,381038574,0,1,0,655.06,4,700857.59,11,6,14,1,True
4691215,330,3,451,8528,381038574,0,0,0,654.99,7,700202.6,11,4,6,3,True
4833890,812,0,10,8770,381038574,0,0,0,654.9,6,700857.5,18,4,0,3,True
5173274,1399,0,451,3247,381038574,0,0,0,655.03,7,700202.47,24,1,15,4,True
5206293,1116,0,10,1025,381038574,0,0,0,655.05,6,700857.52,24,5,19,4,True
5530394,268,2,20,8770,381038574,0,0,0,654.84,3,700202.68,24,6,14,4,True
5562119,355,1,10,1192,381038574,0,0,0,655.05,6,700857.73,24,3,13,4,True
5768449,348,0,30,8253,381038574,0,0,0,654.95,8,700202.78,24,6,11,5,True
5778608,1399,0,25,5529,381038574,0,0,0,655.31,8,699547.47,24,3,4,6,False
6006968,996,0,10,9593,381038574,0,0,0,654.74,6,700202.21,26,5,12,6,True
6122337,1399,0,451,7476,381038574,0,0,0,655.18,7,699547.03,24,6,18,7,True
6134191,1409,1,10,3386,381038574,0,0,0,655.06,6,700202.09,24,4,11,7,True
6194968,1399,0,-1,1703,381038574,0,1,0,655.07,1,700202.09,24,5,6,7,True
6440571,348,0,451,9093,381038574,0,0,0,654.94,7,699547.15,24,5,9,7,True
6510444,1399,0,451,3247,381038574,0,0,0,655.0,7,698892.15,24,6,18,8,True
6591804,1399,0,30,1703,381038574,0,0,0,655.11,8,698237.04,24,5,12,9,True
6726747,742,4,30,6949,381038574,0,0,0,654.76,8,697582.28,24,1,9,9,True
7098558,167,2,20,2018,381038574,0,0,0,655.19,5,696927.09,24,6,15,10,True
7122022,428,0,30,6018,381038574,0,0,0,655.04,8,696272.05,18,3,22,10,True
7155531,234,0,20,2142,381038574,0,0,0,655.09,5,695616.96,26,4,1,11,True
7208962,330,3,30,1703,381038574,0,0,0,655.19,8,694961.77,11,2,2,11,True
7474811,348,0,25,2839,381038574,0,0,0,654.83,8,694306.94,24,2,22,12,True
7867362,989,1,10,6949,381038574,0,0,0,654.96,6,694961.9,22,0,1,4,True
7910401,1399,0,25,7476,381038574,0,0,0,654.81,8,694307.09,24,3,15,5,True
8270173,325,0,20,1192,381038574,0,0,0,655.14,5,693651.95,11,5,5,5,True
8432126,348,0,30,6942,381038574,0,0,0,655.07,8,692996.88,24,0,6,5,True
8777443,1399,0,451,6018,381038574,0,0,0,654.89,7,692341.99,24,4,12,6,True
8879166,366,0,10,7476,381038574,0,0,0,655.02,6,692997.01,25,6,21,7,True
8915123,348,0,451,2526,381038574,0,0,0,654.88,7,692342.13,24,6,7,8,True
9453774,348,0,-1,8685,381038574,0,1,0,654.98,4,692342.13,24,4,22,8,True
9501989,1399,0,30,3121,381038574,0,0,0,655.19,8,691686.94,24,1,22,8,True
9503982,1399,0,25,3908,381038574,0,0,0,654.67,8,691032.27,24,3,2,10,True
9614572,742,4,-1,9093,381038574,0,1,0,655.18,4,691032.27,24,6,20,10,True
9920889,1399,0,451,8770,381038574,0,0,0,654.67,7,690377.6,24,2,16,11,True
1015515,1101,2,451,9166,233704457,1,0,0,1155.94,7,635141.06,0,5,22,1,True
1172537,695,2,20,3853,233704457,1,0,0,1155.98,5,633985.08,24,6,4,1,True
1252974,400,4,25,9506,233704457,1,0,0,1156.17,8,632828.91,10,3,1,2,True
1468498,958,2,451,7289,233704457,1,0,0,1155.74,7,631673.17,13,2,17,3,True
1475417,400,4,25,2303,233704457,1,0,0,1155.98,8,630517.19,10,4,6,3,True
1526576,1402,4,451,4001,233704457,1,0,0,1156.02,7,629361.17,24,2,3,3,True
1534261,812,0,20,5900,233704457,1,0,0,1155.88,5,628205.29,18,3,7,3,True
1537228,966,4,451,6479,233704457,1,0,0,1155.98,7,627049.31,13,3,14,3,True
1540985,537,0,10,9416,233704457,1,0,0,1155.91,6,628205.22,18,3,23,4,True
1661876,966,4,451,5385,233704457,1,0,0,1155.98,7,627049.24,13,3,17,5,True
1770961,1101,2,30,9416,233704457,1,0,0,1156.06,8,625893.18,0,0,15,5,True
1957241,1164,0,10,6571,233704457,1,0,0,1156.17,6,627049.35,24,2,12,5,True
2550108,1402,4,451,7097,233704457,1,0,0,1156.31,7,625893.04,24,5,8,6,True
3080957,958,2,451,5900,233704457,1,0,0,1155.9,7,624737.14,13,4,16,6,True
3254165,829,4,30,9792,233704457,1,0,0,1155.96,8,623581.18,18,6,21,7,True
3385854,1469,4,-1,6571,233704457,1,1,0,1156.21,1,623581.18,11,5,16,8,True
3461732,1101,2,-1,9792,233704457,1,2,0,1155.91,4,623581.18,0,3,5,8,True
3474348,998,0,20,3853,233704457,1,0,0,1155.74,3,622425.44,26,5,15,9,True
4078655,966,4,-1,9506,233704457,1,1,0,1156.01,1,622425.44,13,1,1,9,True
4097806,1019,0,20,7097,233704457,1,0,0,1155.85,5,621269.59,26,6,8,10,True
4107844,966,4,30,6479,233704457,1,0,0,1155.93,8,620113.66,13,4,18,10,True
4550387,1402,4,25,7383,233704457,1,0,0,1156.35,8,618957.31,24,0,14,11,True
4689129,594,0,10,4351,233704457,1,0,0,1156.04,6,620113.35,24,5,23,12,True
4983549,829,4,30,1049,233704457,1,0,0,1155.8,8,618957.55,18,4,6,12,True
5036899,400,4,451,6571,233704457,1,0,0,1156.18,7,617801.37,10,4,11,12,True
5240925,1445,2,20,9166,233704457,1,0,0,1156.12,3,616645.25,24,2,10,12,True
5420883,1402,4,-1,4001,233704457,1,1,0,1155.89,1,616645.25,24,4,11,12,True
5446377,829,4,25,9792,233704457,1,0,0,1156.14,8,615489.11,18,2,9,1,True
5804413,1124,0,10,7097,233704457,1,0,0,1156.13,6,616645.24,24,5,19,2,True
5823498,400,4,25,9737,233704457,1,0,0,1155.91,8,615489.33,10,3,10,3,True
5836038,428,0,10,8186,233704457,1,0,0,1155.97,0,616645.3,18,2,17,4,True
5866549,1469,4,-1,3904,233704457,1,1,0,1156.15,1,616645.3,11,0,9,5,True
6510483,958,2,451,1049,233704457,1,0,0,1156.19,7,615489.11,13,3,10,6,True
6802922,1412,2,20,5900,233704457,1,0,0,1156.1,5,614333.01,24,6,11,7,True
6831403,1429,0,10,9166,233704457,1,0,0,1156.03,6,615489.04,24,4,22,7,True
6999924,400,4,451,3904,233704457,1,0,0,1156.04,7,614333.0,10,1,2,7,True
7095839,400,4,-1,5900,233704457,1,1,0,1156.04,4,614333.0,10,4,22,7,True
7233502,1000,0,10,7671,233704457,1,0,0,1156.0,6,615489.0,26,2,13,8,True
7322734,400,4,451,7671,233704457,1,0,0,1155.99,7,614333.01,10,0,5,9,True
7381632,1402,4,-1,7289,233704457,1,1,0,1155.87,4,614333.01,24,4,16,9,True
7423075,829,4,30,9478,233704457,1,0,0,1155.69,8,613177.32,18,6,22,10,True
7464040,1160,0,20,9737,233704457,1,0,0,1155.91,5,612021.41,15,1,3,2,True
8047731,428,0,20,2807,233704457,1,0,0,1156.06,3,610865.35,18,6,0,2,True
8137320,800,0,10,9478,233704457,1,0,0,1155.85,0,612021.2,11,0,3,3,True
8210559,829,4,25,7383,233704457,1,0,0,1156.06,8,610865.14,18,6,15,4,True
8497620,950,0,20,7671,233704457,1,0,0,1156.09,5,609709.05,24,2,1,5,True
8930290,966,4,451,8186,233704457,1,0,0,1156.13,7,608552.92,13,3,11,5,True
8958616,1101,2,30,5720,233704457,1,0,0,1156.17,8,607396.75,0,3,15,5,True
8985793,1101,2,30,4351,233704457,1,0,0,1155.98,8,606240.77,0,1,3,5,True
9057034,1380,0,10,5900,233704457,1,0,0,1156.1,0,607396.87,16,4,11,6,True
9146434,1402,4,451,2303,233704457,1,0,0,1155.95,7,606240.92,24,4,0,7,True
9236433,829,4,-1,6571,233704457,1,1,0,1156.2,4,606240.92,18,0,23,7,True
9241266,829,4,451,7671,233704457,1,0,0,1156.05,7,605084.87,18,2,0,7,True
9631794,400,4,30,2582,233704457,1,0,0,1156.25,8,603928.62,10,0,4,9,True
9759725,1105,2,20,4351,233704457,1,0,0,1155.62,5,602773.0,0,2,6,9,True
9832250,167,2,20,3853,233704457,1,0,0,1155.93,5,601617.07,24,1,4,11,True
1036409,1036,1,30,2444,222063183,1,0,0,898.77,8,117155.23,11,4,5,1,True
1064896,286,1,10,3310,222063183,1,0,0,899.01,6,118054.24,24,3,5,3,True
1135447,1180,1,30,3974,222063183,1,0,0,899.28,8,117154.96,24,1,1,3,True
1758404,721,4,451,9117,222063183,1,0,0,899.05,7,116255.91,11,3,0,3,True
1942069,1062,3,30,7343,222063183,1,0,0,898.97,8,115356.94,11,6,0,4,True
2030570,833,4,30,3666,222063183,1,0,0,899.0,8,114457.94,5,4,11,5,True
2056773,635,2,20,4310,222063183,1,0,0,898.99,5,113558.95,24,4,23,5,True
2490076,675,2,451,5447,222063183,1,0,0,898.79,7,112660.16,24,6,22,5,True
2717094,925,4,451,6610,222063183,1,0,0,898.98,7,111761.18,18,5,11,8,True
2733429,1180,1,-1,5447,222063183,1,1,0,898.66,4,111761.18,24,6,14,9,True
3349970,806,1,10,5102,222063183,1,0,0,899.14,6,112660.32,11,0,1,9,True
3487408,1180,1,25,5121,222063183,1,0,0,898.93,8,111761.39,24,6,4,9,True
3707751,749,4,-1,9801,222063183,1,1,0,898.8,1,111761.39,24,2,13,10,True
3967823,800,0,20,6190,222063183,1,0,0,899.03,3,110862.36,11,4,23,11,True
4129706,470,1,10,9016,222063183,1,0,0,899.14,0,111761.5,5,1,19,12,True
4361155,833,4,-1,7784,222063183,1,1,0,898.94,1,111761.5,5,4,13,1,True
4376550,749,4,30,4924,222063183,1,0,0,899.0,8,110862.5,24,0,1,1,True
4616804,1180,1,25,5121,222063183,1,0,0,898.87,8,109963.63,24,6,4,2,True
4639830,1126,4,451,3974,222063183,1,0,0,899.06,7,109064.57,24,6,14,2,True
4693791,1271,0,10,3310,222063183,1,0,0,898.9,6,109963.47,23,5,6,2,False
4868444,869,2,20,3310,222063183,1,0,0,899.03,5,109064.44,24,1,7,2,True
4890614,925,4,451,7871,222063183,1,0,0,899.12,7,108165.32,18,3,23,3,True
4931373,925,4,451,7871,222063183,1,0,0,899.04,7,107266.28,18,4,15,3,True
5018384,749,4,451,4716,222063183,1,0,0,898.98,7,106367.3,24,5,1,3,True
5201084,833,4,451,3666,222063183,1,0,0,898.97,7,105468.33,5,1,2,5,True
5345945,1062,3,30,2444,222063183,1,0,0,899.16,8,104569.17,11,1,23,5,True
5514555,925,4,25,5102,222063183,1,0,0,898.95,8,103670.22,18,0,9,5,True
5664422,925,4,25,7871,222063183,1,0,0,898.97,8,102771.25,18,1,20,6,True
5685059,675,2,451,6982,222063183,1,0,0,899.09,7,101872.16,24,1,16,7,False
5761817,1126,4,30,6610,222063183,1,0,0,899.08,8,100973.08,24,3,23,7,True
6030677,833,4,-1,3310,222063183,1,1,0,899.06,1,100973.08,5,3,23,8,True
6333487,1180,1,30,4976,222063183,1,0,0,898.91,8,100074.17,24,6,9,9,True
6453124,1180,1,25,5445,222063183,1,0,0,899.33,8,99174.84,24,4,8,10,True
7492785,1255,0,20,6982,222063183,1,0,0,898.76,5,98276.08,23,2,2,11,True
7508732,721,4,30,4716,222063183,1,0,0,898.98,8,97377.1,11,3,22,12,True
7762489,675,2,-1,6079,222063183,1,1,0,899.06,1,97377.1,24,0,14,1,True
7877125,1338,0,20,9016,222063183,1,0,0,899.07,5,96478.03,18,0,0,2,True
8472305,1206,0,10,5445,222063183,1,0,0,898.97,6,97377.0,24,2,23,5,True
8489985,1126,4,25,6190,222063183,1,0,0,899.01,8,96477.99,24,1,8,5,True
8633412,675,2,451,9016,222063183,1,0,0,899.07,7,95578.92,24,1,18,5,True
8763482,675,2,451,6190,222063183,1,0,0,899.0,7,94679.92,24,4,13,6,True
8772050,833,4,25,7784,222063183,1,0,0,898.81,8,93781.11,5,4,21,7,False
8878328,925,4,30,5102,222063183,1,0,0,899.08,8,92882.03,18,4,16,7,True
9080425,1036,1,451,5984,222063183,1,0,0,898.9,7,91983.13,11,2,22,7,True
9157820,1485,0,20,7871,222063183,1,0,0,898.92,5,91084.21,24,2,17,8,True
9208054,675,2,-1,6079,222063183,1,1,0,898.88,4,91084.21,24,1,17,9,True
9568901,1180,1,451,3666,222063183,1,0,0,898.85,7,90185.36,24,0,14,9,True
9633166,833,4,451,3974,222063183,1,0,0,899.1,7,89286.26,5,6,14,10,True
9757600,1126,4,451,4924,222063183,1,0,0,898.85,7,88387.41,24,1,16,10,True
9878350,721,4,25,3974,222063183,1,0,0,899.09,8,87488.32,11,1,21,10,True
9945736,925,4,451,9016,222063183,1,0,0,898.92,7,86589.4,18,2,20,11,True
1554009,993,0,451,2321,353992071,0,0,0,1181.12,7,285266.88,22,0,3,1,True
1612406,728,1,30,1724,353992071,0,0,0,1181.33,8,284085.55,11,5,20,1,True
1671445,993,0,30,6274,353992071,0,0,0,1180.85,8,282904.7,22,0,10,2,True
1737721,728,1,30,7948,353992071,0,0,0,1180.92,8,281723.78,11,2,21,2,True
1784870,728,1,30,7948,353992071,0,0,0,1181.04,8,280542.74,11,2,13,2,True
2180689,484,0,20,2321,353992071,0,0,0,1180.84,5,279361.9,5,4,8,2,True
2603262,993,0,-1,2321,353992071,0,1,0,1180.95,1,279361.9,22,5,3,3,True
2828020,1027,0,-1,2207,353992071,0,2,0,1181.35,4,279361.9,11,0,9,4,True
2831507,1094,0,451,9449,353992071,0,0,0,1180.99,7,278180.91,0,0,23,4,True
2982215,887,2,20,4771,353992071,0,0,0,1181.09,3,276999.82,27,2,1,5,True
3037877,728,1,-1,9449,353992071,0,1,0,1180.97,1,276999.82,11,0,6,8,True
3086014,728,1,451,6169,353992071,0,0,0,1180.83,7,275818.99,11,0,5,8,True
3144293,1094,0,-1,1618,353992071,0,1,0,1181.06,4,275818.99,0,2,2,8,True
3424373,993,0,25,6373,353992071,0,0,0,1181.11,8,274637.88,22,5,2,8,True
3588676,1041,0,20,2321,353992071,0,0,0,1180.89,5,273456.99,11,5,22,9,True
3630133,993,0,451,6274,353992071,0,0,0,1180.98,7,272276.01,22,0,13,9,True
3720156,993,0,25,6177,353992071,0,0,0,1180.97,8,271095.04,22,0,17,9,True
3814151,977,4,451,9449,353992071,0,0,0,1181.0,7,269914.04,22,3,2,11,True
3832897,1094,0,451,1724,353992071,0,0,0,1181.13,7,268732.91,0,5,13,11,True
3943072,977,4,451,6373,353992071,0,0,0,1180.97,7,267551.94,22,0,17,11,True
3994670,564,0,10,6274,353992071,0,0,0,1180.99,0,268732.93,17,4,20,11,True
4153751,1027,0,451,1618,353992071,0,0,0,1180.73,7,267552.2,11,4,15,11,True
4377845,977,4,451,1724,353992071,0,0,0,1180.98,7,266371.22,22,0,17,12,True
4422460,1103,4,30,9686,353992071,0,0,0,1181.12,8,265190.1,0,1,19,12,True
4543924,993,0,451,2321,353992071,0,0,0,1180.97,7,264009.13,22,0,15,12,True
4675893,398,0,20,1612,353992071,0,0,0,1181.27,5,262827.86,10,1,13,1,True
4833866,993,0,25,2950,353992071,0,0,0,1181.03,8,261646.83,22,5,14,1,True
4978410,799,2,20,9449,353992071,0,0,0,1181.13,5,260465.7,11,5,23,1,True
5312353,1103,4,-1,4771,353992071,0,1,0,1180.81,1,260465.7,0,2,11,2,True
5352397,1027,0,-1,9686,353992071,0,2,0,1181.08,1,260465.7,11,6,8,2,True
5357718,531,0,20,1618,353992071,0,0,0,1181.13,3,259284.57,18,2,21,3,True
5392014,630,0,10,6177,353992071,0,0,0,1181.24,6,260465.81,11,0,21,3,True
5433472,993,0,25,7948,353992071,0,0,0,1180.86,8,259284.95,22,1,6,4,True
5673724,767,0,10,8784,353992071,0,0,0,1180.83,0,260465.78,14,1,9,4,True
5721460,993,0,-1,4771,353992071,0,1,0,1181.03,1,260465.78,22,4,14,4,True
5759796,1027,0,-1,2207,353992071,0,2,0,1181.1,1,260465.78,11,6,4,5,True
6305013,993,0,25,9686,353992071,0,0,0,1181.0,8,259284.78,22,2,7,6,True
6463024,728,1,30,9449,353992071,0,0,0,1180.8,8,258103.98,11,2,17,7,True
6545959,728,1,25,4428,353992071,0,0,0,1181.11,8,256922.87,11,1,7,7,True
6598014,993,0,451,1618,353992071,0,0,0,1181.05,7,255741.82,22,2,7,8,True
6736090,1027,0,25,6177,353992071,0,0,0,1181.03,8,254560.79,11,6,0,9,False
6737113,993,0,25,2950,353992071,0,0,0,1181.0,8,253379.79,22,3,3,9,True
7091794,728,1,-1,6177,353992071,0,1,0,1181.14,1,253379.79,11,5,10,10,True
7336568,319,0,10,2321,353992071,0,0,0,1180.99,6,254560.78,11,6,13,10,True
7648955,1094,0,451,7948,353992071,0,0,0,1180.94,7,253379.84,0,0,18,10,True
7730156,670,0,20,2321,353992071,0,0,0,1180.8,5,252199.04,18,0,20,10,True
8295031,993,0,-1,2321,353992071,0,1,0,1181.06,4,252199.04,22,3,23,10,True
8406441,314,0,20,1612,353992071,0,0,0,1181.0,5,251018.04,4,5,4,11,True
8820011,993,0,451,1618,353992071,0,0,0,1180.79,7,249837.25,22,4,8,12,True
8822966,1179,0,10,4428,353992071,0,0,0,1181.28,0,251018.53,24,4,19,1,True
8908344,1027,0,451,4771,353992071,0,0,0,1181.0,7,249837.53,11,6,5,1,True
8909272,993,0,25,2950,353992071,0,0,0,1181.06,8,248656.47,22,2,21,1,True
8911365,993,0,30,6177,353992071,0,0,0,1180.87,8,247475.6,22,0,14,4,True
9075049,993,0,-1,6373,353992071,0,1,0,1181.18,4,247475.6,22,0,10,5,True
9346380,342,0,10,7948,353992071,0,0,0,1181.24,6,248656.84,24,2,8,6,True
9364635,993,0,30,2207,353992071,0,0,0,1180.93,8,247475.91,22,6,11,6,True
9664504,1246,0,10,2321,353992071,0,0,0,1180.99,6,248656.9,23,6,17,7,True
9899807,1434,0,10,2207,353992071,0,0,0,1181.13,6,249838.03,24,6,16,9,True
1001259,512,0,-1,5165,518291536,0,1,0,243.09,1,951418.0,12,6,22,1,True
1197339,1449,0,30,5864,518291536,0,0,0,242.94,8,951175.06,11,3,8,1,True
1632950,462,4,30,1357,518291536,0,0,0,242.96,8,950932.1,13,4,22,1,True
1753531,1217,0,-1,5864,518291536,0,1,0,242.82,4,950932.1,24,3,19,1,True
1968300,1454,1,30,1357,518291536,0,0,0,243.05,8,950689.05,11,2,11,3,True
1983235,462,4,25,5517,518291536,0,0,0,242.61,8,950446.44,13,4,17,3,True
2124003,503,0,451,6464,518291536,0,0,0,242.9,7,950203.54,12,1,18,4,True
2251816,1112,1,25,1180,518291536,0,0,0,242.64,8,949960.9,0,3,14,4,True
2422775,616,1,10,7751,518291536,0,0,0,243.35,0,950204.25,11,3,23,6,True
2575409,1449,0,-1,6405,518291536,0,1,0,243.15,4,950204.25,11,1,20,8,True
2579727,503,0,30,6464,518291536,0,0,0,242.99,8,949961.26,12,6,2,9,True
2603048,1454,1,30,5864,518291536,0,0,0,243.19,8,949718.07,11,5,17,9,True
2822128,462,4,451,1180,518291536,0,0,0,242.63,7,949475.44,13,2,10,9,True
3533271,1217,0,451,4962,518291536,0,0,0,243.18,7,949232.26,24,3,14,9,False
3558534,1007,2,20,1365,518291536,0,0,0,243.06,5,948989.2,26,2,0,9,True
3606422,1122,1,10,5517,518291536,0,0,0,243.05,6,949232.25,24,0,6,10,False
3715110,1488,0,20,6099,518291536,0,0,0,242.97,5,948989.28,24,6,0,11,True
4101433,195,1,10,1357,518291536,0,0,0,243.17,6,949232.45,18,0,16,11,True
4280984,1449,0,25,3308,518291536,0,0,0,242.95,8,948989.5,11,6,16,12,True
4303010,462,4,-1,3308,518291536,0,1,0,242.92,4,948989.5,13,2,2,12,False
4342906,1454,1,25,6179,518291536,0,0,0,243.1,8,948746.4,11,4,23,3,False
4610835,1449,0,30,4911,518291536,0,0,0,243.03,8,948503.37,11,0,17,4,True
4617121,641,0,20,6179,518291536,0,0,0,242.88,5,948260.49,24,3,2,5,True
4694209,848,2,20,8338,518291536,0,0,0,242.99,5,948017.5,5,3,21,5,True
4918835,512,0,-1,3854,518291536,0,1,0,243.12,1,948017.5,12,3,14,5,True
5644889,512,0,451,4911,518291536,0,0,0,243.0,7,947774.5,12,5,2,6,True
5848567,787,0,10,6640,518291536,0,0,0,242.99,6,948017.49,14,5,8,6,False
5968328,462,4,451,6640,518291536,0,0,0,243.0,7,947774.49,13,0,17,7,True
6242861,1064,0,10,6640,518291536,0,0,0,243.08,0,948017.57,11,1,10,8,True
6373129,1255,0,10,3854,518291536,0,0,0,243.09,6,948260.66,23,5,9,8,True
6868953,1112,1,-1,6099,518291536,0,1,0,242.89,4,948260.66,0,3,12,8,True
6901385,1454,1,30,5165,518291536,0,0,0,243.04,8,948017.62,11,0,22,9,True
6934702,462,4,-1,3295,518291536,0,1,0,242.81,4,948017.62,13,4,17,10,True
6965655,116,0,20,5517,518291536,0,0,0,242.95,3,947774.67,3,3,7,11,True
6973061,329,1,10,5165,518291536,0,0,0,243.18,6,948017.85,11,1,19,11,True
6995811,462,4,451,1180,518291536,0,0,0,243.09,7,947774.76,13,2,9,11,True
7030453,1454,1,30,6464,518291536,0,0,0,242.78,8,947531.98,11,3,0,12,True
7181683,512,0,-1,5517,518291536,0,1,0,242.86,4,947531.98,12,5,11,12,True
7194574,462,4,-1,6099,518291536,0,2,0,242.75,1,947531.98,13,4,9,1,True
7334275,1454,1,25,3295,518291536,0,0,0,242.93,8,947289.05,11,5,13,1,True
7482291,1449,0,30,6464,518291536,0,0,0,243.29,8,947045.76,11,5,22,3,True
7985144,512,0,25,4911,518291536,0,0,0,243.38,8,946802.38,12,4,5,4,True
8268457,462,4,451,5165,518291536,0,0,0,243.14,7,946559.24,13,2,22,7,True
8402886,512,0,-1,6405,518291536,0,1,0,243.22,4,946559.24,12,1,10,7,True
8514058,1065,0,10,3308,518291536,0,0,0,243.0,0,946802.24,11,3,20,7,True
8696728,1454,1,-1,1365,518291536,0,1,0,243.19,4,946802.24,11,6,23,8,True
8774211,462,4,-1,3460,518291536,0,2,0,243.09,4,946802.24,13,0,9,8,True
8778718,1217,0,25,6179,518291536,0,0,0,242.79,8,946559.45,24,5,14,8,True
8803398,503,0,30,8338,518291536,0,0,0,242.85,8,946316.6,12,2,21,9,True
8810134,1449,0,30,1180,518291536,0,0,0,243.02,8,946073.58,11,3,0,9,True
8850181,1454,1,30,4911,518291536,0,0,0,243.17,8,945830.41,11,2,1,9,True
9114766,512,0,25,5165,518291536,0,0,0,242.94,8,945587.47,12,2,23,10,True
9740014,1217,0,451,4735,518291536,0,0,0,242.92,7,945344.55,24,3,11,11,True
9904151,1264,0,20,6405,518291536,0,0,0,242.89,3,945101.66,23,5,9,11,True
1035434,1110,0,10,4412,685094766,1,0,0,206.85,6,209338.85,0,2,16,2,True
2093772,1454,1,-1,4412,685094766,1,1,0,207.04,4,209338.85,11,5,10,2,True
2187931,524,1,30,7750,685094766,1,0,0,206.91,8,209131.94,18,5,2,3,True
2263979,1454,1,30,2907,685094766,1,0,0,206.9,8,208925.04,11,6,4,3,True
2508260,267,0,20,4412,685094766,1,0,0,206.88,5,208718.16,6,2,10,4,True
3094069,911,3,30,8979,685094766,1,0,0,206.96,8,208511.2,18,3,10,4,True
3133552,1180,1,-1,1441,685094766,1,1,0,207.09,4,208511.2,24,3,12,5,True
3156296,911,3,451,9051,685094766,1,0,0,207.31,7,208303.89,18,3,16,5,True
3661480,1170,0,451,9053,685094766,1,0,0,207.05,7,208096.84,24,6,11,5,True
3894777,305,1,10,1441,685094766,1,0,0,206.83,6,208303.67,4,5,18,5,True
3993069,524,1,30,1441,685094766,1,0,0,206.78,8,208096.89,18,3,5,6,True
4007413,319,0,10,6747,685094766,1,0,0,206.76,6,208303.65,11,0,15,6,True
4198848,798,4,-1,6747,685094766,1,1,0,207.09,1,208303.65,11,1,9,7,True
4243903,1170,0,451,3944,685094766,1,0,0,207.22,7,208096.43,24,3,11,9,True
4510682,1454,1,-1,8838,685094766,1,1,0,206.76,4,208096.43,11,4,0,9,True
4896148,798,4,25,9053,685094766,1,0,0,207.12,8,207889.31,11,6,22,10,True
4937346,1090,0,25,7750,685094766,1,0,0,207.15,8,207682.16,18,4,4,10,True
4964578,1090,0,451,8838,685094766,1,0,0,207.07,7,207475.09,18,0,14,10,False
5161595,610,0,30,8767,685094766,1,0,0,207.06,8,207268.03,11,6,5,10,True
5261432,1454,1,-1,7750,685094766,1,1,0,206.86,4,207268.03,11,2,3,11,True
5687064,448,0,10,2453,685094766,1,0,0,206.78,6,207474.81,13,5,11,12,True
6127753,1180,1,-1,2907,685094766,1,1,0,207.01,4,207474.81,24,6,10,1,True
6185276,911,3,451,4615,685094766,1,0,0,207.09,7,207267.72,18,5,12,1,True
6218688,1181,2,20,1441,685094766,1,0,0,207.02,3,207060.7,24,0,0,2,True
6435344,1090,0,30,7750,685094766,1,0,0,207.3,8,206853.4,18,1,13,4,True
6514585,1090,0,25,4615,685094766,1,0,0,206.83,8,206646.57,18,5,5,4,True
6758842,911,3,451,9053,685094766,1,0,0,207.04,7,206439.53,18,1,15,6,True
7045369,522,0,10,2453,685094766,1,0,0,206.58,0,206646.11,18,3,1,8,True
7188690,204,0,20,4615,685094766,1,0,0,206.86,5,206439.25,9,1,16,8,True
7455510,1090,0,451,4615,685094766,1,0,0,206.75,7,206232.5,18,5,2,8,True
7457463,911,3,451,3944,685094766,1,0,0,207.16,7,206025.34,18,4,8,9,False
7494692,1180,1,30,3944,685094766,1,0,0,206.85,8,205818.49,24,3,6,9,False
7527688,610,0,25,6747,685094766,1,0,0,207.09,8,205611.4,11,5,15,10,True
7605406,656,2,20,3944,685094766,1,0,0,207.1,3,205404.3,18,3,5,10,True
7647646,911,3,-1,4412,685094766,1,1,0,207.07,4,205404.3,18,4,11,12,True
7681893,610,0,451,6747,685094766,1,0,0,207.11,7,205197.19,11,4,6,12,False
7693778,1454,1,451,9622,685094766,1,0,0,206.91,7,204990.28,11,1,14,1,False
8204951,1170,0,25,4615,685094766,1,0,0,207.15,8,204783.13,24,1,3,2,True
8207136,524,1,25,3944,685094766,1,0,0,206.73,8,204576.4,18,0,23,2,False
8667520,610,0,451,7070,685094766,1,0,0,206.88,7,204369.52,11,5,13,2,True
8733184,369,1,10,8979,685094766,1,0,0,206.91,6,204576.43,25,2,19,4,True
9069889,1364,0,20,7070,685094766,1,0,0,207.12,3,204369.31,16,2,0,5,True
9071906,798,4,451,4800,685094766,1,0,0,207.02,7,204162.29,11,0,19,6,True
9216469,1180,1,25,3944,685094766,1,0,0,207.14,8,203955.15,24,1,20,6,True
9435156,824,2,20,1441,685094766,1,0,0,206.92,5,203748.23,18,4,8,7,True
9477351,1090,0,30,9053,685094766,1,0,0,207.06,8,203541.17,18,6,20,8,True
9550091,1170,0,25,1441,685094766,1,0,0,207.14,8,203334.03,24,5,15,8,True
9645513,1454,1,30,8767,685094766,1,0,0,206.72,8,203127.31,11,3,17,9,True
9698942,610,0,25,6747,685094766,1,0,0,206.84,8,202920.47,11,5,15,9,True
9789692,524,1,-1,2907,685094766,1,1,0,206.8,4,202920.47,18,5,12,11,True
1038658,78,3,25,2654,714847198,1,0,0,428.18,8,343501.82,1,6,23,1,True
1311392,835,4,451,4951,714847198,1,0,0,428.07,7,343073.75,5,5,1,1,False
1362702,499,3,451,6300,714847198,1,0,0,427.57,7,342646.18,12,4,19,1,True
1637307,78,3,30,2654,714847198,1,0,0,427.77,8,342218.41,1,1,0,1,True
1672241,658,4,25,1942,714847198,1,0,0,427.95,8,341790.46,18,3,15,1,True
1893924,715,0,20,6668,714847198,1,0,0,427.86,3,341362.6,18,2,0,2,True
1909351,78,3,30,1286,714847198,1,0,0,427.98,8,340934.62,1,3,9,2,True
2176223,759,0,20,6221,714847198,1,0,0,427.74,5,340506.88,24,3,1,2,True
2220763,314,0,10,3945,714847198,1,0,0,428.11,0,340934.99,4,3,18,2,True
2665038,194,1,10,4951,714847198,1,0,0,428.02,6,341363.01,18,6,22,2,True
2712726,907,0,30,7015,714847198,1,0,0,427.54,8,340935.47,2,2,21,2,True
2818280,499,3,451,1845,714847198,1,0,0,428.01,7,340507.46,12,4,2,3,True
2881562,78,3,451,4951,714847198,1,0,0,427.91,7,340079.55,1,1,13,3,True
2904595,97,0,10,2914,714847198,1,0,0,427.7,6,340507.25,3,3,13,3,True
3187675,262,2,20,4951,714847198,1,0,0,427.92,5,340079.33,6,3,20,4,True
3188352,499,3,451,6221,714847198,1,0,0,427.9,7,339651.43,12,4,16,7,True
3264894,658,4,30,3945,714847198,1,0,0,427.91,8,339223.52,18,4,23,8,True
3835892,78,3,-1,4951,714847198,1,1,0,428.04,4,339223.52,1,6,21,9,True
4170805,658,4,25,4951,714847198,1,0,0,428.25,8,338795.27,18,1,1,9,True
4221879,835,4,451,6221,714847198,1,0,0,428.11,7,338367.16,5,3,22,11,True
4401728,658,4,451,9559,714847198,1,0,0,428.01,7,337939.15,18,1,3,12,True
4939174,274,1,10,9955,714847198,1,0,0,428.12,6,338367.27,24,2,12,4,True
5111656,78,3,451,6221,714847198,1,0,0,428.23,7,337939.04,1,6,8,5,True
5338253,835,4,30,2914,714847198,1,0,0,428.07,8,337510.97,5,5,14,5,True
5482178,411,2,20,8262,714847198,1,0,0,428.03,3,337082.94,18,1,13,5,True
5715399,835,4,30,9955,714847198,1,0,0,428.26,8,336654.68,5,0,4,5,True
5876838,658,4,451,8694,714847198,1,0,0,428.25,7,336226.43,18,2,18,6,False
5939632,499,3,451,6221,714847198,1,0,0,427.84,7,335798.59,12,4,6,6,True
5992269,1272,0,10,9955,714847198,1,0,0,428.06,6,336226.65,24,6,7,7,True
5999581,160,0,10,8262,714847198,1,0,0,427.95,6,336654.6,24,2,18,7,True
6022166,658,4,-1,8262,714847198,1,1,0,427.98,4,336654.6,18,6,5,8,True
6162296,658,4,451,8262,714847198,1,0,0,427.72,7,336226.88,18,6,10,9,True
6219994,155,1,30,9955,714847198,1,0,0,427.88,8,335799.0,18,1,17,9,True
7107910,499,3,25,8694,714847198,1,0,0,428.04,8,335370.96,12,5,21,9,True
7380758,658,4,-1,3945,714847198,1,1,0,428.17,1,335370.96,18,4,14,10,True
7422144,907,0,451,6300,714847198,1,0,0,427.95,7,334943.01,2,1,20,10,True
7573346,260,0,10,1942,714847198,1,0,0,427.89,0,335370.9,6,3,22,12,True
7583262,78,3,30,2914,714847198,1,0,0,428.21,8,334942.69,1,5,14,2,True
7764159,835,4,451,1942,714847198,1,0,0,428.01,7,334514.68,5,4,2,4,True
8037608,907,0,451,1286,714847198,1,0,0,428.02,7,334086.66,2,0,16,5,True
8175008,499,3,-1,2914,714847198,1,1,0,428.14,4,334086.66,12,4,3,5,True
8352320,835,4,25,6221,714847198,1,0,0,428.06,8,333658.6,5,2,19,5,True
8374339,658,4,451,8694,714847198,1,0,0,427.82,7,333230.78,18,0,2,5,True
8451391,194,1,10,1942,714847198,1,0,0,428.14,6,333658.92,18,2,16,5,True
8900490,907,0,25,8739,714847198,1,0,0,427.9,8,333231.02,2,3,10,5,True
8931447,907,0,-1,4951,714847198,1,1,0,428.02,1,333231.02,2,1,7,9,True
9157038,907,0,25,6221,714847198,1,0,0,428.0,8,332803.02,2,1,22,9,True
9503632,819,2,20,9955,714847198,1,0,0,427.9,5,332375.12,18,5,6,9,True
9592275,78,3,25,9559,714847198,1,0,0,427.9,8,331947.22,1,0,7,10,True
9745482,394,0,10,7015,714847198,1,0,0,428.03,6,332375.25,10,3,16,11,False
1128693,1399,0,20,6151,222759098,0,0,0,247.87,3,377584.13,24,5,12,1,True
1263656,736,1,451,6828,222759098,0,0,0,248.01,7,377336.12,11,6,11,1,True
1436648,1399,0,-1,6828,222759098,0,1,0,247.93,4,377336.12,24,4,4,1,True
1448454,655,3,30,9646,222759098,0,0,0,248.09,8,377088.03,18,3,9,2,True
1533500,655,3,-1,2797,222759098,0,1,0,247.9,4,377088.03,18,3,22,3,True
1792417,1111,0,25,2923,222759098,0,0,0,247.83,8,376840.2,0,3,0,3,True
1988207,1189,2,451,4439,222759098,0,0,0,248.02,7,376592.18,24,3,23,3,True
2153153,736,1,30,9797,222759098,0,0,0,248.1,8,376344.08,11,5,3,4,True
2313226,1384,4,25,6151,222759098,0,0,0,247.79,8,376096.29,24,5,20,4,True
2499126,736,1,451,5952,222759098,0,0,0,248.07,7,375848.22,11,4,23,4,True
2569861,736,1,451,2311,222759098,0,0,0,248.18,7,375600.04,11,2,1,8,True
2574514,1399,0,451,8620,222759098,0,0,0,248.04,7,375352.0,24,0,9,9,True
2587518,1064,0,20,8620,222759098,0,0,0,248.02,5,375103.98,11,5,20,10,True
2681780,1384,4,30,7214,222759098,0,0,0,247.93,8,374856.05,24,0,12,11,True
2930378,1111,0,25,9646,222759098,0,0,0,247.89,8,374608.16,0,5,22,12,True
2992286,1111,0,-1,2797,222759098,0,1,0,248.1,4,374608.16,0,1,12,12,True
3202109,655,3,25,2495,222759098,0,0,0,248.18,8,374359.98,18,6,23,12,True
3254306,260,0,10,7187,222759098,0,0,0,248.31,6,374608.29,6,1,8,1,True
3441861,655,3,25,7187,222759098,0,0,0,247.97,8,374360.32,18,0,10,2,True
3763953,215,0,20,2797,222759098,0,0,0,247.88,5,374112.44,9,0,18,2,True
3903600,1189,2,451,5952,222759098,0,0,0,247.89,7,373864.55,24,3,17,2,True
3904179,736,1,25,3790,222759098,0,0,0,248.04,8,373616.51,11,4,19,2,True
3981069,416,2,20,5952,222759098,0,0,0,247.88,5,373368.63,18,4,22,3,True
4223489,1189,2,25,9245,222759098,0,0,0,247.88,8,373120.75,24,1,7,3,True
4501964,1189,2,30,6828,222759098,0,0,0,248.12,8,372872.63,24,2,5,3,True
4764017,1189,2,30,3531,222759098,0,0,0,248.17,8,372624.46,24,2,22,4,True
4783021,1189,2,-1,2535,222759098,0,1,0,247.82,4,372624.46,24,0,22,7,True
5197049,1189,2,-1,3790,222759098,0,2,0,248.17,1,372624.46,24,5,5,7,True
5260423,1399,0,451,6151,222759098,0,0,0,247.88,7,372376.58,24,0,4,8,True
5697280,1384,4,451,3851,222759098,0,0,0,248.0,7,372128.58,24,1,3,8,True
5788113,980,1,10,1077,222759098,0,0,0,248.04,6,372376.62,22,1,16,8,True
6183873,1488,0,10,2311,222759098,0,0,0,248.03,6,372624.65,24,2,0,9,False
6436015,736,1,-1,2923,222759098,0,1,0,247.82,1,372624.65,11,0,17,10,True
6979267,1384,4,451,8620,222759098,0,0,0,248.03,7,372376.62,24,6,6,10,True
7128260,736,1,451,2495,222759098,0,0,0,247.92,7,372128.7,11,1,18,10,True
7274761,611,0,20,5952,222759098,0,0,0,248.17,3,371880.53,11,1,12,10,True
7443061,1399,0,451,4398,222759098,0,0,0,247.7,7,371632.83,24,4,11,12,True
7557965,655,3,451,6151,222759098,0,0,0,248.16,7,371384.67,18,5,11,1,True
7687661,644,0,10,9646,222759098,0,0,0,247.81,6,371632.48,24,5,11,1,True
8048202,655,3,30,4843,222759098,0,0,0,248.06,8,371384.42,18,3,3,1,True
8222347,1189,2,451,6828,222759098,0,0,0,247.99,7,371136.43,24,2,17,1,False
8262666,1189,2,451,9664,222759098,0,0,0,247.99,7,370888.44,24,0,13,3,True
8358818,570,2,20,7633,222759098,0,0,0,247.87,3,370640.57,11,1,9,3,True
8405931,1189,2,-1,9535,222759098,0,1,0,248.17,4,370640.57,24,2,13,4,True
8518320,1017,2,451,5952,222759098,0,0,0,247.88,7,370392.69,26,6,2,4,True
8655259,1175,2,20,2797,222759098,0,0,0,248.04,5,370144.65,24,6,10,5,True
8680937,655,3,30,8620,222759098,0,0,0,247.97,8,369896.68,18,5,3,6,False
8927114,655,3,451,6151,222759098,0,0,0,248.0,7,369648.68,18,3,8,6,True
9101901,1017,2,30,6890,222759098,0,0,0,247.82,8,369400.86,26,4,5,7,True
9186558,1384,4,30,9245,222759098,0,0,0,248.01,8,369152.85,24,4,0,8,True
9208202,714,2,20,4439,222759098,0,0,0,248.1,3,368904.75,18,6,17,8,True
9334308,497,0,10,7633,222759098,0,0,0,247.66,0,369152.41,12,0,3,10,True
9785649,736,1,451,7633,222759098,0,0,0,247.56,7,368904.85,11,5,15,11,True
9847882,378,0,20,9535,222759098,0,0,0,248.06,5,368656.79,25,0,0,11,True
9857495,1399,0,-1,4398,222759098,0,1,0,247.9,1,368656.79,24,2,5,11,True
1127215,1252,4,451,2239,664222450,0,0,0,758.79,7,403264.21,23,3,10,1,True
1439450,449,4,25,1335,664222450,0,0,0,758.87,8,402505.34,13,6,5,2,True
1927548,1010,0,10,7189,664222450,0,0,0,759.4,0,403264.74,26,0,5,2,True
1937260,1285,1,30,4073,664222450,0,0,0,758.89,8,402505.85,24,2,16,2,True
2518687,1436,0,10,1335,664222450,0,0,0,759.05,0,403264.9,24,1,8,3,True
2896032,1159,0,20,3498,664222450,0,0,0,758.98,5,402505.92,15,0,0,5,True
2988688,429,0,20,7269,664222450,0,0,0,758.97,5,401746.95,24,2,14,5,True
3092484,1069,1,-1,6919,664222450,0,1,0,759.06,1,401746.95,18,2,22,6,True
3102521,913,0,20,9404,664222450,0,0,0,758.75,3,400988.2,18,6,3,6,True
3267568,818,1,10,8840,664222450,0,0,0,759.06,6,401747.26,18,3,6,7,True
3337420,427,2,20,2239,664222450,0,0,0,758.9,5,400988.36,18,5,16,7,True
3388863,1069,1,30,2239,664222450,0,0,0,758.77,8,400229.59,18,1,16,8,True
3669584,1285,1,-1,9404,664222450,0,1,0,758.85,4,400229.59,24,2,4,9,True
3800019,1069,1,10,8035,664222450,0,0,0,758.97,6,400988.56,18,5,1,10,True
3809878,1285,1,451,8461,664222450,0,0,0,758.9,7,400229.66,24,5,13,10,True
3874165,1235,1,10,9221,664222450,0,0,0,759.08,6,400988.74,18,3,17,10,True
4013384,1252,4,30,4849,664222450,0,0,0,759.23,8,400229.51,23,2,7,12,True
4058617,449,4,25,6876,664222450,0,0,0,759.1,8,399470.41,13,3,23,12,True
4625808,1285,1,451,2239,664222450,0,0,0,758.91,7,398711.5,24,6,10,12,True
4639502,1252,4,25,8840,664222450,0,0,0,758.87,8,397952.63,23,1,11,12,True
4925897,1312,0,20,8035,664222450,0,0,0,758.96,5,397193.67,5,5,5,2,True
5142543,1380,0,20,3976,664222450,0,0,0,758.94,3,396434.73,16,0,9,3,True
5153947,1252,4,451,3976,664222450,0,0,0,758.95,7,395675.78,23,4,6,3,True
5335182,1252,4,30,4073,664222450,0,0,0,758.86,8,394916.92,23,5,21,4,True
5433344,436,4,30,5477,664222450,0,0,0,759.06,8,394157.86,24,1,0,4,True
6106550,728,1,25,4849,664222450,0,0,0,759.02,8,393398.84,11,6,18,6,True
6220267,1285,1,25,4073,664222450,0,0,0,759.07,8,392639.77,24,5,3,6,True
6477039,535,0,10,7590,664222450,0,0,0,758.96,6,393398.73,18,1,18,6,True
6525618,436,4,25,9221,664222450,0,0,0,759.05,8,392639.68,24,5,23,7,True
6556112,1285,1,-1,7189,664222450,0,1,0,759.09,1,392639.68,24,4,2,7,True
6731441,1285,1,30,4849,664222450,0,0,0,758.83,8,391880.85,24,2,23,8,True
6839914,449,4,30,8461,664222450,0,0,0,758.92,8,391121.93,13,0,17,8,True
6902865,1069,1,451,3976,664222450,0,0,0,759.09,7,390362.84,18,5,21,11,True
7180441,449,4,30,6919,664222450,0,0,0,759.08,8,389603.76,13,5,23,11,True
7401599,1271,0,20,5385,664222450,0,0,0,758.97,5,388844.79,23,6,13,12,True
7451212,449,4,25,3976,664222450,0,0,0,758.85,8,388085.94,13,1,2,12,True
7524665,1252,4,-1,8035,664222450,0,1,0,759.1,1,388085.94,23,0,12,1,True
7591168,1252,4,25,3498,664222450,0,0,0,758.96,8,387326.98,23,3,11,2,True
7959203,1285,1,451,7189,664222450,0,0,0,758.94,7,386568.04,24,5,4,2,True
8018071,1069,1,-1,3976,664222450,0,1,0,759.17,4,386568.04,18,1,9,2,True
8210034,41,2,20,9221,664222450,0,0,0,758.97,5,385809.07,11,2,22,5,True
8241060,1285,1,30,4073,664222450,0,0,0,758.79,8,385050.28,24,0,18,5,True
8562878,996,0,20,1335,664222450,0,0,0,759.21,5,384291.07,26,2,13,5,True
8689662,777,3,25,8035,664222450,0,0,0,759.01,8,383532.06,14,1,8,6,True
8771626,1069,1,25,4849,664222450,0,0,0,758.99,8,382773.07,18,6,16,6,True
8815976,944,2,20,7189,664222450,0,0,0,759.15,5,382013.92,24,5,5,6,True
9152178,1382,0,20,6876,664222450,0,0,0,758.93,5,381254.99,16,2,2,6,False
9210041,1285,1,451,8840,664222450,0,0,0,758.89,7,380496.1,24,5,18,8,True
9228904,1069,1,30,4073,664222450,0,0,0,759.01,8,379737.09,18,6,3,8,True
9331432,728,1,25,9404,664222450,0,0,0,758.94,8,378978.15,11,6,19,8,True
9543145,205,0,10,1335,664222450,0,0,0,758.87,0,379737.02,9,0,17,10,True
9584747,449,4,451,8035,664222450,0,0,0,758.85,7,378978.17,13,6,5,10,True
9697986,449,4,-1,5385,664222450,0,1,0,759.19,1,378978.17,13,0,22,11,True
1158170,689,0,20,4683,506756228,0,0,0,1050.01,5,315971.99,24,5,15,1,True
1161680,594,0,30,7915,506756228,0,0,0,1050.11,8,314921.88,24,5,14,1,True
1459197,144,1,10,4636,506756228,0,0,0,1050.09,6,315971.97,18,6,2,2,True
1592805,398,0,20,9179,506756228,0,0,0,1049.68,3,314922.29,10,2,19,2,True
2009800,594,0,451,9624,506756228,0,0,0,1050.06,7,313872.23,24,0,2,3,True
2101180,1465,4,25,2998,506756228,0,0,0,1050.14,8,312822.09,11,3,15,4,True
2523154,816,0,25,4532,506756228,0,0,0,1050.12,8,311771.97,18,6,2,5,True
2934278,989,1,10,1712,506756228,0,0,0,1049.8,6,312821.77,22,5,3,5,True
2945897,203,0,10,7316,506756228,0,0,0,1050.09,6,313871.86,9,3,23,6,True
3056821,1451,1,10,4868,506756228,0,0,0,1050.23,6,314922.09,11,0,1,7,True
3139067,406,1,451,5214,506756228,0,0,0,1049.81,7,313872.28,10,0,10,8,True
3195145,1127,0,20,2334,506756228,0,0,0,1049.88,5,312822.4,24,6,12,8,True
3423219,406,1,30,4868,506756228,0,0,0,1049.84,8,311772.56,10,4,17,8,True
3624975,594,0,25,4868,506756228,0,0,0,1050.02,8,310722.54,24,0,5,9,True
3649567,726,0,20,2334,506756228,0,0,0,1049.98,5,309672.56,11,0,6,10,True
3887433,406,1,30,5214,506756228,0,0,0,1049.97,8,308622.59,10,5,7,11,True
4146667,816,0,451,2998,506756228,0,0,0,1049.98,7,307572.61,18,3,17,1,True
4179342,744,4,451,4636,506756228,0,0,0,1050.22,7,306522.39,24,5,12,1,True
4219862,373,1,10,2998,506756228,0,0,0,1050.02,6,307572.41,25,6,17,2,True
4246695,744,4,451,4341,506756228,0,0,0,1050.06,7,306522.35,24,0,21,3,True
4324066,1132,0,20,7738,506756228,0,0,0,1050.11,3,305472.24,24,2,12,3,True
4419988,406,1,25,2911,506756228,0,0,0,1050.04,8,304422.2,10,3,18,4,True
4478021,1488,0,20,4868,506756228,0,0,0,1049.81,3,303372.39,24,0,12,4,True
4554282,806,1,10,8974,506756228,0,0,0,1049.9,0,304422.29,11,6,19,4,True
4661614,816,0,25,7995,506756228,0,0,0,1050.1,8,303372.19,18,2,20,5,True
4861113,406,1,-1,7915,506756228,0,1,0,1050.0,1,303372.19,10,4,16,5,True
5231748,287,0,20,4532,506756228,0,0,0,1050.06,5,302322.13,24,1,2,5,True
5436720,594,0,-1,9179,506756228,0,1,0,1050.13,4,302322.13,24,3,7,6,True
5436906,1465,4,-1,7316,506756228,0,2,0,1050.14,1,302322.13,11,5,6,6,True
5792895,816,0,25,2334,506756228,0,0,0,1049.52,8,301272.61,18,1,9,6,True
5898416,744,4,-1,4683,506756228,0,1,0,1050.08,1,301272.61,24,6,17,7,True
6364013,406,1,25,9624,506756228,0,0,0,1050.21,8,300222.4,10,4,0,7,True
6392977,406,1,451,4683,506756228,0,0,0,1050.07,7,299172.33,10,6,2,7,False
6411959,816,0,451,5214,506756228,0,0,0,1049.98,7,298122.35,18,6,12,8,False
6549600,816,0,25,7915,506756228,0,0,0,1050.14,8,297072.21,18,2,11,8,True
6761977,744,4,-1,2334,506756228,0,1,0,1050.04,1,297072.21,24,4,13,8,True
6918053,804,0,20,4341,506756228,0,0,0,1049.78,5,296022.43,11,2,11,9,True
7098368,594,0,451,9179,506756228,0,0,0,1050.08,7,294972.35,24,1,23,9,True
7227273,816,0,451,2998,506756228,0,0,0,1049.98,7,293922.37,18,6,11,10,True
7660442,594,0,30,2998,506756228,0,0,0,1049.98,8,292872.39,24,4,18,10,True
7717576,480,0,20,2911,506756228,0,0,0,1050.16,5,291822.23,5,5,6,10,True
7722482,594,0,30,4532,506756228,0,0,0,1050.01,8,290772.22,24,0,10,1,True
7876293,406,1,451,9624,506756228,0,0,0,1050.08,7,289722.14,10,2,18,2,True
8253759,816,0,451,4532,506756228,0,0,0,1049.89,7,288672.25,18,1,11,2,True
8416642,95,2,20,6363,506756228,0,0,0,1049.85,3,287622.4,1,2,2,3,True
8670079,1465,4,451,8974,506756228,0,0,0,1050.08,7,286572.32,11,1,22,3,False
8670810,816,0,451,7590,506756228,0,0,0,1049.72,7,285522.6,18,5,9,5,True
8695357,744,4,25,7915,506756228,0,0,0,1050.02,8,284472.58,24,3,1,5,True
8729812,816,0,-1,4868,506756228,0,1,0,1049.93,4,284472.58,18,0,9,7,True
9244403,816,0,25,1712,506756228,0,0,0,1050.1,8,283422.48,18,6,13,8,True
9392213,594,0,30,9624,506756228,0,0,0,1049.75,8,282372.73,24,5,0,11,True
9392854,594,0,-1,7738,506756228,0,1,0,1049.98,4,282372.73,24,5,16,11,False
9787631,816,0,451,6363,506756228,0,0,0,1050.01,7,281322.72,18,2,12,11,True
9948313,406,1,451,7316,506756228,0,0,0,1050.01,7,280272.71,10,5,11,11,True
1186824,195,1,10,3553,415567499,1,0,0,996.19,6,672539.19,18,4,15,1,True
1234967,303,0,30,3134,415567499,1,0,0,996.04,8,671543.15,4,1,19,1,True
1684884,303,0,30,4851,415567499,1,0,0,995.95,8,670547.2,4,6,4,2,True
1970015,84,4,-1,7572,415567499,1,1,0,995.85,4,670547.2,1,4,12,3,True
1972615,238,0,20,7572,415567499,1,0,0,996.14,3,669551.06,26,3,11,3,True
2016016,988,3,25,6079,415567499,1,0,0,996.15,8,668554.91,22,2,14,4,True
2136219,1483,0,10,4441,415567499,1,0,0,995.8,0,669550.71,24,1,1,5,True
2193104,84,4,25,6634,415567499,1,0,0,996.09,8,668554.62,1,2,5,6,True
2655408,1431,4,-1,4726,415567499,1,1,0,996.03,1,668554.62,24,5,22,7,True
2743171,956,1,10,2984,415567499,1,0,0,996.05,6,669550.67,13,2,22,8,True
3290812,1467,0,30,6114,415567499,1,0,0,996.12,8,668554.55,11,4,22,8,True
3599565,84,4,-1,7572,415567499,1,1,0,996.07,1,668554.55,1,6,21,9,True
3658114,1431,4,25,2984,415567499,1,0,0,996.0,8,667558.55,24,6,2,9,True
3794859,988,3,30,6114,415567499,1,0,0,996.17,8,666562.38,22,2,1,10,True
3810591,21,0,20,6114,415567499,1,0,0,995.89,3,665566.49,11,5,3,10,True
3964217,988,3,451,6201,415567499,1,0,0,996.02,7,664570.47,22,5,12,10,True
4117783,942,0,20,3720,415567499,1,0,0,996.08,5,663574.39,24,4,10,10,True
4262678,303,0,451,7847,415567499,1,0,0,995.99,7,662578.4,4,5,3,10,True
4500584,1338,0,20,8685,415567499,1,0,0,996.08,5,661582.32,18,3,2,11,True
4927137,1431,4,25,3720,415567499,1,0,0,995.88,8,660586.44,24,6,19,11,True
5149268,1007,2,20,4851,415567499,1,0,0,995.94,5,659590.5,26,0,8,11,True
5234135,114,0,10,9736,415567499,1,0,0,995.68,6,660586.18,3,6,23,12,True
5238009,988,3,30,6201,415567499,1,0,0,996.01,8,659590.17,22,2,18,12,True
5241316,1289,1,10,8951,415567499,1,0,0,995.91,0,660586.08,24,3,20,3,True
5376670,988,3,-1,2288,415567499,1,1,0,995.92,1,660586.08,22,3,18,3,True
5533609,84,4,451,9138,415567499,1,0,0,995.88,7,659590.2,1,0,17,4,True
5536695,1431,4,25,3720,415567499,1,0,0,995.86,8,658594.34,24,3,14,6,True
6151097,84,4,451,3529,415567499,1,0,0,995.77,7,657598.57,1,5,10,8,True
6151187,84,4,451,5149,415567499,1,0,0,995.81,7,656602.76,1,5,13,8,True
6349667,1467,0,451,8760,415567499,1,0,0,995.95,7,655606.81,11,0,22,10,True
6449376,303,0,-1,4651,415567499,1,1,0,995.83,4,655606.81,4,0,23,10,True
6892747,988,3,25,4441,415567499,1,0,0,995.91,8,654610.9,22,1,7,10,True
6902011,988,3,25,9608,415567499,1,0,0,996.12,8,653614.78,22,2,7,11,True
6947930,1431,4,25,4651,415567499,1,0,0,995.96,8,652618.82,24,1,16,11,True
7204008,303,0,451,3134,415567499,1,0,0,996.0,7,651622.82,4,4,2,12,True
7523701,84,4,451,4651,415567499,1,0,0,996.13,7,650626.69,1,5,3,12,False
7802139,84,4,451,9736,415567499,1,0,0,995.85,7,649630.84,1,1,21,1,True
8000180,97,0,20,3134,415567499,1,0,0,996.0,3,648634.84,3,1,11,1,True
8449322,783,0,10,5149,415567499,1,0,0,996.14,0,649630.98,14,2,14,2,True
8508694,346,0,10,3529,415567499,1,0,0,996.06,6,650627.04,24,3,9,2,True
8972325,84,4,-1,4726,415567499,1,1,0,996.01,4,650627.04,1,2,9,4,True
8981949,1431,4,30,9608,415567499,1,0,0,995.83,8,649631.21,24,6,23,4,True
9104165,303,0,25,5149,415567499,1,0,0,996.17,8,648635.04,4,3,20,6,True
9193469,988,3,451,6823,415567499,1,0,0,995.79,7,647639.25,22,4,5,7,True
9564940,1467,0,25,3529,415567499,1,0,0,995.91,8,646643.34,11,5,12,8,True
9568310,303,0,451,9608,415567499,1,0,0,995.75,7,645647.59,4,0,1,8,True
9686746,1431,4,451,4851,415567499,1,0,0,995.92,7,644651.67,24,0,0,9,True
9730538,1467,0,25,4221,415567499,1,0,0,995.93,8,643655.74,11,0,23,9,True
9760963,249,0,10,6079,415567499,1,0,0,995.75,6,644651.49,6,5,0,10,True
9813060,303,0,25,3134,415567499,1,0,0,996.22,8,643655.27,4,4,11,10,True
9823533,303,0,30,2984,415567499,1,0,0,995.75,8,642659.52,4,4,11,10,True
9879405,1431,4,25,4441,415567499,1,0,0,995.94,8,641663.58,24,2,3,11,True
1111761,520,4,451,9201,580695204,0,0,0,187.17,7,646329.83,18,0,12,1,True
1172182,1422,1,-1,3384,580695204,0,1,0,187.0,4,646329.83,24,0,6,3,True
1385074,713,0,10,5629,580695204,0,0,0,187.04,6,646516.87,18,1,1,4,True
1452296,134,4,30,5339,580695204,0,0,0,186.86,8,646330.01,18,4,3,4,True
1495849,470,1,10,5983,580695204,0,0,0,186.97,6,646516.98,5,6,6,5,True
1498990,134,4,451,6420,580695204,0,0,0,187.14,7,646329.84,18,5,1,5,True
1542585,1163,4,30,5468,580695204,0,0,0,186.95,8,646142.89,24,1,0,6,True
1568884,862,4,30,4948,580695204,0,0,0,186.94,8,645955.95,24,1,6,7,True
1582795,134,4,30,6695,580695204,0,0,0,186.94,8,645769.01,18,6,2,8,True
1646641,1239,1,10,9201,580695204,0,0,0,187.16,6,645956.17,18,4,9,8,True
1741559,1271,0,10,6333,580695204,0,0,0,187.11,6,646143.28,23,0,20,8,True
2034055,703,0,20,3471,580695204,0,0,0,187.22,5,645956.06,18,3,3,9,True
2192349,1422,1,25,8042,580695204,0,0,0,186.8,8,645769.26,24,3,3,10,True
2662954,1409,1,10,6333,580695204,0,0,0,187.15,0,645956.41,24,2,7,10,True
2751593,883,0,20,5629,580695204,0,0,0,187.03,5,645769.38,24,3,2,11,True
2765896,862,4,30,5983,580695204,0,0,0,186.92,8,645582.46,24,1,15,12,True
3162031,1422,1,25,5983,580695204,0,0,0,186.95,8,645395.51,24,4,0,1,True
3268305,862,4,451,7461,580695204,0,0,0,186.86,7,645208.65,24,2,10,1,True
3401692,134,4,30,6403,580695204,0,0,0,186.96,8,645021.69,18,0,2,1,True
3910001,862,4,451,1459,580695204,0,0,0,186.92,7,644834.77,24,3,19,2,True
4214795,1163,4,25,5714,580695204,0,0,0,186.93,8,644647.84,24,0,18,2,True
4448959,1179,0,10,3322,580695204,0,0,0,186.69,6,644834.53,24,1,5,2,True
4459700,179,4,25,1459,580695204,0,0,0,187.07,8,644647.46,24,0,14,5,True
4777224,179,4,30,3570,580695204,0,0,0,186.87,8,644460.59,24,4,20,5,True
5043566,1422,1,451,8042,580695204,0,0,0,187.23,7,644273.36,24,3,13,6,True
5092556,862,4,-1,3322,580695204,0,1,0,187.01,4,644273.36,24,6,2,7,True
5099582,626,2,20,3570,580695204,0,0,0,187.21,5,644086.15,11,1,1,8,True
5455151,1422,1,25,3471,580695204,0,0,0,186.96,8,643899.19,24,6,18,9,True
5558072,179,4,-1,8042,580695204,0,1,0,187.11,4,643899.19,24,2,22,9,True
5798994,1163,4,451,8042,580695204,0,0,0,186.94,7,643712.25,24,4,0,9,True
5892345,1422,1,25,4512,580695204,0,0,0,186.78,8,643525.47,24,5,10,9,True
5949214,862,4,30,1974,580695204,0,0,0,186.83,8,643338.64,24,1,11,9,True
6119665,134,4,451,3384,580695204,0,0,0,186.86,7,643151.78,18,0,13,10,True
6173585,862,4,30,5468,580695204,0,0,0,186.65,8,642965.13,24,2,19,10,True
6559332,862,4,25,6333,580695204,0,0,0,187.26,8,642777.87,24,3,1,10,True
6640291,1169,0,10,5805,580695204,0,0,0,186.85,6,642964.72,24,3,18,10,True
6752815,879,1,10,9085,580695204,0,0,0,187.02,6,643151.74,27,6,2,11,True
6900269,520,4,30,5629,580695204,0,0,0,186.91,8,642964.83,18,6,10,12,True
7266153,1422,1,30,5805,580695204,0,0,0,186.71,8,642778.12,24,1,6,12,True
7313048,1471,0,20,4512,580695204,0,0,0,186.83,5,642591.29,24,6,6,2,True
7411224,134,4,30,3471,580695204,0,0,0,187.02,8,642404.27,18,0,22,3,True
7623474,862,4,25,9085,580695204,0,0,0,186.94,8,642217.33,24,5,13,3,True
7637444,46,1,10,5339,580695204,0,0,0,187.06,6,642404.39,24,1,20,4,True
7789965,862,4,30,9201,580695204,0,0,0,187.07,8,642217.32,24,3,16,4,True
7816941,134,4,451,6695,580695204,0,0,0,186.64,7,642030.68,18,6,0,5,True
7909164,916,0,10,9201,580695204,0,0,0,187.1,6,642217.78,18,6,7,6,True
8013908,520,4,451,3384,580695204,0,0,0,187.0,7,642030.78,18,2,3,6,True
8082439,862,4,-1,6403,580695204,0,1,0,187.12,1,642030.78,24,1,9,6,True
8095565,179,4,25,8042,580695204,0,0,0,186.86,8,641843.92,24,1,3,6,True
8265674,1163,4,451,3570,580695204,0,0,0,187.28,7,641656.64,24,4,8,7,True
8401531,1422,1,30,4948,580695204,0,0,0,187.16,8,641469.48,24,3,23,8,True
8404618,520,4,30,7461,580695204,0,0,0,186.84,8,641282.64,18,4,22,9,True
8666541,179,4,451,1459,580695204,0,0,0,187.1,7,641095.54,24,2,9,9,True
9044172,862,4,30,9085,580695204,0,0,0,186.98,8,640908.56,24,2,11,9,True
9622777,179,4,-1,3384,580695204,0,1,0,187.0,4,640908.56,24,6,7,9,True
9789356,895,0,20,7461,580695204,0,0,0,187.05,3,640721.51,24,5,5,11,True
9896750,1163,4,451,9201,580695204,0,0,0,187.0,7,640534.51,24,1,23,11,True
1147839,1162,2,20,4373,246195060,1,0,0,714.84,3,758279.16,24,5,11,1,True
1219697,424,1,10,6660,246195060,1,0,0,714.94,6,758994.1,18,5,9,1,True
1384176,1133,4,-1,1006,246195060,1,1,0,715.01,4,758994.1,24,2,12,1,True
1599665,820,1,451,4251,246195060,1,0,0,715.22,7,758278.88,18,0,15,1,True
1997785,1072,0,451,5143,246195060,1,0,0,715.19,7,757563.69,18,1,6,2,True
2268547,1413,0,20,2427,246195060,1,0,0,714.91,5,756848.78,24,2,17,3,True
2391488,1103,4,451,4373,246195060,1,0,0,714.97,7,756133.81,0,2,16,4,False
2432452,792,1,10,5780,246195060,1,0,0,714.76,6,756848.57,11,3,22,5,True
2753068,857,1,10,7864,246195060,1,0,0,715.12,6,757563.69,24,1,20,5,True
3237691,820,1,451,8319,246195060,1,0,0,715.3,7,756848.39,18,4,17,5,True
3362906,1103,4,451,7370,246195060,1,0,0,715.27,7,756133.12,0,1,12,6,True
3473044,378,0,20,7768,246195060,1,0,0,715.11,5,755418.01,25,3,23,7,True
3744441,1072,0,30,9455,246195060,1,0,0,714.96,8,754703.05,18,4,17,8,True
3986536,1206,0,10,2427,246195060,1,0,0,715.06,0,755418.11,24,4,22,8,True
4021845,122,3,451,2610,246195060,1,0,0,715.11,7,754703.0,18,6,17,9,True
4518596,937,0,10,5133,246195060,1,0,0,715.14,6,755418.14,24,2,20,9,True
4873779,820,1,30,1676,246195060,1,0,0,714.84,8,754703.3,18,5,15,9,True
5059831,732,0,-1,8319,246195060,1,1,0,715.12,4,754703.3,11,5,23,9,True
5102250,947,2,30,3762,246195060,1,0,0,715.11,8,753988.19,24,6,18,12,True
5103831,947,2,-1,2610,246195060,1,1,0,715.09,4,753988.19,24,4,2,1,True
5107123,1468,1,451,9767,246195060,1,0,0,715.52,7,753272.67,11,5,6,2,True
5312028,1072,0,451,1676,246195060,1,0,0,715.0,7,752557.67,18,3,21,3,True
5548543,649,0,10,2392,246195060,1,0,0,715.03,6,753272.7,24,1,18,3,True
5930137,947,2,-1,9455,246195060,1,1,0,714.7,1,753272.7,24,6,22,4,True
6098664,732,0,-1,5780,246195060,1,2,0,715.01,4,753272.7,11,4,19,4,True
6121191,1476,0,10,4547,246195060,1,0,0,714.96,6,753987.66,24,0,2,4,True
6258426,484,0,10,4251,246195060,1,0,0,715.01,6,754702.67,5,2,15,5,True
6461676,1072,0,451,1006,246195060,1,0,0,714.92,7,753987.75,18,4,17,6,True
6785531,1103,4,25,8150,246195060,1,0,0,715.07,8,753272.68,0,3,7,6,True
6987772,564,0,20,4545,246195060,1,0,0,715.0,3,752557.68,17,4,12,6,True
7049604,811,0,20,7370,246195060,1,0,0,714.96,5,751842.72,18,1,9,8,True
7161811,947,2,25,5702,246195060,1,0,0,714.86,8,751127.86,24,3,17,9,True
7624166,122,3,451,9767,246195060,1,0,0,715.27,7,750412.59,18,6,2,9,True
7641419,1072,0,-1,4545,246195060,1,1,0,714.95,4,750412.59,18,6,14,9,True
7835781,947,2,30,6984,246195060,1,0,0,715.06,8,749697.53,24,2,21,9,True
7944880,523,2,20,1676,246195060,1,0,0,714.96,5,748982.57,18,5,18,10,True
8108298,1103,4,30,9767,246195060,1,0,0,714.87,8,748267.7,0,1,15,10,True
8496005,627,0,20,4202,246195060,1,0,0,715.06,5,747552.64,11,1,9,10,True
8515489,1322,2,20,7768,246195060,1,0,0,715.06,5,746837.58,18,6,9,1,True
8554764,820,1,451,4251,246195060,1,0,0,714.82,7,746122.76,18,0,18,1,True
8642651,1468,1,451,8001,246195060,1,0,0,714.94,7,745407.82,11,6,15,2,True
8707084,677,0,20,2392,246195060,1,0,0,714.67,5,744693.15,24,3,19,3,True
8838696,1468,1,30,1676,246195060,1,0,0,714.9,8,743978.25,11,4,12,3,True
8957083,1170,0,20,4969,246195060,1,0,0,714.95,3,743263.3,24,1,7,8,True
9066214,732,0,30,4251,246195060,1,0,0,715.25,8,742548.05,11,2,23,8,True
9101869,219,0,10,2510,246195060,1,0,0,715.14,6,743263.19,9,6,2,9,True
9138652,1103,4,25,4373,246195060,1,0,0,714.85,8,742548.34,0,1,21,10,True
9519741,695,2,20,1006,246195060,1,0,0,714.94,5,741833.4,24,1,17,10,True
9605095,1133,4,451,8167,246195060,1,0,0,715.17,7,741118.23,24,1,0,11,True
9691570,732,0,451,2427,246195060,1,0,0,714.87,7,740403.36,11,1,10,11,False
1035297,795,4,25,5006,244376998,0,0,0,828.31,8,664869.69,11,6,19,3,False
1141826,712,0,20,4722,244376998,0,0,0,828.18,3,664041.51,18,0,17,6,True
1252665,1235,1,-1,1937,244376998,0,1,0,828.27,4,664041.51,18,1,23,8,True
1323815,216,4,-1,6755,244376998,0,2,0,828.12,4,664041.51,9,4,15,7,True
1427327,795,4,-1,5006,244376998,0,3,1,828.2,1,0.0,11,6,0,10,True
1060072,808,3,451,7047,921817490,0,0,0,110.07,7,130662.93,11,4,1,2,True
1317557,1072,0,30,1273,921817490,0,0,0,109.93,8,130553.0,18,4,10,2,True
1462655,883,0,25,5583,921817490,0,0,0,110.07,8,130442.93,24,0,2,2,True
1560127,1445,2,-1,7047,921817490,0,1,0,110.06,1,130442.93,24,1,10,2,True
1602164,883,0,-1,8740,921817490,0,2,0,109.71,4,130442.93,24,2,5,3,True
1662844,883,0,451,3629,921817490,0,0,0,109.78,7,130333.15,24,5,22,3,True
1707009,825,2,20,8926,921817490,0,0,0,109.92,5,130223.23,18,2,11,4,True
1829801,883,0,451,4053,921817490,0,0,0,110.0,7,130113.23,24,3,21,4,True
2349513,183,1,10,1065,921817490,0,0,0,110.12,6,130223.35,18,2,11,6,True
2377802,808,3,30,6418,921817490,0,0,0,109.77,8,130113.58,11,4,1,8,True
2435806,883,0,25,4053,921817490,0,0,0,109.96,8,130003.62,24,6,9,9,True
2658468,385,1,10,4053,921817490,0,0,0,109.92,6,130113.54,25,0,2,9,True
2723646,448,0,20,7047,921817490,0,0,0,110.09,5,130003.45,13,4,6,9,True
2936928,1445,2,25,6385,921817490,0,0,0,110.09,8,129893.36,24,5,3,10,True
3164935,1072,0,451,1273,921817490,0,0,0,109.89,7,129783.47,18,0,1,10,True
3212025,224,3,451,5583,921817490,0,0,0,109.99,7,129673.48,26,4,19,11,True
3291561,1445,2,-1,7203,921817490,0,1,0,110.01,1,129673.48,24,4,6,11,True
3508507,958,2,20,7047,921817490,0,0,0,110.04,3,129563.44,13,4,7,11,True
3521818,1471,0,10,4053,921817490,0,0,0,110.0,0,129673.44,24,3,13,12,True
3622558,224,3,30,8285,921817490,0,0,0,109.94,8,129563.5,26,4,0,12,True
4025290,808,3,30,8926,921817490,0,0,0,109.85,8,129453.65,11,2,21,12,True
4513402,808,3,30,3361,921817490,0,0,0,109.89,8,129343.76,11,3,7,12,False
4610230,1445,2,-1,7203,921817490,0,1,0,109.98,1,129343.76,24,1,3,12,True
4688249,224,3,30,6418,921817490,0,0,0,109.86,8,129233.9,26,3,4,1,True
4734276,1445,2,451,9249,921817490,0,0,0,110.0,7,129123.9,24,4,13,1,True
4788192,580,0,451,3629,921817490,0,0,0,110.25,7,129013.65,11,6,21,4,True
4883623,1079,4,451,3780,921817490,0,0,0,109.94,7,128903.71,18,0,14,4,True
5139892,224,3,30,4053,921817490,0,0,0,109.9,8,128793.81,26,5,9,7,True
5280200,681,2,20,6418,921817490,0,0,0,110.14,3,128683.67,24,2,12,7,True
5480358,1273,0,10,8740,921817490,0,0,0,110.16,6,128793.83,24,0,18,7,True
5682760,883,0,30,8285,921817490,0,0,0,110.0,8,128683.83,24,2,2,8,True
5870376,129,0,10,3629,921817490,0,0,0,109.93,0,128793.76,18,3,19,8,False
6332951,841,1,10,7748,921817490,0,0,0,110.06,0,128903.82,5,2,7,11,False
6595022,914,2,20,5224,921817490,0,0,0,110.0,3,128793.82,18,2,10,12,True
6964055,580,0,25,6418,921817490,0,0,0,109.86,8,128683.96,11,4,4,12,True
7178188,1079,4,451,3780,921817490,0,0,0,110.05,7,128573.91,18,1,21,12,True
7503239,1390,0,20,8285,921817490,0,0,0,110.04,3,128463.87,24,4,5,2,True
7702405,465,0,20,3302,921817490,0,0,0,110.06,3,128353.81,13,0,20,3,True
7890541,1079,4,-1,8926,921817490,0,1,0,109.9,4,128353.81,18,0,16,3,False
8056546,224,3,451,8926,921817490,0,0,0,110.17,7,128243.64,26,0,17,3,True
8148713,335,4,25,9249,921817490,0,0,0,109.73,8,128133.91,11,3,15,4,True
8222338,732,0,10,9249,921817490,0,0,0,110.03,6,128243.94,11,4,12,4,True
8472833,224,3,30,1928,921817490,0,0,0,110.08,8,128133.86,26,6,13,5,False
8555326,1445,2,451,1928,921817490,0,0,0,109.8,7,128024.06,24,3,15,6,True
8730341,1435,2,20,9239,921817490,0,0,0,110.08,5,127913.98,24,6,7,7,True
8824962,335,4,30,3629,921817490,0,0,0,109.94,8,127804.04,11,5,8,8,True
9044591,748,1,10,9249,921817490,0,0,0,110.09,0,127914.13,24,2,3,9,True
9592386,1079,4,451,9249,921817490,0,0,0,110.22,7,127803.91,18,0,17,10,False
9894234,1445,2,451,9239,921817490,0,0,0,110.17,7,127693.74,24,0,8,11,True
9993561,580,0,25,7075,921817490,0,0,0,109.89,8,127583.85,11,0,11,11,True
1057983,253,2,20,4118,821667067,0,0,0,279.19,3,506540.81,6,5,10,4,True
1453688,1028,4,30,2148,821667067,0,0,0,278.73,8,506262.08,11,4,16,5,True
1608614,49,3,451,7322,821667067,0,0,0,279.08,7,505983.0,20,5,4,5,True
1776518,716,0,10,6088,821667067,0,0,0,278.85,6,506261.85,18,4,23,6,True
1904984,1108,1,25,5286,821667067,0,0,0,279.0,8,505982.85,0,0,23,6,True
2037498,328,0,20,1552,821667067,0,0,0,279.15,5,505703.7,11,5,3,7,True
2120403,1061,2,20,1753,821667067,0,0,0,278.9,5,505424.8,11,0,3,7,True
2129898,880,1,30,5286,821667067,0,0,0,279.02,8,505145.78,27,6,23,8,True
2252570,910,0,20,7286,821667067,0,0,0,279.26,5,504866.52,18,6,15,8,True
2376059,1063,0,10,7322,821667067,0,0,0,279.09,6,505145.61,11,0,4,9,True
2936421,1365,3,451,6088,821667067,0,0,0,278.97,7,504866.64,16,2,17,9,True
3251992,137,2,25,9037,821667067,0,0,0,279.21,8,504587.43,18,5,19,9,True
3286885,1044,0,451,1753,821667067,0,0,0,278.72,7,504308.71,11,6,9,10,True
3840628,1044,0,25,9037,821667067,0,0,0,279.1,8,504029.61,11,5,13,11,True
3926627,1028,4,-1,7322,821667067,0,1,0,279.04,4,504029.61,11,5,19,11,True
4075374,223,2,30,9838,821667067,0,0,0,279.0,8,503750.61,26,6,8,12,True
4103583,1421,0,20,9037,821667067,0,0,0,279.14,5,503471.47,24,3,10,12,True
4593637,1028,4,30,7229,821667067,0,0,0,278.88,8,503192.59,11,3,2,1,True
4770862,1028,4,451,4118,821667067,0,0,0,278.87,7,502913.72,11,4,21,1,True
4844883,49,3,-1,5277,821667067,0,1,0,279.07,4,502913.72,20,1,5,5,True
5039392,1028,4,25,1552,821667067,0,0,0,278.97,8,502634.75,11,4,20,5,True
5157381,137,2,30,7286,821667067,0,0,0,279.03,8,502355.72,18,2,0,5,True
5346302,223,2,25,7322,821667067,0,0,0,279.26,8,502076.46,26,3,19,6,True
5511572,1365,3,451,7322,821667067,0,0,0,279.22,7,501797.24,16,2,5,6,True
5622069,49,3,451,9037,821667067,0,0,0,279.09,7,501518.15,20,3,0,7,True
5635012,1124,0,10,1552,821667067,0,0,0,279.14,0,501797.29,24,0,10,7,True
5658037,137,2,30,7322,821667067,0,0,0,279.09,8,501518.2,18,5,16,7,False
5880898,611,0,20,9037,821667067,0,0,0,278.95,5,501239.25,11,2,20,8,True
6155639,1028,4,-1,3745,821667067,0,1,0,278.86,1,501239.25,11,4,18,9,True
6480075,137,2,30,1121,821667067,0,0,0,278.89,8,500960.36,18,5,6,11,True
6524150,1217,0,20,7229,821667067,0,0,0,279.03,3,500681.33,24,4,2,12,True
6625559,223,2,30,3745,821667067,0,0,0,278.88,8,500402.45,26,2,21,1,True
6814510,834,0,10,9838,821667067,0,0,0,278.92,6,500681.37,5,3,18,3,True
7665082,1063,0,10,1506,821667067,0,0,0,278.88,0,500960.25,11,2,5,4,True
7695150,1028,4,451,5286,821667067,0,0,0,279.24,7,500681.01,11,1,3,4,True
7751781,937,0,10,2148,821667067,0,0,0,279.15,0,500960.16,24,1,16,5,True
7989073,880,1,25,7229,821667067,0,0,0,278.89,8,500681.27,27,3,8,6,True
8098646,137,2,25,8923,821667067,0,0,0,278.82,8,500402.45,18,4,0,6,True
8164435,49,3,451,9838,821667067,0,0,0,278.78,7,500123.67,20,5,5,6,True
8206019,1365,3,-1,7286,821667067,0,1,0,278.92,4,500123.67,16,3,4,6,True
8207387,223,2,451,3358,821667067,0,0,0,279.28,7,499844.39,26,3,4,7,True
8357482,880,1,-1,1753,821667067,0,1,0,278.74,4,499844.39,27,4,17,7,True
8417568,1028,4,25,1753,821667067,0,0,0,278.96,8,499565.43,11,5,12,8,True
8475092,654,1,10,4118,821667067,0,0,0,278.82,6,499844.25,18,3,21,8,True
8476059,137,2,30,9037,821667067,0,0,0,278.89,8,499565.36,18,0,14,8,True
8506677,49,3,25,9432,821667067,0,0,0,278.96,8,499286.4,20,4,20,9,True
8677720,448,0,20,6088,821667067,0,0,0,278.99,5,499007.41,13,0,8,9,True
8896190,1142,2,20,9838,821667067,0,0,0,279.04,5,498728.37,15,3,8,9,True
9293335,223,2,25,7229,821667067,0,0,0,278.82,8,498449.55,26,0,6,10,True
9385801,1044,0,451,1121,821667067,0,0,0,279.02,7,498170.53,11,2,23,10,True
9635058,223,2,451,8923,821667067,0,0,0,278.92,7,497891.61,26,2,9,11,True
9936419,880,1,30,7286,821667067,0,0,0,278.96,8,497612.65,27,2,12,11,True
1001988,1223,3,451,6029,714860804,0,0,0,353.88,7,308626.12,24,2,5,3,True
1005620,502,0,451,9013,714860804,0,0,0,353.85,7,308272.27,12,4,22,3,True
1027646,1404,2,-1,3436,714860804,0,1,0,353.97,4,308272.27,24,1,13,3,True
1181194,299,1,10,4982,714860804,0,0,0,354.14,6,308626.41,4,4,20,4,True
1285402,502,0,30,5136,714860804,0,0,0,354.0,8,308272.41,12,1,8,4,True
1384672,89,3,30,6959,714860804,0,0,0,353.99,8,307918.42,1,6,17,6,True
1504094,112,4,451,9171,714860804,0,0,0,353.82,7,307564.6,3,1,4,8,True
1711317,1404,2,451,4982,714860804,0,0,0,354.06,7,307210.54,24,1,1,8,True
1907558,159,2,-1,9171,714860804,0,1,0,353.83,4,307210.54,24,2,6,9,True
1951491,1460,2,30,4905,714860804,0,0,0,354.06,8,306856.48,11,4,14,9,True
1978254,424,1,10,4982,714860804,0,0,0,353.82,0,307210.3,18,6,23,10,True
2300274,796,2,20,5136,714860804,0,0,0,354.11,5,306856.19,11,0,11,10,True
2342227,89,3,25,9899,714860804,0,0,0,354.02,8,306502.17,1,2,1,10,True
2716330,1404,2,30,9171,714860804,0,0,0,353.98,8,306148.19,24,2,7,10,True
2774315,502,0,451,6029,714860804,0,0,0,353.9,7,305794.29,12,5,0,11,True
2808147,1223,3,451,9013,714860804,0,0,0,354.03,7,305440.26,24,6,13,12,True
2814702,159,2,25,3810,714860804,0,0,0,353.76,8,305086.5,24,5,5,2,True
2837383,1270,1,10,3436,714860804,0,0,0,354.13,6,305440.63,23,5,22,2,True
2945243,1355,4,30,9171,714860804,0,0,0,354.07,8,305086.56,24,2,11,3,True
3212198,502,0,-1,9013,714860804,0,1,0,353.83,4,305086.56,12,0,14,4,True
3358074,1460,2,451,5136,714860804,0,0,0,353.72,7,304732.84,11,6,16,4,True
3599177,1355,4,-1,5993,714860804,0,1,0,354.2,4,304732.84,24,1,7,5,True
4118653,159,2,25,3810,714860804,0,0,0,354.03,8,304378.81,24,6,0,5,True
4360830,980,1,10,4905,714860804,0,0,0,354.26,6,304733.07,22,2,4,6,True
4697598,1355,4,30,7162,714860804,0,0,0,353.94,8,304379.13,24,2,18,8,True
5220773,159,2,30,9390,714860804,0,0,0,354.2,8,304024.93,24,1,9,8,True
5609946,502,0,451,5331,714860804,0,0,0,354.13,7,303670.8,12,3,17,9,True
5653032,1223,3,30,9171,714860804,0,0,0,353.91,8,303316.89,24,0,22,10,True
5701033,502,0,25,9013,714860804,0,0,0,353.96,8,302962.93,12,0,22,10,True
5824705,748,1,10,9795,714860804,0,0,0,354.04,6,303316.97,24,1,22,10,True
5856801,1460,2,451,4767,714860804,0,0,0,354.24,7,302962.73,11,1,16,11,True
6072146,112,4,30,5331,714860804,0,0,0,354.03,8,302608.7,3,3,18,11,True
6155117,1355,4,30,9899,714860804,0,0,0,353.83,8,302254.87,24,0,7,12,True
6188341,445,0,10,3810,714860804,0,0,0,353.94,6,302608.81,13,1,9,12,True
6595699,502,0,30,9899,714860804,0,0,0,354.08,8,302254.73,12,4,8,12,False
6659722,537,0,25,5331,714860804,0,0,0,353.76,8,301900.97,18,5,2,1,True
6846646,112,4,451,5071,714860804,0,0,0,354.22,7,301546.75,3,5,23,1,True
7191260,1460,2,451,9390,714860804,0,0,0,354.04,7,301192.71,11,4,21,2,True
7367985,159,2,-1,7162,714860804,0,1,0,354.01,4,301192.71,24,1,14,2,True
7598853,537,0,25,9795,714860804,0,0,0,353.97,8,300838.74,18,0,15,2,True
7656330,159,2,451,5136,714860804,0,0,0,353.75,7,300484.99,24,3,15,3,True
7907468,537,0,451,5584,714860804,0,0,0,354.29,7,300130.7,18,3,6,3,True
7917929,537,0,451,5331,714860804,0,0,0,354.15,7,299776.55,18,3,9,4,True
8280661,1210,0,10,6502,714860804,0,0,0,354.14,0,300130.69,24,1,12,4,True
8760530,1404,2,25,2603,714860804,0,0,0,354.22,8,299776.47,24,0,0,6,True
8968835,1355,4,30,5993,714860804,0,0,0,354.08,8,299422.39,24,6,18,7,True
9085380,1150,0,10,6959,714860804,0,0,0,353.82,6,299776.21,15,3,12,7,True
9219727,1355,4,30,6502,714860804,0,0,0,354.1,8,299422.11,24,1,15,8,True
9221743,871,0,20,6502,714860804,0,0,0,353.93,5,299068.18,24,6,6,8,True
9228928,112,4,451,2603,714860804,0,0,0,353.96,7,298714.22,3,5,19,9,True
9408149,558,0,20,9899,714860804,0,0,0,353.72,5,298360.5,17,0,6,9,True
9410767,159,2,451,6502,714860804,0,0,0,354.09,7,298006.41,24,3,15,9,True
9741435,502,0,30,5331,714860804,0,0,0,354.04,8,297652.37,12,6,19,10,True
9780674,713,0,20,6959,714860804,0,0,0,354.2,5,297298.17,18,3,8,10,True
9783829,523,2,20,6029,714860804,0,0,0,354.38,5,296943.79,18,2,21,10,True
9881483,537,0,451,4905,714860804,0,0,0,354.03,7,296589.76,18,1,21,11,True
1025437,1247,0,10,5029,357467085,0,0,0,820.01,6,906734.01,23,1,13,1,False
1231112,1238,0,10,3481,357467085,0,0,0,819.83,6,907553.84,18,2,2,1,True
1267303,589,1,10,4792,357467085,0,0,0,819.86,6,908373.7,24,5,10,1,True
1702504,1485,0,30,2925,357467085,0,0,0,819.94,8,907553.76,24,1,12,3,False
1814253,765,4,-1,1715,357467085,0,1,0,819.86,4,907553.76,14,2,22,3,True
1940568,1119,0,10,4561,357467085,0,0,0,819.88,0,908373.64,24,6,6,3,True
2529675,1485,0,451,6970,357467085,0,0,0,820.08,7,907553.56,24,3,19,4,True
2957459,514,4,451,2618,357467085,0,0,0,820.03,7,906733.53,12,3,0,5,True
3011396,1019,0,20,5599,357467085,0,0,0,820.02,5,905913.51,26,3,19,5,True
3118512,381,4,-1,6816,357467085,0,1,0,819.94,4,905913.51,25,1,20,5,True
3171368,1481,4,451,8451,357467085,0,0,0,820.21,7,905093.3,24,0,0,6,True
3834839,765,4,25,3044,357467085,0,0,0,820.12,8,904273.18,14,3,11,7,True
3859589,547,4,30,7557,357467085,0,0,0,820.08,8,903453.1,17,1,7,8,True
3972976,238,0,-1,5029,357467085,0,1,0,819.68,4,903453.1,26,0,12,9,True
4023312,1485,0,451,8283,357467085,0,0,0,820.12,7,902632.98,24,2,10,10,True
4428971,350,0,10,3192,357467085,0,0,0,819.67,6,903452.65,24,5,18,11,True
4580284,955,4,25,2925,357467085,0,0,0,819.74,8,902632.91,13,5,23,12,True
4669719,765,4,25,2618,357467085,0,0,0,819.88,8,901813.03,14,3,2,1,True
4716578,1481,4,451,1715,357467085,0,0,0,819.93,7,900993.1,24,3,2,2,True
4723502,1485,0,451,3044,357467085,0,0,0,819.91,7,900173.19,24,4,5,2,True
4869933,381,4,451,7078,357467085,0,0,0,820.23,7,899352.96,25,0,20,2,True
4952578,547,4,30,5235,357467085,0,0,0,820.05,8,898532.91,17,4,20,5,True
5144502,765,4,-1,7013,357467085,0,1,0,819.95,1,898532.91,14,3,5,6,True
5197838,1255,0,20,4172,357467085,0,0,0,820.08,5,897712.83,23,6,7,6,True
5206936,1481,4,451,6970,357467085,0,0,0,819.97,7,896892.86,24,0,21,6,True
5394698,238,0,30,5599,357467085,0,0,0,820.13,8,896072.73,26,6,13,8,True
5427986,514,4,451,9865,357467085,0,0,0,819.98,7,895252.75,12,0,6,9,True
5487875,1481,4,25,3481,357467085,0,0,0,819.9,8,894432.85,24,1,23,9,True
5588040,1009,0,20,2565,357467085,0,0,0,820.11,3,893612.74,26,4,18,9,True
5627719,1481,4,30,7078,357467085,0,0,0,819.89,8,892792.85,24,1,3,9,True
5970166,381,4,25,7013,357467085,0,0,0,819.98,8,891972.87,25,2,19,10,True
6380809,238,0,25,3192,357467085,0,0,0,820.22,8,891152.65,26,0,1,1,True
6489601,547,4,451,9865,357467085,0,0,0,819.61,7,890333.04,17,1,3,1,True
6534544,1481,4,30,3192,357467085,0,0,0,819.97,8,889513.07,24,5,11,3,True
6614987,238,0,25,7557,357467085,0,0,0,819.96,8,888693.11,26,3,15,3,True
6762086,955,4,451,9164,357467085,0,0,0,820.18,7,887872.93,13,1,11,4,True
6801739,1485,0,30,3044,357467085,0,0,0,820.04,8,887052.89,24,6,9,5,True
7176422,381,4,-1,2618,357467085,0,1,0,820.04,1,887052.89,25,2,23,5,True
7231603,1481,4,451,9167,357467085,0,0,0,819.99,7,886232.9,24,4,9,5,True
7305624,942,0,20,4561,357467085,0,0,0,820.03,5,885412.87,24,6,7,5,True
8047918,1481,4,451,1715,357467085,0,0,0,819.92,7,884592.95,24,4,0,6,True
8334842,514,4,25,8451,357467085,0,0,0,820.18,8,883772.77,12,1,5,6,True
8446913,955,4,451,4172,357467085,0,0,0,819.98,7,882952.79,13,5,12,7,True
8573968,955,4,451,5693,357467085,0,0,0,819.94,7,882132.85,13,5,15,7,True
8591791,1010,0,10,5235,357467085,0,0,0,820.0,6,882952.85,26,2,16,7,True
8634448,514,4,30,9164,357467085,0,0,0,820.03,8,882132.82,12,5,10,7,True
9130291,238,0,451,7095,357467085,0,0,0,819.61,7,881313.21,26,4,23,8,True
9197742,381,4,451,7095,357467085,0,0,0,820.18,7,880493.03,25,1,18,8,True
9264690,1485,0,451,8451,357467085,0,0,0,819.87,7,879673.16,24,4,3,9,True
9444135,765,4,451,5693,357467085,0,0,0,820.05,7,878853.11,14,0,19,9,True
9521365,320,1,10,2565,357467085,0,0,0,819.94,6,879673.05,11,2,0,11,True
9885352,238,0,30,9164,357467085,0,0,0,820.07,8,878852.98,26,5,12,11,True
1127458,228,0,-1,9527,301802952,0,1,0,779.11,1,418145.0,26,5,19,1,True
1275949,1206,0,10,4085,301802952,0,0,0,779.25,6,418924.25,24,5,9,2,False
1315401,126,1,451,2505,301802952,0,0,0,779.15,7,418145.1,18,0,0,2,True
1533055,410,4,30,6234,301802952,0,0,0,779.13,8,417365.97,18,4,13,3,True
1599307,228,0,-1,7268,301802952,0,1,0,778.65,1,417365.97,26,2,22,3,True
1933551,228,0,30,2419,301802952,0,0,0,778.92,8,416587.05,26,0,6,4,True
2065392,371,3,-1,4085,301802952,0,1,0,779.07,4,416587.05,25,5,20,4,False
2384367,1265,4,25,1153,301802952,0,0,0,779.32,8,415807.73,23,0,1,5,True
2460338,1068,2,20,6107,301802952,0,0,0,779.02,5,415028.71,18,0,17,5,True
2658896,757,0,20,2509,301802952,0,0,0,779.09,5,414249.62,24,5,12,5,True
2661739,204,0,10,3000,301802952,0,0,0,778.9,0,415028.52,9,1,2,6,True
2792948,371,3,-1,2078,301802952,0,1,0,778.86,4,415028.52,25,4,23,7,True
3050999,997,3,451,2505,301802952,0,0,0,778.84,7,414249.68,26,5,8,7,True
3084757,1025,1,10,2419,301802952,0,0,0,778.96,0,415028.64,11,6,11,7,True
3138052,371,3,-1,7197,301802952,0,1,0,779.12,1,415028.64,25,0,10,8,True
3189174,126,1,25,6234,301802952,0,0,0,779.11,8,414249.53,18,2,3,9,True
3670471,1265,4,451,7574,301802952,0,0,0,778.72,7,413470.81,23,4,3,10,True
3695141,712,0,10,7197,301802952,0,0,0,779.32,0,414250.13,18,2,17,10,True
3708363,228,0,451,6085,301802952,0,0,0,778.8,7,413471.33,26,6,14,10,True
3874186,64,0,10,7197,301802952,0,0,0,779.01,6,414250.34,20,0,6,10,True
4018728,1111,0,-1,4015,301802952,0,1,0,778.94,1,414250.34,0,1,9,11,True
4266216,1111,0,451,4015,301802952,0,0,0,779.04,7,413471.3,0,1,2,12,True
4431626,997,3,-1,5577,301802952,0,1,0,779.11,1,413471.3,26,1,12,12,True
4628214,324,4,25,8663,301802952,0,0,0,778.63,8,412692.67,11,2,9,12,True
5062952,126,1,25,2429,301802952,0,0,0,778.92,8,411913.75,18,6,19,4,True
5297571,1114,1,451,2419,301802952,0,0,0,779.16,7,411134.59,0,0,18,4,True
5314028,371,3,451,9527,301802952,0,0,0,778.87,7,410355.72,25,3,4,4,True
5360029,1111,0,451,8663,301802952,0,0,0,778.83,7,409576.89,0,0,12,4,True
5465424,116,0,10,6875,301802952,0,0,0,779.03,6,410355.92,3,6,17,4,True
5802761,1111,0,451,1153,301802952,0,0,0,779.19,7,409576.73,0,5,16,4,True
5895020,324,4,30,7574,301802952,0,0,0,778.93,8,408797.8,11,2,5,5,True
5901875,1265,4,451,4085,301802952,0,0,0,779.39,7,408018.41,23,5,6,5,True
6018926,577,0,10,9527,301802952,0,0,0,778.95,6,408797.36,11,4,7,6,True
6235166,324,4,-1,6234,301802952,0,1,0,778.85,1,408797.36,11,6,10,7,True
6238955,228,0,25,8686,301802952,0,0,0,779.09,8,408018.27,26,6,16,7,True
6262267,1089,0,10,1581,301802952,0,0,0,778.82,6,408797.09,18,1,1,8,True
6330470,371,3,451,5577,301802952,0,0,0,779.06,7,408018.03,25,1,0,11,True
7109677,371,3,25,5577,301802952,0,0,0,778.9,8,407239.13,25,5,8,12,True
7285753,58,2,20,3000,301802952,0,0,0,779.26,3,406459.87,20,2,8,12,True
7515166,228,0,451,2509,301802952,0,0,0,778.92,7,405680.95,26,2,6,12,True
7582693,1265,4,451,2509,301802952,0,0,0,779.14,7,404901.81,23,0,14,12,True
7644144,1265,4,25,8663,301802952,0,0,0,779.01,8,404122.8,23,6,4,12,True
8001690,997,3,30,2419,301802952,0,0,0,778.88,8,403343.92,26,1,16,1,True
8012306,228,0,25,3000,301802952,0,0,0,778.98,8,402564.94,26,0,23,4,True
8062564,1265,4,25,2429,301802952,0,0,0,779.14,8,401785.8,23,6,18,5,True
8136891,126,1,25,6234,301802952,0,0,0,778.89,8,401006.91,18,4,4,5,True
8210987,997,3,451,2429,301802952,0,0,0,779.02,7,400227.89,26,0,10,6,True
8340382,1235,1,10,5577,301802952,0,0,0,778.96,0,401006.85,18,5,6,6,True
8369875,324,4,-1,9527,301802952,0,1,0,779.1,1,401006.85,11,5,2,7,True
8570240,410,4,25,4015,301802952,0,0,0,778.87,8,400227.98,18,1,11,7,True
8819067,324,4,-1,6085,301802952,0,1,0,778.85,1,400227.98,11,5,4,8,False
9131810,327,0,20,7197,301802952,0,0,0,778.98,3,399449.0,11,1,2,8,True
9153753,324,4,-1,2419,301802952,0,1,0,778.92,4,399449.0,11,2,8,9,True
9423709,689,0,10,1581,301802952,0,0,0,779.19,0,400228.19,24,2,11,10,True
9505607,371,3,-1,2374,301802952,0,1,0,778.81,4,400228.19,25,3,4,10,True
9518348,1160,0,20,7574,301802952,0,0,0,779.07,3,399449.12,15,1,10,10,True
9648795,1114,1,451,3000,301802952,0,0,0,779.05,7,398670.07,0,4,19,10,True
9688022,997,3,25,7612,301802952,0,0,0,778.85,8,397891.22,26,2,7,10,True
9898243,325,0,10,8686,301802952,0,0,0,778.85,6,398670.07,11,3,19,11,True
1023467,939,0,30,6771,389084217,1,0,0,922.69,8,765611.31,24,4,6,1,True
1310313,1408,1,451,4252,389084217,1,0,0,922.91,7,764688.4,24,3,6,2,True
1376002,1238,0,10,6077,389084217,1,0,0,923.08,0,765611.48,18,4,6,2,True
1916096,947,2,20,2717,389084217,1,0,0,922.84,5,764688.64,24,2,7,3,True
1974034,1408,1,-1,7553,389084217,1,1,0,922.97,1,764688.64,24,2,14,3,True
1993753,780,0,20,2178,389084217,1,0,0,923.04,5,763765.6,14,2,17,3,True
2022371,51,0,10,8326,389084217,1,0,0,923.11,6,764688.71,20,1,8,3,True
2138226,281,1,30,2954,389084217,1,0,0,923.09,8,763765.62,24,3,0,3,True
2294411,425,4,451,3752,389084217,1,0,0,923.19,7,762842.43,18,4,3,4,False
2436339,903,3,451,4252,389084217,1,0,0,922.98,7,761919.45,2,4,15,5,True
2509357,94,3,451,7130,389084217,1,0,0,922.91,7,760996.54,1,4,23,5,True
3017102,757,0,20,8995,389084217,1,0,0,923.13,3,760073.41,24,5,12,6,True
3828368,939,0,-1,9970,389084217,1,1,0,923.28,4,760073.41,24,1,14,6,True
4159849,939,0,30,9644,389084217,1,0,0,923.05,8,759150.36,24,6,5,7,True
4175935,1408,1,451,7712,389084217,1,0,0,923.18,7,758227.18,24,2,1,7,True
4223034,903,3,-1,3752,389084217,1,1,0,923.32,4,758227.18,2,4,13,9,True
4274035,1132,0,20,7553,389084217,1,0,0,923.0,5,757304.18,24,5,1,9,True
4328480,281,1,451,3155,389084217,1,0,0,923.1,7,756381.08,24,1,14,10,True
4434884,548,2,20,8851,389084217,1,0,0,922.97,5,755458.11,17,2,23,11,True
4641829,965,4,30,9657,389084217,1,0,0,923.09,8,754535.02,13,0,2,11,True
5510054,903,3,30,6698,389084217,1,0,0,922.9,8,753612.12,2,2,16,12,True
5547184,333,1,10,8287,389084217,1,0,0,922.97,6,754535.09,11,4,12,2,True
5592846,1408,1,25,7740,389084217,1,0,0,922.99,8,753612.1,24,6,6,3,True
5758669,160,0,10,9970,389084217,1,0,0,922.76,6,754534.86,24,5,20,4,True
5758844,1069,1,10,4061,389084217,1,0,0,922.92,6,755457.78,18,1,11,5,True
5880480,281,1,30,9644,389084217,1,0,0,923.04,8,754534.74,24,3,10,6,True
5886913,1408,1,30,3752,389084217,1,0,0,922.72,8,753612.02,24,2,15,6,True
6129896,367,1,10,2441,389084217,1,0,0,922.92,6,754534.94,25,0,16,7,True
6152266,281,1,30,9970,389084217,1,0,0,923.02,8,753611.92,24,1,9,7,True
6439867,713,0,10,4252,389084217,1,0,0,923.1,0,754535.02,18,0,7,8,True
6485731,425,4,451,6771,389084217,1,0,0,923.37,7,753611.65,18,6,18,9,True
6669849,281,1,451,6771,389084217,1,0,0,923.11,7,752688.54,24,3,5,9,False
6787943,94,3,25,7740,389084217,1,0,0,923.0,8,751765.54,1,3,19,11,True
7137940,1408,1,451,1934,389084217,1,0,0,922.97,7,750842.57,24,1,17,12,True
7290152,425,4,25,6426,389084217,1,0,0,923.0,8,749919.57,18,3,7,2,True
7542286,939,0,25,9644,389084217,1,0,0,922.83,8,748996.74,24,4,15,3,True
7594183,903,3,451,2178,389084217,1,0,0,922.98,7,748073.76,2,2,3,4,True
7640925,1260,0,451,4785,389084217,1,0,0,923.07,7,747150.69,23,3,13,4,True
7732494,1039,1,10,5550,389084217,1,0,0,923.24,0,748073.93,11,5,11,4,True
7808482,1390,0,10,4061,389084217,1,0,0,922.79,0,748996.72,24,6,15,5,True
8004439,281,1,25,8995,389084217,1,0,0,923.04,8,748073.68,24,6,9,5,True
8224679,1119,0,10,4061,389084217,1,0,0,923.19,6,748996.87,24,2,6,6,True
8633885,939,0,451,9657,389084217,1,0,0,923.08,7,748073.79,24,2,3,7,True
9112275,939,0,25,8326,389084217,1,0,0,923.16,8,747150.63,24,3,6,7,True
9154793,94,3,25,1515,389084217,1,0,0,922.82,8,746227.81,1,5,19,8,False
9172112,281,1,30,5341,389084217,1,0,0,922.96,8,745304.85,24,5,20,8,True
9465354,159,2,20,5550,389084217,1,0,0,922.99,3,744381.86,24,3,17,8,True
9500527,200,0,20,1515,389084217,1,0,0,922.97,3,743458.89,9,0,15,8,True
9551413,425,4,30,8314,389084217,1,0,0,922.93,8,742535.96,18,6,20,11,True
9589924,425,4,-1,4785,389084217,1,1,0,923.06,4,742535.96,18,4,21,11,True
9681100,425,4,25,8287,389084217,1,0,0,922.82,8,741613.14,18,1,23,11,True
1289639,398,0,30,1439,399118971,1,0,0,392.15,8,980700.85,10,6,18,1,True
1774202,585,2,25,8491,399118971,1,0,0,391.98,8,980308.87,11,1,15,1,True
1794809,398,0,-1,9619,399118971,1,1,0,392.15,1,980308.87,10,3,20,1,True
2458936,588,0,25,1369,399118971,1,0,0,391.92,8,979916.95,24,1,0,4,True
2534955,1421,0,10,6719,399118971,1,0,0,392.04,6,980308.99,24,2,14,5,True
2694127,585,2,25,3194,399118971,1,0,0,392.05,8,979916.94,11,2,12,5,True
2891569,398,0,25,7429,399118971,1,0,0,391.88,8,979525.06,10,2,9,7,True
2966194,687,0,20,1160,399118971,1,0,0,392.29,3,979132.77,24,1,10,8,True
3187973,588,0,451,8058,399118971,1,0,0,391.96,7,978740.81,24,5,20,8,True
3204603,444,2,20,4899,399118971,1,0,0,392.06,5,978348.75,24,1,23,8,True
3350412,865,0,10,7724,399118971,1,0,0,391.83,6,978740.58,24,2,13,9,True
3372737,1120,4,30,4346,399118971,1,0,0,391.95,8,978348.63,24,5,16,9,True
3408579,1123,2,451,4346,399118971,1,0,0,391.85,7,977956.78,24,1,8,9,True
3737988,1120,4,451,4346,399118971,1,0,0,391.87,7,977564.91,24,5,4,10,True
3757369,59,0,20,2848,399118971,1,0,0,391.8,3,977173.11,20,3,14,10,True
3963565,1123,2,451,7036,399118971,1,0,0,391.94,7,976781.17,24,5,4,11,True
3977187,1123,2,30,4705,399118971,1,0,0,392.1,8,976389.07,24,2,0,11,True
4037307,588,0,-1,7724,399118971,1,1,0,392.31,4,976389.07,24,3,13,12,True
4045142,260,0,10,7676,399118971,1,0,0,392.09,6,976781.16,6,2,12,1,True
4246861,677,0,20,4000,399118971,1,0,0,391.83,3,976389.33,24,5,8,1,True
4355075,1123,2,30,1369,399118971,1,0,0,391.97,8,975997.36,24,6,17,1,True
4582668,990,0,10,6851,399118971,1,0,0,392.21,6,976389.57,22,4,20,2,True
4751370,123,0,20,1160,399118971,1,0,0,392.06,5,975997.51,18,4,16,2,True
4980818,585,2,-1,4935,399118971,1,1,0,391.69,4,975997.51,11,3,2,4,True
5029325,605,0,451,7724,399118971,1,0,0,392.08,7,975605.43,24,4,5,5,True
5418041,588,0,451,4346,399118971,1,0,0,391.8,7,975213.63,24,1,18,5,True
5525632,675,2,20,7036,399118971,1,0,0,392.1,5,974821.53,24,6,6,6,True
5625122,605,0,30,7724,399118971,1,0,0,392.18,8,974429.35,24,6,22,6,True
5671066,1123,2,-1,7724,399118971,1,1,0,391.9,4,974429.35,24,3,10,6,True
5861935,605,0,25,4935,399118971,1,0,0,392.06,8,974037.29,24,0,1,7,True
6041011,585,2,451,8279,399118971,1,0,0,391.96,7,973645.33,11,5,18,7,True
6207374,628,0,20,7676,399118971,1,0,0,392.19,5,973253.14,11,5,17,8,True
6511257,727,0,20,7724,399118971,1,0,0,391.92,5,972861.22,11,4,8,8,True
6690449,605,0,451,3194,399118971,1,0,0,391.87,7,972469.35,24,6,16,8,True
7082695,605,0,30,7429,399118971,1,0,0,391.81,8,972077.54,24,0,10,8,True
7235553,444,2,20,8279,399118971,1,0,0,392.1,5,971685.44,24,0,8,9,True
7532628,605,0,25,1160,399118971,1,0,0,392.11,8,971293.33,24,1,5,9,True
7681174,1123,2,451,8279,399118971,1,0,0,391.99,7,970901.34,24,3,6,9,True
7731861,1120,4,25,8058,399118971,1,0,0,392.17,8,970509.17,24,3,2,9,True
7741353,588,0,25,6719,399118971,1,0,0,392.07,8,970117.1,24,4,3,10,True
7965786,71,1,10,1369,399118971,1,0,0,391.87,0,970508.97,20,1,20,10,True
8390754,1123,2,30,3651,399118971,1,0,0,392.0,8,970116.97,24,3,20,12,True
8421484,588,0,25,1439,399118971,1,0,0,392.0,8,969724.97,24,2,6,4,True
9210753,585,2,-1,1776,399118971,1,1,0,392.1,4,969724.97,11,2,22,5,True
9245330,1123,2,25,6851,399118971,1,0,0,392.17,8,969332.8,24,6,3,5,True
9252913,1146,2,20,1776,399118971,1,0,0,392.02,5,968940.78,15,0,4,5,True
9387742,1399,0,10,4935,399118971,1,0,0,392.09,6,969332.87,24,3,2,5,True
9457127,398,0,-1,7676,399118971,1,1,0,392.08,1,969332.87,10,4,13,6,True
9652390,1120,4,25,3651,399118971,1,0,0,391.65,8,968941.22,24,4,20,6,True
9815729,589,1,10,7036,399118971,1,0,0,391.9,6,969333.12,24,6,15,6,True
9827245,787,0,20,8058,399118971,1,0,0,391.76,3,968941.36,14,1,21,10,True
9839663,588,0,-1,7429,399118971,1,1,0,391.93,4,968941.36,24,6,3,11,True
9911756,1411,0,20,1439,399118971,1,0,0,391.91,5,968549.45,24,6,5,11,True
1109881,767,0,30,6216,551549191,0,0,0,529.9,8,855885.1,14,0,16,2,True
1217294,520,4,451,1044,551549191,0,0,0,529.95,7,855355.15,18,4,3,3,True
1449454,670,0,451,1044,551549191,0,0,0,529.96,7,854825.19,18,2,1,4,True
1539192,58,2,451,6692,551549191,0,0,0,530.03,7,854295.16,20,5,17,4,True
1642684,1014,1,10,2128,551549191,0,0,0,530.04,0,854825.2,26,1,17,4,True
1815074,80,4,451,1044,551549191,0,0,0,529.66,7,854295.54,1,6,8,5,True
2072396,1152,0,10,5679,551549191,0,0,0,529.9,6,854825.44,15,1,2,6,True
2180071,80,4,451,7092,551549191,0,0,0,530.21,7,854295.23,1,3,11,8,True
2197767,80,4,451,7092,551549191,0,0,0,529.81,7,853765.42,1,1,3,8,True
2237427,767,0,30,5679,551549191,0,0,0,530.03,8,853235.39,14,3,13,9,False
2254061,376,0,10,2235,551549191,0,0,0,529.81,6,853765.2,25,3,8,9,True
2257308,670,0,451,1044,551549191,0,0,0,529.96,7,853235.24,18,5,4,10,True
2423525,80,4,30,6537,551549191,0,0,0,529.83,8,852705.41,1,3,20,11,True
2520275,767,0,30,5679,551549191,0,0,0,529.95,8,852175.46,14,1,12,12,True
2785203,58,2,30,5456,551549191,0,0,0,530.12,8,851645.34,20,2,7,1,True
3094451,520,4,30,8317,551549191,0,0,0,530.01,8,851115.33,18,4,1,1,True
3243814,520,4,451,8901,551549191,0,0,0,529.85,7,850585.48,18,0,20,2,True
3794133,304,0,451,5456,551549191,0,0,0,530.1,7,850055.38,4,1,18,2,True
3871993,1179,0,30,1503,551549191,0,0,0,530.0,8,849525.38,24,2,19,3,True
4032946,304,0,30,8901,551549191,0,0,0,529.88,8,848995.5,4,4,17,3,True
4044061,767,0,30,6692,551549191,0,0,0,529.97,8,848465.53,14,2,7,5,True
4844275,1307,0,10,8317,551549191,0,0,0,529.82,6,848995.35,5,3,9,6,True
4913437,520,4,-1,6216,551549191,0,1,0,530.06,4,848995.35,18,1,19,6,True
5039455,520,4,30,5456,551549191,0,0,0,530.03,8,848465.32,18,3,2,6,True
5258444,670,0,451,2128,551549191,0,0,0,529.96,7,847935.36,18,4,7,7,True
5484485,58,2,451,6692,551549191,0,0,0,530.01,7,847405.35,20,0,9,7,True
5608815,1179,0,451,8901,551549191,0,0,0,529.91,7,846875.44,24,3,4,8,True
5860437,304,0,30,6537,551549191,0,0,0,530.09,8,846345.35,4,6,23,8,True
5864484,1179,0,451,5456,551549191,0,0,0,529.95,7,845815.4,24,3,11,8,True
5917728,58,2,30,8317,551549191,0,0,0,529.7,8,845285.7,20,6,8,9,True
5920410,1152,0,20,6216,551549191,0,0,0,530.14,3,844755.56,15,4,9,10,True
6093975,670,0,-1,9577,551549191,0,1,0,530.05,4,844755.56,18,0,6,10,True
6448519,520,4,30,2128,551549191,0,0,0,529.73,8,844225.83,18,6,6,11,True
6504912,520,4,451,9577,551549191,0,0,0,529.9,7,843695.93,18,0,15,11,True
7061043,670,0,30,8317,551549191,0,0,0,529.98,8,843165.95,18,4,1,11,True
7112465,1195,1,10,2235,551549191,0,0,0,529.93,6,843695.88,24,0,21,11,True
7177776,58,2,-1,6692,551549191,0,1,0,529.73,1,843695.88,20,3,0,12,True
7479494,767,0,451,1044,551549191,0,0,0,530.07,7,843165.81,14,2,1,1,True
7646354,1179,0,451,1503,551549191,0,0,0,530.33,7,842635.48,24,2,0,1,True
8091921,811,0,20,2128,551549191,0,0,0,530.18,5,842105.3,18,1,10,1,True
8134300,670,0,451,2235,551549191,0,0,0,530.25,7,841575.05,18,6,15,2,True
8199716,520,4,451,6692,551549191,0,0,0,529.78,7,841045.27,18,2,3,2,True
8335876,670,0,451,1503,551549191,0,0,0,530.31,7,840514.96,18,1,4,3,True
8346523,752,0,10,6216,551549191,0,0,0,530.03,6,841044.99,24,2,18,3,True
8516238,304,0,25,3712,551549191,0,0,0,530.04,8,840514.95,4,2,13,4,True
8531999,58,2,30,8901,551549191,0,0,0,530.1,8,839984.85,20,4,4,5,True
8614990,80,4,451,3712,551549191,0,0,0,530.17,7,839454.68,1,5,5,7,True
8774066,1179,0,-1,1503,551549191,0,1,0,529.87,1,839454.68,24,0,2,8,True
8779095,287,0,10,6537,551549191,0,0,0,530.2,6,839984.88,24,0,5,9,True
8903307,670,0,30,2128,551549191,0,0,0,530.12,8,839454.76,18,1,8,9,True
9131960,1179,0,451,5679,551549191,0,0,0,529.78,7,838924.98,24,3,15,10,True
9146108,1278,0,20,2627,551549191,0,0,0,529.92,5,838395.06,24,4,5,10,True
9834325,670,0,25,7092,551549191,0,0,0,530.01,8,837865.05,18,6,22,11,True
9882477,520,4,25,9577,551549191,0,0,0,529.94,8,837335.11,18,4,0,11,True
1302249,916,0,20,6189,433907826,0,0,0,763.93,3,308499.07,18,4,17,2,True
1539078,219,0,20,5992,433907826,0,0,0,763.95,5,307735.12,9,5,11,2,True
1649225,1207,4,25,3325,433907826,0,0,0,763.85,8,306971.27,24,6,1,2,True
1748644,1488,0,451,5260,433907826,0,0,0,764.26,7,306207.01,24,1,5,2,True
1802910,1168,3,-1,7803,433907826,0,1,0,764.0,1,306207.01,24,3,17,3,True
1979162,1488,0,30,4527,433907826,0,0,0,764.46,8,305442.55,24,5,12,3,True
2198101,1488,0,451,8161,433907826,0,0,0,764.18,7,304678.37,24,3,17,3,True
2212392,739,1,30,5438,433907826,0,0,0,764.05,8,303914.32,24,3,20,3,True
2297466,996,0,10,8724,433907826,0,0,0,764.07,6,304678.39,26,4,7,4,True
2357393,1207,4,30,8305,433907826,0,0,0,763.86,8,303914.53,24,5,0,4,True
2550278,739,1,25,4050,433907826,0,0,0,763.91,8,303150.62,24,5,12,4,True
3112066,234,0,10,8229,433907826,0,0,0,764.04,6,303914.66,26,5,10,6,True
3182776,1207,4,30,6127,433907826,0,0,0,764.06,8,303150.6,24,6,7,6,True
3191763,1207,4,451,5260,433907826,0,0,0,764.24,7,302386.36,24,5,2,7,True
3313017,859,2,451,6189,433907826,0,0,0,763.99,7,301622.37,24,5,4,7,True
3315954,1272,0,10,1977,433907826,0,0,0,763.77,0,302386.14,24,5,7,7,True
3444279,1168,3,25,3325,433907826,0,0,0,764.17,8,301621.97,24,5,22,8,True
3536941,747,1,10,4373,433907826,0,0,0,763.75,0,302385.72,24,6,11,9,True
4191681,694,2,20,8724,433907826,0,0,0,764.12,3,301621.6,24,3,15,10,True
4474417,577,0,451,1223,433907826,0,0,0,764.12,7,300857.48,11,1,18,10,True
4753493,1168,3,25,8229,433907826,0,0,0,763.96,8,300093.52,24,0,15,11,True
4802692,577,0,-1,6127,433907826,0,1,0,764.1,1,300093.52,11,4,13,12,True
4864670,200,0,20,8161,433907826,0,0,0,764.32,5,299329.2,9,4,14,12,True
4909755,643,4,451,5260,433907826,0,0,0,764.3,7,298564.9,24,1,23,12,True
5250162,1207,4,30,4631,433907826,0,0,0,764.27,8,297800.63,24,2,2,12,True
5391421,1243,2,20,4527,433907826,0,0,0,764.11,3,297036.52,18,0,23,1,True
5398369,947,2,20,5260,433907826,0,0,0,764.11,3,296272.41,24,5,3,1,True
5419667,1093,0,20,4373,433907826,0,0,0,764.24,5,295508.17,18,1,6,2,True
5455617,643,4,451,1223,433907826,0,0,0,764.12,7,294744.05,24,4,12,3,True
5917560,1282,2,20,7315,433907826,0,0,0,763.73,5,293980.32,24,6,20,4,True
6517979,947,2,20,5992,433907826,0,0,0,763.7,5,293216.62,24,2,12,4,True
7061917,577,0,451,7315,433907826,0,0,0,763.96,7,292452.66,11,0,1,4,True
7228155,643,4,30,4050,433907826,0,0,0,764.0,8,291688.66,24,2,23,5,True
7252181,643,4,451,1666,433907826,0,0,0,763.87,7,290924.79,24,5,10,6,True
7371941,530,0,10,1223,433907826,0,0,0,764.1,0,291688.89,18,1,8,6,True
7893874,739,1,30,5438,433907826,0,0,0,763.91,8,290924.98,24,0,16,7,True
7944922,1207,4,451,9307,433907826,0,0,0,764.21,7,290160.77,24,2,0,9,True
8105521,859,2,451,4582,433907826,0,0,0,764.03,7,289396.74,24,0,6,9,True
8287124,739,1,30,4050,433907826,0,0,0,764.02,8,288632.72,24,5,9,9,True
8292848,577,0,-1,6189,433907826,0,1,0,763.89,1,288632.72,11,5,19,9,True
8321209,1207,4,451,1223,433907826,0,0,0,763.98,7,287868.74,24,1,17,10,True
8370121,739,1,451,4373,433907826,0,0,0,763.78,7,287104.96,24,2,6,11,True
8377310,865,0,10,8305,433907826,0,0,0,764.19,6,287869.15,24,0,19,12,True
8423234,1168,3,451,9307,433907826,0,0,0,763.95,7,287105.2,24,6,9,12,True
8508265,577,0,-1,8161,433907826,0,1,0,764.21,4,287105.2,11,6,12,1,True
8573529,643,4,451,6127,433907826,0,0,0,763.75,7,286341.45,24,4,23,1,True
8776634,739,1,30,5438,433907826,0,0,0,764.0,8,285577.45,24,2,22,3,True
9233849,859,2,451,1223,433907826,0,0,0,764.02,7,284813.43,24,1,21,4,True
9237865,577,0,451,7315,433907826,0,0,0,764.29,7,284049.14,11,3,18,5,True
9276568,577,0,25,3330,433907826,0,0,0,764.05,8,283285.09,11,0,17,6,True
9284158,303,0,10,6127,433907826,0,0,0,764.0,6,284049.09,4,1,12,7,True
9759609,859,2,451,3325,433907826,0,0,0,763.79,7,283285.3,24,3,5,8,True
9784104,96,0,20,8305,433907826,0,0,0,764.15,3,282521.15,1,1,7,11,True
1003591,1156,1,10,8027,937804838,0,0,0,692.16,6,734823.16,15,0,4,1,True
1006342,1189,2,20,7066,937804838,0,0,0,691.9,3,734131.26,24,2,5,1,True
1519869,991,1,451,9624,937804838,0,0,0,692.15,7,733439.11,22,0,23,1,False
1674928,1272,0,20,8027,937804838,0,0,0,692.11,3,732747.0,24,5,6,1,True
1944994,257,1,25,3164,937804838,0,0,0,691.64,8,732055.36,6,1,7,2,True
1988558,334,0,30,3163,937804838,0,0,0,691.71,8,731363.65,11,2,20,3,True
2032371,257,1,451,6828,937804838,0,0,0,691.93,7,730671.72,6,3,14,5,True
2108579,990,0,10,8336,937804838,0,0,0,692.04,6,731363.76,22,5,1,5,True
2145426,279,2,-1,6828,937804838,0,1,0,691.84,4,731363.76,24,6,21,5,True
2563351,991,1,451,8336,937804838,0,0,0,691.8,7,730671.96,22,3,15,6,True
2810132,257,1,25,8336,937804838,0,0,0,692.29,8,729979.67,6,2,9,6,True
3045999,1140,0,20,6613,937804838,0,0,0,692.06,3,729287.61,15,6,7,6,True
3110146,944,2,451,7066,937804838,0,0,0,691.96,7,728595.65,24,2,21,8,True
3449178,952,0,20,5900,937804838,0,0,0,692.01,3,727903.64,13,0,1,10,True
3531917,334,0,451,5132,937804838,0,0,0,691.8,7,727211.84,11,3,14,10,True
3543757,398,0,-1,5132,937804838,0,1,0,691.9,4,727211.84,10,2,19,12,True
3785376,944,2,451,8027,937804838,0,0,0,692.05,7,726519.79,24,5,19,3,True
3836872,991,1,451,6828,937804838,0,0,0,691.71,7,725828.08,22,1,22,3,True
3945909,812,0,10,3666,937804838,0,0,0,691.93,6,726520.01,18,4,5,3,True
4177692,522,0,10,9624,937804838,0,0,0,691.85,0,727211.86,18,1,13,5,True
4343570,944,2,-1,9624,937804838,0,1,0,692.04,4,727211.86,24,2,3,5,True
4955233,944,2,30,7066,937804838,0,0,0,692.05,8,726519.81,24,4,1,7,True
5135653,334,0,25,8027,937804838,0,0,0,692.08,8,725827.73,11,1,18,8,True
5415121,257,1,451,8336,937804838,0,0,0,692.02,7,725135.71,6,5,12,11,True
5428995,1170,0,451,3536,937804838,0,0,0,692.16,7,724443.55,24,0,12,12,True
5580116,257,1,451,5132,937804838,0,0,0,692.15,7,723751.4,6,6,10,1,True
5603694,398,0,451,5900,937804838,0,0,0,692.01,7,723059.39,10,5,5,2,True
5709544,257,1,30,5132,937804838,0,0,0,692.03,8,722367.36,6,3,19,2,True
6020059,334,0,25,8027,937804838,0,0,0,692.01,8,721675.35,11,6,21,2,True
6216579,257,1,451,6613,937804838,0,0,0,692.2,7,720983.15,6,4,19,3,True
6294834,944,2,30,5900,937804838,0,0,0,692.06,8,720291.09,24,3,23,4,True
6765806,279,2,451,7771,937804838,0,0,0,692.11,7,719598.98,24,4,0,5,True
7070180,334,0,451,7208,937804838,0,0,0,692.0,7,718906.98,11,4,21,6,True
7087088,429,0,20,7710,937804838,0,0,0,692.1,3,718214.88,24,2,22,7,True
7168668,257,1,30,7066,937804838,0,0,0,692.04,8,717522.84,6,5,17,7,True
7257899,398,0,30,5132,937804838,0,0,0,691.76,8,716831.08,10,6,18,7,True
7339318,1170,0,451,1092,937804838,0,0,0,692.31,7,716138.77,24,4,3,9,True
7366584,509,0,10,7066,937804838,0,0,0,692.18,0,716830.95,12,0,4,9,True
7481914,117,1,10,1256,937804838,0,0,0,692.0,0,717522.95,18,6,15,9,True
7620307,531,0,10,1092,937804838,0,0,0,691.76,0,718214.71,18,2,19,10,True
7884824,1170,0,-1,6828,937804838,0,1,0,692.0,4,718214.71,24,1,16,10,True
7998377,944,2,-1,5900,937804838,0,2,0,692.19,1,718214.71,24,6,21,11,True
8222932,334,0,-1,3163,937804838,0,3,1,691.92,4,0.0,11,6,0,11,True
1112054,496,1,25,6232,225695011,0,0,0,433.9,8,813177.1,12,0,23,1,True
1463185,919,4,451,7348,225695011,0,0,0,434.01,7,812743.09,18,1,2,1,True
1528451,1053,1,10,8266,225695011,0,0,0,434.21,0,813177.3,11,6,23,5,True
1550415,721,4,25,8132,225695011,0,0,0,434.11,8,812743.19,11,1,23,7,True
1734225,1111,0,10,7730,225695011,0,0,0,433.97,0,813177.16,0,4,7,9,True
1855074,919,4,30,1536,225695011,0,0,0,434.05,8,812743.11,18,2,7,9,True
2318530,670,0,10,8266,225695011,0,0,0,434.31,6,813177.42,18,3,2,10,True
2451214,919,4,451,8030,225695011,0,0,0,433.95,7,812743.47,18,4,0,10,True
2499495,496,1,30,7026,225695011,0,0,0,434.12,8,812309.35,12,1,7,12,True
2500368,1061,2,-1,7730,225695011,0,1,0,434.24,4,812309.35,11,3,12,12,True
2513294,314,0,10,8266,225695011,0,0,0,434.0,0,812743.35,4,4,12,12,True
2592002,1429,0,30,2080,225695011,0,0,0,433.9,8,812309.45,24,2,3,12,True
2631554,1061,2,25,7026,225695011,0,0,0,433.98,8,811875.47,11,0,2,1,True
2989859,1122,1,10,2080,225695011,0,0,0,433.95,6,812309.42,24,6,2,2,True
3024105,1061,2,25,4363,225695011,0,0,0,434.15,8,811875.27,11,3,15,4,True
3040453,1086,0,20,8132,225695011,0,0,0,434.02,5,811441.25,18,0,10,5,True
3129975,919,4,25,8132,225695011,0,0,0,433.88,8,811007.37,18,3,21,7,True
3263032,1367,4,451,9966,225695011,0,0,0,433.86,7,810573.51,16,5,16,9,True
3358198,496,1,451,5491,225695011,0,0,0,433.95,7,810139.56,12,6,9,10,True
3465039,800,0,451,8030,225695011,0,0,0,433.9,7,809705.66,11,2,6,11,True
3552071,496,1,30,5582,225695011,0,0,0,433.81,8,809271.85,12,5,15,11,True
3995662,721,4,451,1878,225695011,0,0,0,434.23,7,808837.62,11,6,14,12,True
4090771,514,4,30,6232,225695011,0,0,0,433.92,8,808403.7,12,2,10,1,True
4134001,116,0,10,1242,225695011,0,0,0,434.03,6,808837.73,3,5,6,2,True
4576689,721,4,-1,8030,225695011,0,1,0,434.09,4,808837.73,11,6,4,2,True
4632623,626,2,20,5554,225695011,0,0,0,434.12,3,808403.61,11,0,6,3,True
4748803,537,0,20,9966,225695011,0,0,0,434.06,5,807969.55,18,6,5,4,True
4893688,919,4,451,5540,225695011,0,0,0,433.87,7,807535.68,18,1,14,4,True
4917061,329,1,10,4363,225695011,0,0,0,434.14,0,807969.82,11,2,23,7,True
5134844,84,4,-1,5582,225695011,0,1,0,434.12,4,807969.82,1,4,13,7,True
5233878,721,4,-1,5491,225695011,0,2,0,433.78,4,807969.82,11,0,7,10,True
5304755,514,4,-1,7546,225695011,0,3,1,434.19,4,0.0,12,3,22,10,True
1013626,84,4,30,9254,636193227,0,0,0,938.93,8,240763.07,1,5,23,1,True
1144762,563,4,30,8742,636193227,0,0,0,939.31,8,239823.76,17,2,4,4,True
1569747,1009,0,10,8742,636193227,0,0,0,939.19,6,240762.95,26,5,6,4,True
1649320,84,4,25,3244,636193227,0,0,0,939.17,8,239823.78,1,3,23,4,True
1816007,563,4,-1,6101,636193227,0,1,0,938.78,4,239823.78,17,0,2,7,True
1908569,140,3,451,6364,636193227,0,0,0,938.94,7,238884.84,18,2,0,7,True
2416294,314,0,-1,7657,636193227,0,1,0,939.0,4,238884.84,4,4,6,7,True
2435465,53,0,451,3244,636193227,0,0,0,938.91,7,237945.93,20,1,9,8,True
2465853,84,4,25,3616,636193227,0,0,0,938.9,8,237007.03,1,0,17,8,True
2472621,490,4,451,3206,636193227,0,0,0,938.91,7,236068.12,12,1,11,8,True
2677153,1424,4,451,8605,636193227,0,0,0,938.97,7,235129.15,24,1,22,9,True
2752298,140,3,-1,6579,636193227,0,1,0,938.94,1,235129.15,18,2,6,9,True
2940488,1354,0,20,3616,636193227,0,0,0,939.32,5,234189.83,24,3,6,9,True
3003201,291,3,-1,3616,636193227,0,1,0,938.98,4,234189.83,24,4,3,9,True
3026912,562,1,10,6364,636193227,0,0,0,939.02,6,235128.85,17,6,20,10,True
3435638,291,3,30,3616,636193227,0,0,0,939.26,8,234189.59,24,1,17,10,True
3694192,53,0,451,8807,636193227,0,0,0,938.94,7,233250.65,20,0,21,11,True
3906114,563,4,451,6516,636193227,0,0,0,939.0,7,232311.65,17,1,0,11,False
3980571,291,3,451,3511,636193227,0,0,0,938.84,7,231372.81,24,5,21,12,True
4258081,490,4,30,1305,636193227,0,0,0,939.02,8,230433.79,12,0,5,1,True
4393297,291,3,30,1891,636193227,0,0,0,939.24,8,229494.55,24,5,8,2,True
4518051,490,4,451,7657,636193227,0,0,0,939.33,7,228555.22,12,5,11,2,True
4637812,940,1,10,8605,636193227,0,0,0,939.11,6,229494.33,24,0,21,3,True
4674208,1390,0,10,8605,636193227,0,0,0,938.9,6,230433.23,24,3,3,4,True
4710772,563,4,-1,3141,636193227,0,1,0,938.64,4,230433.23,17,5,19,4,True
5022823,291,3,30,5451,636193227,0,0,0,939.06,8,229494.17,24,1,11,5,True
5101829,1436,0,20,8012,636193227,0,0,0,938.88,3,228555.29,24,0,8,7,True
5273842,503,0,20,2565,636193227,0,0,0,939.16,3,227616.13,12,4,8,7,True
5285377,889,0,20,3206,636193227,0,0,0,939.07,5,226677.06,27,2,2,7,False
5505776,140,3,451,2565,636193227,0,0,0,939.07,7,225737.99,18,4,7,7,True
5508281,314,0,451,7657,636193227,0,0,0,939.14,7,224798.85,4,4,0,8,True
5763079,563,4,-1,6364,636193227,0,1,0,938.94,1,224798.85,17,4,9,8,False
5784955,563,4,451,6516,636193227,0,0,0,939.08,7,223859.77,17,6,1,9,True
6184133,84,4,25,6364,636193227,0,0,0,939.06,8,222920.71,1,2,1,9,True
6447360,140,3,25,5904,636193227,0,0,0,939.03,8,221981.68,18,3,7,12,True
6471455,140,3,451,8012,636193227,0,0,0,939.12,7,221042.56,18,3,10,1,True
6520477,490,4,-1,8742,636193227,0,1,0,939.05,1,221042.56,12,0,0,1,False
6716084,140,3,451,3244,636193227,0,0,0,938.87,7,220103.69,18,4,17,3,True
6855611,53,0,-1,7657,636193227,0,1,0,939.01,4,220103.69,20,1,17,5,True
7072337,490,4,451,9254,636193227,0,0,0,938.87,7,219164.82,12,2,20,5,True
7133930,563,4,25,9254,636193227,0,0,0,938.96,8,218225.86,17,6,21,5,True
7422631,314,0,30,6579,636193227,0,0,0,938.98,8,217286.88,4,4,1,7,True
7548813,140,3,451,3244,636193227,0,0,0,939.08,7,216347.8,18,5,5,7,True
7731238,1424,4,30,6516,636193227,0,0,0,939.09,8,215408.71,24,1,2,7,True
8755243,53,0,451,8012,636193227,0,0,0,938.85,7,214469.86,20,4,1,8,True
9195737,642,0,20,5451,636193227,0,0,0,939.02,3,213530.84,24,4,3,8,True
9730100,314,0,30,8807,636193227,0,0,0,938.84,8,212592.0,4,1,23,8,True
9746633,563,4,30,3511,636193227,0,0,0,938.92,8,211653.08,17,3,13,9,True
9762277,140,3,25,3141,636193227,0,0,0,938.89,8,210714.19,18,4,23,10,True
9829354,490,4,451,1891,636193227,0,0,0,938.75,7,209775.44,12,6,18,10,True
9831798,563,4,-1,1305,636193227,0,1,0,938.61,1,209775.44,17,3,1,11,True
1053218,871,0,20,9980,540169508,1,0,0,813.85,5,262915.15,24,6,13,1,True
1093508,678,4,-1,2676,540169508,1,1,0,813.97,4,262915.15,24,4,7,2,True
1156087,1339,2,25,8616,540169508,1,0,0,813.97,8,262101.18,18,3,6,2,True
1352148,678,4,-1,7365,540169508,1,1,0,813.95,4,262101.18,24,1,3,2,True
1364591,81,0,451,7365,540169508,1,0,0,814.04,7,261287.14,1,3,7,3,True
1373312,159,2,451,7365,540169508,1,0,0,814.13,7,260473.01,24,6,9,3,True
1437576,767,0,-1,2184,540169508,1,1,0,814.19,4,260473.01,14,4,11,3,True
1518147,715,0,451,4553,540169508,1,0,0,814.17,7,259658.84,18,3,18,3,True
1910991,781,1,10,9752,540169508,1,0,0,814.02,0,260472.86,14,2,7,4,True
2274731,1339,2,451,7365,540169508,1,0,0,814.06,7,259658.8,18,4,12,4,True
2427469,1318,0,10,2414,540169508,1,0,0,813.86,6,260472.66,18,5,10,6,True
2531969,1339,2,-1,4092,540169508,1,1,0,813.91,1,260472.66,18,4,23,6,True
2591728,29,0,20,4553,540169508,1,0,0,813.63,5,259659.03,11,5,13,6,True
2968714,715,0,451,8863,540169508,1,0,0,813.92,7,258845.11,18,5,14,6,True
3116487,159,2,25,9752,540169508,1,0,0,814.14,8,258030.97,24,3,8,7,True
3600048,52,4,451,7589,540169508,1,0,0,813.84,7,257217.13,20,4,9,8,True
3619370,81,0,451,8684,540169508,1,0,0,814.12,7,256403.01,1,5,1,9,True
3841903,767,0,451,2414,540169508,1,0,0,813.97,7,255589.04,14,0,8,9,True
4019329,1226,2,20,4553,540169508,1,0,0,813.93,5,254775.11,18,6,3,9,True
4045872,715,0,25,9980,540169508,1,0,0,813.88,8,253961.23,18,1,15,9,True
4277765,159,2,30,9752,540169508,1,0,0,813.99,8,253147.24,24,4,14,10,True
4291426,767,0,25,2676,540169508,1,0,0,814.11,8,252333.13,14,5,11,10,True
4460665,767,0,-1,3164,540169508,1,1,0,813.95,4,252333.13,14,3,0,12,False
4513873,752,0,20,7589,540169508,1,0,0,814.11,5,251519.02,24,5,23,12,True
4705165,949,4,-1,4092,540169508,1,1,0,813.86,4,251519.02,24,3,12,1,False
4828239,678,4,30,6360,540169508,1,0,0,814.39,8,250704.63,24,0,18,1,True
4861552,831,1,10,2676,540169508,1,0,0,813.98,6,251518.61,5,2,13,2,False
4874504,678,4,451,2676,540169508,1,0,0,814.09,7,250704.52,24,0,15,3,True
5474727,52,4,30,4553,540169508,1,0,0,814.14,8,249890.38,20,2,14,3,True
5652083,159,2,30,9192,540169508,1,0,0,813.83,8,249076.55,24,1,9,4,True
6185686,767,0,30,3164,540169508,1,0,0,814.14,8,248262.41,14,3,22,4,True
6273646,1339,2,30,4882,540169508,1,0,0,813.68,8,247448.73,18,2,20,5,True
6505960,715,0,-1,2184,540169508,1,1,0,814.02,4,247448.73,18,1,14,6,True
6633292,159,2,451,6360,540169508,1,0,0,814.21,7,246634.52,24,1,18,6,True
6654394,159,2,-1,4553,540169508,1,1,0,814.12,4,246634.52,24,3,22,7,True
6659412,678,4,25,2184,540169508,1,0,0,814.08,8,245820.44,24,2,18,8,True
6775559,767,0,30,4092,540169508,1,0,0,814.0,8,245006.44,14,2,8,9,True
6790138,949,4,451,4092,540169508,1,0,0,813.98,7,244192.46,24,3,20,9,True
6802335,159,2,451,9752,540169508,1,0,0,814.01,7,243378.45,24,2,15,9,True
7092872,882,0,10,2414,540169508,1,0,0,814.05,0,244192.5,27,2,8,10,True
7204929,767,0,451,7589,540169508,1,0,0,813.87,7,243378.63,14,1,19,10,True
7267666,1278,0,10,4092,540169508,1,0,0,813.7,6,244192.33,24,3,13,12,True
7308511,767,0,-1,9192,540169508,1,1,0,813.99,1,244192.33,14,1,23,12,True
7366048,159,2,451,4882,540169508,1,0,0,814.0,7,243378.33,24,6,16,12,True
7471380,81,0,25,8684,540169508,1,0,0,814.17,8,242564.16,1,5,1,2,True
7900248,81,0,-1,8863,540169508,1,1,0,813.87,4,242564.16,1,3,1,4,True
8245815,678,4,451,4576,540169508,1,0,0,813.92,7,241750.24,24,3,2,6,True
8548519,767,0,25,4553,540169508,1,0,0,813.7,8,240936.54,14,6,10,7,True
8580740,1321,0,20,9980,540169508,1,0,0,813.95,3,240122.59,18,4,19,7,True
8622322,58,2,20,4553,540169508,1,0,0,813.85,3,239308.74,20,4,3,7,True
8697561,767,0,451,8309,540169508,1,0,0,814.12,7,238494.62,14,1,4,8,True
8820939,1247,0,20,9752,540169508,1,0,0,813.98,3,237680.64,23,3,8,8,True
8950770,81,0,-1,3164,540169508,1,1,0,814.09,4,237680.64,1,4,10,8,True
9109502,1413,0,10,6360,540169508,1,0,0,813.63,6,238494.27,24,5,21,9,True
9557132,949,4,25,6360,540169508,1,0,0,814.1,8,237680.17,24,4,21,9,True
9622242,1339,2,30,2184,540169508,1,0,0,813.97,8,236866.2,18,1,22,11,True
9631648,949,4,25,6360,540169508,1,0,0,813.93,8,236052.27,24,2,12,11,True
9672016,767,0,-1,4576,540169508,1,1,0,813.81,1,236052.27,14,5,0,11,True
9874240,715,0,-1,7589,540169508,1,2,0,814.08,4,236052.27,18,1,20,11,True
1013714,1318,0,20,5188,518011847,1,0,0,268.92,5,418208.08,18,6,12,1,True
1128980,1041,0,10,5188,518011847,1,0,0,268.82,6,418476.9,11,3,23,2,True
1258681,605,0,10,8314,518011847,1,0,0,269.03,6,418745.93,24,3,14,2,True
1416389,1393,3,25,5181,518011847,1,0,0,268.65,8,418477.28,24,6,15,3,True
1511173,867,0,10,5844,518011847,1,0,0,269.12,6,418746.4,24,0,10,4,True
1624157,626,2,-1,2151,518011847,1,1,0,269.0,4,418746.4,11,6,1,5,True
1740983,575,4,25,4877,518011847,1,0,0,268.85,8,418477.55,11,2,18,6,True
1976524,958,2,20,2050,518011847,1,0,0,269.03,3,418208.52,13,1,23,7,True
2022002,1443,4,30,1266,518011847,1,0,0,269.15,8,417939.37,24,5,2,7,True
2105864,626,2,-1,3822,518011847,1,1,0,268.85,1,417939.37,11,3,15,9,True
2141787,807,0,20,7717,518011847,1,0,0,268.98,3,417670.39,11,3,3,9,True
2878778,626,2,451,1423,518011847,1,0,0,269.19,7,417401.2,11,4,20,10,True
3244462,1393,3,25,8019,518011847,1,0,0,268.91,8,417132.29,24,0,14,10,True
3610591,51,0,30,7717,518011847,1,0,0,268.99,8,416863.3,20,4,17,11,True
3660413,1443,4,30,4164,518011847,1,0,0,269.27,8,416594.03,24,0,22,11,True
3883105,626,2,451,5178,518011847,1,0,0,268.89,7,416325.14,11,4,10,11,True
3897094,282,2,20,5181,518011847,1,0,0,268.97,5,416056.17,24,5,1,2,True
3964519,51,0,30,4164,518011847,1,0,0,269.07,8,415787.1,20,6,21,2,True
4346313,1443,4,451,4877,518011847,1,0,0,269.07,7,415518.03,24,1,20,2,True
5028482,51,0,25,5188,518011847,1,0,0,269.04,8,415248.99,20,3,12,3,True
5082818,1443,4,30,5178,518011847,1,0,0,269.05,8,414979.94,24,2,13,4,True
5097722,98,0,20,5181,518011847,1,0,0,268.96,3,414710.98,3,6,9,4,True
5436467,281,1,10,9076,518011847,1,0,0,268.8,0,414979.78,24,2,8,5,True
5449270,609,3,451,9183,518011847,1,0,0,269.03,7,414710.75,24,4,6,6,True
5704233,609,3,451,5878,518011847,1,0,0,268.93,7,414441.82,24,3,15,7,True
5830844,51,0,-1,5181,518011847,1,1,0,269.32,1,414441.82,20,2,11,7,True
5846709,626,2,30,9183,518011847,1,0,0,269.05,8,414172.77,11,3,3,7,True
5847780,300,0,20,6162,518011847,1,0,0,269.17,5,413903.6,4,0,16,7,True
6015058,1393,3,451,7543,518011847,1,0,0,268.95,7,413634.65,24,1,15,8,True
6022524,575,4,451,8314,518011847,1,0,0,269.03,7,413365.62,11,4,13,11,True
6071001,609,3,30,5181,518011847,1,0,0,269.27,8,413096.35,24,4,19,11,True
6133504,609,3,25,5181,518011847,1,0,0,268.9,8,412827.45,24,4,1,12,True
6235940,222,2,20,4877,518011847,1,0,0,268.82,5,412558.63,26,6,18,1,True
6375319,882,0,10,3103,518011847,1,0,0,269.0,6,412827.63,27,5,20,2,True
6885610,1443,4,30,1423,518011847,1,0,0,269.09,8,412558.54,24,3,20,2,True
6943253,523,2,20,1423,518011847,1,0,0,269.22,5,412289.32,18,6,12,3,True
6948919,1443,4,451,2541,518011847,1,0,0,268.93,7,412020.39,24,2,8,4,True
7007921,787,0,10,3822,518011847,1,0,0,268.95,6,412289.34,14,2,4,4,True
7191304,609,3,25,3080,518011847,1,0,0,268.83,8,412020.51,24,3,11,4,True
7225348,609,3,451,8314,518011847,1,0,0,269.0,7,411751.51,24,4,15,5,True
7542626,609,3,451,4877,518011847,1,0,0,269.12,7,411482.39,24,2,19,5,True
8003207,1443,4,451,4877,518011847,1,0,0,268.85,7,411213.54,24,1,2,5,True
8137130,1443,4,451,3822,518011847,1,0,0,268.89,7,410944.65,24,1,14,5,True
8148004,609,3,451,8019,518011847,1,0,0,268.83,7,410675.82,24,4,11,6,True
8295271,609,3,25,7543,518011847,1,0,0,269.08,8,410406.74,24,3,6,7,True
8673071,1029,0,10,7543,518011847,1,0,0,269.25,6,410675.99,11,3,14,8,True
8765833,609,3,-1,5178,518011847,1,1,0,269.0,1,410675.99,24,3,10,8,True
9307347,626,2,25,2252,518011847,1,0,0,268.91,8,410407.08,11,6,21,8,True
9394502,238,0,10,2541,518011847,1,0,0,269.09,6,410676.17,26,1,20,9,True
9435577,609,3,-1,6162,518011847,1,1,0,269.1,1,410676.17,24,3,11,10,True
9534671,51,0,25,4164,518011847,1,0,0,268.83,8,410407.34,20,6,5,11,True
9757310,465,0,10,5650,518011847,1,0,0,268.94,6,410676.28,13,4,15,11,True
1030505,273,4,-1,3631,820573605,1,1,0,337.8,4,184889.0,24,5,23,1,True
1055263,1123,2,25,9625,820573605,1,0,0,337.86,8,184551.14,24,6,15,1,True
1058425,324,4,25,6942,820573605,1,0,0,337.91,8,184213.23,11,6,9,1,True
1313948,132,2,451,9686,820573605,1,0,0,337.81,7,183875.42,18,3,0,2,True
1394694,155,1,-1,4952,820573605,1,1,0,338.34,4,183875.42,18,3,21,3,True
1991649,996,0,-1,1870,820573605,1,2,0,338.38,4,183875.42,26,2,22,4,True
2012613,1094,0,451,5258,820573605,1,0,0,338.09,7,183537.33,0,4,2,4,True
2062054,273,4,451,5999,820573605,1,0,0,337.95,7,183199.38,24,2,21,6,True
2267694,1039,1,10,3948,820573605,1,0,0,338.14,0,183537.52,11,6,20,9,True
2268481,1426,1,10,9978,820573605,1,0,0,338.08,0,183875.6,24,6,12,10,True
3241668,324,4,25,5021,820573605,1,0,0,338.07,8,183537.53,11,5,20,11,True
3276131,324,4,451,5923,820573605,1,0,0,337.93,7,183199.6,11,1,11,3,True
3312004,132,2,451,7712,820573605,1,0,0,338.12,7,182861.48,18,3,3,4,True
3530234,273,4,30,1085,820573605,1,0,0,337.99,8,182523.49,24,5,16,5,True
3655213,273,4,451,1667,820573605,1,0,0,338.02,7,182185.47,24,2,16,5,True
3780940,1094,0,451,9978,820573605,1,0,0,338.08,7,181847.39,0,3,3,7,True
4175455,132,2,25,9686,820573605,1,0,0,338.1,8,181509.29,18,2,18,8,True
4318170,1298,0,20,5258,820573605,1,0,0,338.04,5,181171.25,5,2,14,10,True
4335097,1123,2,-1,6642,820573605,1,1,0,338.08,1,181171.25,24,2,10,11,True
4488343,273,4,-1,6942,820573605,1,2,0,338.18,4,181171.25,24,0,23,3,True
4663189,132,2,-1,3631,820573605,1,3,1,338.01,1,181171.25,18,0,23,8,True
1167172,943,4,451,4069,216648812,1,0,0,222.06,7,676081.94,24,5,1,1,True
1186448,523,2,20,3688,216648812,1,0,0,222.19,5,675859.75,18,1,1,1,True
1337744,782,4,25,1827,216648812,1,0,0,222.07,8,675637.68,14,4,17,1,True
1377055,673,0,451,9244,216648812,1,0,0,221.84,7,675415.84,18,5,20,1,True
1562390,811,0,451,4701,216648812,1,0,0,221.96,7,675193.88,18,2,15,2,True
1637818,416,2,451,9824,216648812,1,0,0,221.93,7,674971.95,18,6,9,2,True
1673040,811,0,-1,2637,216648812,1,1,0,221.65,4,674971.95,18,6,18,2,True
1786905,804,0,10,4787,216648812,1,0,0,222.01,6,675193.96,11,2,14,2,True
1837769,635,2,20,7432,216648812,1,0,0,221.92,5,674972.04,24,4,14,4,True
2610410,498,0,10,3078,216648812,1,0,0,221.85,6,675193.89,12,0,9,5,True
3033740,334,0,20,4368,216648812,1,0,0,222.03,3,674971.86,11,3,17,5,True
3091300,1354,0,10,3030,216648812,1,0,0,222.03,6,675193.89,24,3,20,6,True
3221415,416,2,451,4368,216648812,1,0,0,222.16,7,674971.73,18,0,9,6,True
3400192,416,2,25,4634,216648812,1,0,0,221.93,8,674749.8,18,0,18,7,True
4161360,673,0,-1,9913,216648812,1,1,0,222.03,4,674749.8,18,6,4,7,True
4308519,416,2,30,4787,216648812,1,0,0,221.86,8,674527.94,18,4,22,7,True
4414172,943,4,30,4096,216648812,1,0,0,222.09,8,674305.85,24,5,14,11,True
4472055,416,2,25,3688,216648812,1,0,0,222.08,8,674083.77,18,5,18,1,True
4474012,1210,0,10,5959,216648812,1,0,0,222.09,0,674305.86,24,4,17,2,True
4654112,548,2,20,2942,216648812,1,0,0,221.72,3,674084.14,17,0,17,2,True
4789705,719,4,25,3123,216648812,1,0,0,222.1,8,673862.04,11,5,11,3,True
5139752,719,4,451,7432,216648812,1,0,0,222.24,7,673639.8,11,1,19,5,True
5286909,811,0,-1,4634,216648812,1,1,0,222.32,4,673639.8,18,5,21,7,True
5350111,1264,0,451,9913,216648812,1,0,0,221.98,7,673417.82,23,3,23,7,True
5502745,538,0,10,4787,216648812,1,0,0,222.13,6,673639.95,18,5,18,7,True
5691491,979,0,20,4701,216648812,1,0,0,221.95,3,673418.0,22,6,10,8,True
5908331,782,4,30,2637,216648812,1,0,0,221.88,8,673196.12,14,2,20,9,True
5928474,416,2,25,2637,216648812,1,0,0,222.16,8,672973.96,18,3,17,9,True
5930949,1264,0,-1,2637,216648812,1,1,0,222.04,4,672973.96,23,1,1,9,True
6094162,1264,0,451,9824,216648812,1,0,0,221.87,7,672752.09,23,4,8,9,True
6243794,719,4,25,5959,216648812,1,0,0,222.0,8,672530.09,11,4,12,10,True
6294862,673,0,-1,4701,216648812,1,1,0,221.92,1,672530.09,18,0,22,11,True
6454808,673,0,-1,5959,216648812,1,2,0,221.68,4,672530.09,18,1,7,11,True
6462622,1264,0,30,4701,216648812,1,0,0,221.83,8,672308.26,23,2,17,11,True
6615373,811,0,-1,4368,216648812,1,1,0,222.07,4,672308.26,18,4,4,11,False
7009892,811,0,30,4787,216648812,1,0,0,222.31,8,672085.95,18,0,12,12,True
7015361,811,0,25,2516,216648812,1,0,0,222.25,8,671863.7,18,2,10,12,True
7390722,1247,0,10,7432,216648812,1,0,0,222.0,6,672085.7,23,6,2,12,True
7453978,943,4,451,2029,216648812,1,0,0,221.93,7,671863.77,24,5,8,1,True
7581572,1264,0,20,2029,216648812,1,0,0,221.96,5,671641.81,23,0,23,2,True
7895702,811,0,25,4701,216648812,1,0,0,221.83,8,671419.98,18,2,22,3,True
8286688,416,2,-1,2685,216648812,1,1,0,221.79,1,671419.98,18,1,13,3,True
8590022,719,4,30,2685,216648812,1,0,0,221.57,8,671198.41,11,2,16,4,True
8688307,416,2,25,1827,216648812,1,0,0,222.09,8,670976.32,18,5,4,4,True
8914777,416,2,451,6354,216648812,1,0,0,222.06,7,670754.26,18,3,22,6,True
9069159,94,3,451,2685,216648812,1,0,0,221.92,7,670532.34,1,1,18,6,True
9156013,416,2,451,9824,216648812,1,0,0,221.86,7,670310.48,18,6,18,7,True
9372288,416,2,451,2942,216648812,1,0,0,221.87,7,670088.61,18,5,2,9,True
9381388,1233,0,10,2516,216648812,1,0,0,221.86,0,670310.47,18,1,17,9,True
9458080,64,0,20,2516,216648812,1,0,0,222.25,5,670088.22,20,4,20,9,True
9573694,916,0,20,4096,216648812,1,0,0,222.29,5,669865.93,18,5,11,9,True
9612236,1264,0,30,4634,216648812,1,0,0,221.71,8,669644.22,23,0,1,11,True
9636850,416,2,-1,2516,216648812,1,1,0,221.71,1,669644.22,18,4,0,11,True
9924237,94,3,25,2029,216648812,1,0,0,221.94,8,669422.28,1,2,5,11,True
1053760,858,1,-1,7623,245293792,1,1,0,842.83,1,195203.0,24,6,16,1,True
1076102,677,0,451,6117,245293792,1,0,0,842.98,7,194360.02,24,0,12,2,True
1117213,350,0,20,3412,245293792,1,0,0,843.06,5,193516.96,24,0,1,2,True
1202380,194,1,10,2764,245293792,1,0,0,842.85,6,194359.81,18,0,4,3,True
1423838,1132,0,10,9955,245293792,1,0,0,842.85,6,195202.66,24,6,1,4,True
1634900,1124,0,20,3412,245293792,1,0,0,842.91,3,194359.75,24,0,7,4,True
1940459,728,1,10,6413,245293792,1,0,0,843.07,6,195202.82,11,0,21,4,True
2078519,1027,0,10,8648,245293792,1,0,0,843.06,6,196045.88,11,1,17,4,True
2533736,138,3,451,9104,245293792,1,0,0,842.95,7,195202.93,18,3,11,4,True
2632793,997,3,451,6489,245293792,1,0,0,842.88,7,194360.05,26,5,20,4,True
2748035,858,1,-1,3412,245293792,1,1,0,843.21,1,194360.05,24,3,12,6,True
2890952,669,2,451,8953,245293792,1,0,0,842.84,7,193517.21,18,6,18,8,True
2897666,1246,0,451,3590,245293792,1,0,0,843.1,7,192674.11,23,4,8,9,True
3385381,1249,2,20,9955,245293792,1,0,0,842.95,3,191831.16,23,1,9,9,True
3516929,858,1,-1,5746,245293792,1,1,0,843.09,1,191831.16,24,3,12,9,True
3582906,446,1,10,7623,245293792,1,0,0,843.11,6,192674.27,13,4,23,9,True
3613935,783,0,10,5109,245293792,1,0,0,842.83,0,193517.1,14,2,1,10,True
3684896,669,2,451,8953,245293792,1,0,0,842.91,7,192674.19,18,3,5,10,True
3809346,378,0,10,3590,245293792,1,0,0,842.73,0,193516.92,25,5,19,10,True
3899759,138,3,-1,8889,245293792,1,1,0,843.0,4,193516.92,18,5,12,11,True
4001859,228,0,20,6334,245293792,1,0,0,843.1,5,192673.82,26,0,18,12,True
4254086,669,2,25,7623,245293792,1,0,0,843.06,8,191830.76,18,5,16,12,True
4369814,1246,0,-1,5454,245293792,1,1,0,843.08,4,191830.76,23,5,19,1,True
4447914,384,3,451,5119,245293792,1,0,0,843.15,7,190987.61,25,6,4,3,True
4753108,858,1,451,7623,245293792,1,0,0,842.95,7,190144.66,24,3,23,4,True
4766940,350,0,20,6217,245293792,1,0,0,843.14,5,189301.52,24,0,17,5,True
4897954,203,0,10,6413,245293792,1,0,0,842.85,0,190144.37,9,2,13,5,True
5105858,138,3,25,6060,245293792,1,0,0,842.94,8,189301.43,18,1,14,5,True
5117956,998,0,20,3412,245293792,1,0,0,843.25,3,188458.18,26,5,23,6,True
5485319,677,0,25,7240,245293792,1,0,0,842.99,8,187615.19,24,6,6,6,True
5700275,1377,0,10,3590,245293792,1,0,0,843.0,6,188458.19,16,2,11,8,True
5835607,446,1,10,3412,245293792,1,0,0,843.05,6,189301.24,13,2,15,8,True
6009864,1037,0,20,9955,245293792,1,0,0,842.84,5,188458.4,11,1,6,9,True
6199044,867,0,10,9955,245293792,1,0,0,843.12,6,189301.52,24,5,8,9,True
6424754,1235,1,451,9407,245293792,1,0,0,843.11,7,188458.41,18,5,13,10,True
6843374,384,3,-1,6489,245293792,1,1,0,843.3,4,188458.41,25,5,23,10,True
7035800,974,3,25,6217,245293792,1,0,0,842.95,8,187615.46,22,4,4,10,True
7189287,974,3,451,8648,245293792,1,0,0,843.05,7,186772.41,22,6,7,11,True
7236380,997,3,30,7623,245293792,1,0,0,843.1,8,185929.31,26,3,4,11,True
7580882,677,0,451,9576,245293792,1,0,0,842.88,7,185086.43,24,0,10,12,True
7836266,669,2,25,6413,245293792,1,0,0,842.93,8,184243.5,18,2,20,1,True
7942642,1023,2,20,7240,245293792,1,0,0,842.98,3,183400.52,11,1,23,2,True
8089368,997,3,451,7830,245293792,1,0,0,842.93,7,182557.59,26,5,14,2,True
8152705,677,0,451,3432,245293792,1,0,0,842.95,7,181714.64,24,3,11,3,True
8224440,907,0,10,9955,245293792,1,0,0,843.21,6,182557.85,2,4,6,3,True
8378244,1285,1,10,7240,245293792,1,0,0,842.83,6,183400.68,24,3,14,3,True
8429871,1272,0,20,5115,245293792,1,0,0,843.09,3,182557.59,24,5,7,4,True
8627822,126,1,10,3412,245293792,1,0,0,842.9,6,183400.49,18,1,10,4,True
8674053,138,3,25,5115,245293792,1,0,0,842.69,8,182557.8,18,4,3,5,True
8793419,974,3,30,9104,245293792,1,0,0,843.04,8,181714.76,22,4,10,5,True
8897362,138,3,25,9955,245293792,1,0,0,842.95,8,180871.81,18,0,23,5,True
8934157,1246,0,-1,5746,245293792,1,1,0,843.1,1,180871.81,23,1,13,6,True
9059901,1235,1,25,9407,245293792,1,0,0,842.71,8,180029.1,18,0,8,8,True
9079810,974,3,25,6060,245293792,1,0,0,842.88,8,179186.22,22,4,9,8,True
9417657,997,3,25,6334,245293792,1,0,0,843.19,8,178343.03,26,4,3,9,True
9708952,1235,1,30,5115,245293792,1,0,0,843.15,8,177499.88,18,0,20,9,True
9836213,677,0,30,5119,245293792,1,0,0,842.9,8,176656.98,24,0,5,10,True
9844396,974,3,30,7338,245293792,1,0,0,842.83,8,175814.15,22,2,21,11,True
1062166,1110,0,25,9347,761493620,1,0,0,625.08,8,996593.92,0,1,11,1,True
1121473,499,3,30,1213,761493620,1,0,0,624.9,8,995969.02,12,5,9,1,True
1416230,499,3,-1,8040,761493620,1,1,0,624.95,1,995969.02,12,4,1,4,True
1681752,1486,2,-1,2749,761493620,1,2,0,625.03,4,995969.02,24,4,7,4,True
1762811,612,4,25,2714,761493620,1,0,0,625.13,8,995343.89,11,0,2,4,True
2239237,1110,0,30,3040,761493620,1,0,0,625.14,8,994718.75,0,6,19,5,True
2330691,1485,0,30,3040,761493620,1,0,0,624.93,8,994093.82,24,4,12,5,True
2628239,149,2,20,6153,761493620,1,0,0,624.95,5,993468.87,18,3,16,6,True
2752546,1485,0,30,4636,761493620,1,0,0,624.83,8,992844.04,24,3,22,6,True
2768817,1485,0,-1,7361,761493620,1,1,0,625.05,1,992844.04,24,4,20,6,True
2943074,203,0,20,4636,761493620,1,0,0,624.92,5,992219.12,9,2,4,7,True
3182443,612,4,30,4636,761493620,1,0,0,625.07,8,991594.05,11,4,4,8,True
3185302,1486,2,-1,9908,761493620,1,1,0,625.35,4,991594.05,24,4,12,8,True
3201950,198,0,20,7361,761493620,1,0,0,624.79,5,990969.26,18,3,23,9,True
3208878,1485,0,30,1748,761493620,1,0,0,625.01,8,990344.25,24,3,6,11,True
3214422,866,0,20,2749,761493620,1,0,0,625.02,3,989719.23,24,2,9,12,True
3269354,499,3,30,2714,761493620,1,0,0,625.04,8,989094.19,12,6,14,1,True
3395610,1110,0,30,5794,761493620,1,0,0,625.08,8,988469.11,0,0,16,1,True
3482008,1485,0,451,9908,761493620,1,0,0,624.95,7,987844.16,24,3,8,2,True
3502122,1380,0,10,6153,761493620,1,0,0,625.01,0,988469.17,16,0,20,2,True
3613475,1069,1,10,2714,761493620,1,0,0,624.85,6,989094.02,18,4,23,3,True
3796235,1486,2,30,7498,761493620,1,0,0,625.26,8,988468.76,24,0,1,5,True
3989358,1110,0,25,6289,761493620,1,0,0,624.68,8,987844.08,0,2,11,7,True
4095474,1110,0,-1,4636,761493620,1,1,0,625.01,1,987844.08,0,5,10,8,True
4302950,499,3,25,1317,761493620,1,0,0,625.0,8,987219.08,12,6,13,8,True
4502986,1485,0,25,1317,761493620,1,0,0,625.17,8,986593.91,24,0,2,8,True
4511193,1110,0,-1,8040,761493620,1,1,0,625.01,4,986593.91,0,1,5,8,True
4601527,990,0,20,1317,761493620,1,0,0,624.68,5,985969.23,22,3,1,9,True
4678672,1110,0,30,1213,761493620,1,0,0,624.93,8,985344.3,0,3,20,10,True
4786708,1486,2,30,9319,761493620,1,0,0,624.73,8,984719.57,24,4,21,11,True
4793162,1110,0,30,4370,761493620,1,0,0,625.2,8,984094.37,0,1,13,11,True
5169077,1485,0,25,3243,761493620,1,0,0,624.77,8,983469.6,24,5,14,11,True
5309074,167,2,20,3040,761493620,1,0,0,624.96,3,982844.64,24,2,17,12,True
5732508,1483,0,10,8445,761493620,1,0,0,625.0,6,983469.64,24,0,21,12,False
6156169,865,0,20,5794,761493620,1,0,0,624.68,5,982844.96,24,2,23,12,True
6507548,333,1,10,3040,761493620,1,0,0,624.91,0,983469.87,11,4,8,1,True
6687901,1485,0,30,9908,761493620,1,0,0,625.07,8,982844.8,24,3,15,2,True
7147404,612,4,30,1948,761493620,1,0,0,625.01,8,982219.79,11,1,1,5,True
7169247,1486,2,-1,7361,761493620,1,1,0,624.96,4,982219.79,24,4,3,5,True
7365979,1485,0,451,9473,761493620,1,0,0,625.07,7,981594.72,24,2,18,6,True
7494850,1110,0,-1,3243,761493620,1,1,0,625.06,1,981594.72,0,6,9,6,True
7496420,1110,0,25,2714,761493620,1,0,0,625.06,8,980969.66,0,2,7,7,True
7622141,499,3,30,7361,761493620,1,0,0,625.02,8,980344.64,12,4,5,7,True
7996651,1485,0,-1,9347,761493620,1,1,0,624.89,4,980344.64,24,0,6,8,True
8461219,499,3,-1,1213,761493620,1,2,0,624.94,1,980344.64,12,5,11,8,True
8777694,499,3,451,3243,761493620,1,0,0,624.94,7,979719.7,12,3,13,9,True
8968052,499,3,451,1317,761493620,1,0,0,624.99,7,979094.71,12,4,1,9,True
9552704,1110,0,25,7498,761493620,1,0,0,624.88,8,978469.83,0,5,1,9,True
9754978,757,0,10,1748,761493620,1,0,0,625.12,6,979094.95,24,3,17,10,False
9791602,612,4,451,9319,761493620,1,0,0,624.67,7,978470.28,11,5,21,11,True
9949234,1289,1,10,9319,761493620,1,0,0,624.98,0,979095.26,24,5,16,11,True
1097737,961,4,30,8199,183806470,1,0,0,918.09,8,764539.91,13,5,16,1,True
1123273,766,4,451,6952,183806470,1,0,0,917.97,7,763621.94,14,3,11,1,True
1215605,57,3,451,6683,183806470,1,0,0,917.93,7,762704.01,20,3,23,2,True
1494322,57,3,25,3503,183806470,1,0,0,917.92,8,761786.09,20,5,11,3,True
1579713,57,3,25,2446,183806470,1,0,0,917.8,8,760868.29,20,0,6,3,True
1621150,1426,1,30,7148,183806470,1,0,0,918.16,8,759950.13,24,2,16,3,True
1682474,917,0,10,4636,183806470,1,0,0,917.97,6,760868.1,18,4,20,4,True
2172382,57,3,451,1527,183806470,1,0,0,917.79,7,759950.31,20,1,0,4,True
2393973,1312,0,10,3503,183806470,1,0,0,918.04,6,760868.35,5,5,4,4,True
2452089,961,4,30,5547,183806470,1,0,0,918.08,8,759950.27,13,4,16,4,True
2631750,1486,2,-1,4636,183806470,1,1,0,917.85,4,759950.27,24,0,7,5,True
2697786,1476,0,30,1635,183806470,1,0,0,918.12,8,759032.15,24,1,7,5,True
3034452,1476,0,30,6821,183806470,1,0,0,918.01,8,758114.14,24,2,3,6,True
3076531,57,3,30,8199,183806470,1,0,0,917.93,8,757196.21,20,3,11,6,True
3598113,1271,0,10,7148,183806470,1,0,0,918.01,6,758114.22,23,4,18,7,True
3766325,695,2,20,5809,183806470,1,0,0,918.1,5,757196.12,24,5,18,7,True
3805376,1476,0,25,7575,183806470,1,0,0,917.99,8,756278.13,24,1,22,8,True
3999520,1486,2,-1,6683,183806470,1,1,0,918.13,4,756278.13,24,0,13,9,True
4040876,1426,1,25,8935,183806470,1,0,0,917.86,8,755360.27,24,0,10,9,True
4210056,1352,1,30,4636,183806470,1,0,0,917.93,8,754442.34,24,0,4,9,True
4353834,1426,1,30,4636,183806470,1,0,0,918.16,8,753524.18,24,6,15,12,True
4539791,1406,0,10,5809,183806470,1,0,0,917.85,6,754442.03,24,3,0,12,True
4576911,334,0,10,6683,183806470,1,0,0,918.18,6,755360.21,11,3,15,1,True
5581253,64,0,10,6952,183806470,1,0,0,918.05,6,756278.26,20,6,10,1,True
5700589,57,3,25,4636,183806470,1,0,0,918.12,8,755360.14,20,3,17,2,True
5902124,1476,0,451,5547,183806470,1,0,0,918.09,7,754442.05,24,1,19,3,True
5962828,783,0,20,2446,183806470,1,0,0,917.81,5,753524.24,14,3,18,3,True
6233160,108,2,20,6683,183806470,1,0,0,917.85,3,752606.39,3,1,4,3,True
6476211,1352,1,-1,5645,183806470,1,1,0,917.99,4,752606.39,24,5,9,5,True
6690789,785,0,20,7575,183806470,1,0,0,917.77,5,751688.62,14,5,5,6,True
6741370,57,3,-1,4636,183806470,1,1,0,917.88,4,751688.62,20,4,22,6,True
6801798,961,4,-1,5809,183806470,1,2,0,918.05,1,751688.62,13,4,1,7,True
6932842,1476,0,451,4636,183806470,1,0,0,917.88,7,750770.74,24,0,23,7,True
6938258,766,4,-1,5645,183806470,1,1,0,917.91,4,750770.74,14,3,22,9,True
8066919,57,3,25,8935,183806470,1,0,0,917.98,8,749852.76,20,3,21,9,True
8102027,57,3,30,1635,183806470,1,0,0,918.07,8,748934.69,20,6,20,12,True
8108074,1352,1,30,3503,183806470,1,0,0,917.92,8,748016.77,24,2,19,1,True
8394683,961,4,451,6952,183806470,1,0,0,917.77,7,747099.0,13,0,13,1,True
8498348,1476,0,-1,6683,183806470,1,1,0,918.08,4,747099.0,24,0,11,3,True
8500089,961,4,451,1635,183806470,1,0,0,918.08,7,746180.92,13,5,18,3,True
8831027,961,4,451,7555,183806470,1,0,0,918.21,7,745262.71,13,0,2,3,False
9027417,1352,1,25,5547,183806470,1,0,0,918.27,8,744344.44,24,1,15,3,True
9075546,1352,1,451,4636,183806470,1,0,0,918.02,7,743426.42,24,2,0,4,True
9243639,1352,1,451,5645,183806470,1,0,0,918.11,7,742508.31,24,6,7,4,True
9253901,1352,1,25,4636,183806470,1,0,0,917.99,8,741590.32,24,0,2,4,True
9326689,297,0,20,1635,183806470,1,0,0,917.96,5,740672.36,4,4,4,4,True
9596249,961,4,30,1635,183806470,1,0,0,917.75,8,739754.61,13,0,1,7,True
9642118,1488,0,20,5547,183806470,1,0,0,918.17,5,738836.44,24,1,23,9,True
9878219,502,0,20,2446,183806470,1,0,0,918.18,5,737918.26,12,5,19,10,True
9904338,961,4,30,6683,183806470,1,0,0,918.07,8,737000.19,13,5,8,11,True
1091852,945,1,25,3572,241086269,0,0,0,819.01,8,858930.99,24,0,20,1,True
1186369,529,2,25,1648,241086269,0,0,0,818.88,8,858112.11,18,3,13,1,True
1615520,1029,0,20,4967,241086269,0,0,0,819.11,3,857293.0,11,6,13,1,True
1617282,459,1,451,7217,241086269,0,0,0,818.92,7,856474.08,13,0,12,2,True
1853469,644,0,30,4902,241086269,0,0,0,818.94,8,855655.14,24,2,8,3,True
1890225,644,0,25,6173,241086269,0,0,0,818.74,8,854836.4,24,0,5,4,True
1965282,459,1,-1,6173,241086269,0,1,0,818.64,4,854836.4,13,2,9,4,True
2115699,1164,0,10,3572,241086269,0,0,0,819.12,6,855655.52,24,4,16,4,True
2131312,1455,2,20,4788,241086269,0,0,0,819.06,5,854836.46,11,3,3,5,True
3015596,71,1,10,6868,241086269,0,0,0,819.07,0,855655.53,20,2,3,6,False
3071784,1198,4,451,8767,241086269,0,0,0,818.9,7,854836.63,24,6,11,7,True
3156857,1198,4,25,2485,241086269,0,0,0,818.9,8,854017.73,24,6,7,8,True
3275126,687,0,20,9395,241086269,0,0,0,818.97,5,853198.76,24,2,12,9,True
3708977,918,2,20,2485,241086269,0,0,0,818.96,3,852379.8,18,3,5,9,True
3823156,603,0,10,8767,241086269,0,0,0,818.69,6,853198.49,24,1,13,10,True
3873117,1477,2,30,7843,241086269,0,0,0,819.08,8,852379.41,24,4,14,10,True
3968363,115,2,20,7843,241086269,0,0,0,819.11,5,851560.3,3,4,7,11,True
4314469,945,1,-1,6868,241086269,0,1,0,819.05,4,851560.3,24,1,7,12,True
4599381,1198,4,451,2706,241086269,0,0,0,819.16,7,850741.14,24,6,13,1,True
4641568,459,1,451,3572,241086269,0,0,0,818.73,7,849922.41,13,4,6,2,True
4748759,535,0,20,5322,241086269,0,0,0,818.89,5,849103.52,18,4,18,2,True
5080880,644,0,25,1228,241086269,0,0,0,819.05,8,848284.47,24,3,6,2,True
5158640,529,2,25,9395,241086269,0,0,0,819.01,8,847465.46,18,1,2,3,True
5307135,529,2,25,5322,241086269,0,0,0,819.04,8,846646.42,18,2,21,4,True
5477580,348,0,20,5417,241086269,0,0,0,818.9,3,845827.52,24,4,4,4,True
5480724,945,1,-1,5677,241086269,0,1,0,819.02,1,845827.52,24,1,5,5,True
5533041,302,1,10,8274,241086269,0,0,0,819.08,6,846646.6,4,6,10,5,True
5964235,94,3,451,3572,241086269,0,0,0,818.99,7,845827.61,1,3,19,5,True
6091651,1094,0,20,5322,241086269,0,0,0,819.21,5,845008.4,0,3,10,6,True
6171911,945,1,-1,2706,241086269,0,1,0,818.88,1,845008.4,24,2,15,6,True
6218187,679,0,20,8274,241086269,0,0,0,818.92,5,844189.48,24,3,16,6,True
6520368,759,0,25,5417,241086269,0,0,0,819.0,8,843370.48,24,4,22,7,True
6574497,267,0,10,2706,241086269,0,0,0,819.02,6,844189.5,6,6,12,9,True
6601445,529,2,25,5677,241086269,0,0,0,819.04,8,843370.46,18,1,15,10,True
6624244,1037,0,20,5677,241086269,0,0,0,819.09,5,842551.37,11,4,15,11,True
6739023,945,1,451,9284,241086269,0,0,0,819.0,7,841732.37,24,1,11,11,True
6910800,529,2,451,6808,241086269,0,0,0,818.95,7,840913.42,18,3,22,11,True
7052156,94,3,451,6868,241086269,0,0,0,818.92,7,840094.5,1,0,5,11,True
7636804,627,0,10,5677,241086269,0,0,0,818.84,6,840913.34,11,2,13,11,True
7711558,688,0,10,6173,241086269,0,0,0,819.01,6,841732.35,24,6,11,12,True
7819997,203,0,10,6821,241086269,0,0,0,819.25,6,842551.6,9,3,7,1,True
7981934,1477,2,451,6173,241086269,0,0,0,819.05,7,841732.55,24,2,19,3,True
8121227,883,0,20,4788,241086269,0,0,0,818.88,5,840913.67,24,3,6,4,True
8265051,644,0,-1,5677,241086269,0,1,0,819.11,1,840913.67,24,1,20,4,True
8379283,1477,2,30,6808,241086269,0,0,0,819.12,8,840094.55,24,6,4,5,True
8489019,1198,4,451,5677,241086269,0,0,0,819.05,7,839275.5,24,4,1,5,True
8526523,1198,4,451,5677,241086269,0,0,0,819.38,7,838456.12,24,4,17,5,True
8604184,937,0,10,5322,241086269,0,0,0,819.11,6,839275.23,24,4,22,5,True
8702920,195,1,10,9284,241086269,0,0,0,818.99,6,840094.22,18,1,3,6,True
8747750,1382,0,20,6868,241086269,0,0,0,818.98,5,839275.24,16,6,3,6,True
8764343,1198,4,25,3977,241086269,0,0,0,818.92,8,838456.32,24,1,23,7,True
9172799,1198,4,451,1542,241086269,0,0,0,818.85,7,837637.47,24,2,20,7,True
9207049,1477,2,-1,8767,241086269,0,1,0,819.25,1,837637.47,24,3,3,8,True
9248401,1198,4,-1,4902,241086269,0,2,0,818.83,4,837637.47,24,5,13,8,True
9663613,945,1,25,5973,241086269,0,0,0,818.94,8,836818.53,24,6,23,9,True
9682117,945,1,25,4902,241086269,0,0,0,818.81,8,835999.72,24,6,6,9,True
9682310,287,0,20,5677,241086269,0,0,0,819.13,3,835180.59,24,0,13,10,True
9853679,1198,4,451,2485,241086269,0,0,0,818.89,7,834361.7,24,5,2,11,True
9856261,126,1,10,9395,241086269,0,0,0,819.11,6,835180.81,18,3,23,11,False
1187610,1485,0,-1,8457,177533105,0,1,0,1165.2,1,347061.0,24,6,4,1,True
1228736,996,0,10,3583,177533105,0,0,0,1164.88,0,348225.88,26,3,11,1,True
1313785,1485,0,30,4486,177533105,0,0,0,1165.07,8,347060.81,24,3,14,1,True
1530509,714,2,25,4277,177533105,0,0,0,1164.88,8,345895.93,18,2,4,2,True
1620291,714,2,30,4535,177533105,0,0,0,1165.22,8,344730.71,18,3,6,3,True
1663808,1017,2,20,7825,177533105,0,0,0,1165.2,3,343565.51,26,4,10,5,True
1667515,239,1,10,7657,177533105,0,0,0,1164.82,0,344730.33,26,6,18,5,True
1696046,215,0,451,7825,177533105,0,0,0,1165.26,7,343565.07,9,6,3,6,False
1730954,215,0,451,6451,177533105,0,0,0,1164.94,7,342400.13,9,1,18,8,True
1844313,1162,2,30,1255,177533105,0,0,0,1164.99,8,341235.14,24,0,1,9,True
1963396,385,1,10,6138,177533105,0,0,0,1165.09,0,342400.23,25,2,16,9,True
2375642,317,4,451,4277,177533105,0,0,0,1165.03,7,341235.2,4,5,6,10,False
2625053,360,0,10,9730,177533105,0,0,0,1164.92,0,342400.12,24,3,3,10,True
2819466,378,0,20,7825,177533105,0,0,0,1164.73,5,341235.39,25,0,3,11,True
3187359,811,0,10,6438,177533105,0,0,0,1165.26,6,342400.65,18,1,16,11,False
3222239,1485,0,30,3405,177533105,0,0,0,1165.18,8,341235.47,24,1,21,12,False
3822004,1485,0,-1,7825,177533105,0,1,0,1165.07,4,341235.47,24,6,6,1,True
3936641,1219,1,10,9730,177533105,0,0,0,1164.93,0,342400.4,24,4,14,2,True
4145543,287,0,10,9955,177533105,0,0,0,1164.94,6,343565.34,24,6,16,3,True
4286959,215,0,25,3405,177533105,0,0,0,1164.95,8,342400.39,9,0,6,4,True
4340187,1162,2,451,3583,177533105,0,0,0,1164.99,7,341235.4,24,0,14,4,True
4346676,317,4,451,6434,177533105,0,0,0,1164.8,7,340070.6,4,4,0,4,True
4405101,1485,0,451,1707,177533105,0,0,0,1165.26,7,338905.34,24,1,2,5,True
4513782,1485,0,30,7884,177533105,0,0,0,1165.15,8,337740.19,24,1,10,5,True
4528953,1162,2,25,4535,177533105,0,0,0,1165.01,8,336575.18,24,2,12,5,True
4736740,714,2,-1,1255,177533105,0,1,0,1164.84,4,336575.18,18,3,6,6,True
4770650,317,4,30,6434,177533105,0,0,0,1165.08,8,335410.1,4,5,11,7,True
4906836,1110,0,10,7884,177533105,0,0,0,1164.71,6,336574.81,0,4,0,8,False
4928439,729,0,30,6438,177533105,0,0,0,1165.09,8,335409.72,11,5,19,8,True
4955488,1162,2,451,9955,177533105,0,0,0,1165.03,7,334244.69,24,5,14,9,True
5028727,714,2,30,9673,177533105,0,0,0,1164.85,8,333079.84,18,0,10,9,True
5101736,677,0,20,7657,177533105,0,0,0,1164.82,3,331915.02,24,5,19,9,True
5197353,729,0,451,9955,177533105,0,0,0,1165.01,7,330750.01,11,6,6,12,True
6314767,1162,2,451,5296,177533105,0,0,0,1165.18,7,329584.83,24,4,7,12,True
6381785,1485,0,30,4535,177533105,0,0,0,1165.07,8,328419.76,24,5,4,12,True
6492469,729,0,451,7657,177533105,0,0,0,1165.07,7,327254.69,11,5,6,12,True
6506184,1485,0,30,1791,177533105,0,0,0,1164.98,8,326089.71,24,0,17,1,True
6691889,215,0,30,3406,177533105,0,0,0,1164.71,8,324925.0,9,5,5,1,True
6804989,1428,1,-1,1041,177533105,0,1,0,1165.16,4,324925.0,24,6,20,2,True
6918446,714,2,25,8457,177533105,0,0,0,1165.01,8,323759.99,18,4,17,2,True
7069026,729,0,451,7884,177533105,0,0,0,1164.71,7,322595.28,11,2,23,2,True
7103753,714,2,25,1707,177533105,0,0,0,1164.96,8,321430.32,18,3,20,3,True
7243441,1428,1,451,1707,177533105,0,0,0,1165.25,7,320265.07,24,6,20,4,True
7353679,1485,0,-1,8531,177533105,0,1,0,1164.81,1,320265.07,24,5,10,4,True
7869902,1485,0,451,8531,177533105,0,0,0,1164.84,7,319100.23,24,1,6,5,True
8061871,1093,0,10,6451,177533105,0,0,0,1165.28,6,320265.51,18,0,8,6,True
8167213,349,2,20,7657,177533105,0,0,0,1165.29,5,319100.22,24,0,16,7,True
9029968,937,0,20,1255,177533105,0,0,0,1165.08,5,317935.14,24,5,17,9,True
9091910,729,0,451,9730,177533105,0,0,0,1164.86,7,316770.28,11,3,7,9,True
9095353,714,2,30,6438,177533105,0,0,0,1165.45,8,315604.83,18,5,16,9,True
9139791,1485,0,451,7884,177533105,0,0,0,1165.15,7,314439.68,24,3,19,10,True
9183547,714,2,-1,6434,177533105,0,1,0,1165.26,1,314439.68,18,4,7,10,True
9270823,895,0,20,9673,177533105,0,0,0,1165.05,5,313274.63,24,2,9,10,True
1142277,1260,0,20,4646,395948405,1,0,0,368.19,3,202630.81,23,4,8,2,True
1277653,518,2,30,6141,395948405,1,0,0,368.0,8,202262.81,18,0,16,3,True
1364414,518,2,25,4479,395948405,1,0,0,368.23,8,201894.58,18,2,9,4,True
1492766,1173,1,451,6652,395948405,1,0,0,368.15,7,201526.43,24,6,16,5,True
1694258,883,0,30,8304,395948405,1,0,0,367.86,8,201158.57,24,6,17,6,True
1823698,713,0,10,4646,395948405,1,0,0,367.83,0,201526.4,18,1,10,6,True
1832639,652,0,20,4431,395948405,1,0,0,367.97,5,201158.43,24,3,19,7,True
1891769,147,0,10,4431,395948405,1,0,0,368.23,0,201526.66,18,6,5,7,True
2109445,1267,2,20,6539,395948405,1,0,0,367.87,3,201158.79,23,2,5,7,True
2326463,701,2,20,4279,395948405,1,0,0,367.98,3,200790.81,18,1,22,8,True
2475057,464,1,10,8376,395948405,1,0,0,368.11,6,201158.92,13,3,14,8,True
2785006,1173,1,-1,1302,395948405,1,1,0,368.07,4,201158.92,24,1,8,9,True
2997751,795,4,451,2428,395948405,1,0,0,367.91,7,200791.01,11,3,0,9,True
3074107,1403,4,-1,1143,395948405,1,1,0,367.99,1,200791.01,24,6,18,11,True
3257506,795,4,451,5798,395948405,1,0,0,367.75,7,200423.26,11,0,1,12,True
3327310,1403,4,25,8304,395948405,1,0,0,368.11,8,200055.15,24,4,14,12,True
3557196,558,0,20,8376,395948405,1,0,0,367.93,3,199687.22,17,0,4,1,True
3613555,942,0,20,4527,395948405,1,0,0,367.99,3,199319.23,24,2,14,1,True
4084921,518,2,451,6349,395948405,1,0,0,367.98,7,198951.25,18,3,15,1,True
4126151,281,1,10,1302,395948405,1,0,0,367.99,6,199319.24,24,2,11,1,True
4177418,215,0,25,4527,395948405,1,0,0,368.08,8,198951.16,9,5,11,1,True
4265487,215,0,30,9236,395948405,1,0,0,368.03,8,198583.13,9,0,21,2,True
4579887,1173,1,-1,6141,395948405,1,1,0,368.14,4,198583.13,24,5,22,2,True
4608741,1173,1,30,2745,395948405,1,0,0,368.04,8,198215.09,24,4,15,3,True
4783978,518,2,25,4279,395948405,1,0,0,368.0,8,197847.09,18,3,1,3,True
4825978,518,2,30,6349,395948405,1,0,0,368.02,8,197479.07,18,4,22,4,True
4942616,883,0,451,5185,395948405,1,0,0,368.01,7,197111.06,24,3,10,5,True
4962012,518,2,451,6539,395948405,1,0,0,368.19,7,196742.87,18,2,15,7,True
4973665,588,0,20,1302,395948405,1,0,0,367.85,5,196375.02,24,0,9,8,True
5373525,883,0,451,1302,395948405,1,0,0,367.8,7,196007.22,24,1,8,9,True
5613121,1403,4,25,2745,395948405,1,0,0,367.95,8,195639.27,24,4,0,10,True
5713609,1403,4,25,4431,395948405,1,0,0,367.95,8,195271.32,24,5,12,10,True
5771906,883,0,30,6337,395948405,1,0,0,368.09,8,194903.23,24,6,3,10,True
6006302,1403,4,30,4431,395948405,1,0,0,368.01,8,194535.22,24,6,20,11,True
6244985,1403,4,25,2428,395948405,1,0,0,367.89,8,194167.33,24,2,0,11,True
6528494,883,0,451,4279,395948405,1,0,0,368.08,7,193799.25,24,0,20,12,True
6693177,795,4,451,4527,395948405,1,0,0,367.93,7,193431.32,11,4,3,1,True
6727532,518,2,-1,6337,395948405,1,1,0,368.01,1,193431.32,18,0,5,1,True
6975011,1403,4,30,2428,395948405,1,0,0,368.11,8,193063.21,24,0,17,1,True
7023977,883,0,451,4479,395948405,1,0,0,368.15,7,192695.06,24,1,2,1,True
7260665,1173,1,451,1302,395948405,1,0,0,368.0,7,192327.06,24,2,9,1,True
7435449,325,0,10,4479,395948405,1,0,0,367.97,0,192695.03,11,2,17,2,True
7680991,215,0,451,6539,395948405,1,0,0,367.73,7,192327.3,9,1,13,2,False
7928841,883,0,451,4646,395948405,1,0,0,368.07,7,191959.23,24,3,3,2,True
8056618,1435,2,20,2428,395948405,1,0,0,368.05,3,191591.18,24,4,19,4,True
8200365,558,0,10,5185,395948405,1,0,0,367.93,6,191959.11,17,1,2,4,True
8373525,1403,4,25,9236,395948405,1,0,0,368.02,8,191591.09,24,1,2,5,True
8374800,675,2,20,1823,395948405,1,0,0,367.83,5,191223.26,24,1,11,5,True
8467995,883,0,451,5554,395948405,1,0,0,367.76,7,190855.5,24,5,20,6,True
8515036,1173,1,30,1143,395948405,1,0,0,368.04,8,190487.46,24,5,14,6,True
8922246,1173,1,30,6337,395948405,1,0,0,367.96,8,190119.5,24,3,1,7,False
8947989,627,0,10,4431,395948405,1,0,0,368.14,6,190487.64,11,2,23,7,False
9157688,795,4,451,4646,395948405,1,0,0,368.21,7,190119.43,11,3,21,10,True
9973300,128,0,10,4646,395948405,1,0,0,368.02,0,190487.45,18,4,3,11,True
1614742,701,2,451,6281,476969934,0,0,0,308.21,7,424713.79,18,1,6,1,True
1821701,375,4,451,3650,476969934,0,0,0,307.92,7,424405.87,25,4,13,3,True
1825413,990,0,30,6281,476969934,0,0,0,307.74,8,424098.13,22,6,17,3,True
1975655,701,2,30,5351,476969934,0,0,0,308.11,8,423790.02,18,4,13,6,True
2193911,375,4,451,5919,476969934,0,0,0,308.12,7,423481.9,25,1,23,7,True
2238632,990,0,30,5919,476969934,0,0,0,308.38,8,423173.52,22,2,17,7,True
2417085,754,4,25,5351,476969934,0,0,0,307.87,8,422865.65,24,3,2,7,True
2726492,754,4,-1,5315,476969934,0,1,0,308.16,1,422865.65,24,1,11,7,True
2767544,701,2,25,8313,476969934,0,0,0,308.07,8,422557.58,18,6,7,9,True
2867378,1142,2,20,6257,476969934,0,0,0,308.13,5,422249.45,15,5,6,10,True
2945922,951,0,10,6220,476969934,0,0,0,308.04,6,422557.49,24,6,0,10,True
3014557,701,2,30,3650,476969934,0,0,0,308.02,8,422249.47,18,1,21,11,True
3522944,375,4,451,6281,476969934,0,0,0,308.1,7,421941.37,25,0,20,12,True
3693205,701,2,30,1471,476969934,0,0,0,307.85,8,421633.52,18,6,0,12,True
3928194,990,0,30,6220,476969934,0,0,0,308.0,8,421325.52,22,3,21,12,True
4199276,754,4,25,6281,476969934,0,0,0,308.12,8,421017.4,24,2,15,1,True
4245651,58,2,20,5919,476969934,0,0,0,307.81,5,420709.59,20,2,6,2,True
4480618,123,0,20,7570,476969934,0,0,0,307.81,5,420401.78,18,1,22,2,True
4630846,544,3,25,6281,476969934,0,0,0,308.24,8,420093.54,17,5,1,2,True
4778405,754,4,30,5919,476969934,0,0,0,307.81,8,419785.73,24,4,12,3,True
4822662,544,3,451,5919,476969934,0,0,0,308.17,7,419477.56,17,2,19,4,True
4899785,584,0,10,5315,476969934,0,0,0,307.73,0,419785.29,11,5,18,4,True
4967730,120,4,-1,6281,476969934,0,1,0,307.96,4,419785.29,18,6,1,5,True
5041742,990,0,25,5351,476969934,0,0,0,308.2,8,419477.09,22,3,23,5,True
5152778,544,3,-1,7767,476969934,0,1,0,307.92,1,419477.09,17,6,10,5,True
5339600,716,0,10,3650,476969934,0,0,0,307.97,6,419785.06,18,4,1,6,True
5347298,544,3,-1,5315,476969934,0,1,0,308.12,1,419785.06,17,4,16,6,True
5477172,1419,1,10,3786,476969934,0,0,0,307.97,0,420093.03,24,1,4,7,True
5494831,806,1,10,9146,476969934,0,0,0,308.2,6,420401.23,11,1,18,8,True
5658791,375,4,451,7635,476969934,0,0,0,308.11,7,420093.12,25,6,11,9,True
5669604,701,2,30,5351,476969934,0,0,0,308.07,8,419785.05,18,2,11,9,True
5794190,812,0,20,6257,476969934,0,0,0,307.97,5,419477.08,18,1,2,9,True
5823152,1461,0,10,7030,476969934,0,0,0,308.06,0,419785.14,11,0,4,11,True
6301290,522,0,20,6737,476969934,0,0,0,308.13,5,419477.01,18,5,20,11,True
6597214,544,3,30,9146,476969934,0,0,0,308.19,8,419168.82,17,5,18,12,True
6653966,701,2,25,6737,476969934,0,0,0,308.15,8,418860.67,18,1,9,12,True
6808151,542,0,10,6737,476969934,0,0,0,307.77,6,419168.44,17,4,15,12,True
7042777,544,3,25,6737,476969934,0,0,0,307.98,8,418860.46,17,3,4,2,True
7467369,574,2,20,9146,476969934,0,0,0,307.8,3,418552.66,11,5,12,3,True
7538619,544,3,30,3650,476969934,0,0,0,308.05,8,418244.61,17,6,11,5,True
7578468,918,2,20,6220,476969934,0,0,0,308.11,5,417936.5,18,0,18,5,True
7581307,375,4,451,6737,476969934,0,0,0,307.77,7,417628.73,25,1,0,6,True
7620738,754,4,451,7570,476969934,0,0,0,307.96,7,417320.77,24,2,8,7,True
7767772,145,0,20,5351,476969934,0,0,0,307.91,5,417012.86,18,2,15,7,True
7768430,701,2,-1,6281,476969934,0,1,0,308.0,1,417012.86,18,6,10,7,True
7978188,996,0,20,7635,476969934,0,0,0,308.14,3,416704.72,26,0,3,7,True
8149320,544,3,25,5315,476969934,0,0,0,307.99,8,416396.73,17,1,14,8,True
8326212,304,0,10,9146,476969934,0,0,0,308.11,6,416704.84,4,1,14,10,True
8506982,544,3,-1,3650,476969934,0,1,0,307.91,1,416704.84,17,0,3,10,True
8801159,754,4,-1,6220,476969934,0,2,0,308.0,1,416704.84,24,0,17,10,True
9034835,990,0,-1,3277,476969934,0,3,1,308.09,4,0.0,22,2,9,11,True
1135105,1284,2,25,8766,233100711,0,0,0,155.19,8,946802.81,24,6,18,1,True
1455627,340,4,451,5251,233100711,0,0,0,154.88,7,946647.93,24,5,4,1,True
1575386,996,0,20,2245,233100711,0,0,0,155.1,5,946492.83,26,3,6,2,True
1583983,1166,2,451,5940,233100711,0,0,0,154.98,7,946337.85,24,0,6,3,True
1686714,759,0,10,2476,233100711,0,0,0,154.92,6,946492.77,24,2,6,3,True
1903748,340,4,25,6176,233100711,0,0,0,154.91,8,946337.86,24,0,7,3,False
2513731,1022,4,30,6930,233100711,0,0,0,154.99,8,946182.87,11,2,5,5,True
2970259,1022,4,30,4854,233100711,0,0,0,155.07,8,946027.8,11,0,15,5,True
3059732,1022,4,451,6930,233100711,0,0,0,154.93,7,945872.87,11,6,23,5,True
3616748,1239,1,10,7102,233100711,0,0,0,154.91,6,946027.78,18,2,7,5,True
3672927,1425,0,20,8686,233100711,0,0,0,155.17,3,945872.61,24,3,11,5,True
3758338,787,0,10,3742,233100711,0,0,0,154.69,6,946027.3,14,1,6,6,True
3913647,1095,4,451,2619,233100711,0,0,0,154.87,7,945872.43,0,6,15,6,False
4247965,467,0,20,6176,233100711,0,0,0,155.24,3,945717.19,5,6,3,7,False
4295376,1095,4,451,1856,233100711,0,0,0,154.94,7,945562.25,0,5,16,7,True
4381424,1022,4,451,9787,233100711,0,0,0,154.89,7,945407.36,11,6,18,8,False
4569634,403,0,20,6180,233100711,0,0,0,155.07,3,945252.29,10,6,14,9,True
4632757,1095,4,30,5940,233100711,0,0,0,154.87,8,945097.42,0,6,8,1,True
4735074,1022,4,25,3026,233100711,0,0,0,154.85,8,944942.57,11,1,20,1,True
4962012,913,0,20,5940,233100711,0,0,0,155.4,5,944787.17,18,1,23,1,True
4973569,727,0,20,4854,233100711,0,0,0,154.89,5,944632.28,11,6,10,2,True
5037782,404,1,30,5251,233100711,0,0,0,155.06,8,944477.22,10,6,14,2,True
5799456,340,4,25,7102,233100711,0,0,0,155.06,8,944322.16,24,1,9,2,True
5862839,1022,4,451,3742,233100711,0,0,0,154.81,7,944167.35,11,1,21,3,True
6410306,1284,2,30,5794,233100711,0,0,0,155.08,8,944012.27,24,1,15,4,True
6533064,1284,2,25,1856,233100711,0,0,0,154.86,8,943857.41,24,6,22,4,True
6727876,1284,2,-1,9787,233100711,0,1,0,155.04,4,943857.41,24,5,16,5,True
6743933,1166,2,25,7052,233100711,0,0,0,155.18,8,943702.23,24,5,17,6,True
6816973,1022,4,-1,7052,233100711,0,1,0,154.91,1,943702.23,11,6,21,6,True
6849656,1095,4,451,6930,233100711,0,0,0,154.76,7,943547.47,0,1,1,8,True
6904564,1271,0,20,9731,233100711,0,0,0,154.92,3,943392.55,23,2,16,8,True
6926897,1284,2,451,8766,233100711,0,0,0,155.1,7,943237.45,24,2,19,9,True
6935439,1095,4,451,6176,233100711,0,0,0,154.93,7,943082.52,0,2,12,10,True
7208618,1095,4,25,4788,233100711,0,0,0,155.16,8,942927.36,0,0,22,11,True
7368812,1022,4,25,2619,233100711,0,0,0,155.01,8,942772.35,11,1,15,11,True
7399886,1022,4,451,9731,233100711,0,0,0,154.96,7,942617.39,11,4,22,12,True
7529898,1166,2,451,2245,233100711,0,0,0,154.99,7,942462.4,24,2,5,1,True
7555466,340,4,451,5794,233100711,0,0,0,155.17,7,942307.23,24,0,4,1,True
7889846,1022,4,451,2619,233100711,0,0,0,155.08,7,942152.15,11,2,14,1,True
8069318,1022,4,30,6176,233100711,0,0,0,154.94,8,941997.21,11,6,8,2,True
8157256,404,1,451,4788,233100711,0,0,0,155.08,7,941842.13,10,5,4,3,True
8216035,1022,4,451,9787,233100711,0,0,0,154.68,7,941687.45,11,5,9,3,True
8325567,1022,4,25,6180,233100711,0,0,0,154.76,8,941532.69,11,2,23,7,True
8364359,1284,2,-1,6176,233100711,0,1,0,154.85,4,941532.69,24,6,10,7,True
8446075,1166,2,451,4854,233100711,0,0,0,155.14,7,941377.55,24,5,2,7,True
8452931,297,0,10,2245,233100711,0,0,0,155.24,6,941532.79,4,4,2,9,True
8578032,404,1,25,8766,233100711,0,0,0,154.98,8,941377.81,10,4,8,9,True
8611420,1166,2,25,1856,233100711,0,0,0,155.08,8,941222.73,24,1,5,10,True
9049890,1022,4,451,2245,233100711,0,0,0,154.97,7,941067.76,11,4,7,10,True
9323722,340,4,25,3026,233100711,0,0,0,154.97,8,940912.79,24,4,21,10,True
1311717,766,4,30,2473,583469447,0,0,0,254.97,8,705437.03,14,4,8,1,True
1514781,766,4,451,3962,583469447,0,0,0,254.84,7,705182.19,14,2,9,3,True
1630810,1456,4,451,9809,583469447,0,0,0,255.19,7,704927.0,11,6,3,3,True
1646598,1037,0,10,8929,583469447,0,0,0,254.85,6,705181.85,11,3,3,5,True
1741450,198,0,25,8213,583469447,0,0,0,255.21,8,704926.64,18,5,13,6,True
1797965,766,4,25,9795,583469447,0,0,0,254.85,8,704671.79,14,5,23,8,True
1800677,766,4,25,5526,583469447,0,0,0,255.03,8,704416.76,14,6,5,9,True
2055543,1456,4,25,3962,583469447,0,0,0,254.75,8,704162.01,11,0,4,9,True
2083639,1072,0,20,3601,583469447,0,0,0,254.95,5,703907.06,18,6,7,10,True
2154934,1456,4,451,8533,583469447,0,0,0,254.59,7,703652.47,11,1,7,11,True
2243278,198,0,451,6110,583469447,0,0,0,254.61,7,703397.86,18,2,6,11,True
2273083,1315,0,10,9795,583469447,0,0,0,254.73,6,703652.59,5,4,4,11,True
2304798,765,4,-1,3601,583469447,0,1,0,254.96,4,703652.59,14,5,7,11,True
2546702,1456,4,451,8010,583469447,0,0,0,255.17,7,703397.42,11,5,16,12,True
2898417,1456,4,30,7687,583469447,0,0,0,255.01,8,703142.41,11,1,13,12,True
3264332,227,4,-1,6110,583469447,0,1,0,254.84,1,703142.41,26,3,18,12,False
3320314,766,4,-1,8010,583469447,0,2,0,255.34,4,703142.41,14,6,9,1,False
3748204,765,4,30,6654,583469447,0,0,0,254.76,8,702887.65,14,5,11,1,True
3813620,21,0,20,8010,583469447,0,0,0,255.11,5,702632.54,11,0,17,1,True
3980830,1312,0,20,3601,583469447,0,0,0,255.12,5,702377.42,5,1,20,2,True
4133575,766,4,25,8213,583469447,0,0,0,254.78,8,702122.64,14,6,21,3,True
4252708,766,4,25,4012,583469447,0,0,0,254.95,8,701867.69,14,4,15,4,False
4344492,724,3,451,1878,583469447,0,0,0,255.08,7,701612.61,11,0,10,5,True
4925500,1456,4,-1,4752,583469447,0,1,0,255.0,4,701612.61,11,0,13,5,True
4985252,765,4,-1,3962,583469447,0,2,0,254.84,4,701612.61,14,6,16,5,True
5087309,227,4,451,6369,583469447,0,0,0,254.85,7,701357.76,26,1,4,5,False
5173563,1456,4,451,2473,583469447,0,0,0,254.92,7,701102.84,11,2,20,5,True
5652020,765,4,451,2473,583469447,0,0,0,255.02,7,700847.82,14,4,5,6,True
5831524,1456,4,30,3601,583469447,0,0,0,254.99,8,700592.83,11,5,22,7,True
5863214,192,2,20,9795,583469447,0,0,0,254.87,3,700337.96,18,5,17,8,True
5968569,724,3,25,8583,583469447,0,0,0,255.0,8,700082.96,11,3,5,8,True
6218681,1456,4,451,3340,583469447,0,0,0,255.15,7,699827.81,11,2,18,9,True
6399432,766,4,30,1878,583469447,0,0,0,254.96,8,699572.85,14,4,10,9,True
6491518,1010,0,20,4752,583469447,0,0,0,254.78,3,699318.07,26,4,23,10,True
6526096,765,4,-1,6110,583469447,0,1,0,254.93,4,699318.07,14,1,8,10,True
6725546,765,4,451,3601,583469447,0,0,0,254.68,7,699063.39,14,5,4,10,True
6769762,765,4,-1,6110,583469447,0,1,0,255.16,1,699063.39,14,1,1,10,True
7122319,673,0,10,6654,583469447,0,0,0,255.05,6,699318.44,18,3,12,11,True
7179769,227,4,451,8533,583469447,0,0,0,255.07,7,699063.37,26,0,4,11,True
7650184,1456,4,451,4012,583469447,0,0,0,255.19,7,698808.18,11,4,8,11,True
7719578,558,0,10,9795,583469447,0,0,0,255.05,6,699063.23,17,2,13,12,True
7968277,766,4,451,3340,583469447,0,0,0,255.06,7,698808.17,14,3,1,1,True
8683214,198,0,451,6369,583469447,0,0,0,255.03,7,698553.14,18,2,0,2,True
8767518,227,4,-1,9795,583469447,0,1,0,254.92,1,698553.14,26,4,23,4,True
8786671,198,0,25,5526,583469447,0,0,0,255.35,8,698297.79,18,1,20,4,True
8837485,766,4,451,7716,583469447,0,0,0,254.95,7,698042.84,14,2,5,5,True
8952140,766,4,25,6369,583469447,0,0,0,255.01,8,697787.83,14,4,8,5,True
9058647,724,3,30,7716,583469447,0,0,0,254.76,8,697533.07,11,5,21,7,True
9259728,522,0,10,4012,583469447,0,0,0,255.03,6,697788.1,18,4,8,7,True
9271968,766,4,451,3340,583469447,0,0,0,255.1,7,697533.0,14,3,14,7,True
9392677,1094,0,20,4752,583469447,0,0,0,254.71,5,697278.29,0,1,1,8,True
9488270,681,2,20,4012,583469447,0,0,0,254.89,5,697023.4,24,5,5,9,True
9634220,1456,4,25,6654,583469447,0,0,0,255.21,8,696768.19,11,1,1,9,False
9713370,694,2,20,7692,583469447,0,0,0,255.04,5,696513.15,24,2,12,10,True
9838833,724,3,25,6567,583469447,0,0,0,254.84,8,696258.31,11,3,10,10,True
9894094,309,0,20,2473,583469447,0,0,0,254.76,3,696003.55,4,4,1,10,True
9935914,227,4,30,9795,583469447,0,0,0,255.09,8,695748.46,26,4,2,11,True
1072942,195,1,25,2906,924149802,1,0,0,881.02,8,561426.98,18,1,5,1,True
1178675,280,4,451,5807,924149802,1,0,0,880.88,7,560546.1,24,5,9,1,True
1211970,785,0,451,5150,924149802,1,0,0,880.88,7,559665.22,14,1,14,1,True
1403518,366,0,10,1843,924149802,1,0,0,881.09,6,560546.31,25,2,9,2,True
1552406,785,0,25,6522,924149802,1,0,0,881.09,8,559665.22,14,0,14,2,True
1707306,713,0,10,5150,924149802,1,0,0,881.26,6,560546.48,18,0,11,2,True
1746886,85,2,20,6986,924149802,1,0,0,880.96,5,559665.52,1,5,18,4,True
1790925,335,4,451,6986,924149802,1,0,0,880.88,7,558784.64,11,1,6,4,False
1869575,333,1,10,8048,924149802,1,0,0,880.9,6,559665.54,11,0,5,4,True
1927785,828,4,25,7843,924149802,1,0,0,881.0,8,558784.54,18,0,23,5,True
1964831,732,0,20,8048,924149802,1,0,0,881.11,5,557903.43,11,5,16,5,True
1977930,216,4,30,6522,924149802,1,0,0,881.17,8,557022.26,9,6,18,6,True
2035386,1010,0,10,9178,924149802,1,0,0,880.87,0,557903.13,26,2,21,7,True
2162427,20,0,10,7114,924149802,1,0,0,881.05,0,558784.18,24,5,3,7,True
2279911,542,0,10,2906,924149802,1,0,0,881.2,6,559665.38,17,6,9,8,False
2675712,785,0,25,7470,924149802,1,0,0,880.76,8,558784.62,14,2,11,8,False
2699202,1134,1,451,8755,924149802,1,0,0,880.95,7,557903.67,24,6,1,9,False
2800395,649,0,451,3025,924149802,1,0,0,881.18,7,557022.49,24,5,5,11,True
2813633,610,0,10,7575,924149802,1,0,0,881.09,6,557903.58,11,1,14,12,True
2860690,195,1,451,7843,924149802,1,0,0,880.93,7,557022.65,18,3,3,1,True
2947074,280,4,451,7114,924149802,1,0,0,881.15,7,556141.5,24,3,8,1,False
3746421,299,1,10,7741,924149802,1,0,0,880.95,0,557022.45,4,2,10,2,True
4266610,1134,1,30,3025,924149802,1,0,0,881.03,8,556141.42,24,5,19,2,True
4396501,195,1,30,8755,924149802,1,0,0,880.78,8,555260.64,18,2,2,2,True
4430432,335,4,30,1314,924149802,1,0,0,881.19,8,554379.45,11,2,22,3,True
4497071,785,0,-1,5150,924149802,1,1,0,880.98,4,554379.45,14,3,16,3,True
4813841,568,1,30,6341,924149802,1,0,0,881.14,8,553498.31,11,3,17,4,True
4856881,335,4,30,7843,924149802,1,0,0,881.07,8,552617.24,11,4,18,6,True
5021015,335,4,25,1314,924149802,1,0,0,880.91,8,551736.33,11,4,0,7,True
5032973,118,2,20,7647,924149802,1,0,0,880.87,5,550855.46,18,3,20,7,True
5245309,828,4,451,9522,924149802,1,0,0,881.29,7,549974.17,18,6,6,8,True
5253359,785,0,-1,9178,924149802,1,1,0,881.07,4,549974.17,14,3,15,8,True
5534543,511,1,10,1314,924149802,1,0,0,881.14,6,550855.31,12,0,8,8,True
5941165,996,0,10,7114,924149802,1,0,0,880.78,6,551736.09,26,5,7,9,True
6012030,610,0,20,9296,924149802,1,0,0,881.28,3,550854.81,11,0,3,10,True
6146499,649,0,451,5928,924149802,1,0,0,880.66,7,549974.15,24,5,21,10,True
6174239,216,4,-1,9522,924149802,1,1,0,880.97,4,549974.15,9,6,9,12,True
6641813,785,0,30,8048,924149802,1,0,0,881.08,8,549093.07,14,5,11,1,True
6821971,1134,1,30,9522,924149802,1,0,0,880.91,8,548212.16,24,2,13,1,True
6831319,216,4,451,7000,924149802,1,0,0,881.0,7,547331.16,9,4,9,1,True
7005105,160,0,10,7831,924149802,1,0,0,881.01,0,548212.17,24,0,4,2,True
7061555,790,0,10,9296,924149802,1,0,0,880.73,6,549092.9,11,1,7,2,True
7064676,234,0,20,6899,924149802,1,0,0,880.71,5,548212.19,26,1,19,2,True
7480940,828,4,451,4029,924149802,1,0,0,880.96,7,547331.23,18,4,17,3,True
7803530,1134,1,451,7114,924149802,1,0,0,880.91,7,546450.32,24,1,0,4,True
8071280,280,4,25,7647,924149802,1,0,0,880.73,8,545569.59,24,1,9,4,True
8077913,216,4,451,6767,924149802,1,0,0,880.99,7,544688.6,9,6,2,5,True
8582527,649,0,451,6986,924149802,1,0,0,880.94,7,543807.66,24,0,3,5,False
8719556,195,1,-1,1843,924149802,1,1,0,881.18,4,543807.66,18,0,15,6,True
8788120,1134,1,451,7741,924149802,1,0,0,880.79,7,542926.87,24,2,3,7,True
8814441,335,4,451,1706,924149802,1,0,0,881.2,7,542045.67,11,3,10,7,True
8825433,216,4,451,2192,924149802,1,0,0,881.12,7,541164.55,9,3,12,7,True
9389481,81,0,20,3025,924149802,1,0,0,880.9,5,540283.65,1,2,13,8,False
9430263,828,4,30,7647,924149802,1,0,0,880.86,8,539402.79,18,1,6,9,True
9669024,216,4,451,7831,924149802,1,0,0,881.02,7,538521.77,9,1,22,10,True
9669581,360,0,10,7831,924149802,1,0,0,881.24,6,539403.01,24,3,2,10,True
9857024,649,0,25,6899,924149802,1,0,0,881.15,8,538521.86,24,6,15,11,True
9899805,267,0,10,6767,924149802,1,0,0,880.96,6,539402.82,6,0,17,11,True
1459687,996,0,20,4456,400263609,0,0,0,315.93,5,713111.07,26,0,0,1,True
1462691,300,0,451,4456,400263609,0,0,0,315.8,7,712795.27,4,0,5,2,True
1550368,472,4,451,3334,400263609,0,0,0,316.19,7,712479.08,5,1,20,2,True
1585725,1485,0,20,6500,400263609,0,0,0,316.05,5,712163.03,24,1,23,3,True
1714832,1296,4,25,6500,400263609,0,0,0,316.14,8,711846.89,5,2,15,4,True
1940574,1296,4,30,2768,400263609,0,0,0,316.09,8,711530.8,5,3,1,4,True
1983884,300,0,451,4409,400263609,0,0,0,315.7,7,711215.1,4,1,2,4,True
1987915,218,0,20,1162,400263609,0,0,0,316.18,5,710898.92,9,0,5,4,True
2081877,1296,4,-1,6938,400263609,0,1,0,315.89,4,710898.92,5,6,16,5,True
2251316,238,0,20,1743,400263609,0,0,0,315.54,3,710583.38,26,0,18,6,True
2278689,392,4,25,8573,400263609,0,0,0,315.88,8,710267.5,10,4,0,7,True
2343114,279,2,20,8624,400263609,0,0,0,316.12,5,709951.38,24,1,7,7,True
2433590,300,0,30,3727,400263609,0,0,0,316.22,8,709635.16,4,5,18,8,True
2518654,1296,4,451,8624,400263609,0,0,0,315.98,7,709319.18,5,3,6,9,True
2830402,392,4,25,8624,400263609,0,0,0,316.16,8,709003.02,10,4,7,9,True
2857151,392,4,30,2768,400263609,0,0,0,316.06,8,708686.96,10,2,12,9,True
3076257,300,0,25,6452,400263609,0,0,0,315.9,8,708371.06,4,6,17,10,False
3079783,472,4,-1,6500,400263609,0,1,0,315.86,4,708371.06,5,3,20,11,True
3290573,392,4,451,4409,400263609,0,0,0,315.77,7,708055.29,10,6,14,12,True
3510631,307,4,30,2341,400263609,0,0,0,315.86,8,707739.43,4,2,0,1,True
3730667,1296,4,451,3334,400263609,0,0,0,316.08,7,707423.35,5,2,18,1,True
3845406,962,0,20,4456,400263609,0,0,0,315.84,5,707107.51,13,2,19,1,False
3926499,1296,4,25,2341,400263609,0,0,0,315.8,8,706791.71,5,4,7,3,True
4012805,1116,0,10,8573,400263609,0,0,0,316.26,0,707107.97,24,1,17,4,True
4014233,472,4,451,8573,400263609,0,0,0,316.14,7,706791.83,5,1,7,5,True
4224864,472,4,-1,1135,400263609,0,1,0,316.06,4,706791.83,5,1,17,5,True
4947305,307,4,451,4456,400263609,0,0,0,316.15,7,706475.68,4,5,9,5,True
5538248,300,0,451,1743,400263609,0,0,0,316.26,7,706159.42,4,0,5,6,True
5626386,307,4,25,4787,400263609,0,0,0,315.99,8,705843.43,4,1,22,7,False
5678045,1296,4,-1,9262,400263609,0,1,0,315.85,4,705843.43,5,4,17,7,True
5761728,300,0,451,4409,400263609,0,0,0,315.89,7,705527.54,4,4,14,7,True
6129174,392,4,451,6452,400263609,0,0,0,315.98,7,705211.56,10,4,7,8,True
6421418,365,0,10,3727,400263609,0,0,0,315.79,6,705527.35,25,6,9,8,False
6506245,1380,0,10,4409,400263609,0,0,0,316.11,6,705843.46,16,2,11,9,True
6574974,1421,0,10,4787,400263609,0,0,0,316.05,6,706159.51,24,1,21,10,True
6815907,472,4,451,8573,400263609,0,0,0,316.0,7,705843.51,5,6,18,11,True
6833343,300,0,-1,1743,400263609,0,1,0,315.91,4,705843.51,4,4,17,11,True
6836114,1296,4,25,2341,400263609,0,0,0,316.13,8,705527.38,5,6,7,11,True
6871013,1027,0,10,6500,400263609,0,0,0,315.75,6,705843.13,11,0,1,12,True
6927337,530,0,10,4409,400263609,0,0,0,316.16,0,706159.29,18,3,10,1,True
7457240,392,4,451,2976,400263609,0,0,0,316.12,7,705843.17,10,5,17,1,True
7697379,1068,2,20,4409,400263609,0,0,0,316.13,3,705527.04,18,2,5,1,True
7739075,472,4,25,4337,400263609,0,0,0,316.13,8,705210.91,5,3,4,2,True
7881612,392,4,451,1977,400263609,0,0,0,315.95,7,704894.96,10,6,4,2,False
8112235,307,4,30,2976,400263609,0,0,0,315.98,8,704578.98,4,3,7,2,True
8288723,785,0,20,9427,400263609,0,0,0,316.21,5,704262.77,14,1,14,3,False
8913706,1296,4,30,2768,400263609,0,0,0,315.98,8,703946.79,5,1,2,4,True
8925283,472,4,25,8573,400263609,0,0,0,316.17,8,703630.62,5,1,0,5,True
9149980,472,4,25,9427,400263609,0,0,0,315.76,8,703314.86,5,2,6,5,True
9197842,392,4,451,9427,400263609,0,0,0,315.77,7,702999.09,10,5,2,5,True
9420412,1296,4,25,3727,400263609,0,0,0,316.11,8,702682.98,5,0,21,7,True
9445612,509,0,10,3334,400263609,0,0,0,316.14,0,702999.12,12,1,4,8,True
9457801,307,4,30,8573,400263609,0,0,0,315.81,8,702683.31,4,3,12,8,True
9474670,1435,2,20,9427,400263609,0,0,0,315.82,5,702367.49,24,2,16,8,True
9571939,703,0,10,6500,400263609,0,0,0,316.09,0,702683.58,18,6,14,9,True
9624162,392,4,30,7030,400263609,0,0,0,315.87,8,702367.71,10,2,0,10,True
9661180,1140,0,20,9427,400263609,0,0,0,316.17,5,702051.54,15,4,0,10,True
9886254,392,4,-1,1743,400263609,0,1,0,316.22,4,702051.54,10,2,4,11,True
1006804,464,1,25,4265,453828531,0,0,0,1060.03,8,362957.97,13,5,9,1,True
1345469,979,0,25,4756,453828531,0,0,0,1059.95,8,361898.02,22,4,11,1,True
1502688,1364,0,20,1046,453828531,0,0,0,1060.1,3,360837.92,16,3,9,2,True
1560026,312,0,30,4756,453828531,0,0,0,1059.78,8,359778.14,4,6,4,4,False
1589179,1094,0,20,9540,453828531,0,0,0,1060.13,5,358718.01,0,6,22,4,True
1935596,455,4,-1,7974,453828531,0,1,0,1060.1,1,358718.01,13,6,18,6,True
2124327,464,1,25,7855,453828531,0,0,0,1060.23,8,357657.78,13,5,13,7,False
2124414,312,0,451,3572,453828531,0,0,0,1060.12,7,356597.66,4,0,10,7,True
2221839,818,1,10,4388,453828531,0,0,0,1059.64,6,357657.3,18,3,10,7,True
2259556,979,0,-1,4265,453828531,0,1,0,1060.0,1,357657.3,22,6,17,7,True
2427323,673,0,20,8841,453828531,0,0,0,1059.8,5,356597.5,18,1,2,7,True
2487072,312,0,-1,8841,453828531,0,1,0,1060.02,4,356597.5,4,4,15,9,True
2678698,51,0,20,3754,453828531,0,0,0,1059.92,5,355537.58,20,2,14,9,True
3048752,312,0,451,3742,453828531,0,0,0,1060.28,7,354477.3,4,2,18,10,True
3069285,979,0,30,8249,453828531,0,0,0,1060.07,8,353417.23,22,3,22,10,True
3250308,312,0,-1,3754,453828531,0,1,0,1059.92,4,353417.23,4,6,10,12,True
3264535,929,0,10,2800,453828531,0,0,0,1060.15,6,354477.38,18,4,12,12,True
3269305,328,0,10,2800,453828531,0,0,0,1059.94,6,355537.32,11,6,17,1,True
3573570,455,4,30,7855,453828531,0,0,0,1059.92,8,354477.4,13,2,9,3,True
3871093,464,1,451,7974,453828531,0,0,0,1059.88,7,353417.52,13,4,2,3,True
3881122,979,0,30,6993,453828531,0,0,0,1060.01,8,352357.51,22,2,3,4,True
3988550,455,4,-1,7912,453828531,0,1,0,1059.97,1,352357.51,13,4,13,4,True
3993384,979,0,451,6600,453828531,0,0,0,1059.87,7,351297.64,22,0,10,4,True
3994051,312,0,25,7855,453828531,0,0,0,1059.9,8,350237.74,4,5,13,4,True
3996049,155,1,10,3129,453828531,0,0,0,1060.14,6,351297.88,18,4,6,5,True
4183027,979,0,451,6600,453828531,0,0,0,1060.16,7,350237.72,22,0,23,6,True
4692116,455,4,30,6600,453828531,0,0,0,1060.13,8,349177.59,13,0,6,6,True
4761915,1144,2,20,6993,453828531,0,0,0,1060.23,5,348117.36,15,1,16,7,True
4770706,219,0,10,5251,453828531,0,0,0,1060.07,6,349177.43,9,2,17,7,True
4854842,350,0,10,7974,453828531,0,0,0,1059.78,6,350237.21,24,4,19,8,True
5417286,979,0,-1,2800,453828531,0,1,0,1060.29,4,350237.21,22,6,9,8,True
5579479,269,0,20,3254,453828531,0,0,0,1060.05,5,349177.16,24,3,17,10,True
5660592,464,1,451,6123,453828531,0,0,0,1059.94,7,348117.22,13,1,4,11,True
5778847,1239,1,10,7855,453828531,0,0,0,1060.18,6,349177.4,18,0,10,12,True
5917259,918,2,20,1046,453828531,0,0,0,1060.04,3,348117.36,18,3,22,1,True
5958846,1380,0,20,8841,453828531,0,0,0,1060.07,5,347057.29,16,6,5,1,True
6090574,464,1,451,3129,453828531,0,0,0,1059.79,7,345997.5,13,3,10,2,True
6205222,455,4,25,3254,453828531,0,0,0,1059.91,8,344937.59,13,0,16,2,True
7495078,312,0,451,2712,453828531,0,0,0,1060.01,7,343877.58,4,1,19,3,True
7607851,344,3,451,8034,453828531,0,0,0,1059.84,7,342817.74,24,1,23,3,True
7877504,558,0,20,7855,453828531,0,0,0,1059.73,3,341758.01,17,5,12,4,True
7948819,979,0,-1,2800,453828531,0,1,0,1059.82,4,341758.01,22,6,0,4,True
7955522,603,0,10,6549,453828531,0,0,0,1059.96,6,342817.97,24,3,22,5,True
8128956,312,0,451,5251,453828531,0,0,0,1059.93,7,341758.04,4,5,14,5,True
8161557,312,0,30,4756,453828531,0,0,0,1060.3,8,340697.74,4,0,18,5,True
8188400,787,0,20,4756,453828531,0,0,0,1060.0,5,339637.74,14,5,17,6,True
8298140,312,0,451,8249,453828531,0,0,0,1060.28,7,338577.46,4,0,21,6,True
8534978,979,0,451,6600,453828531,0,0,0,1060.09,7,337517.37,22,2,2,6,True
8656663,979,0,25,4265,453828531,0,0,0,1060.24,8,336457.13,22,1,23,6,True
9069353,312,0,-1,4756,453828531,0,1,0,1059.99,4,336457.13,4,3,12,6,True
9436504,455,4,25,2712,453828531,0,0,0,1060.09,8,335397.04,13,2,12,7,True
9461758,327,0,20,2800,453828531,0,0,0,1059.88,5,334337.16,11,5,6,8,False
9464247,312,0,25,4388,453828531,0,0,0,1059.92,8,333277.24,4,3,17,9,True
9776730,455,4,451,7855,453828531,0,0,0,1060.22,7,332217.02,13,5,20,9,True
9967088,979,0,30,3754,453828531,0,0,0,1059.8,8,331157.22,22,3,21,10,True
1016919,1134,1,30,7582,229673964,1,0,0,996.07,8,154347.93,24,1,19,1,True
1017863,1483,0,20,3341,229673964,1,0,0,996.09,5,153351.84,24,0,20,1,True
1122421,126,1,451,4825,229673964,1,0,0,995.97,7,152355.87,18,4,7,3,True
1477923,200,0,25,1283,229673964,1,0,0,996.03,8,151359.84,9,5,0,3,True
1518752,798,4,25,4825,229673964,1,0,0,996.14,8,150363.7,11,0,7,3,True
1523469,126,1,-1,3147,229673964,1,1,0,996.22,1,150363.7,18,4,19,3,False
1581504,200,0,30,5261,229673964,1,0,0,995.84,8,149367.86,9,4,7,3,True
1736145,818,1,10,7131,229673964,1,0,0,995.78,6,150363.64,18,4,2,6,True
1778700,1150,0,10,9612,229673964,1,0,0,996.06,0,151359.7,15,5,3,6,True
1866337,424,1,10,8376,229673964,1,0,0,996.17,0,152355.87,18,6,1,6,True
1886639,126,1,451,1283,229673964,1,0,0,995.87,7,151360.0,18,6,10,7,True
1926043,1411,0,10,6933,229673964,1,0,0,995.94,6,152355.94,24,1,23,7,True
2132399,384,3,451,3341,229673964,1,0,0,996.08,7,151359.86,25,0,21,8,True
2264779,31,3,451,5629,229673964,1,0,0,995.99,7,150363.87,11,4,20,9,True
2304542,384,3,451,6850,229673964,1,0,0,996.33,7,149367.54,25,2,1,9,True
2331780,384,3,30,7788,229673964,1,0,0,996.07,8,148371.47,25,4,15,9,True
2673180,562,1,10,5629,229673964,1,0,0,995.99,6,149367.46,17,2,18,10,True
2775683,126,1,451,3341,229673964,1,0,0,995.87,7,148371.59,18,1,5,11,True
3009744,641,0,20,7921,229673964,1,0,0,996.01,5,147375.58,24,3,15,11,True
3050492,384,3,-1,6183,229673964,1,1,0,996.17,4,147375.58,25,3,10,11,True
3325859,200,0,-1,7256,229673964,1,2,0,996.21,4,147375.58,9,3,9,12,True
3395268,1134,1,451,6933,229673964,1,0,0,996.22,7,146379.36,24,2,8,1,False
3591913,200,0,-1,3341,229673964,1,1,0,996.28,4,146379.36,9,2,16,1,True
4390851,31,3,451,5629,229673964,1,0,0,996.11,7,145383.25,11,2,23,2,True
4417833,31,3,-1,7921,229673964,1,1,0,995.88,1,145383.25,11,1,4,3,True
4646568,384,3,30,1329,229673964,1,0,0,995.8,8,144387.45,25,6,18,3,True
5312459,95,2,20,8615,229673964,1,0,0,996.05,3,143391.4,1,4,1,4,True
5556225,31,3,-1,4825,229673964,1,1,0,995.97,4,143391.4,11,2,22,5,True
5728044,798,4,-1,5629,229673964,1,2,0,996.05,4,143391.4,11,0,19,5,True
6105959,798,4,451,6850,229673964,1,0,0,996.16,7,142395.24,11,0,12,7,True
6191841,798,4,451,7200,229673964,1,0,0,996.4,7,141398.84,11,1,15,7,True
6877462,1134,1,25,6183,229673964,1,0,0,996.15,8,140402.69,24,4,12,8,True
6966165,910,0,20,7131,229673964,1,0,0,995.83,3,139406.86,18,6,12,9,True
7265724,759,0,10,7582,229673964,1,0,0,996.13,0,140402.99,24,5,4,9,True
7288244,1297,0,30,5261,229673964,1,0,0,996.34,8,139406.65,5,6,17,9,True
7455139,579,0,10,6389,229673964,1,0,0,996.15,6,140402.8,11,4,13,10,True
7722211,309,0,10,4825,229673964,1,0,0,995.81,6,141398.61,4,5,10,10,True
7809501,348,0,20,7788,229673964,1,0,0,996.03,3,140402.58,24,2,3,11,True
7890220,1297,0,25,7788,229673964,1,0,0,996.06,8,139406.52,5,4,18,11,True
7901088,1075,0,20,5261,229673964,1,0,0,995.79,5,138410.73,18,0,18,12,True
7953750,200,0,25,8376,229673964,1,0,0,996.28,8,137414.45,9,3,20,12,True
8014091,1206,0,20,6183,229673964,1,0,0,995.88,5,136418.57,24,4,18,12,True
8165708,68,0,10,7921,229673964,1,0,0,995.82,0,137414.39,20,6,2,1,True
8235955,1134,1,-1,7256,229673964,1,1,0,996.12,4,137414.39,24,2,2,3,True
8252049,1134,1,451,6183,229673964,1,0,0,996.11,7,136418.28,24,4,8,3,True
8619054,126,1,451,8615,229673964,1,0,0,995.96,7,135422.32,18,6,20,3,True
8623676,767,0,10,7788,229673964,1,0,0,996.3,6,136418.62,14,1,13,3,True
8633094,931,0,20,1283,229673964,1,0,0,996.15,5,135422.47,24,4,7,4,True
8659895,1134,1,-1,5889,229673964,1,1,0,995.67,1,135422.47,24,2,0,5,True
8968881,31,3,451,6850,229673964,1,0,0,995.96,7,134426.51,11,1,3,6,True
9073986,31,3,451,2391,229673964,1,0,0,996.17,7,133430.34,11,0,2,7,True
9128148,384,3,25,5498,229673964,1,0,0,996.0,8,132434.34,25,2,13,7,True
9262331,1297,0,-1,2391,229673964,1,1,0,995.99,4,132434.34,5,6,20,7,True
9374878,798,4,451,9137,229673964,1,0,0,996.1,7,131438.24,11,0,9,7,True
9468333,200,0,30,7256,229673964,1,0,0,996.08,8,130442.16,9,5,6,9,True
9956879,384,3,25,1283,229673964,1,0,0,996.06,8,129446.1,25,6,17,9,True
9998491,384,3,30,7582,229673964,1,0,0,996.01,8,128450.09,25,2,6,11,True
1226297,1164,0,10,3833,299665877,1,0,0,213.77,0,329559.77,24,3,5,1,True
1286774,698,4,30,6743,299665877,1,0,0,214.11,8,329345.66,18,4,9,1,True
1371633,698,4,-1,8592,299665877,1,1,0,214.2,4,329345.66,18,4,1,2,False
1396642,282,2,451,5042,299665877,1,0,0,213.89,7,329131.77,24,5,2,3,True
1601572,362,0,25,8927,299665877,1,0,0,213.92,8,328917.85,24,5,22,3,True
1721267,824,2,20,2588,299665877,1,0,0,214.08,5,328703.77,18,5,14,4,True
1844520,698,4,451,8984,299665877,1,0,0,213.89,7,328489.88,18,1,3,4,True
1978035,698,4,-1,9856,299665877,1,1,0,214.08,1,328489.88,18,2,2,4,True
2238067,282,2,30,9769,299665877,1,0,0,214.03,8,328275.85,24,6,21,5,True
2393743,698,4,25,3127,299665877,1,0,0,214.19,8,328061.66,18,0,15,5,True
2462855,1255,0,20,8927,299665877,1,0,0,214.15,5,327847.51,23,1,21,5,True
2514431,804,0,20,6983,299665877,1,0,0,213.72,5,327633.79,11,6,8,6,True
2517144,644,0,-1,2421,299665877,1,1,0,214.06,1,327633.79,24,0,23,7,True
2695080,1063,0,10,9880,299665877,1,0,0,213.99,6,327847.78,11,4,21,9,True
2720018,644,0,-1,1197,299665877,1,1,0,214.36,4,327847.78,24,1,9,9,True
2723753,644,0,30,3833,299665877,1,0,0,214.15,8,327633.63,24,6,8,9,True
2992895,282,2,451,9194,299665877,1,0,0,214.08,7,327419.55,24,5,17,10,True
3137174,1192,2,25,6211,299665877,1,0,0,214.11,8,327205.44,24,3,19,11,True
3375119,362,0,451,3439,299665877,1,0,0,214.05,7,326991.39,24,1,11,11,True
3446665,362,0,-1,2588,299665877,1,1,0,213.96,1,326991.39,24,1,8,11,True
3931074,1063,0,20,1030,299665877,1,0,0,214.35,5,326777.04,11,6,18,12,True
4003639,282,2,451,8984,299665877,1,0,0,214.18,7,326562.86,24,5,14,12,True
4122192,362,0,451,9634,299665877,1,0,0,213.94,7,326348.92,24,6,4,12,True
4216631,993,0,20,8927,299665877,1,0,0,214.04,5,326134.88,22,6,6,12,True
4572898,342,0,20,8927,299665877,1,0,0,213.95,3,325920.93,24,2,8,12,True
4615066,362,0,-1,5491,299665877,1,1,0,214.07,4,325920.93,24,5,10,2,True
4644624,799,2,20,2588,299665877,1,0,0,214.08,5,325706.85,11,5,6,3,True
4808910,644,0,451,6177,299665877,1,0,0,214.08,7,325492.77,24,2,11,4,True
4838976,562,1,451,3107,299665877,1,0,0,214.09,7,325278.68,17,5,18,4,True
5859280,576,2,20,6983,299665877,1,0,0,214.18,3,325064.5,11,3,8,4,True
5962529,562,1,451,9194,299665877,1,0,0,214.05,7,324850.45,17,6,19,5,True
6382687,1402,4,451,8592,299665877,1,0,0,214.01,7,324636.44,24,4,0,5,True
6640481,1019,0,10,2421,299665877,1,0,0,214.07,0,324850.51,26,2,6,5,True
6705483,572,0,20,1030,299665877,1,0,0,214.06,5,324636.45,11,2,11,5,True
6789569,644,0,451,5491,299665877,1,0,0,213.92,7,324422.53,24,0,15,6,True
6899227,887,2,20,9880,299665877,1,0,0,213.96,5,324208.57,27,1,15,6,True
7044848,644,0,451,8984,299665877,1,0,0,213.88,7,323994.69,24,6,18,6,True
7120390,1192,2,30,3439,299665877,1,0,0,214.11,8,323780.58,24,4,9,7,True
7148443,1255,0,25,9769,299665877,1,0,0,213.68,8,323566.9,23,4,16,7,True
7361508,644,0,-1,9646,299665877,1,1,0,214.12,1,323566.9,24,2,16,8,True
7370507,562,1,-1,6983,299665877,1,2,0,213.79,4,323566.9,17,1,11,10,True
7466345,867,0,10,2588,299665877,1,0,0,214.21,6,323781.11,24,0,20,11,True
7618493,282,2,451,9646,299665877,1,0,0,213.77,7,323567.34,24,1,5,11,True
7640998,362,0,451,6983,299665877,1,0,0,214.2,7,323353.14,24,0,21,12,True
7767380,1402,4,25,9769,299665877,1,0,0,213.96,8,323139.18,24,5,12,12,True
7908064,562,1,30,3833,299665877,1,0,0,213.95,8,322925.23,17,3,14,2,True
8166275,644,0,451,6211,299665877,1,0,0,213.68,7,322711.55,24,0,12,2,True
8185555,1255,0,451,5491,299665877,1,0,0,214.01,7,322497.54,23,0,17,2,True
8398759,562,1,30,2123,299665877,1,0,0,214.0,8,322283.54,17,0,21,3,True
8443642,698,4,30,9646,299665877,1,0,0,213.71,8,322069.83,18,4,3,3,True
8500260,362,0,-1,4032,299665877,1,1,0,214.05,4,322069.83,24,0,23,4,False
8563173,698,4,-1,2421,299665877,1,2,0,213.96,4,322069.83,18,4,8,4,True
8756772,879,1,10,9395,299665877,1,0,0,213.87,0,322283.7,27,6,22,6,True
9727516,562,1,451,2421,299665877,1,0,0,213.87,7,322069.83,17,5,21,6,True
9794901,897,0,20,6211,299665877,1,0,0,214.04,5,321855.79,24,1,16,10,True
9821927,1255,0,451,9634,299665877,1,0,0,213.94,7,321641.85,23,0,18,10,True
9879884,362,0,25,6177,299665877,1,0,0,213.9,8,321427.95,24,2,0,11,True
1040411,1112,1,10,4027,631514992,0,0,0,361.12,6,312178.12,0,5,18,2,True
1176048,341,0,20,3672,631514992,0,0,0,360.94,5,311817.18,24,1,13,2,True
1240193,540,4,25,2526,631514992,0,0,0,360.93,8,311456.25,17,4,12,3,True
1390824,298,4,30,1830,631514992,0,0,0,360.9,8,311095.35,4,2,13,4,True
1499746,1210,0,20,6571,631514992,0,0,0,361.17,5,310734.18,24,3,9,4,True
1551323,1320,3,-1,6949,631514992,0,1,0,360.91,1,310734.18,18,3,19,5,True
1620185,1409,1,451,2526,631514992,0,0,0,361.1,7,310373.08,24,3,1,6,True
1645297,564,0,20,7883,631514992,0,0,0,361.05,3,310012.03,17,0,22,6,True
1682349,340,4,451,6319,631514992,0,0,0,360.95,7,309651.08,24,0,9,6,True
1768649,558,0,20,3080,631514992,0,0,0,361.01,5,309290.07,17,6,2,9,False
1857084,312,0,20,2826,631514992,0,0,0,361.18,5,308928.89,4,2,13,10,True
2382238,540,4,25,3672,631514992,0,0,0,360.9,8,308567.99,17,5,19,11,False
2486785,540,4,451,2505,631514992,0,0,0,360.9,7,308207.09,17,1,15,11,True
2528807,747,1,451,9670,631514992,0,0,0,360.89,7,307846.2,24,6,20,12,True
2681314,588,0,30,9286,631514992,0,0,0,360.87,8,307485.33,24,2,13,1,True
2724260,1409,1,25,3336,631514992,0,0,0,361.07,8,307124.26,24,1,12,2,True
2824852,540,4,451,4456,631514992,0,0,0,361.06,7,306763.2,17,4,12,2,True
2851351,222,2,20,4027,631514992,0,0,0,361.12,3,306402.08,26,4,16,2,True
2927727,1250,1,10,9286,631514992,0,0,0,360.95,6,306763.03,23,2,11,3,True
3213742,540,4,451,9286,631514992,0,0,0,361.03,7,306402.0,17,5,18,3,True
3270994,747,1,25,3080,631514992,0,0,0,360.77,8,306041.23,24,4,1,3,True
3333215,540,4,25,9532,631514992,0,0,0,360.86,8,305680.37,17,1,7,4,True
3374577,747,1,30,6571,631514992,0,0,0,361.28,8,305319.09,24,3,14,4,True
3650501,1409,1,451,2526,631514992,0,0,0,361.1,7,304957.99,24,3,0,4,True
4086469,298,4,451,6319,631514992,0,0,0,361.2,7,304596.79,4,6,12,4,True
4179261,340,4,451,3230,631514992,0,0,0,360.75,7,304236.04,24,4,17,6,True
4210932,812,0,20,1115,631514992,0,0,0,361.02,3,303875.02,18,1,8,6,True
4924381,1409,1,30,4203,631514992,0,0,0,361.05,8,303513.97,24,2,13,6,True
5418398,540,4,30,3930,631514992,0,0,0,361.11,8,303152.86,17,2,21,6,True
5776657,300,0,20,9286,631514992,0,0,0,360.96,5,302791.9,4,1,2,6,True
5807250,340,4,30,3080,631514992,0,0,0,360.76,8,302431.14,24,0,3,7,True
6128011,1320,3,-1,2526,631514992,0,1,0,361.15,1,302431.14,18,2,6,7,True
6389238,340,4,-1,6571,631514992,0,2,0,360.84,1,302431.14,24,2,3,9,True
6630282,1320,3,30,9532,631514992,0,0,0,360.9,8,302070.24,18,3,17,10,True
6634266,1338,0,20,2826,631514992,0,0,0,361.01,5,301709.23,18,4,17,11,True
6668630,1409,1,-1,3336,631514992,0,1,0,360.97,1,301709.23,24,6,22,12,True
6896499,1409,1,25,4203,631514992,0,0,0,361.02,8,301348.21,24,4,19,12,True
7001133,540,4,451,3672,631514992,0,0,0,361.08,7,300987.13,17,3,18,1,True
7519134,249,0,20,2505,631514992,0,0,0,360.83,3,300626.3,6,1,15,2,True
7537296,540,4,25,2773,631514992,0,0,0,361.03,8,300265.27,17,4,16,2,True
7981947,340,4,451,3930,631514992,0,0,0,360.98,7,299904.29,24,0,21,3,True
8114153,340,4,25,8619,631514992,0,0,0,361.01,8,299543.28,24,1,9,4,True
8387939,1409,1,451,4203,631514992,0,0,0,361.02,7,299182.26,24,0,12,4,True
8519215,297,0,10,6740,631514992,0,0,0,360.97,6,299543.23,4,4,6,5,True
8823458,1322,2,25,3930,631514992,0,0,0,361.11,8,299182.12,18,2,0,5,True
8857183,1409,1,30,9286,631514992,0,0,0,360.96,8,298821.16,24,0,17,5,True
8864216,588,0,-1,4100,631514992,0,1,0,361.31,4,298821.16,24,0,9,5,True
9167615,540,4,451,9286,631514992,0,0,0,361.07,7,298460.09,17,1,10,5,True
9241048,47,1,10,2526,631514992,0,0,0,360.89,6,298820.98,24,6,17,6,True
9386182,416,2,20,3672,631514992,0,0,0,361.07,5,298459.91,18,2,8,6,True
9418609,340,4,30,3672,631514992,0,0,0,360.9,8,298099.01,24,1,4,7,True
9637765,1320,3,451,3771,631514992,0,0,0,361.16,7,297737.85,18,1,17,8,False
9689953,369,1,10,6949,631514992,0,0,0,360.86,0,298098.71,25,0,1,8,True
9990984,298,4,30,2826,631514992,0,0,0,361.0,8,297737.71,4,1,23,9,True
1271709,650,3,-1,4995,974924620,0,1,0,926.97,4,652304.0,24,6,17,1,True
1329603,1063,0,451,4779,974924620,0,0,0,926.8,7,651377.2,11,4,17,2,True
1364577,134,4,-1,8520,974924620,0,1,0,927.07,4,651377.2,18,6,11,2,True
1486468,807,0,-1,9965,974924620,0,2,0,926.9,4,651377.2,11,0,17,3,True
1492337,224,3,451,4779,974924620,0,0,0,927.28,7,650449.92,26,6,21,3,True
1563815,1063,0,451,2832,974924620,0,0,0,926.73,7,649523.19,11,0,16,4,True
1921164,1063,0,451,4503,974924620,0,0,0,927.02,7,648596.17,11,2,18,4,True
1988946,1063,0,30,9574,974924620,0,0,0,926.82,8,647669.35,11,3,1,4,True
2198716,926,4,30,6988,974924620,0,0,0,926.75,8,646742.6,18,5,12,4,True
2406170,134,4,451,4995,974924620,0,0,0,927.09,7,645815.51,18,1,13,5,True
2499570,224,3,30,9618,974924620,0,0,0,926.73,8,644888.78,26,3,5,6,True
2547627,1063,0,451,3627,974924620,0,0,0,926.9,7,643961.88,11,0,13,6,True
2593389,134,4,30,9504,974924620,0,0,0,926.88,8,643035.0,18,2,9,6,True
2655715,926,4,-1,4291,974924620,0,1,0,927.16,4,643035.0,18,3,0,8,True
2679247,359,2,20,9574,974924620,0,0,0,927.08,3,642107.92,24,3,4,8,True
2731880,1063,0,451,9498,974924620,0,0,0,926.99,7,641180.93,11,6,2,10,True
2799754,570,2,20,3627,974924620,0,0,0,927.04,3,640253.89,11,0,15,10,True
2876502,81,0,10,6022,974924620,0,0,0,926.82,6,641180.71,1,5,3,11,True
2995407,134,4,451,3627,974924620,0,0,0,927.02,7,640253.69,18,3,3,12,True
3182571,21,0,10,3627,974924620,0,0,0,927.01,0,641180.7,11,6,21,12,True
3562563,650,3,451,4503,974924620,0,0,0,926.95,7,640253.75,24,0,0,2,True
4032412,219,0,20,3763,974924620,0,0,0,926.83,3,639326.92,9,6,21,3,True
4219216,348,0,10,5003,974924620,0,0,0,927.05,6,640253.97,24,3,15,3,True
4293823,726,0,10,9618,974924620,0,0,0,926.85,0,641180.82,11,5,12,4,True
4330388,807,0,25,5730,974924620,0,0,0,927.12,8,640253.7,11,4,0,6,True
4671994,650,3,30,9504,974924620,0,0,0,926.91,8,639326.79,24,1,7,7,False
4949240,1063,0,451,4503,974924620,0,0,0,927.1,7,638399.69,11,3,14,7,True
5053757,895,0,10,6227,974924620,0,0,0,927.0,6,639326.69,24,0,5,8,True
5595330,926,4,30,8115,974924620,0,0,0,926.98,8,638399.71,18,3,20,8,False
5888934,926,4,30,4779,974924620,0,0,0,927.19,8,637472.52,18,1,13,8,True
6032801,650,3,25,3763,974924620,0,0,0,927.05,8,636545.47,24,2,8,8,True
6641106,879,1,10,6227,974924620,0,0,0,927.02,0,637472.49,27,3,8,9,True
6658060,134,4,30,5730,974924620,0,0,0,926.93,8,636545.56,18,4,10,10,True
6757850,348,0,20,5003,974924620,0,0,0,926.87,3,635618.69,24,6,4,11,True
7002721,205,0,10,6509,974924620,0,0,0,927.02,6,636545.71,9,5,1,12,True
7193474,1339,2,20,8520,974924620,0,0,0,927.2,5,635618.51,18,6,21,12,True
7709613,926,4,30,6022,974924620,0,0,0,926.84,8,634691.67,18,2,21,1,True
7767295,677,0,10,2832,974924620,0,0,0,927.14,6,635618.81,24,6,3,1,True
8150507,134,4,-1,9574,974924620,0,1,0,926.98,4,635618.81,18,6,20,2,True
8316808,484,0,20,4779,974924620,0,0,0,926.95,5,634691.86,5,4,23,2,True
8336466,926,4,30,9504,974924620,0,0,0,926.88,8,633764.98,18,1,9,2,True
8459289,1063,0,-1,5730,974924620,0,1,0,927.07,1,633764.98,11,0,13,3,True
8508162,807,0,451,2873,974924620,0,0,0,927.01,7,632837.97,11,0,2,3,True
8648813,807,0,30,9498,974924620,0,0,0,926.93,8,631911.04,11,0,14,5,True
8977609,926,4,25,9574,974924620,0,0,0,927.31,8,630983.73,18,6,5,6,True
8999590,224,3,451,4995,974924620,0,0,0,926.87,7,630056.86,26,5,7,8,True
9004735,926,4,-1,2873,974924620,0,1,0,926.98,4,630056.86,18,4,15,9,True
9181485,926,4,451,6988,974924620,0,0,0,926.86,7,629130.0,18,1,4,9,True
9648454,926,4,-1,9618,974924620,0,1,0,927.03,4,629130.0,18,2,2,10,True
9699991,224,3,25,1679,974924620,0,0,0,926.75,8,628203.25,26,0,23,11,True
9812529,926,4,25,8520,974924620,0,0,0,926.86,8,627276.39,18,2,14,11,True
1046468,1179,0,25,1487,783349011,0,0,0,328.09,8,96710.91,24,1,0,1,True
1188526,734,0,20,8534,783349011,0,0,0,327.94,3,96382.97,11,4,20,1,True
1239661,174,3,-1,5053,783349011,0,1,0,327.87,4,96382.97,24,2,18,3,True
1244926,1179,0,30,8534,783349011,0,0,0,328.15,8,96054.82,24,4,10,3,True
1479855,712,0,10,7620,783349011,0,0,0,327.95,6,96382.77,18,5,12,3,False
1677203,1022,4,30,1403,783349011,0,0,0,327.9,8,96054.87,11,1,19,3,True
1876235,914,2,30,1815,783349011,0,0,0,327.85,8,95727.02,18,2,5,4,True
1988401,1401,1,10,8534,783349011,0,0,0,327.94,0,96054.96,24,3,8,6,True
2124852,341,0,30,1839,783349011,0,0,0,328.09,8,95726.87,24,6,1,6,True
2231783,579,0,10,8418,783349011,0,0,0,327.95,6,96054.82,11,0,11,6,True
2422835,705,1,10,4926,783349011,0,0,0,327.88,6,96382.7,18,6,1,7,True
2430628,174,3,25,1225,783349011,0,0,0,327.77,8,96054.93,24,0,12,7,True
2607563,1022,4,451,8418,783349011,0,0,0,327.99,7,95726.94,11,2,1,7,True
2936889,393,1,10,1225,783349011,0,0,0,327.77,0,96054.71,10,5,6,9,True
2999469,914,2,25,6587,783349011,0,0,0,328.01,8,95726.7,18,4,5,9,True
3338405,341,0,451,8534,783349011,0,0,0,327.81,7,95398.89,24,4,0,12,True
3348731,1022,4,-1,1487,783349011,0,1,0,327.91,4,95398.89,11,6,17,12,True
3511875,1179,0,30,8720,783349011,0,0,0,328.08,8,95070.81,24,1,8,12,True
3518170,1179,0,25,4174,783349011,0,0,0,328.07,8,94742.74,24,5,15,2,True
3776174,341,0,25,9517,783349011,0,0,0,327.77,8,94414.97,24,0,4,2,False
4119392,1179,0,30,6494,783349011,0,0,0,328.01,8,94086.96,24,0,13,4,True
4420792,174,3,25,8858,783349011,0,0,0,327.97,8,93758.99,24,3,21,5,True
4521775,1022,4,30,9869,783349011,0,0,0,328.17,8,93430.82,11,6,15,5,True
4668367,174,3,30,2053,783349011,0,0,0,327.79,8,93103.03,24,4,14,6,True
5067282,1179,0,25,1403,783349011,0,0,0,328.12,8,92774.91,24,6,14,6,True
5112699,341,0,25,5053,783349011,0,0,0,328.13,8,92446.78,24,0,8,6,True
5144614,1022,4,30,4174,783349011,0,0,0,328.0,8,92118.78,11,5,23,7,True
5294921,174,3,30,6494,783349011,0,0,0,328.11,8,91790.67,24,5,20,7,True
5321368,914,2,30,6494,783349011,0,0,0,328.07,8,91462.6,18,2,23,7,True
5341144,174,3,-1,9869,783349011,0,1,0,327.91,1,91462.6,24,2,21,8,True
5467875,428,0,10,1487,783349011,0,0,0,328.0,6,91790.6,18,1,12,9,True
5536458,174,3,30,6587,783349011,0,0,0,327.81,8,91462.79,24,2,2,9,True
5541188,1076,1,10,3431,783349011,0,0,0,328.0,0,91790.79,18,3,1,10,True
5651085,465,0,20,1403,783349011,0,0,0,327.99,3,91462.8,13,2,14,10,True
6037830,917,0,20,2053,783349011,0,0,0,327.88,3,91134.92,18,5,23,12,True
6061872,670,0,10,8534,783349011,0,0,0,328.0,6,91462.92,18,0,21,12,True
6647447,174,3,25,5053,783349011,0,0,0,328.02,8,91134.9,24,2,5,12,True
6744138,898,1,10,7376,783349011,0,0,0,328.01,6,91462.91,24,2,7,12,True
7388835,303,0,20,7376,783349011,0,0,0,328.31,5,91134.6,4,1,12,1,True
7451680,914,2,451,1403,783349011,0,0,0,328.18,7,90806.42,18,1,7,2,True
7525546,914,2,25,4174,783349011,0,0,0,327.95,8,90478.47,18,2,14,2,True
7595699,781,1,10,4174,783349011,0,0,0,327.88,6,90806.35,14,2,15,2,True
7764704,341,0,25,5053,783349011,0,0,0,328.0,8,90478.35,24,3,8,3,True
7860477,850,1,10,1839,783349011,0,0,0,327.8,6,90806.15,5,1,20,3,True
8058838,174,3,451,1487,783349011,0,0,0,327.83,7,90478.32,24,2,5,3,True
8077381,1179,0,-1,9869,783349011,0,1,0,327.84,4,90478.32,24,4,20,3,True
8451507,341,0,30,1225,783349011,0,0,0,328.05,8,90150.27,24,5,5,4,True
8614443,174,3,30,4174,783349011,0,0,0,328.15,8,89822.12,24,5,11,4,True
8781047,341,0,451,6587,783349011,0,0,0,328.14,7,89493.98,24,3,14,5,True
8923635,174,3,25,1225,783349011,0,0,0,328.11,8,89165.87,24,1,15,6,True
9047583,341,0,-1,8418,783349011,0,1,0,328.03,4,89165.87,24,2,20,6,True
9071521,914,2,451,8418,783349011,0,0,0,327.84,7,88838.03,18,0,12,7,True
9293437,348,0,20,9517,783349011,0,0,0,327.68,5,88510.35,24,1,15,10,True
9586161,914,2,25,4174,783349011,0,0,0,327.88,8,88182.47,18,1,22,10,True
9782231,444,2,20,9869,783349011,0,0,0,327.91,5,87854.56,24,1,13,10,True
9785868,1179,0,25,3431,783349011,0,0,0,328.05,8,87526.51,24,5,14,10,True
9791730,174,3,-1,9869,783349011,0,1,0,328.21,1,87526.51,24,3,10,11,True
1070774,1115,1,25,2703,129256009,0,0,0,985.1,8,358481.9,0,1,20,1,True
1497708,1297,0,451,6784,129256009,0,0,0,985.24,7,357496.66,5,5,21,2,True
1567034,1426,1,10,1929,129256009,0,0,0,985.04,6,358481.7,24,1,7,2,True
1843522,85,2,20,4578,129256009,0,0,0,985.08,5,357496.62,1,6,13,4,True
1921441,1065,0,10,6185,129256009,0,0,0,985.18,0,358481.8,11,3,15,6,True
2160129,319,0,-1,2728,129256009,0,1,0,985.09,4,358481.8,11,0,9,6,True
2298743,1449,0,10,9704,129256009,0,0,0,984.98,6,359466.78,11,1,21,6,True
2314674,291,3,30,4578,129256009,0,0,0,984.95,8,358481.83,24,2,8,6,True
2364392,319,0,30,1929,129256009,0,0,0,984.8,8,357497.03,11,5,18,6,True
2854457,268,2,451,3170,129256009,0,0,0,985.08,7,356511.95,24,1,5,8,True
2968597,319,0,451,4578,129256009,0,0,0,985.15,7,355526.8,11,6,7,8,True
3251839,854,0,10,6185,129256009,0,0,0,984.97,0,356511.77,24,2,1,8,True
3315619,291,3,451,9704,129256009,0,0,0,984.94,7,355526.83,24,0,2,9,True
3364914,467,0,20,1704,129256009,0,0,0,985.13,3,354541.7,5,1,22,10,True
3644760,1297,0,25,2989,129256009,0,0,0,985.03,8,353556.67,5,4,12,11,True
3735339,291,3,25,6784,129256009,0,0,0,985.16,8,352571.51,24,4,18,11,True
3818533,1249,2,20,6803,129256009,0,0,0,985.18,3,351586.33,23,0,14,11,False
3825020,579,0,10,2956,129256009,0,0,0,984.98,0,352571.31,11,2,10,12,True
4022551,249,0,10,2728,129256009,0,0,0,984.94,6,353556.25,6,2,9,12,True
4129032,1142,2,20,8737,129256009,0,0,0,985.09,3,352571.16,15,6,13,1,False
4148204,531,0,20,1929,129256009,0,0,0,984.97,5,351586.19,18,5,1,2,True
4573594,335,4,451,1929,129256009,0,0,0,985.03,7,350601.16,11,5,15,2,True
4592509,335,4,451,1929,129256009,0,0,0,984.98,7,349616.18,11,2,5,3,True
4740971,126,1,10,6769,129256009,0,0,0,985.16,6,350601.34,18,6,21,3,True
4791620,268,2,30,1496,129256009,0,0,0,985.02,8,349616.32,24,2,7,5,True
5018131,291,3,30,6104,129256009,0,0,0,984.81,8,348631.51,24,6,4,6,True
5514348,335,4,25,2989,129256009,0,0,0,985.1,8,347646.41,11,2,3,6,True
5582193,291,3,451,2989,129256009,0,0,0,984.78,7,346661.63,24,3,12,6,True
5622214,1115,1,-1,6769,129256009,0,1,0,984.69,4,346661.63,0,4,7,7,True
5929871,1010,0,20,1704,129256009,0,0,0,984.93,5,345676.7,26,0,12,8,True
5951653,291,3,-1,9704,129256009,0,1,0,984.95,1,345676.7,24,4,6,9,True
6133018,335,4,-1,1929,129256009,0,2,0,985.0,1,345676.7,11,3,20,10,True
6475091,291,3,30,6104,129256009,0,0,0,984.71,8,344691.99,24,5,11,1,True
6580803,268,2,30,1929,129256009,0,0,0,985.24,8,343706.75,24,2,23,2,True
6664930,747,1,10,6803,129256009,0,0,0,985.0,6,344691.75,24,4,2,3,True
6683477,319,0,451,6769,129256009,0,0,0,985.11,7,343706.64,11,5,21,6,True
6779129,319,0,451,4471,129256009,0,0,0,985.05,7,342721.59,11,3,14,6,True
6826937,1297,0,451,6769,129256009,0,0,0,985.51,7,341736.08,5,5,1,6,True
6936695,254,0,20,6104,129256009,0,0,0,985.26,5,340750.82,6,3,11,7,True
7289459,1297,0,25,9658,129256009,0,0,0,985.11,8,339765.71,5,1,14,7,True
7370162,1297,0,25,2956,129256009,0,0,0,985.03,8,338780.68,5,5,7,7,True
7429818,335,4,25,8195,129256009,0,0,0,984.97,8,337795.71,11,0,2,7,True
7442431,335,4,30,6185,129256009,0,0,0,985.08,8,336810.63,11,2,8,7,True
7717543,291,3,-1,1929,129256009,0,1,0,985.03,1,336810.63,24,6,21,8,True
8277240,333,1,10,6769,129256009,0,0,0,985.11,0,337795.74,11,0,9,9,True
8381009,222,2,20,8195,129256009,0,0,0,984.89,5,336810.85,26,1,9,9,True
9100483,319,0,-1,1496,129256009,0,1,0,984.92,1,336810.85,11,2,1,9,True
9123723,291,3,451,6185,129256009,0,0,0,984.91,7,335825.94,24,6,9,9,True
9543018,319,0,451,2728,129256009,0,0,0,984.86,7,334841.08,11,1,17,10,True
9784127,1297,0,451,2956,129256009,0,0,0,985.08,7,333856.0,5,0,22,10,True
1154671,1035,0,10,9714,607625738,1,0,0,819.69,0,898619.69,11,3,18,1,True
1377181,399,2,20,2359,607625738,1,0,0,820.26,5,897799.43,10,0,14,1,True
1422209,637,4,30,4986,607625738,1,0,0,820.04,8,896979.39,24,6,4,2,True
1562783,917,0,10,6515,607625738,1,0,0,819.87,6,897799.26,18,5,9,2,True
1586937,1168,3,30,8781,607625738,1,0,0,820.14,8,896979.12,24,4,15,2,True
1817197,1436,0,20,8435,607625738,1,0,0,820.06,3,896159.06,24,0,22,3,True
2309770,1486,2,30,4986,607625738,1,0,0,820.01,8,895339.05,24,3,14,3,True
2339777,1486,2,25,8621,607625738,1,0,0,819.91,8,894519.14,24,4,0,4,True
2639641,637,4,30,2420,607625738,1,0,0,819.93,8,893699.21,24,4,13,4,True
2865831,1207,4,25,2420,607625738,1,0,0,820.14,8,892879.07,24,3,22,6,True
3120036,1207,4,25,8781,607625738,1,0,0,819.99,8,892059.08,24,1,20,6,True
3167272,1436,0,10,1695,607625738,1,0,0,820.0,6,892879.08,24,4,10,6,True
3301036,1168,3,451,2507,607625738,1,0,0,819.78,7,892059.3,24,2,2,6,True
3425065,1486,2,30,1373,607625738,1,0,0,820.01,8,891239.29,24,6,2,8,False
3493154,180,0,10,1695,607625738,1,0,0,820.13,0,892059.42,18,3,3,9,True
3673695,1339,2,20,5325,607625738,1,0,0,819.87,3,891239.55,18,5,15,9,True
3868866,610,0,20,5325,607625738,1,0,0,819.96,5,890419.59,11,0,18,9,True
3912571,350,0,20,9714,607625738,1,0,0,820.12,5,889599.47,24,2,15,9,True
3940267,444,2,20,5324,607625738,1,0,0,820.1,3,888779.37,24,6,1,10,True
4000377,1063,0,451,8621,607625738,1,0,0,820.01,7,887959.36,11,4,11,10,True
4036627,1063,0,451,9653,607625738,1,0,0,819.93,7,887139.43,11,6,7,10,True
4282689,1270,1,10,8621,607625738,1,0,0,819.89,0,887959.32,23,2,10,12,True
4285849,1486,2,451,4661,607625738,1,0,0,820.18,7,887139.14,24,0,13,1,True
4295207,531,0,20,4661,607625738,1,0,0,820.4,5,886318.74,18,4,2,1,True
4471935,637,4,451,2507,607625738,1,0,0,820.26,7,885498.48,24,4,21,1,False
4560934,799,2,20,2507,607625738,1,0,0,820.17,5,884678.31,11,3,5,2,False
4868070,1168,3,451,4986,607625738,1,0,0,819.78,7,883858.53,24,3,13,3,True
5303363,114,0,20,5325,607625738,1,0,0,819.96,5,883038.57,3,2,0,3,True
5784143,1168,3,451,2967,607625738,1,0,0,819.91,7,882218.66,24,2,17,3,True
5823048,1207,4,25,2507,607625738,1,0,0,819.89,8,881398.77,24,4,19,3,True
5870994,1063,0,30,5820,607625738,1,0,0,820.01,8,880578.76,11,2,14,4,True
6040217,637,4,451,1373,607625738,1,0,0,819.81,7,879758.95,24,3,6,4,True
6088389,1486,2,-1,8621,607625738,1,1,0,819.74,4,879758.95,24,5,10,4,True
6234275,551,0,20,9923,607625738,1,0,0,819.92,5,878939.03,17,0,2,5,True
6257787,1486,2,25,8630,607625738,1,0,0,819.77,8,878119.26,24,2,17,6,True
6278613,1246,0,10,3793,607625738,1,0,0,820.07,6,878939.33,23,4,8,7,True
6296827,958,2,20,1695,607625738,1,0,0,820.14,3,878119.19,13,5,4,7,True
6352945,158,2,20,9653,607625738,1,0,0,820.06,3,877299.13,24,3,11,8,True
6702443,1486,2,25,2967,607625738,1,0,0,820.1,8,876479.03,24,5,12,9,True
6731263,348,0,20,8781,607625738,1,0,0,820.09,5,875658.94,24,5,10,10,True
6901872,1207,4,30,2839,607625738,1,0,0,820.07,8,874838.87,24,6,21,11,True
7296137,1486,2,451,4661,607625738,1,0,0,820.08,7,874018.79,24,1,19,11,True
7487399,1207,4,25,8630,607625738,1,0,0,820.08,8,873198.71,24,2,10,11,True
7897892,637,4,451,2359,607625738,1,0,0,820.02,7,872378.69,24,3,1,12,True
7904282,637,4,451,1373,607625738,1,0,0,820.04,7,871558.65,24,5,11,12,True
7916842,1063,0,30,8630,607625738,1,0,0,820.21,8,870738.44,11,4,13,3,True
8234032,1063,0,-1,9923,607625738,1,1,0,819.8,4,870738.44,11,1,23,4,True
8293841,267,0,20,4661,607625738,1,0,0,820.34,3,869918.1,6,0,13,4,True
8430102,1168,3,30,6515,607625738,1,0,0,820.21,8,869097.89,24,1,23,5,True
8559896,1063,0,451,2839,607625738,1,0,0,819.98,7,868277.91,11,3,0,7,True
8672035,637,4,451,8781,607625738,1,0,0,819.77,7,867458.14,24,1,1,8,True
9318442,1304,0,20,8630,607625738,1,0,0,819.97,5,866638.17,5,6,3,9,True
9513624,1168,3,30,2839,607625738,1,0,0,819.93,8,865818.24,24,2,10,10,True
9535096,1014,1,10,2359,607625738,1,0,0,820.03,6,866638.27,26,6,12,10,True
9726294,1207,4,451,2359,607625738,1,0,0,819.98,7,865818.29,24,1,9,11,True
9837152,385,1,10,2420,607625738,1,0,0,820.08,0,866638.37,25,3,18,11,True
1083200,199,0,25,2439,837100551,0,0,0,169.19,8,475763.81,18,3,0,1,True
1757730,579,0,451,6476,837100551,0,0,0,169.01,7,475594.8,11,4,19,3,True
1875585,1127,0,20,7807,837100551,0,0,0,168.84,5,475425.96,24,4,1,3,True
1966729,726,0,20,6294,837100551,0,0,0,169.02,5,475256.94,11,6,3,3,True
1997792,305,1,10,6123,837100551,0,0,0,169.43,6,475426.37,4,1,21,3,True
2064696,142,4,25,6123,837100551,0,0,0,168.81,8,475257.56,18,4,18,4,True
2081828,780,0,20,8139,837100551,0,0,0,169.41,3,475088.15,14,5,2,4,True
2291714,579,0,451,4118,837100551,0,0,0,168.99,7,474919.16,11,6,17,4,True
2641915,463,1,10,6476,837100551,0,0,0,169.23,6,475088.39,13,5,19,5,True
2656626,585,2,20,8861,837100551,0,0,0,169.11,3,474919.28,11,5,21,6,True
2817178,1152,0,10,2439,837100551,0,0,0,168.97,6,475088.25,15,2,12,7,True
2977629,538,0,451,6476,837100551,0,0,0,168.88,7,474919.37,18,2,4,7,True
3025291,142,4,25,9349,837100551,0,0,0,168.73,8,474750.64,18,2,15,7,True
3184628,442,3,451,2074,837100551,0,0,0,169.01,7,474581.63,24,6,2,7,True
3272341,544,3,30,8861,837100551,0,0,0,169.01,8,474412.62,17,1,19,7,True
3365243,442,3,451,4254,837100551,0,0,0,168.89,7,474243.73,24,2,22,7,True
3372992,538,0,451,2074,837100551,0,0,0,168.92,7,474074.81,18,5,6,10,True
3383286,538,0,451,6215,837100551,0,0,0,168.82,7,473905.99,18,3,10,10,True
3470550,630,0,20,9349,837100551,0,0,0,169.13,5,473736.86,11,1,9,11,True
4299452,1404,2,20,3724,837100551,0,0,0,169.15,5,473567.71,24,1,15,12,True
4317091,1170,0,10,8139,837100551,0,0,0,168.86,6,473736.57,24,4,11,1,True
4690837,164,4,25,2439,837100551,0,0,0,169.13,8,473567.44,24,2,10,2,False
5524821,1150,0,10,6731,837100551,0,0,0,168.96,6,473736.4,15,5,16,4,True
6015828,142,4,25,6364,837100551,0,0,0,168.92,8,473567.48,18,2,3,6,True
6097065,199,0,451,5248,837100551,0,0,0,168.99,7,473398.49,18,1,5,6,False
6235310,573,0,451,6364,837100551,0,0,0,169.24,7,473229.25,11,3,18,7,True
6251152,572,0,20,4118,837100551,0,0,0,168.97,5,473060.28,11,3,16,8,False
6284319,442,3,25,8139,837100551,0,0,0,169.26,8,472891.02,24,2,9,9,True
6324341,199,0,-1,7673,837100551,0,1,0,169.02,1,472891.02,18,4,1,9,True
6713899,621,2,20,8861,837100551,0,0,0,169.09,5,472721.93,11,6,2,10,True
7006448,1356,2,20,8139,837100551,0,0,0,169.23,5,472552.7,24,3,7,11,True
7132596,935,1,10,6476,837100551,0,0,0,168.96,6,472721.66,24,4,20,12,True
7228503,199,0,25,6215,837100551,0,0,0,169.31,8,472552.35,18,0,12,1,True
7401465,164,4,30,6476,837100551,0,0,0,168.87,8,472383.48,24,1,20,1,True
7792847,544,3,-1,6364,837100551,0,1,0,169.0,4,472383.48,17,3,15,1,True
7794909,1471,0,10,6215,837100551,0,0,0,169.06,6,472552.54,24,0,21,1,True
8125249,442,3,30,6364,837100551,0,0,0,168.73,8,472383.81,24,1,13,2,True
8131111,220,0,20,8139,837100551,0,0,0,168.99,5,472214.82,26,4,2,2,True
8244215,309,0,20,7673,837100551,0,0,0,168.8,3,472046.02,4,6,17,2,True
8362440,538,0,30,6364,837100551,0,0,0,169.02,8,471877.0,18,6,20,3,True
8471621,544,3,451,6731,837100551,0,0,0,168.99,7,471708.01,17,0,7,3,True
8658280,97,0,20,8861,837100551,0,0,0,169.09,5,471538.92,3,1,16,3,True
8866395,1283,2,20,6294,837100551,0,0,0,169.13,3,471369.79,24,2,0,4,True
9027511,979,0,10,7807,837100551,0,0,0,169.06,0,471538.85,22,6,23,5,True
9073208,897,0,10,4254,837100551,0,0,0,169.1,6,471707.95,24,4,17,6,True
9140054,1233,0,20,6294,837100551,0,0,0,168.86,5,471539.09,18,6,10,7,True
9438142,164,4,-1,6215,837100551,0,1,0,169.17,4,471539.09,24,1,2,7,True
9736187,438,1,10,8861,837100551,0,0,0,169.02,6,471708.11,24,2,16,9,True
9744648,811,0,20,9349,837100551,0,0,0,168.69,3,471539.42,18,5,4,9,True
9831201,199,0,-1,6215,837100551,0,1,0,169.05,4,471539.42,18,2,14,10,True
9861592,164,4,-1,8861,837100551,0,2,0,169.18,4,471539.42,24,6,0,11,True
1310489,514,4,25,3659,971038539,0,0,0,679.11,8,288494.89,12,5,4,1,True
1409755,103,3,451,8600,971038539,0,0,0,679.21,7,287815.68,3,1,14,1,True
1536699,1342,3,30,7512,971038539,0,0,0,678.95,8,287136.73,24,4,20,1,True
1609196,953,4,25,6568,971038539,0,0,0,679.3,8,286457.43,13,3,4,2,True
1838849,953,4,25,4205,971038539,0,0,0,678.99,8,285778.44,13,4,5,2,True
2004348,1142,2,20,2563,971038539,0,0,0,678.88,3,285099.56,15,5,1,2,True
2528182,514,4,25,8600,971038539,0,0,0,678.95,8,284420.61,12,2,2,3,True
2625758,525,0,10,3659,971038539,0,0,0,679.0,6,285099.61,18,4,13,4,True
2905536,514,4,-1,7910,971038539,0,1,0,679.06,4,285099.61,12,5,21,5,True
2960792,441,4,25,7512,971038539,0,0,0,678.77,8,284420.84,24,3,13,7,True
3270022,403,0,10,3462,971038539,0,0,0,679.04,6,285099.88,10,5,14,7,True
3443618,103,3,-1,7444,971038539,0,1,0,679.09,4,285099.88,3,5,10,9,False
3613343,441,4,30,7972,971038539,0,0,0,679.12,8,284420.76,24,1,1,10,True
3701628,514,4,-1,1986,971038539,0,1,0,678.91,1,284420.76,12,1,22,10,True
3750701,818,1,10,4205,971038539,0,0,0,678.72,0,285099.48,18,1,11,10,True
3877065,1342,3,25,2173,971038539,0,0,0,678.74,8,284420.74,24,2,23,11,True
3942331,1267,2,20,4205,971038539,0,0,0,678.77,5,283741.97,23,3,2,11,True
4253416,441,4,25,7512,971038539,0,0,0,678.99,8,283062.98,24,4,16,12,True
5118348,103,3,30,7453,971038539,0,0,0,678.83,8,282384.15,3,5,8,1,True
5236051,267,0,20,1986,971038539,0,0,0,679.06,3,281705.09,6,1,17,2,True
5473229,103,3,30,3659,971038539,0,0,0,679.07,8,281026.02,3,6,12,3,True
5528449,715,0,20,3659,971038539,0,0,0,678.85,5,280347.17,18,3,12,3,True
5534198,1210,0,10,7377,971038539,0,0,0,679.0,0,281026.17,24,3,4,4,True
5571622,411,2,20,7377,971038539,0,0,0,678.73,3,280347.44,18,6,18,5,True
5906371,428,0,20,8438,971038539,0,0,0,679.04,5,279668.4,18,2,4,5,True
5911756,953,4,-1,2563,971038539,0,1,0,679.06,4,279668.4,13,1,10,6,False
5929885,996,0,20,2173,971038539,0,0,0,679.2,5,278989.2,26,2,8,7,True
6184627,953,4,25,6568,971038539,0,0,0,678.93,8,278310.27,13,4,5,7,True
6237462,953,4,451,2563,971038539,0,0,0,678.95,7,277631.32,13,1,22,8,True
6382434,1342,3,451,3462,971038539,0,0,0,678.86,7,276952.46,24,6,10,9,True
6613576,1342,3,25,6568,971038539,0,0,0,679.15,8,276273.31,24,6,17,9,True
6781817,514,4,25,7453,971038539,0,0,0,678.92,8,275594.39,12,3,20,9,True
7033295,866,0,10,7512,971038539,0,0,0,679.07,6,276273.46,24,4,4,9,True
7235942,441,4,451,8438,971038539,0,0,0,678.83,7,275594.63,24,3,16,9,True
7312546,441,4,451,6568,971038539,0,0,0,678.99,7,274915.64,24,1,22,10,False
7526688,103,3,30,2563,971038539,0,0,0,679.41,8,274236.23,3,4,1,11,True
7551558,1459,1,10,2563,971038539,0,0,0,679.06,6,274915.29,11,6,8,12,True
8054657,441,4,-1,6568,971038539,0,1,0,678.79,4,274915.29,24,0,8,12,True
8065468,1315,0,10,2173,971038539,0,0,0,679.03,6,275594.32,5,4,13,1,True
8112757,441,4,30,7910,971038539,0,0,0,679.0,8,274915.32,24,6,11,2,True
8126017,441,4,451,7444,971038539,0,0,0,678.82,7,274236.5,24,0,14,2,True
8549028,441,4,25,8438,971038539,0,0,0,678.93,8,273557.57,24,6,16,3,True
8645607,1205,0,20,8438,971038539,0,0,0,678.78,5,272878.79,24,6,12,4,True
8737909,502,0,20,7972,971038539,0,0,0,679.1,5,272199.69,12,1,4,5,True
9131154,441,4,25,3001,971038539,0,0,0,679.11,8,271520.58,24,4,19,6,True
9239124,1010,0,20,7910,971038539,0,0,0,679.03,5,270841.55,26,5,12,6,True
9241863,953,4,30,7453,971038539,0,0,0,679.13,8,270162.42,13,6,20,8,True
9421922,441,4,25,4205,971038539,0,0,0,679.07,8,269483.35,24,6,8,9,True
9423756,441,4,-1,7910,971038539,0,1,0,679.17,4,269483.35,24,5,4,9,True
9445464,441,4,25,1986,971038539,0,0,0,678.85,8,268804.5,24,5,7,9,True
9457751,953,4,-1,7453,971038539,0,1,0,678.91,4,268804.5,13,4,10,9,True
9513097,1342,3,451,7512,971038539,0,0,0,679.21,7,268125.29,24,2,5,11,True
9876414,319,0,20,7910,971038539,0,0,0,679.07,3,267446.22,11,0,7,11,True
1299688,403,0,25,9211,530354089,0,0,0,890.85,8,139456.15,10,0,6,1,True
1380908,403,0,-1,5318,530354089,0,1,0,890.71,4,139456.15,10,1,18,2,True
1410730,503,0,10,1684,530354089,0,0,0,890.78,6,140346.93,12,1,19,2,True
1428769,56,4,451,9211,530354089,0,0,0,891.14,7,139455.79,20,2,8,3,True
1505625,965,4,25,9897,530354089,0,0,0,890.92,8,138564.87,13,4,19,5,True
1513548,357,4,451,8428,530354089,0,0,0,890.74,7,137674.13,24,0,16,5,True
1770285,56,4,30,2991,530354089,0,0,0,890.95,8,136783.18,20,1,12,6,True
1797249,965,4,30,5203,530354089,0,0,0,890.92,8,135892.26,13,1,5,7,True
1800486,777,3,25,3919,530354089,0,0,0,890.93,8,135001.33,14,4,4,7,True
1815563,712,0,25,5318,530354089,0,0,0,890.94,8,134110.39,18,1,10,8,True
2040375,777,3,25,2435,530354089,0,0,0,890.87,8,133219.52,14,2,20,8,True
2345889,403,0,451,5318,530354089,0,0,0,891.2,7,132328.32,10,1,3,8,True
2881073,81,0,20,9211,530354089,0,0,0,891.19,3,131437.13,1,1,20,9,True
3272835,714,2,20,5203,530354089,0,0,0,890.96,5,130546.17,18,3,13,9,True
3318153,56,4,25,5203,530354089,0,0,0,890.86,8,129655.31,20,1,17,11,True
3618993,403,0,451,9897,530354089,0,0,0,891.02,7,128764.29,10,4,15,11,True
3623795,56,4,451,5318,530354089,0,0,0,890.73,7,127873.56,20,4,11,12,True
4126338,403,0,30,3845,530354089,0,0,0,891.22,8,126982.34,10,0,3,1,True
4260799,777,3,451,1684,530354089,0,0,0,891.14,7,126091.2,14,0,4,1,True
4534226,159,2,20,6548,530354089,0,0,0,891.01,5,125200.19,24,4,20,2,True
5000668,965,4,30,1340,530354089,0,0,0,891.0,8,124309.19,13,0,14,3,True
5083859,357,4,25,5318,530354089,0,0,0,891.09,8,123418.1,24,3,2,3,True
5274886,965,4,451,9897,530354089,0,0,0,891.35,7,122526.75,13,2,11,4,True
5518800,712,0,30,7332,530354089,0,0,0,890.86,8,121635.89,18,1,9,5,True
5565338,777,3,451,1340,530354089,0,0,0,890.75,7,120745.14,14,5,10,7,True
5570288,712,0,30,5318,530354089,0,0,0,891.21,8,119853.93,18,1,4,7,True
5629119,357,4,25,1340,530354089,0,0,0,891.18,8,118962.75,24,6,21,8,True
5769786,403,0,-1,4417,530354089,0,1,0,890.78,4,118962.75,10,0,10,8,True
5892802,777,3,30,9897,530354089,0,0,0,891.28,8,118071.47,14,3,5,9,True
6023818,357,4,451,9003,530354089,0,0,0,891.1,7,117180.37,24,0,12,10,True
6048159,234,0,20,4417,530354089,0,0,0,890.91,3,116289.46,26,6,18,11,True
6331958,56,4,451,6548,530354089,0,0,0,890.87,7,115398.59,20,0,5,11,True
6700001,712,0,451,2449,530354089,0,0,0,890.96,7,114507.63,18,0,8,12,True
6712344,777,3,25,7631,530354089,0,0,0,890.81,8,113616.82,14,6,3,12,True
6752449,168,0,20,7332,530354089,0,0,0,890.91,3,112725.91,24,5,21,4,True
6807037,403,0,451,9003,530354089,0,0,0,891.04,7,111834.87,10,2,5,5,True
6869210,357,4,25,9211,530354089,0,0,0,891.08,8,110943.79,24,6,15,6,True
6888977,991,1,10,2449,530354089,0,0,0,891.22,6,111835.01,22,0,10,6,True
7056507,705,1,10,9211,530354089,0,0,0,891.03,6,112726.04,18,4,5,7,False
7103134,712,0,451,7332,530354089,0,0,0,890.92,7,111835.12,18,4,9,7,True
7202614,56,4,25,9003,530354089,0,0,0,891.21,8,110943.91,20,0,3,8,True
7218915,205,0,20,6548,530354089,0,0,0,890.91,5,110053.0,9,3,23,8,True
7608852,56,4,451,9897,530354089,0,0,0,891.11,7,109161.89,20,2,1,8,True
7690579,777,3,25,8499,530354089,0,0,0,890.87,8,108271.02,14,4,15,8,True
7707179,403,0,30,8428,530354089,0,0,0,891.09,8,107379.93,10,0,23,9,True
7752368,777,3,451,8428,530354089,0,0,0,890.8,7,106489.13,14,3,20,10,True
8514827,438,1,10,7631,530354089,0,0,0,890.86,6,107379.99,24,6,2,10,True
8609969,965,4,-1,5318,530354089,0,1,0,890.9,4,107379.99,13,3,3,11,True
9133091,56,4,25,5318,530354089,0,0,0,890.79,8,106489.2,20,1,9,11,True
9483754,777,3,-1,3919,530354089,0,1,0,891.16,1,106489.2,14,5,3,11,True
9624902,56,4,25,8428,530354089,0,0,0,891.04,8,105598.16,20,0,20,11,True
9686069,777,3,25,2991,530354089,0,0,0,891.01,8,104707.15,14,1,0,11,True
9748834,965,4,25,2522,530354089,0,0,0,890.79,8,103816.36,13,2,9,11,True
1062313,1070,4,30,3817,385881305,1,0,0,723.95,8,199121.05,18,2,23,1,True
1272133,1070,4,451,3641,385881305,1,0,0,724.26,7,198396.79,18,0,6,2,True
1505491,1093,0,-1,6882,385881305,1,1,0,723.79,4,198396.79,18,1,9,2,True
1565124,132,2,20,2638,385881305,1,0,0,724.24,5,197672.55,18,4,20,2,True
1662815,64,0,25,5148,385881305,1,0,0,723.97,8,196948.58,20,2,14,3,True
1676489,794,2,25,9952,385881305,1,0,0,724.31,8,196224.27,11,0,3,3,True
1839990,777,3,-1,9240,385881305,1,1,0,724.06,4,196224.27,14,3,2,3,False
2095409,29,0,20,8095,385881305,1,0,0,724.11,5,195500.16,11,3,11,3,True
2620172,794,2,30,8095,385881305,1,0,0,724.18,8,194775.98,11,1,0,4,True
2691455,794,2,25,6882,385881305,1,0,0,724.06,8,194051.92,11,1,22,4,True
2718641,81,0,-1,8276,385881305,1,1,0,723.91,1,194051.92,1,5,5,5,True
2804041,580,0,20,6169,385881305,1,0,0,723.85,3,193328.07,11,2,6,5,True
3303210,1093,0,25,2827,385881305,1,0,0,724.21,8,192603.86,18,0,15,6,True
3386968,64,0,451,9952,385881305,1,0,0,723.53,7,191880.33,20,0,1,7,True
3736331,777,3,30,3641,385881305,1,0,0,723.73,8,191156.6,14,5,16,7,True
4136788,794,2,30,3540,385881305,1,0,0,723.55,8,190433.05,11,1,12,8,True
4216807,794,2,25,7784,385881305,1,0,0,724.21,8,189708.84,11,2,18,8,True
4287742,1070,4,30,9952,385881305,1,0,0,724.18,8,188984.66,18,3,21,8,True
4321809,1070,4,451,9952,385881305,1,0,0,723.87,7,188260.79,18,1,22,8,True
4659472,777,3,451,1886,385881305,1,0,0,724.12,7,187536.67,14,0,3,9,True
4780730,916,0,20,6169,385881305,1,0,0,723.73,5,186812.94,18,3,1,9,True
4870398,1070,4,25,9094,385881305,1,0,0,724.21,8,186088.73,18,0,15,10,True
4949466,147,0,10,9952,385881305,1,0,0,723.89,6,186812.62,18,2,18,10,True
4999316,1039,1,10,8095,385881305,1,0,0,724.2,0,187536.82,11,0,22,1,True
5044871,794,2,-1,2827,385881305,1,1,0,724.07,4,187536.82,11,5,11,1,True
5058571,1093,0,451,1886,385881305,1,0,0,723.94,7,186812.88,18,2,9,2,True
5288292,777,3,30,7896,385881305,1,0,0,724.01,8,186088.87,14,2,7,2,True
5460666,777,3,-1,8179,385881305,1,1,0,724.35,4,186088.87,14,4,6,3,True
5604093,303,0,20,7896,385881305,1,0,0,724.01,3,185364.86,4,6,6,4,True
5626244,664,2,20,4302,385881305,1,0,0,724.12,5,184640.74,18,5,5,4,True
5891097,794,2,30,2638,385881305,1,0,0,723.82,8,183916.92,11,6,11,4,True
5909061,794,2,-1,9952,385881305,1,1,0,724.29,4,183916.92,11,3,7,5,True
5976638,1093,0,30,2827,385881305,1,0,0,724.12,8,183192.8,18,5,20,5,True
6509632,64,0,-1,8179,385881305,1,1,0,723.77,4,183192.8,20,0,6,5,True
6519617,81,0,451,6169,385881305,1,0,0,723.79,7,182469.01,1,4,13,6,True
6687351,866,0,20,9270,385881305,1,0,0,724.08,3,181744.93,24,2,7,7,False
6882227,777,3,-1,6585,385881305,1,1,0,724.01,4,181744.93,14,4,17,8,True
6905365,1063,0,20,2827,385881305,1,0,0,724.35,5,181020.58,11,0,14,8,True
7011228,1070,4,30,7896,385881305,1,0,0,724.03,8,180296.55,18,5,9,8,True
7391406,1093,0,451,7818,385881305,1,0,0,724.12,7,179572.43,18,4,14,9,True
7597515,64,0,451,8276,385881305,1,0,0,724.05,7,178848.38,20,2,14,10,True
7723490,777,3,451,9291,385881305,1,0,0,724.01,7,178124.37,14,1,7,1,True
7765586,64,0,451,1886,385881305,1,0,0,723.64,7,177400.73,20,4,0,2,True
7874971,777,3,-1,4994,385881305,1,1,0,724.3,4,177400.73,14,2,13,3,True
7877886,794,2,451,8179,385881305,1,0,0,724.34,7,176676.39,11,4,12,4,True
7969558,81,0,451,8276,385881305,1,0,0,724.2,7,175952.19,1,1,22,6,True
8291682,1019,0,20,2638,385881305,1,0,0,724.29,5,175227.9,26,5,2,6,True
8332534,1272,0,20,9291,385881305,1,0,0,724.02,3,174503.88,24,5,10,6,True
8486815,81,0,30,2087,385881305,1,0,0,724.22,8,173779.66,1,3,9,6,True
8650302,1264,0,10,2087,385881305,1,0,0,724.07,6,174503.73,23,1,0,7,True
8764666,64,0,-1,7818,385881305,1,1,0,723.86,1,174503.73,20,4,8,8,True
8868256,81,0,-1,1886,385881305,1,2,0,723.94,1,174503.73,1,3,2,9,True
9057486,1093,0,451,3641,385881305,1,0,0,724.19,7,173779.54,18,4,5,9,True
9183791,662,1,10,8179,385881305,1,0,0,724.29,0,174503.83,18,0,5,9,True
9297130,777,3,451,3817,385881305,1,0,0,724.1,7,173779.73,14,1,0,9,True
9418722,794,2,30,5439,385881305,1,0,0,724.03,8,173055.7,11,0,12,10,True
9677800,64,0,-1,9240,385881305,1,1,0,723.84,4,173055.7,20,5,20,11,True
1039380,360,0,451,9048,188529373,0,0,0,392.23,7,849865.77,24,0,11,1,True
1350685,1012,0,20,5049,188529373,0,0,0,392.11,3,849473.66,26,0,14,1,True
1451890,360,0,30,5049,188529373,0,0,0,391.85,8,849081.81,24,1,10,2,True
1595046,826,1,30,1839,188529373,0,0,0,392.05,8,848689.76,18,4,1,2,True
1675538,689,0,20,5049,188529373,0,0,0,391.57,3,848298.19,24,2,18,3,True
1749563,358,4,451,5049,188529373,0,0,0,391.92,7,847906.27,24,4,7,3,True
1770359,826,1,25,9048,188529373,0,0,0,391.92,8,847514.35,18,6,18,3,True
1813387,1166,2,20,4566,188529373,0,0,0,391.88,5,847122.47,24,1,22,5,True
1838177,360,0,451,3838,188529373,0,0,0,392.36,7,846730.11,24,1,1,5,False
1851739,360,0,30,1782,188529373,0,0,0,392.01,8,846338.1,24,6,19,6,True
2111613,825,2,25,3662,188529373,0,0,0,392.08,8,845946.02,18,0,22,7,True
2337599,143,4,30,9582,188529373,0,0,0,392.19,8,845553.83,18,4,18,7,True
2434918,360,0,25,9582,188529373,0,0,0,392.02,8,845161.81,24,4,6,8,True
2546011,825,2,30,9605,188529373,0,0,0,391.85,8,844769.96,18,0,6,9,True
2873434,143,4,25,5250,188529373,0,0,0,391.96,8,844378.0,18,5,21,9,True
3025298,360,0,25,3662,188529373,0,0,0,391.94,8,843986.06,24,0,10,11,True
3283054,551,0,20,1782,188529373,0,0,0,392.0,5,843594.06,17,1,18,11,True
3426908,143,4,451,3838,188529373,0,0,0,391.76,7,843202.3,18,2,0,11,True
3546567,1009,0,20,3959,188529373,0,0,0,392.0,3,842810.3,26,4,2,11,True
3619885,358,4,25,5049,188529373,0,0,0,392.19,8,842418.11,24,6,10,12,True
3702353,1210,0,10,1839,188529373,0,0,0,392.09,6,842810.2,24,1,4,1,True
4107602,1298,0,20,1380,188529373,0,0,0,391.99,5,842418.21,5,1,23,2,True
4181755,610,0,20,9048,188529373,0,0,0,392.09,3,842026.12,11,1,12,3,False
4229329,143,4,451,3959,188529373,0,0,0,392.15,7,841633.97,18,1,13,3,True
4562907,360,0,30,3662,188529373,0,0,0,391.98,8,841241.99,24,6,22,3,True
4641003,358,4,451,4566,188529373,0,0,0,392.04,7,840849.95,24,2,7,4,True
4665163,826,1,30,1839,188529373,0,0,0,392.08,8,840457.87,18,0,12,4,True
4747922,360,0,25,4566,188529373,0,0,0,391.91,8,840065.96,24,5,10,5,True
5017296,143,4,25,4566,188529373,0,0,0,392.01,8,839673.95,18,0,6,5,True
5034794,143,4,30,9048,188529373,0,0,0,391.89,8,839282.06,18,0,6,6,True
5222955,825,2,451,1839,188529373,0,0,0,391.9,7,838890.16,18,6,21,7,True
5489005,1210,0,10,6635,188529373,0,0,0,391.85,0,839282.01,24,1,13,7,True
5909272,826,1,-1,6635,188529373,0,1,0,392.14,1,839282.01,18,5,5,7,True
5947631,1380,0,20,1782,188529373,0,0,0,392.04,5,838889.97,16,4,16,7,True
6074062,348,0,20,1380,188529373,0,0,0,392.02,5,838497.95,24,3,16,9,True
6303483,825,2,451,8927,188529373,0,0,0,392.04,7,838105.91,18,5,17,9,True
6596356,826,1,25,6635,188529373,0,0,0,392.02,8,837713.89,18,0,15,10,True
6722606,1072,0,20,2766,188529373,0,0,0,391.97,5,837321.92,18,1,0,10,True
6933681,360,0,451,9605,188529373,0,0,0,391.98,7,836929.94,24,3,0,10,True
6939091,826,1,451,9048,188529373,0,0,0,391.82,7,836538.12,18,0,22,12,True
7272211,825,2,451,6635,188529373,0,0,0,391.88,7,836146.24,18,1,4,1,True
7343403,358,4,451,3959,188529373,0,0,0,391.81,7,835754.43,24,1,7,1,True
7487734,143,4,30,3959,188529373,0,0,0,392.13,8,835362.3,18,0,22,1,True
7652875,1260,0,20,1722,188529373,0,0,0,392.0,5,834970.3,23,1,21,1,True
7677155,825,2,25,5049,188529373,0,0,0,392.03,8,834578.27,18,2,6,1,True
8014198,824,2,20,1839,188529373,0,0,0,392.14,5,834186.13,18,2,6,3,True
8069740,348,0,10,1839,188529373,0,0,0,392.27,0,834578.4,24,5,0,3,True
8214147,128,0,10,8927,188529373,0,0,0,391.93,6,834970.33,18,6,13,4,True
8222588,826,1,25,1782,188529373,0,0,0,391.93,8,834578.4,18,4,12,4,True
8376704,696,2,20,3959,188529373,0,0,0,392.01,3,834186.39,24,0,0,4,True
8482145,825,2,30,6635,188529373,0,0,0,392.28,8,833794.11,18,2,14,7,True
8761105,824,2,20,5250,188529373,0,0,0,391.82,3,833402.29,18,0,0,8,True
9184766,143,4,30,9582,188529373,0,0,0,392.03,8,833010.26,18,5,17,8,True
9241296,826,1,30,8927,188529373,0,0,0,391.8,8,832618.46,18,4,20,9,True
9743718,360,0,-1,9048,188529373,0,1,0,391.95,4,832618.46,24,3,4,10,True
9774045,358,4,451,1782,188529373,0,0,0,392.14,7,832226.32,24,2,10,11,True
9850270,826,1,451,8927,188529373,0,0,0,392.13,7,831834.19,18,0,14,11,True
9888280,956,1,10,3838,188529373,0,0,0,391.83,6,832226.02,13,1,17,11,True
9945254,143,4,-1,8927,188529373,0,1,0,392.19,4,832226.02,18,4,23,11,True
1171511,1377,0,451,8042,255630552,0,0,0,971.2,7,888083.8,16,1,15,1,True
1309578,1072,0,30,9340,255630552,0,0,0,970.87,8,887112.93,18,3,1,4,True
1355368,328,0,25,9749,255630552,0,0,0,971.0,8,886141.93,11,2,7,4,True
1460970,371,3,30,9340,255630552,0,0,0,971.08,8,885170.85,25,6,12,4,True
1856357,1072,0,-1,9340,255630552,0,1,0,970.8,4,885170.85,18,0,0,4,True
2068750,1140,0,-1,7934,255630552,0,2,0,970.88,4,885170.85,15,4,17,5,True
2181919,1140,0,25,7313,255630552,0,0,0,970.96,8,884199.89,15,5,15,5,True
2194466,1377,0,451,5804,255630552,0,0,0,971.04,7,883228.85,16,2,4,6,True
2336038,411,2,20,7934,255630552,0,0,0,971.04,3,882257.81,18,2,16,7,True
2616511,866,0,10,3256,255630552,0,0,0,970.85,0,883228.66,24,1,14,8,True
3027029,1140,0,25,4769,255630552,0,0,0,970.94,8,882257.72,15,2,14,9,False
3229548,1278,0,10,5129,255630552,0,0,0,970.88,6,883228.6,24,0,14,10,True
3337840,1072,0,451,7313,255630552,0,0,0,970.95,7,882257.65,18,2,7,10,True
3419136,645,0,20,4769,255630552,0,0,0,971.23,5,881286.42,24,6,15,11,True
3621023,952,0,10,5804,255630552,0,0,0,971.0,0,882257.42,13,6,17,11,True
3899810,328,0,451,8042,255630552,0,0,0,971.09,7,881286.33,11,1,10,11,True
4246148,1124,0,20,5326,255630552,0,0,0,971.09,5,880315.24,24,6,23,12,True
4778953,328,0,30,5345,255630552,0,0,0,971.26,8,879343.98,11,2,14,2,True
4857757,1140,0,30,7313,255630552,0,0,0,970.95,8,878373.03,15,2,19,2,True
5273153,539,4,30,8324,255630552,0,0,0,971.11,8,877401.92,18,0,11,2,True
5484872,630,0,10,8649,255630552,0,0,0,971.0,6,878372.92,11,3,21,3,False
5533479,1112,1,10,3256,255630552,0,0,0,970.67,6,879343.59,0,1,15,3,True
5575829,539,4,451,3767,255630552,0,0,0,970.8,7,878372.79,18,1,1,6,True
6026531,328,0,25,8999,255630552,0,0,0,971.26,8,877401.53,11,2,12,7,True
6096250,1140,0,30,8324,255630552,0,0,0,971.22,8,876430.31,15,1,4,8,False
6292175,1380,0,10,3256,255630552,0,0,0,971.34,6,877401.65,16,5,12,8,True
6394692,1140,0,-1,4769,255630552,0,1,0,971.05,4,877401.65,15,5,11,9,True
6907074,1377,0,30,3674,255630552,0,0,0,971.12,8,876430.53,16,5,23,10,True
7011120,371,3,451,3767,255630552,0,0,0,971.09,7,875459.44,25,1,22,10,True
7125115,1140,0,-1,9361,255630552,0,1,0,971.15,1,875459.44,15,3,18,10,True
7165857,1072,0,25,3674,255630552,0,0,0,970.87,8,874488.57,18,6,1,11,True
7170363,328,0,25,7571,255630552,0,0,0,971.17,8,873517.4,11,2,4,12,True
7257802,819,2,20,2427,255630552,0,0,0,971.05,3,872546.35,18,2,19,12,True
7259940,328,0,451,9749,255630552,0,0,0,971.12,7,871575.23,11,3,19,12,True
7299022,1072,0,451,8842,255630552,0,0,0,970.81,7,870604.42,18,4,22,2,True
7349964,1140,0,-1,5057,255630552,0,1,0,970.81,4,870604.42,15,2,2,2,True
7435553,688,0,20,5345,255630552,0,0,0,970.86,5,869633.56,24,5,22,2,True
7460856,594,0,20,4870,255630552,0,0,0,971.02,3,868662.54,24,6,4,2,True
7484388,328,0,-1,7313,255630552,0,1,0,971.06,4,868662.54,11,4,4,3,True
7488777,371,3,-1,2427,255630552,0,2,0,971.03,4,868662.54,25,4,0,4,True
7659090,328,0,25,7942,255630552,0,0,0,970.82,8,867691.72,11,2,11,5,True
7660753,1377,0,451,9116,255630552,0,0,0,970.88,7,866720.84,16,3,3,5,True
7875198,1072,0,30,7942,255630552,0,0,0,971.04,8,865749.8,18,2,22,5,True
7886717,1377,0,451,9749,255630552,0,0,0,971.21,7,864778.59,16,3,3,6,True
7951649,1140,0,451,9361,255630552,0,0,0,970.93,7,863807.66,15,6,10,6,True
7975369,328,0,-1,6460,255630552,0,1,0,970.83,4,863807.66,11,6,1,7,True
8400010,328,0,30,7571,255630552,0,0,0,971.06,8,862836.6,11,6,13,7,True
8542361,328,0,30,3674,255630552,0,0,0,971.08,8,861865.52,11,6,4,8,True
8597712,1212,0,10,5057,255630552,0,0,0,970.95,6,862836.47,24,5,8,8,True
8693436,1072,0,-1,8649,255630552,0,1,0,971.13,4,862836.47,18,5,8,9,True
8738672,68,0,20,7571,255630552,0,0,0,970.99,3,861865.48,20,6,7,9,True
9350078,1321,0,10,4870,255630552,0,0,0,971.04,6,862836.52,18,0,22,9,True
9525664,539,4,451,9361,255630552,0,0,0,971.2,7,861865.32,18,3,12,11,True
9697473,539,4,451,3767,255630552,0,0,0,971.15,7,860894.17,18,6,15,11,True
9830592,1072,0,-1,7934,255630552,0,1,0,971.12,1,860894.17,18,3,17,11,True
1149351,168,0,25,7689,687312210,1,0,0,596.02,8,560726.98,24,5,6,1,True
1248649,808,3,25,1961,687312210,1,0,0,595.97,8,560131.01,11,3,9,1,False
1250029,518,2,25,3553,687312210,1,0,0,596.12,8,559534.89,18,0,5,1,True
1363811,1044,0,20,2955,687312210,1,0,0,596.06,5,558938.83,11,5,1,2,True
1576911,1095,4,451,5834,687312210,1,0,0,596.17,7,558342.66,0,3,14,3,True
1789345,808,3,25,9908,687312210,1,0,0,596.12,8,557746.54,11,5,13,3,False
1966623,518,2,30,7689,687312210,1,0,0,596.2,8,557150.34,18,6,20,3,True
2206416,1270,1,10,2955,687312210,1,0,0,595.91,0,557746.25,23,2,10,3,True
2304356,1095,4,-1,6629,687312210,1,1,0,596.13,1,557746.25,0,6,8,4,True
2318426,592,4,25,9228,687312210,1,0,0,596.01,8,557150.24,24,3,13,5,True
2357042,518,2,451,1183,687312210,1,0,0,595.99,7,556554.25,18,2,3,6,True
2711351,937,0,10,2845,687312210,1,0,0,595.87,6,557150.12,24,4,5,7,True
2795161,1212,0,10,9034,687312210,1,0,0,596.05,6,557746.17,24,0,0,9,True
2921884,1419,1,25,6384,687312210,1,0,0,595.74,8,557150.43,24,2,9,10,True
2993110,592,4,-1,9228,687312210,1,1,0,596.03,1,557150.43,24,0,17,11,True
3100921,652,0,451,1722,687312210,1,0,0,595.93,7,556554.5,24,0,21,12,True
3460395,76,0,20,7762,687312210,1,0,0,595.84,5,555958.66,20,6,1,1,True
3612850,1419,1,-1,4165,687312210,1,1,0,595.98,4,555958.66,24,6,16,1,True
3975377,1363,0,20,9034,687312210,1,0,0,596.04,5,555362.62,16,2,0,2,True
4010784,1095,4,25,1183,687312210,1,0,0,595.96,8,554766.66,0,0,16,3,True
4232315,1382,0,20,1961,687312210,1,0,0,596.09,5,554170.57,16,5,4,4,True
4289457,168,0,-1,2593,687312210,1,1,0,596.04,4,554170.57,24,5,10,4,True
4619412,1095,4,25,3174,687312210,1,0,0,596.06,8,553574.51,0,6,22,4,True
4896969,584,0,10,2955,687312210,1,0,0,595.86,6,554170.37,11,3,21,4,True
4963772,1419,1,30,8705,687312210,1,0,0,596.13,8,553574.24,24,2,12,5,True
5077573,1095,4,30,3174,687312210,1,0,0,596.04,8,552978.2,0,4,2,5,True
5132381,168,0,-1,3174,687312210,1,1,0,596.2,1,552978.2,24,0,8,5,True
5320357,808,3,451,7689,687312210,1,0,0,595.97,7,552382.23,11,4,15,6,True
6133994,1483,0,30,4165,687312210,1,0,0,596.0,8,551786.23,24,4,5,8,True
6134477,1095,4,451,9908,687312210,1,0,0,595.85,7,551190.38,0,6,18,8,True
6188361,882,0,20,7835,687312210,1,0,0,596.08,3,550594.3,27,1,19,8,True
6237168,592,4,-1,9034,687312210,1,1,0,596.15,4,550594.3,24,5,7,9,True
6332001,1095,4,451,7415,687312210,1,0,0,596.06,7,549998.24,0,3,10,9,True
6343393,652,0,-1,3553,687312210,1,1,0,595.92,4,549998.24,24,6,22,11,True
6689862,463,1,10,8705,687312210,1,0,0,595.73,0,550593.97,13,6,1,12,True
6873453,168,0,25,7034,687312210,1,0,0,595.83,8,549998.14,24,5,14,12,True
6971115,652,0,25,3174,687312210,1,0,0,596.06,8,549402.08,24,0,11,12,True
7031861,580,0,10,7034,687312210,1,0,0,596.08,6,549998.16,11,5,10,12,True
7146438,168,0,451,7415,687312210,1,0,0,596.15,7,549402.01,24,2,0,1,True
7367057,1483,0,-1,1722,687312210,1,1,0,596.29,4,549402.01,24,6,21,1,True
7539649,738,2,20,1961,687312210,1,0,0,595.85,5,548806.16,11,5,22,1,True
7810447,1095,4,-1,8360,687312210,1,1,0,596.12,1,548806.16,0,2,21,1,True
8028699,1483,0,451,7835,687312210,1,0,0,595.79,7,548210.37,24,4,1,2,True
8134562,1419,1,30,4165,687312210,1,0,0,595.93,8,547614.44,24,3,17,2,True
8206588,1030,4,30,8705,687312210,1,0,0,596.07,8,547018.37,11,4,7,2,True
8334492,1030,4,451,2593,687312210,1,0,0,596.02,7,546422.35,11,2,22,2,True
8416282,518,2,25,8360,687312210,1,0,0,595.74,8,545826.61,18,0,5,5,True
8943241,1030,4,451,5834,687312210,1,0,0,595.97,7,545230.64,11,2,19,5,True
9122535,652,0,30,3553,687312210,1,0,0,595.87,8,544634.77,24,3,9,6,True
9230232,518,2,25,2845,687312210,1,0,0,596.06,8,544038.71,18,6,10,7,True
9326607,592,4,451,6384,687312210,1,0,0,595.78,7,543442.93,24,4,16,8,True
9438743,1007,2,20,7415,687312210,1,0,0,595.96,5,542846.97,26,4,2,10,True
9477540,652,0,451,6313,687312210,1,0,0,596.0,7,542250.97,24,2,1,10,True
9520117,1095,4,25,9228,687312210,1,0,0,595.88,8,541655.09,0,6,17,11,True
9559226,592,4,451,7835,687312210,1,0,0,595.98,7,541059.11,24,5,19,11,True
9768967,518,2,30,1722,687312210,1,0,0,595.96,8,540463.15,18,5,15,11,True
1003291,443,2,25,4414,724006352,1,0,0,678.94,8,543496.06,24,0,4,1,True
1041565,443,2,30,4030,724006352,1,0,0,679.33,8,542816.73,24,5,10,1,True
1145245,135,2,25,6272,724006352,1,0,0,679.08,8,542137.65,18,3,15,2,True
1484017,137,2,20,5308,724006352,1,0,0,679.04,3,541458.61,18,3,20,2,True
1601388,792,1,10,8876,724006352,1,0,0,679.08,6,542137.69,11,5,20,2,True
1752953,215,0,20,2428,724006352,1,0,0,679.09,5,541458.6,9,3,10,3,True
1788531,470,1,-1,3985,724006352,1,1,0,678.92,4,541458.6,5,1,8,3,False
1904549,443,2,451,4404,724006352,1,0,0,679.17,7,540779.43,24,5,5,3,True
2250166,349,2,30,3985,724006352,1,0,0,679.08,8,540100.35,24,5,19,3,True
2571456,349,2,-1,5350,724006352,1,1,0,679.3,4,540100.35,24,1,5,3,True
2683445,349,2,451,1670,724006352,1,0,0,678.89,7,539421.46,24,0,7,5,True
2759757,1160,0,20,5386,724006352,1,0,0,678.86,5,538742.6,15,0,14,5,True
3081718,443,2,-1,9705,724006352,1,1,0,679.07,1,538742.6,24,2,22,6,True
3163689,470,1,451,5205,724006352,1,0,0,678.93,7,538063.67,5,3,7,6,True
3256952,470,1,25,8876,724006352,1,0,0,679.06,8,537384.61,5,5,5,6,True
3290609,349,2,451,4030,724006352,1,0,0,679.0,7,536705.61,24,0,0,6,True
3396319,443,2,-1,2935,724006352,1,1,0,679.15,1,536705.61,24,3,19,8,True
3409108,443,2,451,3507,724006352,1,0,0,679.02,7,536026.59,24,6,4,9,True
3457034,850,1,451,4414,724006352,1,0,0,678.83,7,535347.76,5,1,18,9,True
3608482,135,2,-1,4414,724006352,1,1,0,678.81,4,535347.76,18,4,22,9,True
3861499,470,1,30,5350,724006352,1,0,0,679.02,8,534668.74,5,3,15,9,True
3924703,470,1,25,1723,724006352,1,0,0,678.92,8,533989.82,5,1,7,11,True
3976586,329,1,10,5308,724006352,1,0,0,678.98,6,534668.8,11,5,0,11,True
4239434,135,2,25,2428,724006352,1,0,0,678.83,8,533989.97,18,2,10,12,True
4421460,470,1,451,5823,724006352,1,0,0,679.08,7,533310.89,5,6,17,1,True
5035013,470,1,451,2195,724006352,1,0,0,678.78,7,532632.11,5,1,1,1,True
5144821,135,2,30,2325,724006352,1,0,0,679.05,8,531953.06,18,2,9,2,True
5282577,1471,0,10,4030,724006352,1,0,0,679.17,6,532632.23,24,6,14,2,True
5412975,30,4,451,5386,724006352,1,0,0,678.93,7,531953.3,11,4,15,2,True
5841612,443,2,451,6272,724006352,1,0,0,679.0,7,531274.3,24,4,22,4,True
5895740,199,0,20,3628,724006352,1,0,0,678.75,5,530595.55,18,1,2,4,True
5961120,1449,0,20,4414,724006352,1,0,0,679.03,5,529916.52,11,0,15,5,True
6035935,443,2,-1,3507,724006352,1,1,0,678.86,1,529916.52,24,2,18,5,True
6253814,135,2,451,1723,724006352,1,0,0,678.96,7,529237.56,18,0,23,7,True
6404817,443,2,451,7055,724006352,1,0,0,679.2,7,528558.36,24,5,5,7,True
6429774,850,1,-1,7055,724006352,1,1,0,678.98,4,528558.36,5,0,18,8,True
6497609,135,2,25,5386,724006352,1,0,0,678.97,8,527879.39,18,5,5,10,True
6524524,30,4,451,3628,724006352,1,0,0,678.84,7,527200.55,11,6,22,10,True
6565476,276,0,20,7055,724006352,1,0,0,678.93,5,526521.62,24,1,10,11,True
6746969,349,2,451,2195,724006352,1,0,0,679.03,7,525842.59,24,6,11,11,True
6943130,30,4,-1,3628,724006352,1,1,0,678.89,4,525842.59,11,6,4,12,True
7151199,349,2,30,1723,724006352,1,0,0,679.07,8,525163.52,24,1,15,12,True
7226650,135,2,30,4545,724006352,1,0,0,679.19,8,524484.33,18,0,4,1,True
7355148,325,0,10,5350,724006352,1,0,0,678.81,0,525163.14,11,5,7,1,True
7709037,1260,0,10,8876,724006352,1,0,0,679.05,6,525842.19,23,2,4,1,True
7736759,1243,2,30,8606,724006352,1,0,0,678.78,8,525163.41,18,3,5,2,True
7779058,1401,1,10,8606,724006352,1,0,0,678.73,6,525842.14,24,5,18,3,True
8136603,342,0,20,5350,724006352,1,0,0,679.36,3,525162.78,24,2,14,4,True
8407717,349,2,451,5205,724006352,1,0,0,679.17,7,524483.61,24,2,18,5,True
8510153,850,1,30,4179,724006352,1,0,0,679.16,8,523804.45,5,3,20,5,True
8596210,135,2,451,6794,724006352,1,0,0,678.96,7,523125.49,18,2,1,5,True
9173866,470,1,451,2935,724006352,1,0,0,678.98,7,522446.51,5,0,7,6,True
9243248,349,2,451,1670,724006352,1,0,0,678.89,7,521767.62,24,6,22,7,True
9352498,443,2,451,2935,724006352,1,0,0,679.0,7,521088.62,24,6,15,7,True
9404611,135,2,-1,5823,724006352,1,1,0,678.92,4,521088.62,18,3,9,7,True
9475197,1243,2,-1,5205,724006352,1,2,0,678.86,4,521088.62,18,6,19,8,True
9606241,854,0,20,3985,724006352,1,0,0,679.16,5,520409.46,24,4,11,8,True
9768827,443,2,30,1310,724006352,1,0,0,678.98,8,519730.48,24,5,15,10,True
9943607,30,4,451,2325,724006352,1,0,0,679.03,7,519051.45,11,0,20,10,True
1164341,239,1,451,9793,317973552,1,0,0,1023.23,7,362129.77,26,6,0,1,True
1245499,553,1,451,5774,317973552,1,0,0,1022.89,7,361106.88,17,5,22,2,True
1498779,553,1,30,4935,317973552,1,0,0,1022.78,8,360084.1,17,1,16,2,True
1550831,553,1,25,1945,317973552,1,0,0,1022.83,8,359061.27,17,6,21,2,True
1563518,318,0,10,4498,317973552,1,0,0,1023.27,0,360084.54,11,1,16,3,True
1567861,75,3,30,1411,317973552,1,0,0,1022.91,8,359061.63,20,4,20,3,True
1640321,553,1,25,8643,317973552,1,0,0,1022.78,8,358038.85,17,5,0,3,True
1917448,1041,0,-1,8698,317973552,1,1,0,1022.79,1,358038.85,11,3,23,3,True
1925685,653,1,451,4935,317973552,1,0,0,1023.2,7,357015.65,24,5,5,3,True
2126304,553,1,451,1466,317973552,1,0,0,1022.79,7,355992.86,17,1,15,5,True
2430024,1124,0,10,1945,317973552,1,0,0,1023.29,6,357016.15,24,6,21,5,True
2484120,365,0,20,1254,317973552,1,0,0,1023.01,3,355993.14,25,0,17,5,True
3247045,485,1,10,8643,317973552,1,0,0,1022.95,6,357016.09,5,0,18,8,True
3568926,159,2,451,9239,317973552,1,0,0,1022.71,7,355993.38,24,5,7,8,True
3624381,239,1,25,5774,317973552,1,0,0,1023.0,8,354970.38,26,0,10,10,False
3815080,653,1,451,1254,317973552,1,0,0,1023.13,7,353947.25,24,4,17,11,True
4022068,239,1,-1,5774,317973552,1,1,0,1022.59,4,353947.25,26,5,16,11,False
4052113,75,3,451,8643,317973552,1,0,0,1022.77,7,352924.48,20,5,16,1,True
4172073,653,1,25,9239,317973552,1,0,0,1022.89,8,351901.59,24,6,12,2,True
4356594,239,1,30,3360,317973552,1,0,0,1023.12,8,350878.47,26,3,8,2,True
4385060,1041,0,-1,9239,317973552,1,1,0,1022.95,1,350878.47,11,2,5,3,True
4516789,759,0,10,9793,317973552,1,0,0,1023.09,6,351901.56,24,4,17,3,True
4595442,1471,0,10,9226,317973552,1,0,0,1023.0,0,352924.56,24,2,8,5,True
5492870,553,1,451,1945,317973552,1,0,0,1023.09,7,351901.47,17,6,4,5,True
5695455,1041,0,-1,5809,317973552,1,1,0,1023.35,1,351901.47,11,6,14,5,True
5806488,929,0,20,8602,317973552,1,0,0,1022.74,5,350878.73,18,1,8,5,False
5829351,159,2,25,6644,317973552,1,0,0,1022.87,8,349855.86,24,0,3,7,True
5901026,159,2,30,3806,317973552,1,0,0,1023.03,8,348832.83,24,2,6,8,True
6210658,159,2,30,1254,317973552,1,0,0,1023.11,8,347809.72,24,2,13,8,True
6329740,1239,1,10,8016,317973552,1,0,0,1023.04,0,348832.76,18,0,5,8,True
6610497,239,1,451,1466,317973552,1,0,0,1022.94,7,347809.82,26,0,20,9,True
6621332,553,1,451,7058,317973552,1,0,0,1023.12,7,346786.7,17,4,20,9,True
6777309,239,1,451,8643,317973552,1,0,0,1023.2,7,345763.5,26,0,21,10,True
6783885,159,2,-1,3326,317973552,1,1,0,1023.09,1,345763.5,24,5,6,10,True
7044112,464,1,-1,6644,317973552,1,2,0,1022.85,1,345763.5,13,4,11,11,True
7047823,1272,0,20,5774,317973552,1,0,0,1023.08,5,344740.42,24,1,21,11,True
7127070,239,1,-1,1411,317973552,1,1,0,1023.18,1,344740.42,26,3,19,11,True
7346153,159,2,25,2955,317973552,1,0,0,1022.76,8,343717.66,24,5,16,12,True
7784804,1192,2,20,9793,317973552,1,0,0,1022.96,5,342694.7,24,4,15,1,True
7839240,75,3,451,8643,317973552,1,0,0,1023.16,7,341671.54,20,3,2,4,True
7965316,239,1,451,4498,317973552,1,0,0,1023.04,7,340648.5,26,5,13,4,True
7992525,160,0,10,1905,317973552,1,0,0,1023.02,6,341671.52,24,5,19,6,True
8061434,464,1,-1,8016,317973552,1,1,0,1023.08,1,341671.52,13,2,20,7,True
8189016,1455,2,20,2178,317973552,1,0,0,1023.07,5,340648.45,11,3,9,7,True
8570428,553,1,451,3806,317973552,1,0,0,1022.82,7,339625.63,17,0,6,7,True
8667874,159,2,25,8643,317973552,1,0,0,1022.8,8,338602.83,24,6,19,7,True
8756522,464,1,-1,4498,317973552,1,1,0,1022.77,4,338602.83,13,5,16,8,True
8810796,1312,0,10,9793,317973552,1,0,0,1023.18,0,339626.01,5,3,1,8,True
8959376,553,1,451,1905,317973552,1,0,0,1022.68,7,338603.33,17,5,8,8,True
9169619,159,2,25,2178,317973552,1,0,0,1023.07,8,337580.26,24,3,13,8,True
9327883,553,1,-1,7863,317973552,1,1,0,1022.93,4,337580.26,17,2,18,9,True
9453869,553,1,-1,5809,317973552,1,2,0,1023.06,4,337580.26,17,6,16,10,True
9703316,404,1,10,5153,317973552,1,0,0,1023.05,6,338603.31,10,6,1,11,True
9951224,553,1,451,8016,317973552,1,0,0,1022.91,7,337580.4,17,6,22,11,True
1077363,1311,2,25,6567,341462907,0,0,0,957.82,8,527144.18,5,0,17,1,True
1239336,599,0,20,2936,341462907,0,0,0,958.11,5,526186.07,24,1,1,1,False
1309929,132,2,20,2190,341462907,0,0,0,957.94,5,525228.13,18,3,22,1,True
1724895,539,4,25,7009,341462907,0,0,0,958.25,8,524269.88,18,6,7,1,True
1970054,304,0,30,2190,341462907,0,0,0,957.92,8,523311.96,4,1,15,1,True
2370484,1311,2,451,7009,341462907,0,0,0,958.22,7,522353.74,5,5,23,1,False
2467360,1127,0,10,2190,341462907,0,0,0,957.9,6,523311.64,24,2,9,2,True
2616320,1311,2,451,5195,341462907,0,0,0,958.24,7,522353.4,5,3,11,2,False
2636481,820,1,10,2190,341462907,0,0,0,957.92,6,523311.32,18,1,6,2,True
3152803,287,0,451,8316,341462907,0,0,0,957.94,7,522353.38,24,3,15,2,True
3452786,312,0,451,3272,341462907,0,0,0,957.8,7,521395.58,4,3,7,2,True
3702822,1311,2,30,6567,341462907,0,0,0,957.99,8,520437.59,5,4,3,3,True
3762541,539,4,-1,4013,341462907,0,1,0,958.11,1,520437.59,18,5,0,4,True
3787523,219,0,10,2936,341462907,0,0,0,957.97,6,521395.56,9,3,20,4,True
3795141,907,0,20,5748,341462907,0,0,0,957.98,5,520437.58,2,0,17,5,True
3896979,1192,2,20,4013,341462907,0,0,0,958.1,3,519479.48,24,3,5,5,True
3942052,287,0,30,7287,341462907,0,0,0,958.13,8,518521.35,24,6,16,5,True
4106413,312,0,-1,8316,341462907,0,1,0,958.27,1,518521.35,4,5,5,6,True
4193476,666,4,30,5748,341462907,0,0,0,957.92,8,517563.43,18,5,21,7,True
4203345,304,0,30,9682,341462907,0,0,0,957.97,8,516605.46,4,6,23,8,True
4621919,304,0,451,6567,341462907,0,0,0,958.24,7,515647.22,4,3,19,8,True
4643816,1311,2,451,3272,341462907,0,0,0,957.96,7,514689.26,5,5,0,8,True
4776516,605,0,10,6626,341462907,0,0,0,957.83,6,515647.09,24,6,1,9,True
4992881,312,0,30,6567,341462907,0,0,0,958.04,8,514689.05,4,1,14,9,True
5452765,312,0,451,2810,341462907,0,0,0,958.11,7,513730.94,4,5,15,10,True
5668800,539,4,25,7390,341462907,0,0,0,958.0,8,512772.94,18,2,2,12,True
5682514,537,0,10,2190,341462907,0,0,0,958.12,6,513731.06,18,3,1,12,True
5837568,304,0,-1,8316,341462907,0,1,0,957.78,4,513731.06,4,5,18,1,True
5989188,287,0,451,4013,341462907,0,0,0,957.77,7,512773.29,24,0,2,1,True
6004946,666,4,451,3272,341462907,0,0,0,958.24,7,511815.05,18,3,13,1,True
6071180,1380,0,10,7390,341462907,0,0,0,957.82,0,512772.87,16,3,22,1,True
6074878,312,0,-1,6841,341462907,0,1,0,957.87,4,512772.87,4,5,5,2,True
6318495,304,0,451,6626,341462907,0,0,0,957.77,7,511815.1,4,0,8,2,True
6551363,666,4,451,8316,341462907,0,0,0,958.0,7,510857.1,18,0,22,3,True
6603567,312,0,451,8229,341462907,0,0,0,958.14,7,509898.96,4,2,18,5,True
6702295,539,4,451,2810,341462907,0,0,0,958.3,7,508940.66,18,1,16,5,True
6718412,1093,0,20,4663,341462907,0,0,0,958.08,5,507982.58,18,2,10,5,True
6741880,1289,1,10,5195,341462907,0,0,0,958.07,6,508940.65,24,1,5,5,True
6837498,787,0,20,5195,341462907,0,0,0,957.82,5,507982.83,14,3,4,6,True
6885276,203,0,20,6567,341462907,0,0,0,957.79,3,507025.04,9,6,21,6,True
6920604,1092,1,10,9722,341462907,0,0,0,957.98,0,507983.02,18,5,17,7,True
7483173,287,0,25,5748,341462907,0,0,0,957.85,8,507025.17,24,3,11,7,True
7634447,729,0,20,8316,341462907,0,0,0,957.81,5,506067.36,11,3,12,7,True
7699003,539,4,30,7287,341462907,0,0,0,958.04,8,505109.32,18,0,23,7,True
7867277,1179,0,10,5748,341462907,0,0,0,958.12,6,506067.44,24,3,2,10,True
8003534,287,0,25,7390,341462907,0,0,0,957.98,8,505109.46,24,4,16,10,True
8157916,287,0,451,6626,341462907,0,0,0,957.94,7,504151.52,24,3,20,11,True
8254655,287,0,25,6841,341462907,0,0,0,958.08,8,503193.44,24,0,12,12,True
8338297,362,0,10,6626,341462907,0,0,0,958.02,6,504151.46,24,6,12,2,True
8415063,1311,2,451,9682,341462907,0,0,0,958.17,7,503193.29,5,1,7,2,True
8467642,159,2,20,5195,341462907,0,0,0,958.26,5,502235.03,24,6,18,3,True
8783067,539,4,30,2190,341462907,0,0,0,957.67,8,501277.36,18,3,11,4,True
9260348,539,4,-1,2190,341462907,0,1,0,958.2,4,501277.36,18,3,17,5,True
9410841,1311,2,451,2190,341462907,0,0,0,957.86,7,500319.5,5,4,21,5,True
9470419,1311,2,-1,5195,341462907,0,1,0,958.16,4,500319.5,5,0,16,7,True
9706179,666,4,451,6626,341462907,0,0,0,958.33,7,499361.17,18,3,9,9,True
9757974,309,0,20,9682,341462907,0,0,0,957.84,5,498403.33,4,3,13,10,True
9863045,1311,2,30,5195,341462907,0,0,0,957.91,8,497445.42,5,2,13,11,True
1125827,825,2,30,3960,505316441,1,0,0,1074.92,8,706058.08,18,0,7,1,True
1345993,143,4,-1,3314,505316441,1,1,0,1074.74,1,706058.08,18,0,3,1,True
1511030,529,2,20,3314,505316441,1,0,0,1074.87,5,704983.21,18,4,15,1,True
1518255,547,4,25,4656,505316441,1,0,0,1075.05,8,703908.16,17,3,16,2,True
1615844,143,4,-1,3960,505316441,1,1,0,1075.16,4,703908.16,18,1,10,3,True
1648711,103,3,25,6124,505316441,1,0,0,1074.98,8,702833.18,3,3,20,3,True
1809808,328,0,20,2727,505316441,1,0,0,1075.0,5,701758.18,11,0,11,3,True
2031426,1170,0,30,7520,505316441,1,0,0,1075.09,8,700683.09,24,3,20,4,True
2823990,547,4,-1,7292,505316441,1,1,0,1075.15,4,700683.09,17,1,8,5,True
2904140,480,0,20,7110,505316441,1,0,0,1074.96,3,699608.13,5,4,20,6,True
3178330,825,2,30,3219,505316441,1,0,0,1075.08,8,698533.05,18,6,21,6,True
3405469,1170,0,30,3960,505316441,1,0,0,1075.09,8,697457.96,24,6,7,7,True
3538152,143,4,-1,3219,505316441,1,1,0,1075.35,4,697457.96,18,5,23,7,True
3595049,1312,0,20,7663,505316441,1,0,0,1074.99,5,696382.97,5,1,20,7,True
3618965,547,4,25,3219,505316441,1,0,0,1074.99,8,695307.98,17,2,13,8,True
3690877,115,2,20,6124,505316441,1,0,0,1074.83,5,694233.15,3,0,3,8,True
3867650,85,2,20,3219,505316441,1,0,0,1074.95,5,693158.2,1,0,11,8,True
3934224,1258,3,451,7994,505316441,1,0,0,1074.85,7,692083.35,23,2,23,8,True
4268559,1025,1,10,7110,505316441,1,0,0,1074.92,0,693158.27,11,3,2,9,True
4506019,1258,3,25,5325,505316441,1,0,0,1074.85,8,692083.42,23,1,3,9,True
4522309,1411,0,20,6124,505316441,1,0,0,1074.94,5,691008.48,24,6,17,10,False
4553248,1258,3,-1,6922,505316441,1,1,0,1074.99,4,691008.48,23,2,15,11,True
4743998,1258,3,451,6922,505316441,1,0,0,1075.06,7,689933.42,23,6,15,11,True
4789081,871,0,20,7110,505316441,1,0,0,1075.06,5,688858.36,24,0,14,11,True
4873994,1210,0,20,7663,505316441,1,0,0,1075.02,5,687783.34,24,6,9,11,True
4989919,990,0,30,3467,505316441,1,0,0,1075.06,8,686708.28,22,6,12,12,True
5019864,547,4,25,8189,505316441,1,0,0,1074.78,8,685633.5,17,1,1,12,True
5031179,1258,3,-1,3713,505316441,1,1,0,1075.0,1,685633.5,23,1,6,12,True
5176896,1467,0,10,8014,505316441,1,0,0,1075.14,6,686708.64,11,6,22,12,True
5635982,1170,0,30,3314,505316441,1,0,0,1075.21,8,685633.43,24,1,9,1,True
5694725,471,0,20,2351,505316441,1,0,0,1075.21,5,684558.22,5,1,4,2,True
5713473,716,0,20,2351,505316441,1,0,0,1075.15,5,683483.07,18,0,14,3,True
5760504,103,3,451,8152,505316441,1,0,0,1074.87,7,682408.2,3,2,6,3,True
5920339,123,0,10,8440,505316441,1,0,0,1074.85,6,683483.05,18,0,5,5,True
5983032,990,0,30,3713,505316441,1,0,0,1075.21,8,682407.84,22,6,9,5,True
6061693,990,0,30,2351,505316441,1,0,0,1075.25,8,681332.59,22,5,16,7,True
6209417,103,3,451,8548,505316441,1,0,0,1075.22,7,680257.37,3,3,6,7,True
6363022,1170,0,25,3314,505316441,1,0,0,1074.88,8,679182.49,24,4,13,10,True
6409967,103,3,30,2727,505316441,1,0,0,1074.99,8,678107.5,3,5,21,11,True
6645884,990,0,451,8189,505316441,1,0,0,1074.9,7,677032.6,22,0,14,11,True
6835394,64,0,20,8548,505316441,1,0,0,1074.86,5,675957.74,20,5,6,12,False
6859968,1170,0,30,9044,505316441,1,0,0,1074.98,8,674882.76,24,1,11,1,True
7287459,990,0,30,8014,505316441,1,0,0,1074.88,8,673807.88,22,1,21,2,True
7489260,103,3,451,3219,505316441,1,0,0,1075.17,7,672732.71,3,3,20,2,True
7537952,1258,3,30,3467,505316441,1,0,0,1074.65,8,671658.06,23,2,9,2,True
7958317,1170,0,451,9757,505316441,1,0,0,1074.84,7,670583.22,24,5,16,5,True
8009771,603,0,20,6922,505316441,1,0,0,1074.97,5,669508.25,24,2,16,5,True
8087061,143,4,25,3314,505316441,1,0,0,1074.93,8,668433.32,18,2,7,5,True
8159345,143,4,-1,9757,505316441,1,1,0,1074.98,4,668433.32,18,3,4,5,True
8248273,752,0,20,3960,505316441,1,0,0,1075.06,5,667358.26,24,1,15,6,True
8345604,990,0,451,2727,505316441,1,0,0,1075.19,7,666283.07,22,4,1,8,True
8689586,337,1,10,7663,505316441,1,0,0,1075.03,6,667358.1,11,4,12,8,True
8808766,1052,0,20,7520,505316441,1,0,0,1075.13,3,666282.97,11,0,9,8,True
8831396,1170,0,25,3467,505316441,1,0,0,1074.98,8,665207.99,24,5,9,9,True
8847667,1170,0,-1,5325,505316441,1,1,0,1075.27,1,665207.99,24,6,12,10,True
8983248,1476,0,20,5325,505316441,1,0,0,1074.8,3,664133.19,24,4,2,10,True
9554407,103,3,30,7520,505316441,1,0,0,1075.05,8,663058.14,3,0,7,10,True
1042764,1086,0,-1,4059,732232168,1,1,0,429.03,4,297820.0,18,0,20,3,True
1105547,942,0,20,4769,732232168,1,0,0,429.17,3,297390.83,24,5,2,4,True
1614085,1267,2,25,5899,732232168,1,0,0,428.85,8,296961.98,23,2,11,5,True
1842010,1183,4,451,5986,732232168,1,0,0,428.96,7,296533.02,24,5,7,8,True
1906304,804,0,20,7365,732232168,1,0,0,428.8,5,296104.22,11,1,3,8,True
2063479,1086,0,30,4769,732232168,1,0,0,429.07,8,295675.15,18,6,22,11,True
2086835,844,1,10,4769,732232168,1,0,0,429.13,6,296104.28,5,3,2,3,True
2098506,596,3,-1,4059,732232168,1,1,0,428.95,4,296104.28,24,2,22,4,True
2176324,1435,2,30,4059,732232168,1,0,0,428.94,8,295675.34,24,5,2,6,True
2245677,1411,0,10,1474,732232168,1,0,0,429.0,6,296104.34,24,4,1,6,True
2356885,596,3,30,5986,732232168,1,0,0,428.66,8,295675.68,24,5,6,10,False
2478335,1086,0,451,5131,732232168,1,0,0,429.03,7,295246.65,18,0,0,11,True
3044981,1205,0,30,2725,732232168,1,0,0,428.7,8,294817.95,24,1,2,1,True
3225299,1435,2,451,4769,732232168,1,0,0,429.36,7,294388.59,24,0,1,2,True
3232630,1086,0,451,8312,732232168,1,0,0,428.88,7,293959.71,18,5,2,3,True
3273069,1267,2,25,5131,732232168,1,0,0,428.85,8,293530.86,23,6,20,6,True
3384391,1205,0,25,8601,732232168,1,0,0,428.98,8,293101.88,24,0,2,9,True
3421473,1267,2,-1,7365,732232168,1,1,0,428.74,4,293101.88,23,1,19,9,True
3857860,1175,2,-1,2725,732232168,1,2,0,428.93,4,293101.88,24,4,16,9,True
3967535,963,4,-1,5986,732232168,1,3,1,429.08,4,293101.88,13,3,19,10,True
1092359,1159,0,20,4216,177214697,1,0,0,1037.85,5,225816.15,15,4,7,1,True
1382821,937,0,20,7119,177214697,1,0,0,1038.01,3,224778.14,24,2,5,2,True
1570520,465,0,451,7119,177214697,1,0,0,1038.17,7,223739.97,13,6,0,3,True
1646689,966,4,25,8706,177214697,1,0,0,1038.19,8,222701.78,13,3,1,3,True
1705669,678,4,-1,4740,177214697,1,1,0,1037.98,1,222701.78,24,2,8,3,True
1720631,56,4,451,6414,177214697,1,0,0,1037.77,7,221664.01,20,3,5,4,True
1782752,966,4,25,2992,177214697,1,0,0,1038.03,8,220625.98,13,2,15,4,True
1900837,465,0,25,3441,177214697,1,0,0,1038.19,8,219587.79,13,3,19,5,True
2515516,465,0,30,8706,177214697,1,0,0,1037.83,8,218549.96,13,5,4,5,True
2530893,966,4,451,3817,177214697,1,0,0,1038.07,7,217511.89,13,1,22,6,True
2552883,465,0,451,7872,177214697,1,0,0,1038.21,7,216473.68,13,4,17,7,True
3194313,514,4,30,7600,177214697,1,0,0,1038.02,8,215435.66,12,1,3,7,True
3393090,966,4,30,2992,177214697,1,0,0,1038.17,8,214397.49,13,3,7,7,True
3401486,98,0,10,6414,177214697,1,0,0,1038.25,6,215435.74,3,5,18,7,True
3707152,678,4,25,7600,177214697,1,0,0,1038.18,8,214397.56,24,0,4,7,True
3852684,514,4,451,5497,177214697,1,0,0,1038.03,7,213359.53,12,2,10,7,True
3996801,115,2,20,1509,177214697,1,0,0,1038.28,5,212321.25,3,5,23,8,True
4036357,465,0,25,6285,177214697,1,0,0,1037.94,8,211283.31,13,0,8,10,True
4113203,514,4,451,2838,177214697,1,0,0,1037.96,7,210245.35,12,5,23,10,True
4635188,514,4,-1,7872,177214697,1,1,0,1038.06,1,210245.35,12,2,3,12,True
4642752,1312,0,10,5541,177214697,1,0,0,1038.34,6,211283.69,5,0,8,1,True
5116493,514,4,451,4216,177214697,1,0,0,1037.95,7,210245.74,12,6,2,1,True
5223429,1063,0,20,2482,177214697,1,0,0,1037.83,5,209207.91,11,6,22,2,True
5290133,678,4,451,2838,177214697,1,0,0,1038.09,7,208169.82,24,3,7,3,True
5329990,1338,0,10,5497,177214697,1,0,0,1038.32,6,209208.14,18,1,16,3,True
5406276,465,0,30,8706,177214697,1,0,0,1038.09,8,208170.05,13,5,22,4,True
5619269,56,4,451,2734,177214697,1,0,0,1037.85,7,207132.2,20,1,18,5,True
5685919,966,4,-1,7872,177214697,1,1,0,1037.78,1,207132.2,13,2,10,6,True
5791025,514,4,-1,3817,177214697,1,2,0,1037.96,4,207132.2,12,2,21,6,True
5902380,678,4,451,2482,177214697,1,0,0,1038.0,7,206094.2,24,6,7,6,True
5975010,678,4,-1,7119,177214697,1,1,0,1038.07,1,206094.2,24,4,3,7,True
6003574,465,0,-1,3929,177214697,1,2,0,1038.13,1,206094.2,13,0,23,7,True
6560467,282,2,20,8706,177214697,1,0,0,1038.1,5,205056.1,24,4,16,7,True
6587797,268,2,20,5541,177214697,1,0,0,1038.13,3,204017.97,24,3,10,9,True
6873693,465,0,451,2734,177214697,1,0,0,1037.82,7,202980.15,13,0,12,9,True
6894262,535,0,20,6285,177214697,1,0,0,1038.21,5,201941.94,18,4,16,10,True
7197247,678,4,-1,2482,177214697,1,1,0,1038.13,1,201941.94,24,6,4,10,True
7501875,882,0,20,4740,177214697,1,0,0,1037.91,3,200904.03,27,5,10,1,True
7532162,514,4,451,4740,177214697,1,0,0,1037.95,7,199866.08,12,0,11,1,True
7694010,715,0,10,5497,177214697,1,0,0,1037.63,6,200903.71,18,2,9,1,True
7878703,56,4,451,3830,177214697,1,0,0,1038.07,7,199865.64,20,2,0,1,True
7986713,327,0,20,6285,177214697,1,0,0,1038.18,3,198827.46,11,5,9,2,True
8133130,56,4,451,2838,177214697,1,0,0,1038.31,7,197789.15,20,2,23,3,True
8416590,1270,1,10,4216,177214697,1,0,0,1038.4,6,198827.55,23,5,11,4,True
8560347,56,4,-1,7119,177214697,1,1,0,1038.1,4,198827.55,20,2,17,4,True
8592371,867,0,20,3817,177214697,1,0,0,1038.06,3,197789.49,24,0,11,6,True
8787058,56,4,451,7019,177214697,1,0,0,1038.03,7,196751.46,20,3,15,6,True
9187870,56,4,-1,7019,177214697,1,1,0,1037.86,4,196751.46,20,3,4,7,True
9342796,514,4,451,5497,177214697,1,0,0,1038.19,7,195713.27,12,4,21,8,True
9418881,564,0,10,7872,177214697,1,0,0,1037.92,6,196751.19,17,5,5,8,True
9590306,678,4,451,3441,177214697,1,0,0,1038.17,7,195713.02,24,6,20,8,True
9621425,56,4,451,6331,177214697,1,0,0,1038.12,7,194674.9,20,4,12,10,True
9678639,1304,0,10,6414,177214697,1,0,0,1038.03,6,195712.93,5,0,1,11,True
9681506,56,4,451,5497,177214697,1,0,0,1038.1,7,194674.83,20,2,12,11,True
9689430,514,4,30,3830,177214697,1,0,0,1038.09,8,193636.74,12,1,23,11,True
1119292,191,3,30,7447,392457070,0,0,0,777.0,8,885228.0,18,5,9,1,True
1327980,1093,0,10,4300,392457070,0,0,0,777.13,6,886005.13,18,0,6,1,True
1442786,438,1,451,8019,392457070,0,0,0,777.01,7,885228.12,24,3,9,3,True
1820282,865,0,20,9332,392457070,0,0,0,776.78,3,884451.34,24,4,22,4,True
2112552,191,3,451,1700,392457070,0,0,0,777.29,7,883674.05,18,3,18,4,True
2248110,438,1,-1,7270,392457070,0,1,0,776.88,1,883674.05,24,0,22,5,True
2290928,648,3,451,4300,392457070,0,0,0,776.88,7,882897.17,24,0,9,6,True
2468658,648,3,30,4300,392457070,0,0,0,776.95,8,882120.22,24,4,18,7,True
2473760,438,1,-1,9332,392457070,0,1,0,777.2,1,882120.22,24,6,20,7,True
2483182,1170,0,10,1791,392457070,0,0,0,777.33,6,882897.55,24,6,10,8,False
2511863,542,0,10,8019,392457070,0,0,0,776.97,6,883674.52,17,2,4,8,True
2665474,302,1,10,1257,392457070,0,0,0,776.87,0,884451.39,4,0,10,9,True
2890008,1102,2,20,4029,392457070,0,0,0,776.93,3,883674.46,0,4,13,9,True
2914552,1433,4,-1,5257,392457070,0,1,0,776.85,4,883674.46,24,3,8,10,True
3531817,123,0,20,9332,392457070,0,0,0,777.06,3,882897.4,18,4,14,10,True
3599022,1433,4,25,4300,392457070,0,0,0,776.81,8,882120.59,24,1,8,11,True
3822044,191,3,-1,7447,392457070,0,1,0,777.12,4,882120.59,18,1,7,11,True
3849713,1433,4,30,3960,392457070,0,0,0,777.12,8,881343.47,24,4,6,12,True
3976132,648,3,-1,4029,392457070,0,1,0,777.06,1,881343.47,24,1,3,12,False
4553366,1433,4,-1,3960,392457070,0,2,0,777.11,1,881343.47,24,2,21,2,True
4702442,1433,4,25,4300,392457070,0,0,0,777.03,8,880566.44,24,5,11,2,True
4848281,648,3,30,1791,392457070,0,0,0,776.84,8,879789.6,24,2,18,3,True
4912006,1116,0,20,4300,392457070,0,0,0,776.78,3,879012.82,24,6,23,4,True
5119912,889,0,20,1791,392457070,0,0,0,777.25,3,878235.57,27,4,18,4,True
5174175,773,3,451,1700,392457070,0,0,0,777.22,7,877458.35,14,1,4,4,True
5188899,148,1,10,9332,392457070,0,0,0,777.0,6,878235.35,18,5,17,4,True
5192621,438,1,30,7036,392457070,0,0,0,777.11,8,877458.24,24,6,8,5,True
5466955,773,3,451,5257,392457070,0,0,0,777.11,7,876681.13,14,0,15,5,True
5715138,1433,4,25,8019,392457070,0,0,0,776.96,8,875904.17,24,6,13,5,True
5890785,191,3,451,7447,392457070,0,0,0,776.99,7,875127.18,18,2,23,5,True
6111983,191,3,25,9899,392457070,0,0,0,776.98,8,874350.2,18,3,13,6,True
6189288,572,0,10,4029,392457070,0,0,0,777.06,6,875127.26,11,3,20,6,True
6233786,303,0,20,6459,392457070,0,0,0,777.06,3,874350.2,4,5,23,6,True
6260690,191,3,30,9400,392457070,0,0,0,776.92,8,873573.28,18,0,14,6,True
6437565,438,1,451,4029,392457070,0,0,0,776.83,7,872796.45,24,1,0,7,True
6449538,573,0,10,4300,392457070,0,0,0,777.13,6,873573.58,11,0,8,7,True
6798931,1246,0,20,9400,392457070,0,0,0,777.19,3,872796.39,23,2,6,8,True
6817972,1433,4,-1,1791,392457070,0,1,0,777.13,4,872796.39,24,0,1,11,True
6820537,191,3,451,1257,392457070,0,0,0,777.12,7,872019.27,18,5,8,1,True
7310229,773,3,25,1257,392457070,0,0,0,777.01,8,871242.26,14,1,18,1,True
7361419,438,1,-1,4029,392457070,0,1,0,776.85,4,871242.26,24,2,2,2,True
7406083,438,1,-1,7447,392457070,0,2,0,777.25,4,871242.26,24,0,10,2,True
7614195,773,3,451,7036,392457070,0,0,0,776.98,7,870465.28,14,4,7,3,True
7766838,355,1,10,4300,392457070,0,0,0,776.99,6,871242.27,24,5,4,3,True
8215997,1433,4,30,7036,392457070,0,0,0,777.01,8,870465.26,24,1,19,3,True
8227387,191,3,25,7270,392457070,0,0,0,777.05,8,869688.21,18,5,17,4,True
8298670,438,1,25,6459,392457070,0,0,0,776.83,8,868911.38,24,6,19,4,True
8309170,191,3,-1,7447,392457070,0,1,0,777.16,4,868911.38,18,3,2,5,True
8582594,773,3,25,4863,392457070,0,0,0,777.19,8,868134.19,14,6,15,5,True
9089914,438,1,451,7036,392457070,0,0,0,776.51,7,867357.68,24,3,2,5,True
9422173,191,3,451,7447,392457070,0,0,0,777.06,7,866580.62,18,0,12,7,True
9571523,648,3,451,4863,392457070,0,0,0,777.37,7,865803.25,24,4,12,8,True
9600680,191,3,-1,7270,392457070,0,1,0,777.13,1,865803.25,18,5,2,8,True
9740751,738,2,20,6459,392457070,0,0,0,777.02,5,865026.23,11,6,22,9,True
9754357,167,2,20,9400,392457070,0,0,0,777.04,3,864249.19,24,0,17,10,True
9992025,438,1,451,9400,392457070,0,0,0,776.7,7,863472.49,24,6,1,11,True
1317866,514,4,25,5194,654678389,1,0,0,443.15,8,618609.85,12,2,7,2,True
1345468,1019,0,20,3424,654678389,1,0,0,442.84,5,618167.01,26,0,7,2,True
1369027,1175,2,20,3424,654678389,1,0,0,443.2,3,617723.81,24,1,16,2,True
1391600,167,2,20,8952,654678389,1,0,0,443.1,3,617280.71,24,5,23,3,True
1442511,1387,1,-1,3424,654678389,1,1,0,443.02,1,617280.71,24,5,15,4,True
1514416,1400,3,451,5300,654678389,1,0,0,443.16,7,616837.55,24,1,19,4,True
1582617,647,4,30,2201,654678389,1,0,0,442.94,8,616394.61,24,2,19,6,True
1792790,860,1,10,6980,654678389,1,0,0,442.96,6,616837.57,24,1,6,8,True
1855705,1400,3,25,7692,654678389,1,0,0,442.79,8,616394.78,24,1,21,8,True
2241124,1387,1,451,7508,654678389,1,0,0,443.17,7,615951.61,24,0,15,9,True
2655559,1387,1,451,4261,654678389,1,0,0,443.1,7,615508.51,24,0,9,10,True
3096570,300,0,20,1095,654678389,1,0,0,442.91,5,615065.6,4,4,6,10,True
3101955,287,0,-1,6558,654678389,1,1,0,442.86,1,615065.6,24,5,17,10,True
3138429,287,0,-1,3424,654678389,1,2,0,443.01,4,615065.6,24,4,3,11,True
3171377,647,4,451,6243,654678389,1,0,0,442.84,7,614622.76,24,0,10,11,True
3413873,647,4,30,8115,654678389,1,0,0,443.24,8,614179.52,24,6,5,11,True
3474027,1387,1,-1,7508,654678389,1,1,0,442.82,4,614179.52,24,1,9,12,True
3750168,1387,1,-1,1779,654678389,1,2,0,443.08,4,614179.52,24,1,17,12,True
4209748,1387,1,25,3601,654678389,1,0,0,442.96,8,613736.56,24,4,2,1,True
4260126,287,0,30,6344,654678389,1,0,0,443.0,8,613293.56,24,4,22,2,True
4637565,1387,1,25,2507,654678389,1,0,0,443.01,8,612850.55,24,6,0,3,True
4663519,1387,1,-1,3289,654678389,1,1,0,442.94,1,612850.55,24,4,17,3,True
5136888,514,4,25,6243,654678389,1,0,0,442.84,8,612407.71,12,2,12,3,True
5415735,1400,3,-1,6980,654678389,1,1,0,442.8,4,612407.71,24,1,21,4,True
5696297,1400,3,25,3171,654678389,1,0,0,442.88,8,611964.83,24,3,18,4,True
5712913,647,4,451,8952,654678389,1,0,0,442.87,7,611521.96,24,5,17,5,True
5758215,647,4,451,7508,654678389,1,0,0,443.04,7,611078.92,24,6,1,5,True
5863215,249,0,10,7508,654678389,1,0,0,443.32,6,611522.24,6,0,4,5,True
6145541,1387,1,25,1095,654678389,1,0,0,442.98,8,611079.26,24,4,4,6,True
6477468,1387,1,25,8891,654678389,1,0,0,443.19,8,610636.07,24,0,13,7,True
6514563,514,4,-1,4246,654678389,1,1,0,443.08,4,610636.07,12,1,8,7,True
6885715,514,4,25,6558,654678389,1,0,0,443.11,8,610192.96,12,1,21,7,True
7051529,647,4,25,1779,654678389,1,0,0,443.11,8,609749.85,24,6,5,8,True
7158804,647,4,-1,4261,654678389,1,1,0,442.79,4,609749.85,24,4,18,10,True
7520984,1094,0,20,8115,654678389,1,0,0,443.08,5,609306.77,0,4,9,10,True
7869602,514,4,451,7063,654678389,1,0,0,443.0,7,608863.77,12,5,13,11,True
7921913,1354,0,20,8952,654678389,1,0,0,442.83,5,608420.94,24,0,1,11,True
7969720,525,0,10,3171,654678389,1,0,0,443.01,0,608863.95,18,1,2,12,True
8061314,239,1,10,5300,654678389,1,0,0,442.86,6,609306.81,26,6,11,12,True
8196640,287,0,-1,8115,654678389,1,1,0,443.01,4,609306.81,24,0,3,1,True
8198174,287,0,451,7508,654678389,1,0,0,443.06,7,608863.75,24,5,21,1,True
8479741,1019,0,10,5194,654678389,1,0,0,442.95,6,609306.7,26,1,4,2,True
8627506,482,1,10,1779,654678389,1,0,0,442.86,6,609749.56,5,3,4,3,True
8713992,514,4,30,1095,654678389,1,0,0,443.13,8,609306.43,12,0,11,4,True
8893397,647,4,30,1779,654678389,1,0,0,443.02,8,608863.41,24,4,15,4,True
9013564,514,4,451,2201,654678389,1,0,0,443.16,7,608420.25,12,4,14,5,True
9014712,979,0,20,7508,654678389,1,0,0,443.08,5,607977.17,22,4,4,5,True
9135932,304,0,10,1779,654678389,1,0,0,443.09,0,608420.26,4,0,23,6,False
9151220,1400,3,-1,6558,654678389,1,1,0,442.82,1,608420.26,24,2,0,6,True
9626758,1400,3,30,9178,654678389,1,0,0,442.85,8,607977.41,24,0,17,6,True
9653172,1036,1,10,4261,654678389,1,0,0,442.75,6,608420.16,11,4,13,6,True
9677018,647,4,25,1054,654678389,1,0,0,443.18,8,607976.98,24,4,4,7,True
9677979,287,0,30,5374,654678389,1,0,0,443.03,8,607533.95,24,5,13,8,True
9985832,42,2,20,2547,654678389,1,0,0,442.88,5,607091.07,24,3,21,10,True
1401969,732,0,30,6687,664030201,0,0,0,160.96,8,592809.04,11,6,11,1,True
1445779,689,0,20,3056,664030201,0,0,0,161.07,3,592647.97,24,3,10,1,True
1513472,1052,0,-1,9084,664030201,0,1,0,160.93,1,592647.97,11,4,17,1,False
1615144,176,3,30,6119,664030201,0,0,0,161.01,8,592486.96,24,4,19,2,True
1666943,1027,0,20,9084,664030201,0,0,0,161.0,5,592325.96,11,2,1,3,True
2085492,1052,0,-1,3818,664030201,0,1,0,160.95,1,592325.96,11,4,12,4,True
2128598,779,4,30,9352,664030201,0,0,0,160.77,8,592165.19,14,4,23,5,False
2279168,779,4,451,7634,664030201,0,0,0,161.09,7,592004.1,14,1,1,5,False
2515042,1169,0,10,9352,664030201,0,0,0,161.16,0,592165.26,24,1,18,6,True
2535494,653,1,10,6687,664030201,0,0,0,160.82,6,592326.08,24,3,0,6,True
2821574,1052,0,-1,4992,664030201,0,1,0,160.93,1,592326.08,11,3,7,7,True
3025678,1155,0,20,3056,664030201,0,0,0,160.97,3,592165.11,15,2,1,7,True
3319369,394,0,10,6057,664030201,0,0,0,160.93,6,592326.04,10,0,20,8,True
3439211,732,0,451,2600,664030201,0,0,0,160.86,7,592165.18,11,3,4,8,True
4115002,914,2,20,5766,664030201,0,0,0,161.1,5,592004.08,18,1,3,9,True
4224819,779,4,451,8418,664030201,0,0,0,161.21,7,591842.87,14,0,9,2,True
4260741,328,0,451,6687,664030201,0,0,0,160.87,7,591682.0,11,1,15,2,True
4520885,328,0,-1,7068,664030201,0,1,0,160.97,4,591682.0,11,2,0,3,True
4597674,470,1,10,5956,664030201,0,0,0,160.88,0,591842.88,5,2,13,3,True
4651985,276,0,10,3403,664030201,0,0,0,161.3,0,592004.18,24,0,20,3,False
4771639,1168,3,451,9084,664030201,0,0,0,161.02,7,591843.16,24,2,2,6,True
4831611,328,0,25,2600,664030201,0,0,0,161.1,8,591682.06,11,6,3,7,True
5299811,59,0,25,5516,664030201,0,0,0,160.9,8,591521.16,20,3,16,7,True
5350816,1278,0,10,4799,664030201,0,0,0,160.97,6,591682.13,24,2,22,8,True
5485521,59,0,25,1367,664030201,0,0,0,160.95,8,591521.18,20,4,11,9,True
5637274,1089,0,20,8639,664030201,0,0,0,160.91,3,591360.27,18,0,18,10,True
5654941,59,0,30,8639,664030201,0,0,0,161.29,8,591198.98,20,3,21,12,True
5802730,531,0,10,8628,664030201,0,0,0,160.72,6,591359.7,18,1,13,1,True
5890789,910,0,30,6296,664030201,0,0,0,160.78,8,591198.92,18,6,4,1,True
6374273,1093,0,20,7916,664030201,0,0,0,160.82,3,591038.1,18,4,1,2,True
6736259,1233,0,10,3403,664030201,0,0,0,160.75,6,591198.85,18,5,6,2,True
7431804,328,0,451,7578,664030201,0,0,0,160.66,7,591038.19,11,4,19,2,True
7455907,628,0,10,2344,664030201,0,0,0,160.93,6,591199.12,11,2,21,2,True
7477255,761,2,20,3818,664030201,0,0,0,160.87,5,591038.25,24,0,12,2,True
7526085,732,0,451,3955,664030201,0,0,0,160.9,7,590877.35,11,2,15,3,True
7633266,1168,3,30,9464,664030201,0,0,0,161.17,8,590716.18,24,1,21,4,True
7728499,732,0,25,6687,664030201,0,0,0,161.1,8,590555.08,11,0,1,4,True
7730988,328,0,25,2344,664030201,0,0,0,161.12,8,590393.96,11,1,6,4,True
7996170,176,3,-1,5766,664030201,0,1,0,161.1,4,590393.96,24,4,14,5,True
8115843,59,0,30,4979,664030201,0,0,0,161.33,8,590232.63,20,3,14,5,True
8131600,584,0,10,8640,664030201,0,0,0,160.5,6,590393.13,11,2,2,6,True
8190049,176,3,25,6458,664030201,0,0,0,160.91,8,590232.22,24,0,10,6,True
8232546,59,0,451,5956,664030201,0,0,0,160.8,7,590071.42,20,2,17,7,True
8304944,328,0,451,9084,664030201,0,0,0,160.9,7,589910.52,11,6,4,7,True
8348718,670,0,10,8640,664030201,0,0,0,161.04,0,590071.56,18,6,5,7,True
8752694,1052,0,-1,2600,664030201,0,1,0,160.79,4,590071.56,11,5,0,7,True
8762362,779,4,30,5956,664030201,0,0,0,161.18,8,589910.38,14,4,5,8,True
8876413,1052,0,25,5956,664030201,0,0,0,161.35,8,589749.03,11,3,11,8,True
9302264,1052,0,25,7634,664030201,0,0,0,161.09,8,589587.94,11,1,7,8,True
9536307,895,0,20,6119,664030201,0,0,0,161.05,3,589426.89,24,2,21,9,True
9699460,59,0,451,8418,664030201,0,0,0,160.8,7,589266.09,20,2,1,10,True
9762790,59,0,25,9464,664030201,0,0,0,161.17,8,589104.92,20,0,22,11,True
9790975,1108,1,10,7068,664030201,0,0,0,160.93,6,589265.85,0,3,16,11,True
9958808,1168,3,30,1367,664030201,0,0,0,160.98,8,589104.87,24,6,12,11,True
1121714,348,0,-1,6072,128957034,1,1,0,312.13,4,560688.0,24,3,1,2,True
1621379,729,0,-1,6072,128957034,1,2,0,311.59,4,560688.0,11,3,18,2,True
1691580,58,2,451,3018,128957034,1,0,0,312.01,7,560375.99,20,5,10,4,True
2373655,1254,4,30,3018,128957034,1,0,0,312.1,8,560063.89,23,6,1,4,True
2429179,1072,0,20,9534,128957034,1,0,0,311.9,5,559751.99,18,5,8,5,True
2617248,263,3,25,8230,128957034,1,0,0,312.17,8,559439.82,6,0,11,5,True
2940867,1254,4,30,7398,128957034,1,0,0,312.16,8,559127.66,23,6,4,6,True
3150037,219,0,10,8999,128957034,1,0,0,312.05,6,559439.71,9,2,23,6,True
3160889,42,2,20,9904,128957034,1,0,0,312.12,5,559127.59,24,6,15,7,True
3392249,359,2,20,3033,128957034,1,0,0,311.85,5,558815.74,24,1,13,7,True
3425550,283,4,-1,9431,128957034,1,1,0,312.01,1,558815.74,24,2,14,7,True
3497075,421,3,-1,6615,128957034,1,2,0,312.18,1,558815.74,18,2,1,9,True
3506512,53,0,10,3033,128957034,1,0,0,312.06,0,559127.8,20,4,4,10,True
3791091,1336,2,451,8717,128957034,1,0,0,311.97,7,558815.83,18,0,14,11,True
3792845,1254,4,451,6063,128957034,1,0,0,311.99,7,558503.84,23,1,2,1,True
4843111,1284,2,20,8999,128957034,1,0,0,312.1,3,558191.74,24,3,13,1,True
4884780,644,0,20,6615,128957034,1,0,0,311.91,3,557879.83,24,2,23,1,True
5237248,1065,0,10,3061,128957034,1,0,0,312.44,6,558192.27,11,5,1,2,True
5449610,729,0,451,9616,128957034,1,0,0,311.71,7,557880.56,11,4,4,3,True
5557064,1404,2,20,2807,128957034,1,0,0,312.0,5,557568.56,24,2,6,3,True
5714857,263,3,30,9616,128957034,1,0,0,311.97,8,557256.59,6,4,5,5,True
6031363,421,3,25,1619,128957034,1,0,0,312.14,8,556944.45,18,1,1,5,False
6054289,58,2,451,6615,128957034,1,0,0,311.75,7,556632.7,20,4,1,5,True
6357532,283,4,451,9618,128957034,1,0,0,311.94,7,556320.76,24,5,1,7,True
6365286,1150,0,20,2159,128957034,1,0,0,312.22,3,556008.54,15,5,13,7,True
6474327,807,0,10,9431,128957034,1,0,0,311.73,6,556320.27,11,4,23,8,True
6474900,263,3,451,4272,128957034,1,0,0,312.16,7,556008.11,6,5,7,8,True
6538597,621,2,25,3033,128957034,1,0,0,312.15,8,555695.96,11,6,16,9,True
6675445,1254,4,25,4667,128957034,1,0,0,311.97,8,555383.99,23,0,14,9,True
6762127,263,3,30,4648,128957034,1,0,0,312.15,8,555071.84,6,1,22,9,False
6811527,58,2,25,6072,128957034,1,0,0,311.84,8,554760.0,20,0,0,9,True
6934278,729,0,451,6063,128957034,1,0,0,312.02,7,554447.98,11,2,17,10,True
7055900,729,0,30,1730,128957034,1,0,0,312.02,8,554135.96,11,3,11,11,True
7059798,348,0,-1,9343,128957034,1,1,0,311.99,4,554135.96,24,2,7,11,True
7117856,283,4,451,9431,128957034,1,0,0,311.88,7,553824.08,24,2,10,12,True
7445164,348,0,451,9431,128957034,1,0,0,311.9,7,553512.18,24,3,5,12,False
7489638,263,3,-1,6615,128957034,1,1,0,311.77,1,553512.18,6,2,0,12,True
7524823,577,0,20,3018,128957034,1,0,0,312.03,5,553200.15,11,6,8,12,True
7597067,790,0,20,7398,128957034,1,0,0,311.75,5,552888.4,11,6,19,12,True
7698038,421,3,451,3018,128957034,1,0,0,312.16,7,552576.24,18,4,13,1,True
7816519,1336,2,451,1730,128957034,1,0,0,312.08,7,552264.16,18,2,2,1,True
7864484,621,2,451,1619,128957034,1,0,0,311.84,7,551952.32,11,0,4,2,True
8034746,58,2,451,2159,128957034,1,0,0,311.88,7,551640.44,20,0,15,2,True
8115771,421,3,30,9616,128957034,1,0,0,312.01,8,551328.43,18,4,11,2,True
8284996,421,3,25,9904,128957034,1,0,0,312.3,8,551016.13,18,1,8,4,True
8332484,58,2,25,6063,128957034,1,0,0,312.03,8,550704.1,20,4,17,6,True
8446023,58,2,-1,3033,128957034,1,1,0,311.89,4,550704.1,20,6,9,6,True
8769974,263,3,-1,3579,128957034,1,2,0,311.89,1,550704.1,6,0,13,6,True
8777065,952,0,20,4272,128957034,1,0,0,312.19,5,550391.91,13,4,4,6,True
8895085,1254,4,451,6615,128957034,1,0,0,311.85,7,550080.06,23,2,2,7,True
8929029,348,0,451,3579,128957034,1,0,0,312.1,7,549767.96,24,2,10,7,True
9057189,1336,2,30,4667,128957034,1,0,0,311.99,8,549455.97,18,4,13,8,True
9093098,1254,4,451,4272,128957034,1,0,0,311.96,7,549144.01,23,1,21,8,True
9220532,348,0,-1,3579,128957034,1,1,0,312.1,4,549144.01,24,1,16,9,True
9275338,263,3,30,3061,128957034,1,0,0,312.17,8,548831.84,6,3,11,10,False
9628078,621,2,30,3061,128957034,1,0,0,311.9,8,548519.94,11,4,22,10,True
9770237,729,0,25,3033,128957034,1,0,0,311.9,8,548208.04,11,5,11,11,True
9980871,58,2,451,6063,128957034,1,0,0,311.87,7,547896.17,20,6,22,11,True
1119049,1282,2,20,5313,732430851,1,0,0,365.4,3,92292.6,24,1,0,1,True
1173618,441,4,-1,4227,732430851,1,1,0,365.32,4,92292.6,24,2,18,1,True
1233638,441,4,-1,5313,732430851,1,2,0,364.97,4,92292.6,24,1,8,2,True
1420583,441,4,451,9923,732430851,1,0,0,365.05,7,91927.55,24,1,18,2,True
1441584,800,0,10,6550,732430851,1,0,0,365.18,0,92292.73,11,1,19,2,True
1513237,952,0,25,5313,732430851,1,0,0,364.98,8,91927.75,13,6,7,2,True
1734758,952,0,-1,4510,732430851,1,1,0,365.14,4,91927.75,13,1,20,3,True
1753136,734,0,451,8811,732430851,1,0,0,364.97,7,91562.78,11,4,4,3,True
1979846,790,0,10,6550,732430851,1,0,0,365.17,6,91927.95,11,0,9,3,True
2723405,967,1,451,4227,732430851,1,0,0,364.74,7,91563.21,13,3,20,4,True
2748662,1311,2,451,5959,732430851,1,0,0,365.07,7,91198.14,5,1,22,5,True
3614331,269,0,20,8255,732430851,1,0,0,364.93,3,90833.21,24,0,7,8,False
3666400,1155,0,20,6395,732430851,1,0,0,365.02,5,90468.19,15,3,8,10,True
3754447,734,0,-1,4440,732430851,1,1,0,365.33,1,90468.19,11,2,21,12,True
3825632,1311,2,25,9923,732430851,1,0,0,364.97,8,90103.22,5,5,18,12,True
3957596,441,4,451,8811,732430851,1,0,0,365.06,7,89738.16,24,3,20,12,True
4010440,641,0,20,6806,732430851,1,0,0,364.84,5,89373.32,24,4,19,12,True
4186857,441,4,25,4959,732430851,1,0,0,364.83,8,89008.49,24,2,4,1,True
4370635,35,2,20,8095,732430851,1,0,0,364.89,5,88643.6,11,1,20,1,True
4821992,734,0,451,4227,732430851,1,0,0,364.91,7,88278.69,11,5,14,2,True
5191667,300,0,25,8255,732430851,1,0,0,365.0,8,87913.69,4,3,3,2,True
5236259,441,4,25,8255,732430851,1,0,0,365.08,8,87548.61,24,4,2,5,True
5281270,790,0,10,6806,732430851,1,0,0,364.87,6,87913.48,11,5,13,5,True
5466662,300,0,451,5313,732430851,1,0,0,364.95,7,87548.53,4,0,7,5,True
5481770,1311,2,30,4440,732430851,1,0,0,365.16,8,87183.37,5,5,8,5,True
5493764,1311,2,25,4440,732430851,1,0,0,364.66,8,86818.71,5,5,17,5,True
5562550,734,0,-1,1070,732430851,1,1,0,364.9,4,86818.71,11,2,5,7,True
5857617,329,1,10,4227,732430851,1,0,0,365.13,6,87183.84,11,6,6,7,True
5875432,734,0,30,6390,732430851,1,0,0,365.04,8,86818.8,11,6,4,8,True
6159797,441,4,-1,4227,732430851,1,1,0,365.08,4,86818.8,24,2,15,8,True
6190324,1311,2,30,2719,732430851,1,0,0,364.92,8,86453.88,5,0,10,9,True
6775055,734,0,451,8095,732430851,1,0,0,364.91,7,86088.97,11,4,5,10,True
6996742,441,4,451,6395,732430851,1,0,0,364.95,7,85724.02,24,4,23,10,True
7148870,300,0,-1,6390,732430851,1,1,0,365.3,4,85724.02,4,2,16,11,True
7681887,1311,2,25,7978,732430851,1,0,0,364.76,8,85359.26,5,2,15,11,True
7879726,967,1,451,6272,732430851,1,0,0,365.25,7,84994.01,13,5,9,12,True
8036942,300,0,25,6272,732430851,1,0,0,365.15,8,84628.86,4,5,12,1,True
8211317,300,0,25,8811,732430851,1,0,0,364.85,8,84264.01,4,6,15,1,True
8395094,1311,2,451,1448,732430851,1,0,0,364.73,7,83899.28,5,5,1,1,True
8420965,441,4,451,7978,732430851,1,0,0,364.96,7,83534.32,24,3,10,2,True
8502036,1246,0,20,5959,732430851,1,0,0,365.18,5,83169.14,23,2,3,2,True
8907901,734,0,-1,4233,732430851,1,1,0,365.07,4,83169.14,11,0,17,3,True
8956241,1156,1,10,6272,732430851,1,0,0,365.27,0,83534.41,15,0,13,4,True
8987347,509,0,20,5959,732430851,1,0,0,365.0,3,83169.41,12,1,0,4,True
9084712,952,0,30,9923,732430851,1,0,0,364.99,8,82804.42,13,4,20,5,True
9162550,952,0,-1,1034,732430851,1,1,0,365.22,4,82804.42,13,4,6,6,True
9408206,967,1,25,1070,732430851,1,0,0,364.87,8,82439.55,13,1,6,7,True
9530429,1311,2,25,4233,732430851,1,0,0,365.25,8,82074.3,5,6,16,7,True
9596915,1311,2,-1,9115,732430851,1,1,0,365.07,4,82074.3,5,4,13,8,True
9619388,759,0,20,1034,732430851,1,0,0,364.93,3,81709.37,24,1,16,8,True
9675846,1311,2,451,7542,732430851,1,0,0,365.23,7,81344.14,5,6,13,8,True
9781768,441,4,30,4440,732430851,1,0,0,364.95,8,80979.19,24,6,16,9,True
9838701,1311,2,451,1220,732430851,1,0,0,365.1,7,80614.09,5,1,3,9,True
9865541,572,0,10,8095,732430851,1,0,0,365.21,0,80979.3,11,5,0,10,True
9941425,734,0,25,9923,732430851,1,0,0,364.87,8,80614.43,11,0,0,10,True
9960882,1311,2,-1,7542,732430851,1,1,0,364.75,1,80614.43,5,2,22,11,True
1270870,718,4,25,6805,623884950,0,0,0,301.01,8,915450.99,18,4,16,1,True
1349278,1076,1,30,7142,623884950,0,0,0,300.98,8,915150.01,18,4,21,1,True
1558096,866,0,20,6762,623884950,0,0,0,300.95,5,914849.06,24,0,4,2,True
1704738,1325,0,10,6805,623884950,0,0,0,301.0,6,915150.06,18,4,7,3,True
1771820,605,0,-1,4216,623884950,0,1,0,301.17,4,915150.06,24,1,0,3,True
2004371,627,0,20,1937,623884950,0,0,0,301.12,5,914848.94,11,4,22,4,True
2048777,1294,4,-1,8384,623884950,0,1,0,301.09,1,914848.94,24,0,5,4,True
2104570,605,0,25,9586,623884950,0,0,0,301.11,8,914547.83,24,1,4,4,True
2114962,1294,4,30,7654,623884950,0,0,0,301.21,8,914246.62,24,6,2,4,True
2701172,333,1,10,9586,623884950,0,0,0,301.14,6,914547.76,11,1,16,8,True
2967129,767,0,20,6805,623884950,0,0,0,301.08,3,914246.68,14,2,23,8,True
3068833,605,0,-1,6675,623884950,0,1,0,301.2,4,914246.68,24,2,20,8,True
3227205,949,4,451,8031,623884950,0,0,0,300.85,7,913945.83,24,0,0,9,True
3286066,561,4,25,8384,623884950,0,0,0,300.89,8,913644.94,17,1,16,9,True
3499828,461,4,25,6762,623884950,0,0,0,300.94,8,913344.0,13,0,8,11,True
3657896,950,0,20,8384,623884950,0,0,0,300.94,5,913043.06,24,3,16,12,True
4010987,51,0,10,9586,623884950,0,0,0,300.92,6,913343.98,20,6,0,1,True
4156657,485,1,10,7142,623884950,0,0,0,300.87,6,913644.85,5,4,9,3,True
4272750,135,2,20,6805,623884950,0,0,0,300.91,5,913343.94,18,2,17,3,True
4948217,1284,2,20,1937,623884950,0,0,0,301.0,3,913042.94,24,1,21,4,True
5159868,182,1,10,4216,623884950,0,0,0,301.09,6,913344.03,18,3,4,4,True
5178112,564,0,10,7142,623884950,0,0,0,300.88,6,913644.91,17,5,20,5,True
5181580,949,4,25,8384,623884950,0,0,0,300.93,8,913343.98,24,4,0,6,True
5251692,393,1,10,7142,623884950,0,0,0,301.12,0,913645.1,10,6,23,6,True
5560687,561,4,25,6805,623884950,0,0,0,301.22,8,913343.88,17,2,14,7,True
5856926,294,3,451,6762,623884950,0,0,0,300.9,7,913042.98,4,5,7,7,True
5894105,1294,4,451,9586,623884950,0,0,0,301.17,7,912741.81,24,4,8,9,True
6285694,550,0,20,8031,623884950,0,0,0,300.84,5,912440.97,17,6,5,9,True
6319095,605,0,30,6675,623884950,0,0,0,300.96,8,912140.01,24,6,6,9,True
6594430,303,0,20,6762,623884950,0,0,0,300.9,3,911839.11,4,0,12,9,False
6662816,950,0,10,8384,623884950,0,0,0,300.63,6,912139.74,24,3,10,11,True
6767816,561,4,451,6805,623884950,0,0,0,300.91,7,911838.83,17,6,5,11,True
6856086,949,4,451,1937,623884950,0,0,0,300.8,7,911538.03,24,3,10,12,True
6952006,478,4,25,5035,623884950,0,0,0,301.23,8,911236.8,5,3,2,12,True
7271684,1076,1,451,9586,623884950,0,0,0,301.06,7,910935.74,18,0,2,1,True
7342036,535,0,20,6762,623884950,0,0,0,301.01,3,910634.73,18,4,12,2,True
7675255,457,0,10,5390,623884950,0,0,0,300.83,6,910935.56,13,0,17,2,True
7756545,478,4,30,4668,623884950,0,0,0,301.0,8,910634.56,5,4,13,3,True
7859919,1076,1,451,4668,623884950,0,0,0,301.0,7,910333.56,18,1,3,3,True
8364607,1413,0,10,5035,623884950,0,0,0,301.09,0,910634.65,24,2,7,3,True
8485270,461,4,451,8031,623884950,0,0,0,301.24,7,910333.41,13,6,15,3,True
8547873,880,1,10,9586,623884950,0,0,0,301.03,6,910634.44,27,3,0,4,True
8590877,294,3,30,5390,623884950,0,0,0,301.1,8,910333.34,4,6,15,4,True
8706389,478,4,30,7142,623884950,0,0,0,301.02,8,910032.32,5,3,18,4,True
8941339,478,4,451,5390,623884950,0,0,0,300.87,7,909731.45,5,3,20,4,True
9078251,1076,1,451,4216,623884950,0,0,0,301.28,7,909430.17,18,5,15,6,True
9128782,478,4,25,2375,623884950,0,0,0,300.96,8,909129.21,5,1,15,6,True
9199104,605,0,-1,2375,623884950,0,1,0,301.24,4,909129.21,24,5,9,6,True
9464392,1162,2,20,6675,623884950,0,0,0,300.73,5,908828.48,24,6,18,7,True
9729705,1361,2,20,5035,623884950,0,0,0,300.92,5,908527.56,16,5,10,10,True
1001787,1159,0,30,8808,167866073,0,0,0,356.85,8,148574.15,15,2,3,1,True
1461180,770,4,25,8808,167866073,0,0,0,357.17,8,148216.98,14,3,7,2,True
1748268,1159,0,30,8994,167866073,0,0,0,357.08,8,147859.9,15,2,18,2,True
2038351,76,0,10,8018,167866073,0,0,0,356.91,0,148216.81,20,2,5,2,True
2114551,1027,0,20,8675,167866073,0,0,0,356.71,3,147860.1,11,1,4,4,True
2206808,1170,0,20,8018,167866073,0,0,0,356.96,5,147503.14,24,1,0,4,True
2247561,1451,1,451,6375,167866073,0,0,0,357.16,7,147145.98,11,0,7,4,True
2249703,268,2,20,9102,167866073,0,0,0,356.86,5,146789.12,24,5,17,5,True
2553435,475,4,25,6204,167866073,0,0,0,356.96,8,146432.16,5,1,22,5,True
2886707,14,2,30,9665,167866073,0,0,0,356.92,8,146075.24,24,3,16,7,True
3159903,1159,0,30,6375,167866073,0,0,0,356.99,8,145718.25,15,2,19,7,True
3431068,365,0,20,7057,167866073,0,0,0,356.83,3,145361.42,25,3,16,7,True
4011635,1451,1,-1,8560,167866073,0,1,0,356.91,4,145361.42,11,1,23,9,True
4812829,166,4,-1,6375,167866073,0,2,0,356.97,1,145361.42,24,2,20,9,True
4837469,443,2,20,4655,167866073,0,0,0,356.87,5,145004.55,24,3,16,9,True
4879130,1278,0,20,8808,167866073,0,0,0,357.04,3,144647.51,24,6,17,9,True
4955019,1041,0,-1,4179,167866073,0,1,0,357.03,1,144647.51,11,5,2,10,True
5004645,14,2,451,6204,167866073,0,0,0,357.14,7,144290.37,24,1,11,10,True
5066744,1451,1,25,9665,167866073,0,0,0,357.23,8,143933.14,11,6,13,10,True
5415201,14,2,30,1436,167866073,0,0,0,356.99,8,143576.15,24,5,0,11,True
5498274,1451,1,451,6204,167866073,0,0,0,356.94,7,143219.21,11,3,9,11,True
5558309,1041,0,25,6616,167866073,0,0,0,356.86,8,142862.35,11,4,10,11,True
5560784,64,0,20,1436,167866073,0,0,0,357.13,5,142505.22,20,4,1,12,True
5784415,14,2,451,9665,167866073,0,0,0,357.21,7,142148.01,24,5,5,12,True
5796278,770,4,-1,3375,167866073,0,1,0,356.97,1,142148.01,14,5,6,12,True
5976005,166,4,30,9102,167866073,0,0,0,357.16,8,141790.85,24,2,13,1,True
6063542,770,4,-1,7744,167866073,0,1,0,357.03,4,141790.85,14,0,4,3,True
6201713,1488,0,10,4655,167866073,0,0,0,357.1,6,142147.95,24,6,20,3,True
6415626,47,1,10,7602,167866073,0,0,0,357.07,6,142505.02,24,6,17,4,True
6417662,1451,1,451,7602,167866073,0,0,0,356.99,7,142148.03,11,0,14,5,True
6596251,475,4,30,4377,167866073,0,0,0,356.99,8,141791.04,5,3,13,5,True
6673900,757,0,20,9102,167866073,0,0,0,357.07,5,141433.97,24,2,3,5,True
6735686,180,0,20,3543,167866073,0,0,0,357.18,5,141076.79,18,3,0,7,True
6801554,14,2,451,4179,167866073,0,0,0,356.76,7,140720.03,24,5,14,7,True
6880351,1383,4,30,6204,167866073,0,0,0,356.94,8,140363.09,16,0,21,7,True
6940905,770,4,-1,5575,167866073,0,1,0,357.14,4,140363.09,14,0,4,8,True
7325884,770,4,30,9087,167866073,0,0,0,357.09,8,140006.0,14,4,19,8,True
7473804,1383,4,451,9747,167866073,0,0,0,357.04,7,139648.96,16,5,19,9,True
7696673,889,0,20,3780,167866073,0,0,0,356.84,5,139292.12,27,6,23,11,True
7803701,475,4,30,9813,167866073,0,0,0,357.26,8,138934.86,5,4,8,12,True
7940219,573,0,10,9087,167866073,0,0,0,357.04,6,139291.9,11,3,0,12,True
8032005,14,2,451,4179,167866073,0,0,0,356.83,7,138935.07,24,1,15,12,True
8116729,425,4,25,9665,167866073,0,0,0,356.87,8,138578.2,18,1,7,1,True
8272904,425,4,451,6375,167866073,0,0,0,356.92,7,138221.28,18,0,0,2,True
8404884,160,0,10,9747,167866073,0,0,0,357.03,0,138578.31,24,4,9,2,True
8567813,1383,4,25,8675,167866073,0,0,0,357.13,8,138221.18,16,1,2,3,True
8691939,1159,0,451,7602,167866073,0,0,0,356.97,7,137864.21,15,6,8,3,True
8697425,1041,0,25,7602,167866073,0,0,0,357.0,8,137507.21,11,2,16,3,True
8741700,573,0,20,7049,167866073,0,0,0,356.85,3,137150.36,11,2,13,4,True
8760643,1364,0,20,9087,167866073,0,0,0,356.88,5,136793.48,16,3,0,5,True
8877799,475,4,25,7392,167866073,0,0,0,357.11,8,136436.37,5,2,1,7,True
9033573,425,4,30,7744,167866073,0,0,0,357.19,8,136079.18,18,5,0,8,True
9421610,1041,0,451,7049,167866073,0,0,0,356.99,7,135722.19,11,0,4,9,True
9491951,305,1,10,4655,167866073,0,0,0,357.1,6,136079.29,4,2,12,9,True
9495224,542,0,20,9813,167866073,0,0,0,357.07,5,135722.22,17,0,16,10,True
9735482,1383,4,25,4655,167866073,0,0,0,357.26,8,135364.96,16,3,22,10,True
9816291,1146,2,20,5153,167866073,0,0,0,356.92,5,135008.04,15,2,23,11,True
1554105,766,4,-1,9187,220498387,1,1,0,1020.0,1,690717.0,14,2,20,2,True
2308622,1238,0,20,6606,220498387,1,0,0,1020.01,5,689696.99,18,2,6,3,True
2412591,1172,3,451,5438,220498387,1,0,0,1019.95,7,688677.04,24,0,0,4,True
2441576,690,4,-1,9187,220498387,1,1,0,1019.73,4,688677.04,24,3,17,4,True
2635390,1112,1,10,5406,220498387,1,0,0,1019.7,6,689696.74,0,0,13,5,True
2651044,403,0,25,1570,220498387,1,0,0,1019.99,8,688676.75,10,6,13,6,True
2736651,1108,1,10,1570,220498387,1,0,0,1019.86,0,689696.61,0,0,8,6,True
3066466,403,0,25,1851,220498387,1,0,0,1019.75,8,688676.86,10,1,21,7,True
3071497,1172,3,30,7620,220498387,1,0,0,1019.5,8,687657.36,24,3,13,7,True
3079519,690,4,451,8278,220498387,1,0,0,1020.13,7,686637.23,24,0,6,8,True
3166718,1349,3,451,1999,220498387,1,0,0,1020.12,7,685617.11,24,4,18,8,True
3603747,123,0,30,1999,220498387,1,0,0,1019.95,8,684597.16,18,3,14,9,True
3837725,123,0,451,8854,220498387,1,0,0,1020.01,7,683577.15,18,1,16,10,True
4002650,403,0,25,9187,220498387,1,0,0,1020.21,8,682556.94,10,6,18,10,True
4062189,403,0,451,6606,220498387,1,0,0,1019.81,7,681537.13,10,2,17,11,True
4267851,690,4,30,8854,220498387,1,0,0,1019.78,8,680517.35,24,0,7,1,True
4658625,394,0,20,2018,220498387,1,0,0,1019.97,5,679497.38,10,4,5,2,True
4779587,1172,3,451,5384,220498387,1,0,0,1020.23,7,678477.15,24,4,0,2,True
5148038,1349,3,-1,6214,220498387,1,1,0,1019.98,4,678477.15,24,6,1,2,True
5194764,1011,4,25,4232,220498387,1,0,0,1019.9,8,677457.25,26,4,8,4,True
5655468,1349,3,451,4323,220498387,1,0,0,1019.84,7,676437.41,24,2,19,5,True
5660008,1349,3,451,5985,220498387,1,0,0,1020.02,7,675417.39,24,5,19,6,True
5673157,690,4,451,9762,220498387,1,0,0,1019.77,7,674397.62,24,0,0,7,True
5885828,766,4,25,8327,220498387,1,0,0,1020.06,8,673377.56,14,0,3,7,True
6107087,766,4,30,7740,220498387,1,0,0,1020.0,8,672357.56,14,2,18,7,True
6173187,537,0,10,7419,220498387,1,0,0,1019.78,6,673377.34,18,1,5,8,True
6233390,1011,4,25,8278,220498387,1,0,0,1019.88,8,672357.46,26,4,0,9,True
6265997,766,4,25,8327,220498387,1,0,0,1020.31,8,671337.15,14,0,23,10,True
6369706,403,0,-1,9762,220498387,1,1,0,1020.02,4,671337.15,10,6,0,12,True
6458233,766,4,30,9762,220498387,1,0,0,1020.19,8,670316.96,14,4,2,1,True
6589636,766,4,30,3318,220498387,1,0,0,1020.25,8,669296.71,14,0,1,1,True
6696710,889,0,20,9187,220498387,1,0,0,1019.8,3,668276.91,27,5,8,2,True
6697460,1349,3,451,5477,220498387,1,0,0,1019.96,7,667256.95,24,5,23,2,True
6751436,123,0,-1,6214,220498387,1,1,0,1020.03,1,667256.95,18,2,15,3,True
6964708,1011,4,-1,5406,220498387,1,2,0,1020.39,4,667256.95,26,5,7,3,True
7734079,766,4,451,1570,220498387,1,0,0,1020.0,7,666236.95,14,1,22,3,True
7913834,1471,0,10,3318,220498387,1,0,0,1019.91,0,667256.86,24,6,18,4,True
8144636,690,4,-1,5418,220498387,1,1,0,1020.17,4,667256.86,24,6,19,4,True
8273034,1272,0,20,5406,220498387,1,0,0,1020.01,3,666236.85,24,3,5,4,True
8301782,690,4,25,5406,220498387,1,0,0,1020.2,8,665216.65,24,3,20,5,False
8769622,1303,0,20,4323,220498387,1,0,0,1019.8,3,664196.85,5,5,2,6,True
8991548,766,4,-1,6513,220498387,1,1,0,1019.67,4,664196.85,14,4,5,6,True
9159319,1172,3,30,4771,220498387,1,0,0,1020.13,8,663176.72,24,6,20,6,True
9304831,1282,2,20,8278,220498387,1,0,0,1020.0,3,662156.72,24,4,13,8,True
9356001,123,0,451,7767,220498387,1,0,0,1020.13,7,661136.59,18,1,18,8,True
9448780,292,1,10,6214,220498387,1,0,0,1020.2,6,662156.79,4,0,11,8,True
9519650,867,0,20,4232,220498387,1,0,0,1020.09,3,661136.7,24,0,23,9,True
9599526,1349,3,451,4232,220498387,1,0,0,1019.76,7,660116.94,24,2,14,9,True
9780071,114,0,20,1999,220498387,1,0,0,1020.28,5,659096.66,3,2,12,11,True
9934696,535,0,20,5477,220498387,1,0,0,1020.09,3,658076.57,18,2,21,11,True
1214303,120,4,25,4646,209967320,0,0,0,131.98,8,629709.02,18,0,23,1,True
1434550,958,2,20,9226,209967320,0,0,0,131.93,3,629577.09,13,6,6,2,True
1449291,120,4,451,3904,209967320,0,0,0,132.14,7,629444.95,18,1,1,3,True
1530617,411,2,20,9186,209967320,0,0,0,132.13,5,629312.82,18,1,20,4,True
1561170,80,4,451,1546,209967320,0,0,0,131.99,7,629180.83,1,6,11,5,True
1651345,919,4,30,5493,209967320,0,0,0,131.66,8,629049.17,18,3,15,5,True
1669203,429,0,10,3516,209967320,0,0,0,131.88,0,629181.05,24,5,12,5,True
1735987,1463,2,25,8840,209967320,0,0,0,132.15,8,629048.9,11,0,12,6,True
2096830,96,0,-1,6166,209967320,0,1,0,131.89,1,629048.9,1,1,1,7,True
2212446,96,0,30,4646,209967320,0,0,0,132.04,8,628916.86,1,0,0,7,True
2225286,1363,0,10,7423,209967320,0,0,0,132.23,6,629049.09,16,1,1,7,True
2373260,96,0,25,9226,209967320,0,0,0,131.93,8,628917.16,1,2,4,7,True
2717459,1463,2,-1,9186,209967320,0,1,0,131.76,4,628917.16,11,1,11,8,True
2956281,757,0,25,9186,209967320,0,0,0,131.9,8,628785.26,24,5,11,8,True
3144800,261,3,451,5253,209967320,0,0,0,132.01,7,628653.25,6,1,5,8,True
3551320,120,4,-1,3516,209967320,0,1,0,132.02,1,628653.25,18,0,2,10,True
3652582,261,3,451,4646,209967320,0,0,0,131.92,7,628521.33,6,2,13,10,True
3698890,1338,0,20,5493,209967320,0,0,0,131.78,3,628389.55,18,3,15,11,True
3860114,120,4,-1,6590,209967320,0,1,0,132.08,4,628389.55,18,1,14,11,True
4219061,96,0,30,5012,209967320,0,0,0,132.0,8,628257.55,1,4,14,11,True
4323182,80,4,451,9404,209967320,0,0,0,131.81,7,628125.74,1,4,5,12,True
4485394,599,0,10,5012,209967320,0,0,0,132.15,6,628257.89,24,6,15,1,True
4890457,96,0,451,7656,209967320,0,0,0,131.86,7,628126.03,1,3,17,2,True
4897044,1210,0,20,5493,209967320,0,0,0,132.25,3,627993.78,24,2,17,4,True
4917538,261,3,451,2124,209967320,0,0,0,131.99,7,627861.79,6,3,1,5,True
4999767,80,4,-1,7172,209967320,0,1,0,131.83,4,627861.79,1,2,7,6,True
5189684,96,0,451,5012,209967320,0,0,0,132.03,7,627729.76,1,0,7,7,True
5337958,96,0,451,2124,209967320,0,0,0,132.27,7,627597.49,1,2,19,8,True
5413416,261,3,451,3542,209967320,0,0,0,131.99,7,627465.5,6,2,14,8,True
5441993,919,4,25,9226,209967320,0,0,0,131.92,8,627333.58,18,0,5,8,False
5922631,147,0,20,5493,209967320,0,0,0,131.86,5,627201.72,18,0,22,9,True
5981409,1429,0,20,3759,209967320,0,0,0,131.96,3,627069.76,24,0,7,10,True
6120182,275,0,20,6590,209967320,0,0,0,132.04,5,626937.72,24,5,0,10,True
6161006,127,1,10,5605,209967320,0,0,0,131.98,6,627069.7,18,2,11,10,True
6257892,96,0,451,5493,209967320,0,0,0,131.97,7,626937.73,1,5,10,11,True
6389858,96,0,-1,8840,209967320,0,1,0,132.07,1,626937.73,1,0,6,11,True
6480630,525,0,10,5493,209967320,0,0,0,132.1,6,627069.83,18,4,22,12,True
6994761,757,0,451,5475,209967320,0,0,0,132.3,7,626937.53,24,2,14,2,True
7274035,1463,2,451,3759,209967320,0,0,0,132.04,7,626805.49,11,6,4,3,True
7433443,679,0,10,3542,209967320,0,0,0,131.59,6,626937.08,24,2,20,4,False
7900286,757,0,451,5159,209967320,0,0,0,132.0,7,626805.08,24,2,6,5,True
8098255,261,3,451,6622,209967320,0,0,0,132.27,7,626672.81,6,3,12,5,True
8537547,96,0,-1,3759,209967320,0,1,0,131.85,4,626672.81,1,0,17,5,True
8617990,713,0,20,6590,209967320,0,0,0,132.21,3,626540.6,18,1,11,5,True
8774476,1463,2,451,1546,209967320,0,0,0,131.87,7,626408.73,11,4,9,5,True
8845002,120,4,451,5605,209967320,0,0,0,131.95,7,626276.78,18,1,1,5,True
8877491,137,2,20,6590,209967320,0,0,0,132.28,5,626144.5,18,3,6,6,True
8947183,919,4,30,9074,209967320,0,0,0,132.02,8,626012.48,18,5,6,7,True
9101167,919,4,451,5475,209967320,0,0,0,131.93,7,625880.55,18,0,11,8,True
9103520,80,4,451,5159,209967320,0,0,0,131.98,7,625748.57,1,3,21,9,True
9497272,757,0,451,1546,209967320,0,0,0,131.77,7,625616.8,24,6,21,10,True
9621568,919,4,-1,4646,209967320,0,1,0,131.9,4,625616.8,18,2,8,10,True
1183897,1152,0,-1,1688,554054972,0,1,0,927.1,4,726675.0,15,6,16,1,True
1287174,859,2,30,8068,554054972,0,0,0,926.85,8,725748.15,24,5,6,3,True
1333514,584,0,20,2557,554054972,0,0,0,927.09,3,724821.06,11,5,2,3,True
1369382,1334,3,25,7359,554054972,0,0,0,927.12,8,723893.94,18,5,5,4,True
1488382,467,0,20,1688,554054972,0,0,0,927.11,3,722966.83,5,4,5,4,True
1574873,1152,0,451,1523,554054972,0,0,0,927.25,7,722039.58,15,6,16,5,True
1634431,391,3,-1,4014,554054972,0,1,0,926.96,4,722039.58,10,6,6,7,True
1817368,1334,3,30,2925,554054972,0,0,0,926.91,8,721112.67,18,4,22,11,True
2021447,1377,0,451,2557,554054972,0,0,0,927.04,7,720185.63,16,0,14,11,True
2054181,391,3,25,5342,554054972,0,0,0,927.05,8,719258.58,10,3,22,12,True
2076051,46,1,10,4443,554054972,0,0,0,926.99,6,720185.57,24,4,18,12,True
2277901,1377,0,451,1878,554054972,0,0,0,926.98,7,719258.59,16,4,22,1,True
2367101,1334,3,-1,1878,554054972,0,1,0,927.28,4,719258.59,18,5,9,1,True
2542318,1377,0,451,6707,554054972,0,0,0,926.94,7,718331.65,16,3,20,2,True
2716888,1334,3,25,7183,554054972,0,0,0,926.82,8,717404.83,18,4,1,2,True
2821156,1334,3,451,5299,554054972,0,0,0,927.32,7,716477.51,18,2,22,6,True
3286920,1314,2,20,5299,554054972,0,0,0,927.19,5,715550.32,5,1,12,7,True
3476738,1425,0,20,4425,554054972,0,0,0,926.74,3,714623.58,24,6,10,7,True
3664648,1377,0,25,4242,554054972,0,0,0,926.99,8,713696.59,16,2,12,11,True
3886092,1152,0,451,5691,554054972,0,0,0,926.77,7,712769.82,15,2,1,11,True
3923073,1377,0,451,5342,554054972,0,0,0,927.24,7,711842.58,16,0,0,12,True
3974608,523,2,20,4443,554054972,0,0,0,927.2,5,710915.38,18,2,4,12,True
3983222,1377,0,30,2861,554054972,0,0,0,927.1,8,709988.28,16,0,3,1,True
3991027,1152,0,-1,4014,554054972,0,1,0,927.1,4,709988.28,15,1,6,4,True
4142314,391,3,30,5891,554054972,0,0,0,926.64,8,709061.64,10,2,3,8,True
4389468,391,3,451,2456,554054972,0,0,0,926.94,7,708134.7,10,3,0,8,True
4405312,1334,3,-1,5640,554054972,0,1,0,927.14,1,708134.7,18,5,0,9,True
4433764,1152,0,-1,1523,554054972,0,2,0,927.2,4,708134.7,15,1,12,10,True
4545231,1334,3,-1,5691,554054972,0,3,1,926.89,4,0.0,18,6,3,10,True
1456548,709,3,25,5015,188380748,1,0,0,382.98,8,869088.02,18,6,12,1,True
1732821,1004,4,451,9684,188380748,1,0,0,382.79,7,868705.23,26,0,1,1,True
1772442,673,0,10,4097,188380748,1,0,0,383.25,6,869088.48,18,6,3,2,True
1864662,709,3,-1,4097,188380748,1,1,0,383.12,4,869088.48,18,4,11,3,True
1922722,1210,0,-1,2578,188380748,1,2,0,382.69,4,869088.48,24,1,17,3,True
1937908,68,0,25,1238,188380748,1,0,0,382.86,8,868705.62,20,6,18,3,True
2003824,913,0,10,9546,188380748,1,0,0,382.87,0,869088.49,18,1,3,6,False
2201446,1004,4,30,9144,188380748,1,0,0,383.07,8,868705.42,26,4,22,7,True
2258177,652,0,20,1510,188380748,1,0,0,383.16,5,868322.26,24,1,16,8,True
2494191,860,1,25,4669,188380748,1,0,0,383.01,8,867939.25,24,1,6,8,True
3076316,1389,4,451,8857,188380748,1,0,0,383.15,7,867556.1,24,0,12,9,True
3124241,654,1,10,4885,188380748,1,0,0,382.94,0,867939.04,18,2,18,9,True
3332915,858,1,10,5015,188380748,1,0,0,382.9,6,868321.94,24,4,10,9,True
3702723,234,0,25,9684,188380748,1,0,0,383.13,8,867938.81,26,2,5,9,True
3993571,603,0,20,5097,188380748,1,0,0,382.9,3,867555.91,24,5,20,11,False
4307304,703,0,20,4097,188380748,1,0,0,383.16,5,867172.75,18,6,6,12,True
4420347,122,3,25,1238,188380748,1,0,0,383.12,8,866789.63,18,5,2,12,True
4451169,68,0,30,7105,188380748,1,0,0,383.0,8,866406.63,20,5,19,1,False
4636134,1114,1,10,5015,188380748,1,0,0,383.05,0,866789.68,0,1,15,2,True
4831194,1004,4,451,1238,188380748,1,0,0,383.0,7,866406.68,26,6,8,3,True
5157419,709,3,451,3747,188380748,1,0,0,382.88,7,866023.8,18,1,0,3,True
5429052,860,1,30,6852,188380748,1,0,0,383.11,8,865640.69,24,2,18,3,True
5430273,234,0,30,6852,188380748,1,0,0,382.99,8,865257.7,26,4,12,3,True
5493627,709,3,451,1969,188380748,1,0,0,383.05,7,864874.65,18,2,15,5,True
5864655,1210,0,30,7644,188380748,1,0,0,382.87,8,864491.78,24,5,21,7,True
5876739,234,0,25,4885,188380748,1,0,0,383.03,8,864108.75,26,5,4,8,True
5983863,709,3,451,9144,188380748,1,0,0,383.14,7,863725.61,18,6,18,8,True
6112980,1389,4,451,9546,188380748,1,0,0,383.32,7,863342.29,24,5,22,9,True
6120034,726,0,20,4669,188380748,1,0,0,383.13,5,862959.16,11,0,20,10,True
6333090,68,0,30,9144,188380748,1,0,0,383.37,8,862575.79,20,4,20,10,True
6500125,463,1,10,4097,188380748,1,0,0,382.84,0,862958.63,13,5,11,10,True
6594493,1201,0,10,6852,188380748,1,0,0,383.23,6,863341.86,24,0,18,11,True
6720003,860,1,451,1238,188380748,1,0,0,383.05,7,862958.81,24,1,13,11,True
6773947,496,1,10,9546,188380748,1,0,0,382.91,6,863341.72,12,0,8,12,True
6841586,234,0,451,3732,188380748,1,0,0,383.05,7,862958.67,26,1,6,12,True
6873518,122,3,25,8403,188380748,1,0,0,382.96,8,862575.71,18,6,1,1,True
6926539,783,0,10,1510,188380748,1,0,0,383.07,6,862958.78,14,6,5,1,True
6994029,1389,4,451,4885,188380748,1,0,0,382.99,7,862575.79,24,3,22,2,True
7174225,1004,4,-1,7644,188380748,1,1,0,382.86,4,862575.79,26,0,18,3,True
7185624,68,0,30,4097,188380748,1,0,0,383.03,8,862192.76,20,2,19,3,True
7282367,1004,4,-1,1510,188380748,1,1,0,382.97,4,862192.76,26,5,4,4,True
7682058,234,0,30,9144,188380748,1,0,0,382.78,8,861809.98,26,6,12,4,True
7797372,851,1,10,9144,188380748,1,0,0,383.04,6,862193.02,5,0,17,4,True
7908787,234,0,451,7105,188380748,1,0,0,383.11,7,861809.91,26,6,22,4,True
8269727,1389,4,30,1238,188380748,1,0,0,383.0,8,861426.91,24,6,10,6,True
8947958,1035,0,20,5177,188380748,1,0,0,383.16,3,861043.75,11,0,23,6,True
8965312,1389,4,30,3747,188380748,1,0,0,383.2,8,860660.55,24,2,15,6,True
8981221,1210,0,451,5177,188380748,1,0,0,382.86,7,860277.69,24,1,0,6,True
9003275,1322,2,20,3732,188380748,1,0,0,383.04,5,859894.65,18,2,8,8,True
9140959,709,3,25,7644,188380748,1,0,0,382.77,8,859511.88,18,0,13,8,True
9236594,122,3,451,1969,188380748,1,0,0,382.91,7,859128.97,18,3,10,8,True
9246476,1210,0,-1,6852,188380748,1,1,0,383.0,1,859128.97,24,5,18,8,True
9427806,1160,0,10,7644,188380748,1,0,0,383.05,6,859512.02,15,3,16,9,True
9484922,860,1,25,1510,188380748,1,0,0,382.96,8,859129.06,24,3,2,10,True
9700532,234,0,30,5097,188380748,1,0,0,382.86,8,858746.2,26,1,6,10,False
9810683,860,1,10,9684,188380748,1,0,0,382.71,6,859128.91,24,1,13,10,True
9861542,860,1,25,8857,188380748,1,0,0,383.2,8,858745.71,24,4,0,11,True
1076831,520,4,30,6316,970635974,0,0,0,701.02,8,664384.98,18,6,10,1,True
1243449,776,3,451,6316,970635974,0,0,0,700.88,7,663684.1,14,5,23,2,True
1307118,476,1,10,9111,970635974,0,0,0,701.21,0,664385.31,5,6,16,2,True
1418240,776,3,30,7895,970635974,0,0,0,701.2,8,663684.11,14,2,21,3,True
1450692,262,2,20,4174,970635974,0,0,0,701.09,3,662983.02,6,4,23,3,True
1470398,1298,0,20,6127,970635974,0,0,0,700.89,5,662282.13,5,5,2,5,True
1519275,478,4,25,3146,970635974,0,0,0,701.23,8,661580.9,5,2,10,6,True
1855364,478,4,30,2129,970635974,0,0,0,700.85,8,660880.05,5,6,15,6,True
2286035,478,4,451,1308,970635974,0,0,0,701.07,7,660178.98,5,4,23,7,True
2588235,499,3,25,4174,970635974,0,0,0,700.93,8,659478.05,12,3,3,7,True
2661404,467,0,30,8052,970635974,0,0,0,700.91,8,658777.14,5,2,19,8,True
2729835,1250,1,10,8052,970635974,0,0,0,701.06,6,659478.2,23,4,7,8,True
2765038,478,4,25,9111,970635974,0,0,0,701.01,8,658777.19,5,4,10,8,True
3348081,621,2,25,7895,970635974,0,0,0,701.09,8,658076.1,11,6,14,8,True
3413981,1141,4,25,5444,970635974,0,0,0,700.76,8,657375.34,15,0,21,8,True
3424294,520,4,451,4174,970635974,0,0,0,700.95,7,656674.39,18,0,14,9,True
3459329,478,4,25,1950,970635974,0,0,0,700.74,8,655973.65,5,3,7,9,True
3620325,478,4,451,7895,970635974,0,0,0,700.79,7,655272.86,5,0,4,10,True
3762389,520,4,30,4174,970635974,0,0,0,701.19,8,654571.67,18,5,22,11,True
3863934,564,0,10,9179,970635974,0,0,0,701.23,0,655272.9,17,0,8,12,True
4125368,776,3,30,1950,970635974,0,0,0,700.88,8,654572.02,14,2,9,12,True
4170604,269,0,10,9179,970635974,0,0,0,701.11,6,655273.13,24,1,22,1,True
4582447,478,4,451,4174,970635974,0,0,0,700.98,7,654572.15,5,6,2,1,True
4729370,790,0,10,2129,970635974,0,0,0,700.83,6,655272.98,11,6,16,1,False
4897619,478,4,25,1950,970635974,0,0,0,701.11,8,654571.87,5,3,18,2,True
5126378,854,0,10,3409,970635974,0,0,0,701.36,0,655273.23,24,4,0,4,True
5213989,962,0,20,8052,970635974,0,0,0,701.11,3,654572.12,13,3,8,5,True
5235786,478,4,-1,9179,970635974,0,1,0,700.9,1,654572.12,5,3,16,5,True
5303526,478,4,30,3409,970635974,0,0,0,701.04,8,653871.08,5,4,6,5,True
5375009,621,2,451,3409,970635974,0,0,0,700.99,7,653170.09,11,0,6,5,True
5393196,520,4,25,8052,970635974,0,0,0,701.08,8,652469.01,18,3,15,6,True
5829917,776,3,451,8052,970635974,0,0,0,701.08,7,651767.93,14,2,21,6,True
6027554,467,0,451,1950,970635974,0,0,0,700.88,7,651067.05,5,5,21,7,True
6088295,334,0,20,6324,970635974,0,0,0,700.97,3,650366.08,11,5,4,7,True
6263147,819,2,20,3146,970635974,0,0,0,701.13,5,649664.95,18,2,17,8,True
6427674,1141,4,451,1950,970635974,0,0,0,700.96,7,648963.99,15,0,8,8,True
6436385,499,3,25,6127,970635974,0,0,0,701.03,8,648262.96,12,5,20,8,True
6490619,1141,4,451,9111,970635974,0,0,0,700.96,7,647562.0,15,6,15,9,True
6504199,467,0,25,5444,970635974,0,0,0,700.99,8,646861.01,5,5,21,9,True
6718153,1141,4,30,3409,970635974,0,0,0,700.92,8,646160.09,15,5,8,10,True
7015859,577,0,20,6127,970635974,0,0,0,701.01,5,645459.08,11,5,18,10,True
7117024,467,0,451,3882,970635974,0,0,0,700.91,7,644758.17,5,6,12,12,True
7163645,867,0,20,3146,970635974,0,0,0,701.03,3,644057.14,24,6,7,12,True
7291869,1105,2,20,7895,970635974,0,0,0,701.1,5,643356.04,0,1,2,1,True
7574932,180,0,10,1950,970635974,0,0,0,701.07,6,644057.11,18,4,21,1,True
7655007,993,0,10,9179,970635974,0,0,0,701.04,6,644758.15,22,6,19,1,True
7672195,520,4,30,1950,970635974,0,0,0,700.91,8,644057.24,18,6,4,2,True
7705858,621,2,-1,7895,970635974,0,1,0,701.03,4,644057.24,11,2,13,3,True
8364453,520,4,451,9111,970635974,0,0,0,701.18,7,643356.06,18,1,1,4,True
8542192,499,3,30,6316,970635974,0,0,0,700.92,8,642655.14,12,0,8,5,True
8662293,115,2,20,6316,970635974,0,0,0,701.04,3,641954.1,3,2,8,6,True
8741067,499,3,30,2898,970635974,0,0,0,701.27,8,641252.83,12,5,3,7,True
9266446,883,0,20,6316,970635974,0,0,0,701.48,5,640551.35,24,2,12,8,True
9420303,621,2,25,8052,970635974,0,0,0,701.14,8,639850.21,11,1,1,8,True
9703057,776,3,30,3146,970635974,0,0,0,700.97,8,639149.24,14,0,0,9,True
9737422,520,4,451,2898,970635974,0,0,0,700.91,7,638448.33,18,3,0,9,True
1025677,37,3,451,1097,527502678,0,0,0,489.27,7,377388.73,11,2,3,1,True
1485257,37,3,30,1831,527502678,0,0,0,489.26,8,376899.47,11,0,8,2,True
1656800,32,3,30,3875,527502678,0,0,0,489.03,8,376410.44,11,0,13,2,True
1671727,895,0,10,1097,527502678,0,0,0,488.78,6,376899.22,24,2,9,2,True
1731884,32,3,25,8692,527502678,0,0,0,488.9,8,376410.32,11,1,3,3,True
1750943,37,3,25,6869,527502678,0,0,0,489.09,8,375921.23,11,2,13,4,True
1867881,939,0,20,6869,527502678,0,0,0,489.01,5,375432.22,24,4,20,5,True
1873755,774,2,20,2957,527502678,0,0,0,489.02,5,374943.2,14,0,16,5,True
2000082,287,0,20,8904,527502678,0,0,0,488.91,3,374454.29,24,0,16,5,False
2317444,919,4,30,3256,527502678,0,0,0,489.01,8,373965.28,18,3,7,6,False
2768029,914,2,25,7074,527502678,0,0,0,488.97,8,373476.31,18,0,10,8,False
3595653,37,3,25,1835,527502678,0,0,0,489.25,8,372987.06,11,1,8,8,True
3617446,919,4,25,8904,527502678,0,0,0,488.95,8,372498.11,18,0,22,9,True
3654433,37,3,451,7750,527502678,0,0,0,488.88,7,372009.23,11,2,13,10,False
3656159,1166,2,20,7074,527502678,0,0,0,488.88,5,371520.35,24,2,21,10,True
3758300,37,3,451,4741,527502678,0,0,0,489.23,7,371031.12,11,0,23,11,True
3889206,703,0,-1,2957,527502678,0,1,0,489.04,1,371031.12,18,6,21,12,True
3931867,37,3,25,2957,527502678,0,0,0,489.11,8,370542.01,11,2,5,1,True
4120942,377,4,25,1097,527502678,0,0,0,489.06,8,370052.95,25,6,9,2,True
4134680,919,4,25,8904,527502678,0,0,0,488.94,8,369564.01,18,1,8,3,True
4228247,1111,0,10,9460,527502678,0,0,0,489.25,6,370053.26,0,2,20,5,True
4310420,1009,0,10,2957,527502678,0,0,0,488.83,6,370542.09,26,6,0,5,True
4645837,1451,1,10,8692,527502678,0,0,0,488.94,6,371031.03,11,1,11,5,True
4652682,919,4,451,7750,527502678,0,0,0,489.09,7,370541.94,18,4,9,6,True
4659715,1111,0,10,1097,527502678,0,0,0,489.06,6,371031.0,0,6,13,7,True
4910258,377,4,451,4741,527502678,0,0,0,489.07,7,370541.93,25,1,17,7,True
5042760,377,4,30,2957,527502678,0,0,0,488.78,8,370053.15,25,1,14,8,True
5162027,37,3,30,8561,527502678,0,0,0,488.9,8,369564.25,11,2,17,8,True
5174221,1180,1,10,2957,527502678,0,0,0,488.58,6,370052.83,24,5,9,9,True
5334371,703,0,25,1097,527502678,0,0,0,489.0,8,369563.83,18,4,4,9,True
5353043,32,3,30,2957,527502678,0,0,0,489.03,8,369074.8,11,3,10,10,True
5486777,757,0,10,1835,527502678,0,0,0,488.95,6,369563.75,24,4,19,11,True
5613942,703,0,451,1097,527502678,0,0,0,488.99,7,369074.76,18,0,22,12,True
5636207,914,2,25,2957,527502678,0,0,0,488.94,8,368585.82,18,2,13,12,True
5661005,377,4,-1,1831,527502678,0,1,0,489.35,1,368585.82,25,1,23,1,True
5906808,914,2,25,9460,527502678,0,0,0,489.06,8,368096.76,18,4,11,1,True
6203606,32,3,25,7074,527502678,0,0,0,489.13,8,367607.63,11,5,2,1,True
6487600,919,4,451,1097,527502678,0,0,0,489.0,7,367118.63,18,6,7,1,True
6548059,32,3,30,3256,527502678,0,0,0,489.08,8,366629.55,11,6,4,2,True
6559929,919,4,451,8904,527502678,0,0,0,488.94,7,366140.61,18,5,5,2,True
6865592,703,0,451,4741,527502678,0,0,0,489.21,7,365651.4,18,0,18,2,True
6876580,703,0,-1,8904,527502678,0,1,0,489.03,1,365651.4,18,2,17,2,True
6890943,703,0,25,1097,527502678,0,0,0,488.8,8,365162.6,18,1,2,3,True
7541513,37,3,30,9460,527502678,0,0,0,488.95,8,364673.65,11,4,13,4,True
7593511,32,3,25,6869,527502678,0,0,0,488.79,8,364184.86,11,5,23,5,True
8140395,378,0,20,7074,527502678,0,0,0,489.12,3,363695.74,25,6,11,6,True
8359042,914,2,25,3256,527502678,0,0,0,488.91,8,363206.83,18,0,4,6,True
8528992,703,0,25,4039,527502678,0,0,0,489.26,8,362717.57,18,1,12,6,True
8816526,919,4,451,4741,527502678,0,0,0,489.16,7,362228.41,18,6,11,7,True
8831909,32,3,-1,4039,527502678,0,1,0,489.18,1,362228.41,11,1,0,7,True
8932172,919,4,30,3875,527502678,0,0,0,489.15,8,361739.26,18,2,20,8,True
9325780,20,0,20,3256,527502678,0,0,0,488.67,3,361250.59,24,6,5,10,True
9498131,32,3,30,3256,527502678,0,0,0,488.93,8,360761.66,11,4,11,10,True
9711305,919,4,451,1835,527502678,0,0,0,488.86,7,360272.8,18,0,13,11,True
9775998,1127,0,10,1835,527502678,0,0,0,488.93,6,360761.73,24,1,11,11,False
1231446,175,3,451,3078,718487679,1,0,0,667.01,7,996452.99,24,5,2,1,True
1637488,1124,0,30,4320,718487679,1,0,0,667.01,8,995785.98,24,5,16,1,False
1690639,59,0,20,1527,718487679,1,0,0,666.79,5,995119.19,20,1,15,3,True
1857074,175,3,25,6614,718487679,1,0,0,667.16,8,994452.03,24,0,2,4,True
1886718,1346,4,451,7696,718487679,1,0,0,666.9,7,993785.13,24,1,7,5,True
1988327,175,3,30,2166,718487679,1,0,0,666.76,8,993118.37,24,1,13,5,True
2024166,210,4,-1,2166,718487679,1,1,0,666.96,4,993118.37,9,1,23,6,True
2080828,175,3,25,8164,718487679,1,0,0,666.94,8,992451.43,24,3,21,7,True
2171537,360,0,20,4320,718487679,1,0,0,666.7,3,991784.73,24,3,4,8,True
2376271,175,3,25,2050,718487679,1,0,0,666.94,8,991117.79,24,0,13,9,True
2503284,564,0,10,3494,718487679,1,0,0,666.99,0,991784.78,17,6,2,9,True
2693112,592,4,30,1527,718487679,1,0,0,667.06,8,991117.72,24,1,0,11,True
2898008,365,0,10,9275,718487679,1,0,0,666.91,6,991784.63,25,1,16,11,True
3026987,175,3,-1,7159,718487679,1,1,0,667.06,4,991784.63,24,5,12,11,False
3104418,1217,0,10,4765,718487679,1,0,0,667.03,6,992451.66,24,6,20,12,True
3167514,175,3,30,7696,718487679,1,0,0,667.19,8,991784.47,24,0,1,12,True
3655644,200,0,10,8125,718487679,1,0,0,667.13,6,992451.6,9,4,17,12,True
3755953,1014,1,10,6614,718487679,1,0,0,667.04,0,993118.64,26,5,7,12,True
3962286,909,2,25,5368,718487679,1,0,0,667.2,8,992451.44,18,6,19,1,False
4151826,210,4,25,3078,718487679,1,0,0,666.64,8,991784.8,9,6,19,1,True
4481234,175,3,30,5390,718487679,1,0,0,667.0,8,991117.8,24,1,3,1,True
4624068,1346,4,30,5868,718487679,1,0,0,667.25,8,990450.55,24,4,13,1,True
4728076,703,0,20,5868,718487679,1,0,0,667.06,3,989783.49,18,3,6,2,True
4744949,485,1,10,3078,718487679,1,0,0,666.76,6,990450.25,5,3,14,2,True
4844727,1346,4,-1,5868,718487679,1,1,0,666.93,4,990450.25,24,1,22,2,True
4982632,1124,0,30,3494,718487679,1,0,0,666.88,8,989783.37,24,2,2,3,True
4995485,909,2,-1,8254,718487679,1,1,0,666.96,4,989783.37,18,4,13,3,True
5385442,909,2,451,7719,718487679,1,0,0,667.13,7,989116.24,18,1,18,3,True
5638745,1124,0,-1,8122,718487679,1,1,0,666.71,1,989116.24,24,6,18,4,True
5967782,1346,4,30,4765,718487679,1,0,0,667.07,8,988449.17,24,5,8,4,True
6059727,1124,0,451,5868,718487679,1,0,0,666.85,7,987782.32,24,5,7,4,True
6102966,210,4,30,9460,718487679,1,0,0,667.38,8,987114.94,9,6,8,5,True
6264979,210,4,25,9460,718487679,1,0,0,667.25,8,986447.69,9,0,21,7,True
6568512,1346,4,451,3494,718487679,1,0,0,666.74,7,985780.95,24,5,23,7,True
6606594,1124,0,451,9460,718487679,1,0,0,667.23,7,985113.72,24,0,9,8,True
6645213,210,4,451,8254,718487679,1,0,0,666.84,7,984446.88,9,4,2,9,True
6675543,592,4,451,2544,718487679,1,0,0,666.95,7,983779.93,24,1,1,10,True
6707568,909,2,30,2166,718487679,1,0,0,666.76,8,983113.17,18,3,0,11,True
6924838,1124,0,-1,2050,718487679,1,1,0,666.74,4,983113.17,24,1,13,11,True
7131509,1124,0,25,8125,718487679,1,0,0,667.13,8,982446.04,24,0,10,12,True
7257940,175,3,451,8122,718487679,1,0,0,666.88,7,981779.16,24,0,16,1,True
7315543,910,0,20,5390,718487679,1,0,0,667.08,5,981112.08,18,5,0,1,True
7380290,1454,1,10,2302,718487679,1,0,0,666.83,6,981778.91,11,5,17,2,True
7385071,713,0,10,5368,718487679,1,0,0,666.71,6,982445.62,18,3,18,2,True
7494967,1029,0,20,4665,718487679,1,0,0,667.2,5,981778.42,11,0,9,2,True
7599606,909,2,451,4665,718487679,1,0,0,667.08,7,981111.34,18,0,1,4,True
7852512,175,3,25,2166,718487679,1,0,0,666.93,8,980444.41,24,5,20,4,True
7990172,1346,4,-1,5868,718487679,1,1,0,666.96,1,980444.41,24,4,4,5,True
8373799,807,0,10,5868,718487679,1,0,0,666.88,6,981111.29,11,6,22,5,True
8393829,1346,4,-1,3078,718487679,1,1,0,667.24,4,981111.29,24,1,15,6,True
8823491,1297,0,10,7159,718487679,1,0,0,667.18,0,981778.47,5,6,14,7,True
8915763,1346,4,25,3078,718487679,1,0,0,666.75,8,981111.72,24,5,4,8,True
9120312,1124,0,30,8164,718487679,1,0,0,667.15,8,980444.57,24,3,8,8,True
9375575,1346,4,-1,7476,718487679,1,1,0,666.88,4,980444.57,24,5,8,8,True
9452537,1124,0,25,8254,718487679,1,0,0,667.1,8,979777.47,24,3,0,9,True
9872221,713,0,10,7447,718487679,1,0,0,667.1,6,980444.57,18,1,10,9,True
9910219,1124,0,451,5868,718487679,1,0,0,666.94,7,979777.63,24,0,9,10,True
9913821,1346,4,30,4320,718487679,1,0,0,666.97,8,979110.66,24,0,20,11,True
1012855,917,0,20,1748,553907874,0,0,0,1155.02,3,292796.98,18,2,0,1,True
1043174,26,3,451,3096,553907874,0,0,0,1154.85,7,291642.13,11,0,4,1,True
1294503,1152,0,451,8688,553907874,0,0,0,1154.84,7,290487.29,15,5,13,1,True
1386654,723,1,10,2018,553907874,0,0,0,1155.01,6,291642.3,11,4,21,3,True
1507428,830,3,451,5505,553907874,0,0,0,1154.92,7,290487.38,18,1,23,3,True
1616163,445,0,30,5964,553907874,0,0,0,1154.82,8,289332.56,13,4,20,4,True
1814865,830,3,30,8546,553907874,0,0,0,1155.23,8,288177.33,18,2,7,5,True
1860744,26,3,451,8041,553907874,0,0,0,1154.78,7,287022.55,11,6,16,5,True
1889466,504,4,30,5851,553907874,0,0,0,1154.95,8,285867.6,12,0,0,5,True
1988717,445,0,30,2330,553907874,0,0,0,1155.11,8,284712.49,13,6,3,6,True
1997517,518,2,20,3096,553907874,0,0,0,1155.08,5,283557.41,18,0,0,6,True
2082472,504,4,-1,5851,553907874,0,1,0,1155.27,1,283557.41,12,2,4,7,True
2122251,1354,0,20,5851,553907874,0,0,0,1155.08,3,282402.33,24,6,11,9,True
2353073,504,4,25,3087,553907874,0,0,0,1155.01,8,281247.32,12,5,3,10,True
2733890,715,0,10,3096,553907874,0,0,0,1154.82,6,282402.14,18,0,4,10,True
2773744,504,4,25,6847,553907874,0,0,0,1155.03,8,281247.11,12,0,6,10,True
2841773,113,4,451,4460,553907874,0,0,0,1155.05,7,280092.06,3,4,19,11,True
2994145,26,3,451,9149,553907874,0,0,0,1154.67,7,278937.39,11,2,19,12,True
3014857,113,4,25,6847,553907874,0,0,0,1154.92,8,277782.47,3,0,4,1,False
3295214,1152,0,25,5505,553907874,0,0,0,1154.88,8,276627.59,15,4,12,2,True
3429042,287,0,451,5883,553907874,0,0,0,1155.11,7,275472.48,24,4,3,2,True
3571143,113,4,25,2018,553907874,0,0,0,1154.95,8,274317.53,3,0,6,2,False
4063022,1152,0,-1,3096,553907874,0,1,0,1155.16,4,274317.53,15,5,22,4,True
4163557,1152,0,-1,1654,553907874,0,2,0,1154.93,4,274317.53,15,2,22,5,True
4203890,1446,1,10,5505,553907874,0,0,0,1154.94,6,275472.47,24,4,19,5,True
4782249,445,0,25,1654,553907874,0,0,0,1155.02,8,274317.45,13,2,5,5,True
5006579,113,4,451,5851,553907874,0,0,0,1155.39,7,273162.06,3,2,8,5,True
5064810,113,4,451,7814,553907874,0,0,0,1154.88,7,272007.18,3,6,0,6,True
5091806,1339,2,20,6847,553907874,0,0,0,1155.05,5,270852.13,18,5,17,6,True
5387534,26,3,30,7814,553907874,0,0,0,1154.94,8,269697.19,11,6,22,8,True
5575225,1022,4,25,8688,553907874,0,0,0,1155.29,8,268541.9,11,4,13,9,False
5712884,1152,0,-1,9268,553907874,0,1,0,1154.9,4,268541.9,15,6,11,9,True
5791100,113,4,451,8999,553907874,0,0,0,1154.77,7,267387.13,3,4,3,11,True
5824165,113,4,-1,8091,553907874,0,1,0,1155.19,4,267387.13,3,1,4,12,True
5834580,858,1,10,3096,553907874,0,0,0,1155.14,6,268542.27,24,6,4,12,True
5960320,504,4,-1,5851,553907874,0,1,0,1154.89,1,268542.27,12,0,8,1,True
6003444,830,3,25,4460,553907874,0,0,0,1155.01,8,267387.26,18,3,11,2,True
6616998,445,0,25,8999,553907874,0,0,0,1155.23,8,266232.03,13,5,9,2,True
6842370,287,0,451,6154,553907874,0,0,0,1155.04,7,265076.99,24,5,4,3,True
6980278,309,0,10,5883,553907874,0,0,0,1154.92,6,266231.91,4,5,21,3,True
7352925,504,4,451,8091,553907874,0,0,0,1155.1,7,265076.81,12,6,7,5,True
7408267,1152,0,25,3096,553907874,0,0,0,1155.19,8,263921.62,15,4,9,7,True
7523095,1063,0,10,5851,553907874,0,0,0,1155.05,6,265076.67,11,3,16,8,True
7546020,26,3,30,8091,553907874,0,0,0,1155.02,8,263921.65,11,0,20,8,True
7577445,645,0,20,6847,553907874,0,0,0,1154.85,5,262766.8,24,4,12,8,True
7917650,445,0,451,7814,553907874,0,0,0,1155.22,7,261611.58,13,5,20,8,True
7920715,287,0,25,2869,553907874,0,0,0,1154.73,8,260456.85,24,6,8,9,True
8409611,1152,0,451,9944,553907874,0,0,0,1154.93,7,259301.92,15,3,19,9,True
8909138,607,2,20,8546,553907874,0,0,0,1155.43,5,258146.49,24,5,10,9,True
9313221,26,3,30,8999,553907874,0,0,0,1154.98,8,256991.51,11,3,15,11,True
1038969,175,3,451,1164,346327652,1,0,0,973.8,7,805528.2,24,2,1,1,True
1483107,1160,0,10,2347,346327652,1,0,0,974.03,6,806502.23,15,4,0,1,True
1535597,497,0,20,8871,346327652,1,0,0,974.03,5,805528.2,12,6,5,1,True
1685452,654,1,25,9547,346327652,1,0,0,974.02,8,804554.18,18,5,9,2,True
1957403,654,1,25,2937,346327652,1,0,0,973.91,8,803580.27,18,1,21,3,True
2008833,898,1,451,1188,346327652,1,0,0,973.82,7,802606.45,24,4,10,3,True
2141794,424,1,451,1193,346327652,1,0,0,973.91,7,801632.54,18,5,22,4,True
2626611,654,1,-1,7976,346327652,1,1,0,974.0,4,801632.54,18,4,9,4,False
2751938,175,3,451,7169,346327652,1,0,0,974.02,7,800658.52,24,0,3,4,True
2815277,761,2,20,4209,346327652,1,0,0,973.91,5,799684.61,24,5,10,4,True
3058502,654,1,25,8871,346327652,1,0,0,974.23,8,798710.38,18,1,16,5,True
3142134,1354,0,10,9547,346327652,1,0,0,973.83,6,799684.21,24,3,0,5,True
3174748,611,0,25,1495,346327652,1,0,0,974.01,8,798710.2,11,4,2,5,True
3200819,611,0,30,5789,346327652,1,0,0,973.98,8,797736.22,11,4,22,6,True
3279103,175,3,-1,7097,346327652,1,1,0,973.8,4,797736.22,24,3,18,9,True
3380702,114,0,20,2402,346327652,1,0,0,973.87,5,796762.35,3,5,16,9,True
3716529,278,1,10,6418,346327652,1,0,0,973.89,0,797736.24,24,4,22,10,True
3926361,898,1,25,6418,346327652,1,0,0,974.02,8,796762.22,24,0,20,12,True
4078708,525,0,20,1868,346327652,1,0,0,974.08,3,795788.14,18,6,15,1,True
4150800,882,0,10,1164,346327652,1,0,0,973.96,0,796762.1,27,4,13,1,True
4248512,898,1,25,8454,346327652,1,0,0,974.02,8,795788.08,24,2,21,2,True
4403031,654,1,-1,5865,346327652,1,1,0,973.78,4,795788.08,18,0,21,2,True
4422702,1181,2,20,1193,346327652,1,0,0,973.7,5,794814.38,24,4,2,2,True
4507241,611,0,-1,7097,346327652,1,1,0,974.28,1,794814.38,11,0,18,3,True
4559550,424,1,451,5865,346327652,1,0,0,973.92,7,793840.46,18,4,7,3,True
4629356,239,1,10,2937,346327652,1,0,0,974.06,0,794814.52,26,0,21,4,True
4684162,1089,0,20,1193,346327652,1,0,0,974.09,3,793840.43,18,5,16,4,False
4981889,898,1,25,3799,346327652,1,0,0,974.15,8,792866.28,24,2,14,5,True
5042244,1116,0,20,1868,346327652,1,0,0,973.91,5,791892.37,24,4,15,5,True
5114692,611,0,30,6663,346327652,1,0,0,973.93,8,790918.44,11,2,22,5,True
5770349,611,0,30,6418,346327652,1,0,0,973.89,8,789944.55,11,0,1,6,False
5804737,424,1,25,7169,346327652,1,0,0,973.95,8,788970.6,18,6,10,8,True
5844699,656,2,20,8420,346327652,1,0,0,974.19,3,787996.41,18,4,10,8,True
6065839,175,3,30,2347,346327652,1,0,0,973.94,8,787022.47,24,0,19,10,True
6249807,175,3,-1,5789,346327652,1,1,0,973.88,1,787022.47,24,0,12,10,True
6268503,654,1,451,1193,346327652,1,0,0,973.9,7,786048.57,18,2,20,1,True
6474941,898,1,451,3893,346327652,1,0,0,974.14,7,785074.43,24,5,13,1,True
6690016,898,1,25,6433,346327652,1,0,0,974.05,8,784100.38,24,6,6,2,True
6902510,175,3,451,8420,346327652,1,0,0,974.18,7,783126.2,24,2,11,2,True
6939979,652,0,10,5789,346327652,1,0,0,974.07,6,784100.27,24,6,13,2,True
7158665,611,0,-1,3799,346327652,1,1,0,974.12,1,784100.27,11,1,16,3,True
7368087,654,1,30,6433,346327652,1,0,0,973.96,8,783126.31,18,4,12,3,True
7484496,168,0,10,8872,346327652,1,0,0,973.82,6,784100.13,24,6,5,3,True
7571064,898,1,451,6663,346327652,1,0,0,974.13,7,783126.0,24,1,8,4,True
7659409,424,1,451,5789,346327652,1,0,0,973.93,7,782152.07,18,1,7,4,True
7690070,866,0,10,2402,346327652,1,0,0,974.09,0,783126.16,24,3,18,5,False
7815590,898,1,-1,7097,346327652,1,1,0,973.79,4,783126.16,24,5,7,6,True
7822528,175,3,25,2402,346327652,1,0,0,973.87,8,782152.29,24,0,2,6,False
7994222,611,0,30,8420,346327652,1,0,0,973.79,8,781178.5,11,5,19,6,False
8040451,175,3,451,1047,346327652,1,0,0,974.07,7,780204.43,24,1,7,6,True
8117428,175,3,451,7976,346327652,1,0,0,973.95,7,779230.48,24,2,20,7,True
8521935,424,1,30,2347,346327652,1,0,0,974.09,8,778256.39,18,1,19,8,False
8563832,898,1,25,8871,346327652,1,0,0,973.99,8,777282.4,24,0,13,9,True
8594215,611,0,451,3893,346327652,1,0,0,973.96,7,776308.44,11,6,17,9,False
9157190,649,0,20,3799,346327652,1,0,0,974.11,5,775334.33,24,3,17,10,True
9465749,1035,0,20,8454,346327652,1,0,0,973.92,5,774360.41,11,5,10,11,True
9705061,542,0,20,8454,346327652,1,0,0,973.84,5,773386.57,17,6,8,11,True
9716365,898,1,25,7097,346327652,1,0,0,974.11,8,772412.46,24,6,2,11,True
1075389,1312,0,25,4824,679557018,0,0,0,1061.09,8,891615.91,5,5,13,2,True
1175982,1208,4,30,7074,679557018,0,0,0,1061.01,8,890554.9,24,3,2,2,True
1214589,259,4,451,5514,679557018,0,0,0,1060.89,7,889494.01,6,0,9,3,True
1355096,767,0,10,3247,679557018,0,0,0,1060.91,6,890554.92,14,1,20,3,True
1432722,1285,1,-1,5587,679557018,0,1,0,1060.83,4,890554.92,24,2,4,5,True
1608673,670,0,10,8591,679557018,0,0,0,1060.95,6,891615.87,18,4,12,6,True
1803934,894,3,30,3751,679557018,0,0,0,1061.02,8,890554.85,24,4,16,9,True
2120336,1212,0,20,3347,679557018,0,0,0,1060.96,5,889493.89,24,6,7,9,True
2652736,1112,1,10,5514,679557018,0,0,0,1061.27,0,890555.16,0,0,4,9,True
2795554,259,4,25,4332,679557018,0,0,0,1060.8,8,889494.36,6,2,16,9,True
2944582,894,3,451,3751,679557018,0,0,0,1061.23,7,888433.13,24,4,19,9,True
3162475,1208,4,451,3527,679557018,0,0,0,1061.08,7,887372.05,24,2,16,11,True
3382733,894,3,30,5455,679557018,0,0,0,1060.83,8,886311.22,24,0,13,12,True
3419102,894,3,25,5932,679557018,0,0,0,1061.2,8,885250.02,24,0,2,1,True
3792672,304,0,10,3194,679557018,0,0,0,1060.95,0,886310.97,4,1,20,1,True
3869372,1044,0,20,3751,679557018,0,0,0,1061.01,5,885249.96,11,5,23,1,True
3957754,1023,2,20,6047,679557018,0,0,0,1061.29,5,884188.67,11,1,0,1,True
4050867,1312,0,25,6450,679557018,0,0,0,1060.71,8,883127.96,5,3,10,2,True
4428656,259,4,25,6450,679557018,0,0,0,1060.93,8,882067.03,6,5,2,2,True
4456302,1312,0,30,5514,679557018,0,0,0,1061.0,8,881006.03,5,1,4,2,True
4577228,259,4,30,3247,679557018,0,0,0,1060.94,8,879945.09,6,5,0,2,True
4768098,1164,0,20,4824,679557018,0,0,0,1060.95,3,878884.14,24,1,17,2,True
5204129,211,0,20,5587,679557018,0,0,0,1060.88,5,877823.26,9,2,8,2,True
5352799,1285,1,25,6450,679557018,0,0,0,1061.18,8,876762.08,24,1,0,3,True
5373085,1245,1,10,7891,679557018,0,0,0,1061.11,0,877823.19,18,5,5,5,True
5450937,393,1,10,3347,679557018,0,0,0,1060.82,0,878884.01,10,5,1,7,False
5934472,1312,0,451,4332,679557018,0,0,0,1061.11,7,877822.9,5,0,8,7,False
6355043,894,3,25,3751,679557018,0,0,0,1061.2,8,876761.7,24,1,4,9,True
6709847,1208,4,25,6450,679557018,0,0,0,1060.91,8,875700.79,24,5,4,9,True
7046473,1312,0,451,3527,679557018,0,0,0,1060.76,7,874640.03,5,4,4,10,True
7048385,1304,0,10,7074,679557018,0,0,0,1061.18,6,875701.21,5,6,4,10,True
7061509,259,4,30,5587,679557018,0,0,0,1060.98,8,874640.23,6,6,9,10,True
7142598,1285,1,25,7074,679557018,0,0,0,1061.29,8,873578.94,24,5,11,11,True
7453421,1312,0,30,3527,679557018,0,0,0,1061.4,8,872517.54,5,5,14,2,True
7765171,1285,1,25,3751,679557018,0,0,0,1061.18,8,871456.36,24,6,13,2,True
7787304,894,3,451,5455,679557018,0,0,0,1060.94,7,870395.42,24,0,23,2,True
7805975,1312,0,-1,5455,679557018,0,1,0,1061.16,1,870395.42,5,4,22,3,True
7854406,1285,1,25,5587,679557018,0,0,0,1061.26,8,869334.16,24,6,7,4,True
8121496,1208,4,30,5455,679557018,0,0,0,1061.1,8,868273.06,24,2,1,4,True
8356711,1312,0,451,4824,679557018,0,0,0,1060.89,7,867212.17,5,1,17,4,False
8429930,1284,2,20,3751,679557018,0,0,0,1060.95,3,866151.22,24,3,21,5,True
8455423,259,4,30,7891,679557018,0,0,0,1061.05,8,865090.17,6,4,15,5,True
8563302,1072,0,10,7891,679557018,0,0,0,1060.89,0,866151.06,18,0,12,5,True
8585103,1285,1,451,3194,679557018,0,0,0,1060.97,7,865090.09,24,1,19,6,True
8749791,894,3,25,5932,679557018,0,0,0,1061.17,8,864028.92,24,6,17,6,True
9495373,1285,1,30,3347,679557018,0,0,0,1061.16,8,862967.76,24,3,3,7,True
9599026,259,4,-1,3194,679557018,0,1,0,1060.91,1,862967.76,6,4,16,8,True
9676153,496,1,10,5587,679557018,0,0,0,1060.84,0,864028.6,12,1,22,8,True
9694238,1285,1,30,8591,679557018,0,0,0,1060.93,8,862967.67,24,5,6,11,True
9913863,1312,0,451,5932,679557018,0,0,0,1061.13,7,861906.54,5,5,12,11,True
1118994,1495,3,30,9823,726581709,1,0,0,492.94,8,620799.06,24,5,15,1,True
1597850,661,4,451,8199,726581709,1,0,0,493.23,7,620305.83,18,3,23,1,True
1686248,292,1,25,5066,726581709,1,0,0,492.93,8,619812.9,4,0,13,1,True
1747160,1321,0,30,5592,726581709,1,0,0,492.8,8,619320.1,18,3,21,2,True
1990075,1180,1,-1,4627,726581709,1,1,0,492.96,1,619320.1,24,4,15,3,True
2058945,1495,3,451,7389,726581709,1,0,0,493.27,7,618826.83,24,2,13,3,True
2084221,1180,1,451,4627,726581709,1,0,0,492.98,7,618333.85,24,1,14,3,True
2103627,1321,0,30,1628,726581709,1,0,0,492.91,8,617840.94,18,3,21,4,True
2156664,677,0,451,7444,726581709,1,0,0,493.03,7,617347.91,24,4,21,5,True
2445453,677,0,30,1890,726581709,1,0,0,492.91,8,616855.0,24,3,4,7,True
2583992,355,1,10,5777,726581709,1,0,0,492.88,6,617347.88,24,2,17,8,True
2688651,1180,1,30,2026,726581709,1,0,0,492.95,8,616854.93,24,1,0,8,True
2771093,471,0,-1,3110,726581709,1,1,0,493.26,4,616854.93,5,1,0,8,True
2947131,661,4,30,2129,726581709,1,0,0,493.0,8,616361.93,18,2,15,9,True
2999593,677,0,25,7975,726581709,1,0,0,492.75,8,615869.18,24,4,20,9,True
3033472,1180,1,451,8199,726581709,1,0,0,492.8,7,615376.38,24,1,14,10,True
3158260,292,1,30,3528,726581709,1,0,0,493.05,8,614883.33,4,5,7,1,True
3615197,1321,0,-1,1990,726581709,1,1,0,492.79,1,614883.33,18,5,17,1,True
3632271,292,1,-1,3833,726581709,1,2,0,492.73,4,614883.33,4,4,22,1,True
3805378,1321,0,451,2207,726581709,1,0,0,493.24,7,614390.09,18,5,6,3,True
3823423,661,4,-1,1890,726581709,1,1,0,493.03,1,614390.09,18,6,10,3,True
3849701,1495,3,451,2026,726581709,1,0,0,493.0,7,613897.09,24,0,12,4,True
4362245,471,0,451,7975,726581709,1,0,0,492.81,7,613404.28,5,0,2,4,True
4407371,292,1,-1,1628,726581709,1,1,0,492.92,4,613404.28,4,5,22,5,True
4441637,661,4,25,4627,726581709,1,0,0,492.86,8,612911.42,18,4,9,6,True
4545625,168,0,10,1628,726581709,1,0,0,492.91,6,613404.33,24,6,22,6,True
4582423,1495,3,25,1628,726581709,1,0,0,493.01,8,612911.32,24,0,4,7,True
4638434,1321,0,451,7389,726581709,1,0,0,492.79,7,612418.53,18,1,6,8,True
4700967,292,1,-1,1890,726581709,1,1,0,492.96,1,612418.53,4,4,1,9,True
4880507,297,0,20,5592,726581709,1,0,0,492.7,5,611925.83,4,6,8,10,True
4943220,215,0,20,9035,726581709,1,0,0,492.92,5,611432.91,9,2,1,11,True
4978965,677,0,451,9035,726581709,1,0,0,493.07,7,610939.84,24,6,13,12,True
5182544,1495,3,25,1990,726581709,1,0,0,492.77,8,610447.07,24,2,23,12,True
5613773,661,4,-1,3528,726581709,1,1,0,493.14,1,610447.07,18,6,20,12,True
5619298,1321,0,30,4627,726581709,1,0,0,492.94,8,609954.13,18,6,23,12,True
5736046,168,0,10,3528,726581709,1,0,0,493.23,0,610447.36,24,0,4,1,True
6203025,1000,0,20,2129,726581709,1,0,0,492.96,3,609954.4,26,0,19,1,True
6405665,1495,3,25,5777,726581709,1,0,0,492.99,8,609461.41,24,1,1,1,True
6845739,677,0,30,3528,726581709,1,0,0,493.37,8,608968.04,24,0,13,3,True
7093795,696,2,20,7975,726581709,1,0,0,493.14,5,608474.9,24,3,7,3,True
7145218,446,1,10,2207,726581709,1,0,0,493.02,0,608967.92,13,4,4,4,True
7430486,20,0,20,5592,726581709,1,0,0,493.23,5,608474.69,24,5,4,4,True
8215675,318,0,10,2129,726581709,1,0,0,492.69,6,608967.38,11,0,7,4,True
8300329,292,1,-1,2129,726581709,1,1,0,493.06,1,608967.38,4,2,18,6,True
8615837,1180,1,25,3110,726581709,1,0,0,492.81,8,608474.57,24,1,11,7,True
8683987,471,0,30,1990,726581709,1,0,0,492.84,8,607981.73,5,1,3,7,True
8850306,661,4,451,3110,726581709,1,0,0,492.84,7,607488.89,18,2,15,8,True
9165029,865,0,10,3833,726581709,1,0,0,492.79,6,607981.68,24,4,3,8,True
9194480,471,0,30,2129,726581709,1,0,0,493.03,8,607488.65,5,1,17,9,True
9217190,1180,1,30,5592,726581709,1,0,0,492.98,8,606995.67,24,3,8,9,True
9301899,292,1,-1,1628,726581709,1,1,0,493.13,4,606995.67,4,5,1,9,True
9507299,1314,2,20,9823,726581709,1,0,0,492.98,5,606502.69,5,3,16,9,True
9770613,1495,3,30,7389,726581709,1,0,0,493.05,8,606009.64,24,1,21,10,True
9804333,1321,0,-1,2207,726581709,1,1,0,492.93,1,606009.64,18,2,10,11,True
9931762,1495,3,25,7975,726581709,1,0,0,492.47,8,605517.17,24,5,17,11,True
1282928,831,1,30,2571,146687544,1,0,0,331.0,8,547468.0,5,2,9,3,True
1553070,1089,0,451,2037,146687544,1,0,0,331.03,7,547136.97,18,3,8,4,True
1630983,849,1,10,7647,146687544,1,0,0,331.1,0,547468.07,5,5,18,10,True
1749101,1107,3,30,2643,146687544,1,0,0,331.23,8,547136.84,0,1,23,10,True
1775490,1107,3,30,6603,146687544,1,0,0,330.96,8,546805.88,0,5,22,12,True
1970587,523,2,20,9392,146687544,1,0,0,330.92,3,546474.96,18,6,8,1,True
2168827,1089,0,451,3211,146687544,1,0,0,330.81,7,546144.15,18,1,7,5,True
2531575,950,0,30,5886,146687544,1,0,0,330.97,8,545813.18,24,0,13,5,True
2650295,1107,3,-1,4985,146687544,1,1,0,331.11,1,545813.18,0,5,0,7,True
2954627,950,0,-1,3400,146687544,1,2,0,330.98,4,545813.18,24,4,7,12,True
2974454,1429,0,10,6603,146687544,1,0,0,331.17,0,546144.35,24,3,11,4,True
2975902,950,0,25,9638,146687544,1,0,0,331.13,8,545813.22,24,5,5,6,True
2985836,1089,0,-1,9392,146687544,1,1,0,331.01,4,545813.22,18,5,15,8,True
3369134,831,1,-1,2571,146687544,1,2,0,331.05,4,545813.22,5,1,10,9,True
3598179,1089,0,-1,2624,146687544,1,3,1,330.94,4,545813.22,18,4,9,11,True
1035327,1107,3,25,1948,102589938,1,0,0,417.96,8,149121.04,0,3,21,1,True
1201746,529,2,30,9923,102589938,1,0,0,418.0,8,148703.04,18,4,15,1,True
1289678,390,4,25,5291,102589938,1,0,0,417.86,8,148285.18,10,2,1,2,True
1364082,329,1,-1,6951,102589938,1,1,0,417.88,4,148285.18,11,3,2,3,True
1468099,1034,1,-1,6997,102589938,1,2,0,417.86,4,148285.18,11,2,23,4,True
1538992,963,4,30,5653,102589938,1,0,0,417.95,8,147867.23,13,6,6,4,True
1541331,866,0,20,2609,102589938,1,0,0,417.86,5,147449.37,24,6,15,4,True
1598805,329,1,451,1948,102589938,1,0,0,418.15,7,147031.22,11,6,13,6,True
1603601,1107,3,451,5735,102589938,1,0,0,418.21,7,146613.01,0,1,23,7,True
1627832,986,4,30,5637,102589938,1,0,0,417.91,8,146195.1,22,2,15,8,True
1948624,1107,3,451,8612,102589938,1,0,0,417.99,7,145777.11,0,6,16,8,True
2139033,309,0,20,8612,102589938,1,0,0,418.08,5,145359.03,4,0,8,8,True
2152669,390,4,451,8612,102589938,1,0,0,417.82,7,144941.21,10,3,23,11,True
2158867,1445,2,20,9356,102589938,1,0,0,417.95,3,144523.26,24,5,9,11,True
2212679,986,4,451,9519,102589938,1,0,0,417.71,7,144105.55,22,4,17,11,True
2587732,327,0,20,4420,102589938,1,0,0,418.27,3,143687.28,11,0,23,12,True
2592888,222,2,25,3183,102589938,1,0,0,417.92,8,143269.36,26,2,8,12,True
2725612,849,1,10,8986,102589938,1,0,0,418.16,0,143687.52,5,6,22,1,True
2756001,529,2,-1,5653,102589938,1,1,0,418.11,4,143687.52,18,4,1,2,True
3372552,390,4,25,8612,102589938,1,0,0,418.08,8,143269.44,10,5,2,4,True
3378661,963,4,30,2269,102589938,1,0,0,417.75,8,142851.69,13,5,10,5,True
3522766,607,2,20,2269,102589938,1,0,0,417.98,5,142433.71,24,1,18,5,True
3671261,1361,2,20,8590,102589938,1,0,0,418.12,5,142015.59,16,0,5,5,True
3715494,986,4,30,3579,102589938,1,0,0,418.02,8,141597.57,22,2,14,6,True
3957780,329,1,-1,8239,102589938,1,1,0,418.11,4,141597.57,11,4,20,6,True
4329898,1170,0,10,8239,102589938,1,0,0,418.12,6,142015.69,24,3,20,6,True
4498216,1107,3,30,9356,102589938,1,0,0,418.04,8,141597.65,0,2,11,7,True
4629252,986,4,451,8612,102589938,1,0,0,418.14,7,141179.51,22,4,21,7,True
4695853,1404,2,20,7522,102589938,1,0,0,418.08,3,140761.43,24,1,6,10,True
4737936,529,2,25,8805,102589938,1,0,0,417.97,8,140343.46,18,6,20,12,True
4745342,329,1,-1,5735,102589938,1,1,0,418.09,4,140343.46,11,6,13,12,True
5011725,390,4,451,8612,102589938,1,0,0,417.94,7,139925.52,10,2,18,12,True
5043888,1034,1,451,4284,102589938,1,0,0,418.01,7,139507.51,11,0,20,1,True
5098970,1036,1,10,9028,102589938,1,0,0,417.9,6,139925.41,11,1,3,1,True
5171114,1064,0,20,5637,102589938,1,0,0,418.12,5,139507.29,11,4,3,1,True
5339183,727,0,10,7522,102589938,1,0,0,417.92,0,139925.21,11,5,18,2,False
5925189,963,4,30,5558,102589938,1,0,0,418.22,8,139506.99,13,1,2,2,True
6456288,757,0,10,9519,102589938,1,0,0,418.08,0,139925.07,24,6,14,2,True
6539116,986,4,30,9028,102589938,1,0,0,418.23,8,139506.84,22,2,12,2,True
6721889,980,1,10,6573,102589938,1,0,0,418.01,6,139924.85,22,5,7,3,False
6872118,1412,2,20,7522,102589938,1,0,0,417.9,3,139506.95,24,6,2,4,True
6931366,747,1,10,9519,102589938,1,0,0,417.85,6,139924.8,24,3,1,4,True
7681970,529,2,451,5394,102589938,1,0,0,418.04,7,139506.76,18,5,4,4,True
7691857,390,4,30,3183,102589938,1,0,0,418.0,8,139088.76,10,3,11,5,True
7892455,963,4,-1,5653,102589938,1,1,0,417.88,4,139088.76,13,0,9,6,True
8166803,1107,3,451,5394,102589938,1,0,0,417.96,7,138670.8,0,2,20,6,True
8441608,529,2,30,7549,102589938,1,0,0,418.07,8,138252.73,18,2,14,7,True
8850210,963,4,-1,4284,102589938,1,1,0,418.22,4,138252.73,13,4,5,8,True
8938765,1363,0,10,2609,102589938,1,0,0,418.01,6,138670.74,16,4,6,8,True
8977280,1107,3,451,6573,102589938,1,0,0,418.09,7,138252.65,0,5,7,9,True
9182118,329,1,25,5394,102589938,1,0,0,418.02,8,137834.63,11,0,22,9,True
9528111,529,2,25,9028,102589938,1,0,0,417.96,8,137416.67,18,1,1,10,True
9558712,329,1,451,2609,102589938,1,0,0,417.77,7,136998.9,11,0,11,10,True
9614652,1474,0,10,5735,102589938,1,0,0,417.96,6,137416.86,24,1,5,10,True
9713841,1107,3,30,8590,102589938,1,0,0,417.78,8,136999.08,0,2,20,11,True
9917268,1034,1,451,1948,102589938,1,0,0,417.98,7,136581.1,11,3,17,11,True
9972543,390,4,451,9028,102589938,1,0,0,417.99,7,136163.11,10,6,10,11,True
1175010,1075,0,20,8499,817566561,0,0,0,303.95,5,666059.05,18,6,0,1,True
1217691,1128,2,20,1846,817566561,0,0,0,304.31,3,665754.74,24,1,22,2,True
1538210,800,0,30,4702,817566561,0,0,0,304.04,8,665450.7,11,5,5,2,True
1567164,149,2,20,3505,817566561,0,0,0,303.65,5,665147.05,18,6,12,2,True
1573795,561,4,30,1780,817566561,0,0,0,304.05,8,664843.0,17,3,3,2,True
1651327,800,0,25,9195,817566561,0,0,0,304.09,8,664538.91,11,4,2,3,True
1971118,20,0,20,1780,817566561,0,0,0,304.05,5,664234.86,24,2,1,3,True
2437621,795,4,-1,1846,817566561,0,1,0,304.06,4,664234.86,11,4,0,3,True
2554557,795,4,-1,2993,817566561,0,2,0,304.25,4,664234.86,11,6,22,4,True
2719282,997,3,25,5563,817566561,0,0,0,304.18,8,663930.68,26,2,4,6,True
2989561,800,0,25,1846,817566561,0,0,0,303.87,8,663626.81,11,1,7,6,True
3008396,1270,1,10,5791,817566561,0,0,0,303.96,6,663930.77,23,3,10,6,True
3010006,10,4,25,6467,817566561,0,0,0,304.29,8,663626.48,24,0,21,9,True
3045507,800,0,451,2993,817566561,0,0,0,303.92,7,663322.56,11,2,7,9,True
3235667,218,0,20,4217,817566561,0,0,0,304.1,3,663018.46,9,5,10,9,True
3342230,1025,1,10,6745,817566561,0,0,0,303.99,6,663322.45,11,4,12,10,True
3351207,561,4,25,9817,817566561,0,0,0,304.23,8,663018.22,17,5,11,10,True
3560611,561,4,30,1780,817566561,0,0,0,304.06,8,662714.16,17,6,5,10,True
4243326,997,3,451,9195,817566561,0,0,0,303.9,7,662410.26,26,4,14,11,True
4325086,10,4,30,9817,817566561,0,0,0,303.95,8,662106.31,24,6,13,11,True
4350562,561,4,-1,8490,817566561,0,1,0,303.75,1,662106.31,17,3,22,12,True
4474273,800,0,-1,6745,817566561,0,2,0,303.93,4,662106.31,11,5,15,1,True
4478213,800,0,451,2656,817566561,0,0,0,304.24,7,661802.07,11,4,7,2,True
4518898,10,4,451,1846,817566561,0,0,0,303.79,7,661498.28,24,2,7,3,True
4686389,530,0,20,5711,817566561,0,0,0,303.75,3,661194.53,18,2,23,4,True
4703148,561,4,451,9195,817566561,0,0,0,304.14,7,660890.39,17,3,5,4,True
4962731,512,0,10,4702,817566561,0,0,0,304.32,6,661194.71,12,4,21,4,True
5309821,800,0,-1,9817,817566561,0,1,0,304.09,4,661194.71,11,1,10,5,True
5410643,266,2,20,8499,817566561,0,0,0,304.01,5,660890.7,6,3,14,5,True
5530031,1210,0,10,5711,817566561,0,0,0,303.95,0,661194.65,24,5,8,6,False
5638181,727,0,10,7230,817566561,0,0,0,303.91,0,661498.56,11,3,13,7,True
5671111,811,0,10,2663,817566561,0,0,0,304.13,6,661802.69,18,4,19,7,True
5702223,10,4,25,5097,817566561,0,0,0,303.87,8,661498.82,24,1,12,9,False
5761481,997,3,451,9195,817566561,0,0,0,303.9,7,661194.92,26,4,5,10,True
5886576,1052,0,10,5563,817566561,0,0,0,304.13,6,661499.05,11,3,8,10,True
5977670,346,0,20,3361,817566561,0,0,0,304.19,5,661194.86,24,1,17,10,True
6000674,362,0,10,5711,817566561,0,0,0,304.4,0,661499.26,24,3,1,12,False
6266956,561,4,-1,3505,817566561,0,1,0,304.02,4,661499.26,17,6,22,12,True
6537040,1089,0,20,8499,817566561,0,0,0,303.85,5,661195.41,18,0,23,1,True
6542254,997,3,-1,9817,817566561,0,1,0,303.96,1,661195.41,26,5,19,2,True
6665694,800,0,451,3361,817566561,0,0,0,303.94,7,660891.47,11,2,23,2,True
6888056,997,3,-1,5097,817566561,0,1,0,304.14,4,660891.47,26,1,21,3,True
7292875,561,4,451,5791,817566561,0,0,0,303.93,7,660587.54,17,1,12,4,True
7628352,561,4,451,9156,817566561,0,0,0,303.56,7,660283.98,17,4,13,5,True
7699613,10,4,451,3361,817566561,0,0,0,303.97,7,659980.01,24,1,4,6,True
7886183,800,0,30,9195,817566561,0,0,0,304.1,8,659675.91,11,1,19,6,True
7923844,795,4,451,3505,817566561,0,0,0,303.99,7,659371.92,11,4,19,6,False
7932101,795,4,30,5711,817566561,0,0,0,304.18,8,659067.74,11,4,22,7,True
8103812,795,4,451,9089,817566561,0,0,0,304.09,7,658763.65,11,1,6,8,True
8180834,561,4,25,5630,817566561,0,0,0,304.03,8,658459.62,17,3,19,8,True
8668153,1170,0,10,8490,817566561,0,0,0,304.25,6,658763.87,24,3,16,8,True
9319424,880,1,10,6467,817566561,0,0,0,303.81,6,659067.68,27,5,7,9,True
9593179,800,0,451,6745,817566561,0,0,0,304.04,7,658763.64,11,3,1,10,True
9718527,997,3,451,2663,817566561,0,0,0,303.98,7,658459.66,26,3,8,10,True
9822862,1451,1,10,5711,817566561,0,0,0,304.06,6,658763.72,11,0,16,11,True
1059648,468,3,-1,6209,371477862,1,1,0,1146.94,4,281178.0,5,1,16,1,True
1087886,260,0,451,1401,371477862,1,0,0,1147.07,7,280030.93,6,5,12,1,True
1173800,261,3,25,6227,371477862,1,0,0,1147.05,8,278883.88,6,2,8,4,True
1208341,1328,4,25,5986,371477862,1,0,0,1146.97,8,277736.91,18,2,13,4,True
1268860,1328,4,451,6209,371477862,1,0,0,1146.75,7,276590.16,18,1,14,5,True
1435737,260,0,25,8850,371477862,1,0,0,1146.95,8,275443.21,6,4,11,5,True
1896036,759,0,20,9364,371477862,1,0,0,1147.19,3,274296.02,24,2,16,5,True
2140163,1328,4,25,6227,371477862,1,0,0,1147.06,8,273148.96,18,4,9,5,True
2318757,468,3,30,5017,371477862,1,0,0,1146.66,8,272002.3,5,6,18,6,True
2370411,468,3,451,9364,371477862,1,0,0,1146.95,7,270855.35,5,3,19,7,True
2444931,733,3,451,6227,371477862,1,0,0,1147.03,7,269708.32,11,4,5,8,True
2469252,260,0,-1,9916,371477862,1,1,0,1147.09,1,269708.32,6,3,17,9,True
2696939,427,2,20,9364,371477862,1,0,0,1146.94,5,268561.38,18,4,4,11,True
2767410,1328,4,451,3899,371477862,1,0,0,1147.3,7,267414.08,18,0,6,1,True
3121299,261,3,30,6758,371477862,1,0,0,1146.86,8,266267.22,6,3,0,1,True
3192575,733,3,451,1401,371477862,1,0,0,1146.87,7,265120.35,11,0,22,2,False
3196269,1328,4,30,3899,371477862,1,0,0,1146.85,8,263973.5,18,2,23,2,True
3820468,733,3,30,6274,371477862,1,0,0,1146.92,8,262826.58,11,3,2,2,True
4038364,1283,2,20,7890,371477862,1,0,0,1146.97,5,261679.61,24,0,16,3,True
4076848,1328,4,451,9364,371477862,1,0,0,1146.87,7,260532.74,18,6,14,4,True
4511823,1328,4,30,6209,371477862,1,0,0,1146.99,8,259385.75,18,6,19,6,True
4923330,51,0,10,5534,371477862,1,0,0,1147.16,6,260532.91,20,0,8,7,True
5036871,260,0,451,1711,371477862,1,0,0,1147.12,7,259385.79,6,3,16,7,True
5044675,260,0,-1,9323,371477862,1,1,0,1146.97,1,259385.79,6,0,11,8,True
5125398,261,3,-1,6474,371477862,1,2,0,1147.21,4,259385.79,6,6,22,8,True
5217038,1128,2,20,9916,371477862,1,0,0,1147.09,5,258238.7,24,6,19,9,True
5453615,1328,4,-1,9323,371477862,1,1,0,1147.2,4,258238.7,18,4,6,10,True
5490981,804,0,10,6274,371477862,1,0,0,1147.18,6,259385.88,11,3,12,10,True
5521059,262,2,20,2017,371477862,1,0,0,1146.79,3,258239.09,6,4,7,10,True
5606076,733,3,30,6758,371477862,1,0,0,1146.89,8,257092.2,11,2,18,11,True
5862910,716,0,20,3899,371477862,1,0,0,1147.24,3,255944.96,18,0,7,12,True
6197332,468,3,451,9916,371477862,1,0,0,1146.95,7,254798.01,5,2,7,1,True
6297300,260,0,25,8850,371477862,1,0,0,1146.9,8,253651.11,6,5,20,1,True
6417132,733,3,-1,8850,371477862,1,1,0,1146.96,1,253651.11,11,1,21,2,True
6589842,733,3,25,5986,371477862,1,0,0,1146.93,8,252504.18,11,3,20,2,True
6672289,468,3,25,8864,371477862,1,0,0,1146.88,8,251357.3,5,3,23,2,True
6712785,376,0,20,5017,371477862,1,0,0,1147.0,5,250210.3,25,3,11,3,True
6938764,260,0,-1,9364,371477862,1,1,0,1147.09,4,250210.3,6,1,18,3,True
6975930,260,0,25,8582,371477862,1,0,0,1146.81,8,249063.49,6,0,17,4,True
7036707,1068,2,20,1711,371477862,1,0,0,1147.1,3,247916.39,18,2,14,4,True
7282338,260,0,10,1362,371477862,1,0,0,1147.27,0,249063.66,6,3,3,5,True
7585406,260,0,-1,6274,371477862,1,1,0,1146.82,4,249063.66,6,6,11,6,True
7693786,261,3,-1,8582,371477862,1,2,0,1147.17,4,249063.66,6,1,9,6,True
7907247,673,0,20,2398,371477862,1,0,0,1146.83,3,247916.83,18,3,2,7,True
8130805,468,3,-1,3899,371477862,1,1,0,1146.96,1,247916.83,5,0,12,7,True
8233611,1273,0,20,9351,371477862,1,0,0,1147.11,5,246769.72,24,6,13,8,True
8695031,468,3,-1,8864,371477862,1,1,0,1146.79,4,246769.72,5,6,7,9,True
8812929,468,3,-1,1461,371477862,1,2,0,1147.14,4,246769.72,5,6,12,9,True
8928213,1328,4,30,2017,371477862,1,0,0,1147.03,8,245622.69,18,4,17,10,True
9107509,261,3,30,7890,371477862,1,0,0,1146.92,8,244475.77,6,5,15,10,True
9238483,260,0,451,1362,371477862,1,0,0,1147.13,7,243328.64,6,1,16,10,True
9281186,1142,2,20,5017,371477862,1,0,0,1146.97,5,242181.67,15,1,15,10,True
9520954,261,3,451,6209,371477862,1,0,0,1146.85,7,241034.82,6,3,9,11,True
9521418,1019,0,10,6209,371477862,1,0,0,1147.39,0,242182.21,26,0,3,11,True
9568182,261,3,451,8864,371477862,1,0,0,1146.82,7,241035.39,6,0,19,11,True
9707401,1328,4,451,1362,371477862,1,0,0,1146.86,7,239888.53,18,3,6,11,True
1008831,958,2,451,9481,111858823,1,0,0,1085.99,7,708210.01,13,6,23,1,True
1467116,1115,1,-1,2757,111858823,1,1,0,1085.87,1,708210.01,0,4,23,1,True
1724324,275,0,451,6598,111858823,1,0,0,1086.14,7,707123.87,24,5,1,2,True
2001760,568,1,10,1100,111858823,1,0,0,1086.21,6,708210.08,11,4,6,4,True
2231485,900,1,30,1100,111858823,1,0,0,1085.87,8,707124.21,24,6,9,5,True
2580402,1315,0,10,1772,111858823,1,0,0,1085.93,6,708210.14,5,1,21,5,True
2652190,275,0,451,2757,111858823,1,0,0,1086.03,7,707124.11,24,5,15,5,True
2797993,900,1,25,8543,111858823,1,0,0,1086.06,8,706038.05,24,2,8,5,True
2972535,275,0,451,7976,111858823,1,0,0,1086.0,7,704952.05,24,1,19,6,True
3175177,1270,1,10,7843,111858823,1,0,0,1086.12,0,706038.17,23,2,1,7,True
3181494,81,0,20,8003,111858823,1,0,0,1085.62,5,704952.55,1,5,17,10,True
3211907,958,2,-1,6269,111858823,1,1,0,1085.72,1,704952.55,13,5,9,10,True
3230403,275,0,30,9571,111858823,1,0,0,1085.98,8,703866.57,24,3,21,11,True
3335048,1115,1,25,6269,111858823,1,0,0,1086.19,8,702780.38,0,5,22,11,True
3619611,900,1,30,9261,111858823,1,0,0,1085.75,8,701694.63,24,6,23,11,True
3694630,21,0,10,6089,111858823,1,0,0,1085.98,0,702780.61,11,1,13,11,True
3714286,958,2,-1,6598,111858823,1,1,0,1085.95,4,702780.61,13,0,9,12,True
3727879,599,0,20,2757,111858823,1,0,0,1085.93,5,701694.68,24,3,5,1,True
3791687,816,0,30,9571,111858823,1,0,0,1086.07,8,700608.61,18,4,0,2,True
3835206,1115,1,451,9261,111858823,1,0,0,1086.07,7,699522.54,0,1,14,2,False
4381564,1115,1,451,2688,111858823,1,0,0,1085.83,7,698436.71,0,4,4,3,True
4506370,275,0,30,9481,111858823,1,0,0,1085.91,8,697350.8,24,3,12,4,True
4610594,816,0,451,1532,111858823,1,0,0,1085.96,7,696264.84,18,3,1,5,True
4642448,816,0,30,1772,111858823,1,0,0,1085.81,8,695179.03,18,1,3,5,True
4664199,254,0,10,8003,111858823,1,0,0,1085.91,6,696264.94,6,6,0,6,True
4969561,1041,0,10,7152,111858823,1,0,0,1086.31,6,697351.25,11,5,6,6,True
5143473,1315,0,10,8704,111858823,1,0,0,1085.85,6,698437.1,5,6,8,7,True
5709173,1115,1,25,2688,111858823,1,0,0,1085.7,8,697351.4,0,4,4,7,True
6305606,995,1,10,2688,111858823,1,0,0,1085.94,0,698437.34,22,3,19,8,True
6365158,820,1,10,8564,111858823,1,0,0,1086.33,6,699523.67,18,4,1,8,True
6401047,900,1,-1,6269,111858823,1,1,0,1085.93,1,699523.67,24,1,20,8,True
6433373,688,0,20,2688,111858823,1,0,0,1086.2,5,698437.47,24,5,20,10,True
6646008,816,0,451,7843,111858823,1,0,0,1085.89,7,697351.58,18,3,0,10,True
6772873,275,0,30,1532,111858823,1,0,0,1086.44,8,696265.14,24,1,9,12,True
6991350,900,1,25,6598,111858823,1,0,0,1086.1,8,695179.04,24,4,18,12,True
7084568,1303,0,20,1772,111858823,1,0,0,1085.97,3,694093.07,5,1,7,1,True
7158119,816,0,30,1772,111858823,1,0,0,1086.05,8,693007.02,18,5,10,2,True
7171851,1163,4,30,6089,111858823,1,0,0,1086.26,8,691920.76,24,6,1,2,True
7313672,958,2,25,2688,111858823,1,0,0,1086.1,8,690834.66,13,4,7,2,True
7512051,376,0,20,1532,111858823,1,0,0,1085.94,5,689748.72,25,6,14,3,True
7562962,1483,0,10,9571,111858823,1,0,0,1086.04,0,690834.76,24,3,23,3,True
7581821,1115,1,25,2688,111858823,1,0,0,1086.18,8,689748.58,0,2,18,3,True
7800053,1064,0,20,8003,111858823,1,0,0,1085.71,5,688662.87,11,1,21,4,True
8131319,1163,4,30,7843,111858823,1,0,0,1086.04,8,687576.83,24,6,0,5,True
8157798,1163,4,30,8564,111858823,1,0,0,1085.94,8,686490.89,24,6,19,6,True
8161253,1422,1,10,1532,111858823,1,0,0,1086.1,6,687576.99,24,5,4,7,True
8432968,275,0,-1,7152,111858823,1,1,0,1085.9,4,687576.99,24,5,13,7,True
8514498,1115,1,451,9481,111858823,1,0,0,1085.92,7,686491.07,0,3,2,8,True
8784912,522,0,20,9481,111858823,1,0,0,1086.12,5,685404.95,18,1,3,8,False
9066039,816,0,-1,8564,111858823,1,1,0,1086.14,4,685404.95,18,2,17,8,True
9273212,1181,2,20,1100,111858823,1,0,0,1086.25,5,684318.7,24,3,13,8,True
9928151,1037,0,20,6089,111858823,1,0,0,1085.92,5,683232.78,11,5,19,11,True
1293708,968,3,-1,3702,584704269,0,1,0,372.89,4,374741.0,13,5,7,1,True
1681669,968,3,451,2136,584704269,0,0,0,373.3,7,374367.7,13,2,8,2,False
1763842,801,4,451,3702,584704269,0,0,0,373.05,7,373994.65,11,0,15,2,True
1875353,23,0,10,6585,584704269,0,0,0,372.96,6,374367.61,11,5,0,3,True
1935649,801,4,30,8628,584704269,0,0,0,373.08,8,373994.53,11,0,4,5,True
2027997,723,1,451,5740,584704269,0,0,0,372.85,7,373621.68,11,6,6,5,True
2154212,1367,4,25,6169,584704269,0,0,0,373.16,8,373248.52,16,6,9,6,True
2323092,968,3,-1,3497,584704269,0,1,0,373.14,4,373248.52,13,3,23,6,True
2414563,517,4,451,4009,584704269,0,0,0,373.06,7,372875.46,12,4,6,6,True
2491592,517,4,-1,3497,584704269,0,1,0,373.08,1,372875.46,12,6,1,7,True
2545156,1089,0,10,3987,584704269,0,0,0,372.8,0,373248.26,18,2,9,7,True
2733243,1060,1,10,3892,584704269,0,0,0,372.89,0,373621.15,11,0,15,8,True
2825136,1367,4,25,8628,584704269,0,0,0,373.1,8,373248.05,16,0,12,8,True
2928912,219,0,20,2136,584704269,0,0,0,373.25,3,372874.8,9,1,19,8,True
2939140,1483,0,20,3211,584704269,0,0,0,372.9,5,372501.9,24,5,21,9,True
2990661,1367,4,25,9427,584704269,0,0,0,373.02,8,372128.88,16,3,22,10,True
3022714,404,1,10,5901,584704269,0,0,0,372.97,0,372501.85,10,1,10,11,True
3113309,968,3,25,2136,584704269,0,0,0,373.03,8,372128.82,13,2,8,2,True
3206278,204,0,10,3413,584704269,0,0,0,373.06,6,372501.88,9,5,10,2,True
3234555,517,4,451,3389,584704269,0,0,0,373.06,7,372128.82,12,1,21,2,True
3690748,968,3,30,6169,584704269,0,0,0,373.29,8,371755.53,13,4,20,3,True
3858091,1367,4,451,3497,584704269,0,0,0,372.97,7,371382.56,16,2,14,4,True
3880062,517,4,30,3987,584704269,0,0,0,372.9,8,371009.66,12,2,19,4,True
4194479,679,0,10,3892,584704269,0,0,0,373.07,6,371382.73,24,4,19,4,True
4210086,517,4,451,4009,584704269,0,0,0,372.95,7,371009.78,12,5,23,4,True
4263519,641,0,10,3413,584704269,0,0,0,373.03,6,371382.81,24,0,0,7,True
4352199,484,0,20,3702,584704269,0,0,0,373.18,5,371009.63,5,3,10,7,True
4561672,801,4,-1,6585,584704269,0,1,0,373.1,1,371009.63,11,0,1,7,True
5066423,517,4,451,2136,584704269,0,0,0,373.14,7,370636.49,12,3,11,7,True
5236897,801,4,-1,5415,584704269,0,1,0,373.23,1,370636.49,11,5,17,7,True
5430273,801,4,25,4009,584704269,0,0,0,373.05,8,370263.44,11,5,11,8,True
5751696,517,4,30,4009,584704269,0,0,0,372.91,8,369890.53,12,5,7,9,True
5980671,611,0,10,2136,584704269,0,0,0,373.0,6,370263.53,11,0,17,9,False
6340228,723,1,25,3702,584704269,0,0,0,373.34,8,369890.19,11,3,12,10,True
6505027,723,1,25,2252,584704269,0,0,0,373.11,8,369517.08,11,6,13,11,True
6558967,801,4,30,2252,584704269,0,0,0,372.82,8,369144.26,11,6,11,12,True
7016487,801,4,451,3413,584704269,0,0,0,372.69,7,368771.57,11,3,3,12,True
7275149,723,1,30,6169,584704269,0,0,0,373.35,8,368398.22,11,2,15,1,True
7294574,1210,0,10,7094,584704269,0,0,0,372.75,6,368770.97,24,6,16,3,True
7334538,238,0,20,6538,584704269,0,0,0,373.18,5,368397.79,26,3,0,3,True
7655451,517,4,451,6585,584704269,0,0,0,373.32,7,368024.47,12,5,2,4,True
7682187,801,4,25,5901,584704269,0,0,0,373.07,8,367651.4,11,3,16,4,True
7757709,801,4,30,5415,584704269,0,0,0,372.94,8,367278.46,11,2,10,4,True
7759237,611,0,10,3211,584704269,0,0,0,372.97,0,367651.43,11,2,4,4,True
7913548,316,2,20,7580,584704269,0,0,0,373.03,5,367278.4,4,5,23,7,True
8129104,517,4,30,8628,584704269,0,0,0,373.16,8,366905.24,12,1,12,7,True
8143888,1367,4,25,8628,584704269,0,0,0,373.11,8,366532.13,16,6,17,7,False
8290614,1367,4,25,4777,584704269,0,0,0,373.23,8,366158.9,16,0,10,7,True
8511702,1367,4,30,3413,584704269,0,0,0,373.19,8,365785.71,16,1,18,7,True
8927682,968,3,25,8632,584704269,0,0,0,372.98,8,365412.73,13,5,21,9,True
9053394,820,1,10,4777,584704269,0,0,0,373.1,6,365785.83,18,6,7,10,True
9560057,517,4,451,9427,584704269,0,0,0,373.0,7,365412.83,12,5,4,11,True
9805751,801,4,-1,7580,584704269,0,1,0,373.19,4,365412.83,11,1,10,11,True
1002460,1128,2,20,2854,306273803,1,0,0,307.95,5,317308.05,24,3,0,1,True
1016206,96,0,20,7846,306273803,1,0,0,307.95,5,317000.1,1,3,15,3,True
1207488,1026,4,-1,8352,306273803,1,1,0,308.0,4,317000.1,11,0,23,5,True
1259003,1066,4,30,8352,306273803,1,0,0,307.82,8,316692.28,11,0,12,5,True
1283896,252,4,30,8793,306273803,1,0,0,308.14,8,316384.14,6,6,19,5,True
1524381,1304,0,30,8751,306273803,1,0,0,307.67,8,316076.47,5,6,4,6,True
1608890,944,2,20,4892,306273803,1,0,0,307.79,3,315768.68,24,5,17,6,True
1621710,1066,4,451,7511,306273803,1,0,0,308.11,7,315460.57,11,4,0,7,True
1692812,344,3,451,8445,306273803,1,0,0,308.24,7,315152.33,24,4,1,7,True
2113835,328,0,451,8352,306273803,1,0,0,308.05,7,314844.28,11,6,11,7,False
2171631,127,1,30,1171,306273803,1,0,0,307.92,8,314536.36,18,0,10,7,True
2500529,122,3,451,7105,306273803,1,0,0,307.93,7,314228.43,18,3,9,8,True
2722667,127,1,-1,5287,306273803,1,1,0,308.04,4,314228.43,18,1,8,8,True
2961714,1066,4,451,7047,306273803,1,0,0,308.23,7,313920.2,11,4,5,9,True
3252149,127,1,30,6464,306273803,1,0,0,307.97,8,313612.23,18,1,5,10,True
3305064,1066,4,30,7105,306273803,1,0,0,307.99,8,313304.24,11,6,3,12,True
3447452,1026,4,451,8445,306273803,1,0,0,307.76,7,312996.48,11,2,11,12,False
3561724,990,0,20,6947,306273803,1,0,0,307.9,5,312688.58,22,2,18,12,True
3575312,328,0,-1,7507,306273803,1,1,0,307.94,1,312688.58,11,2,14,3,True
3615747,200,0,10,6464,306273803,1,0,0,307.98,6,312996.56,9,6,23,4,True
3771004,328,0,451,8445,306273803,1,0,0,308.03,7,312688.53,11,0,21,5,True
4376250,1026,4,-1,4634,306273803,1,1,0,308.01,4,312688.53,11,6,14,6,True
4858902,1044,0,10,3310,306273803,1,0,0,308.06,0,312996.59,11,6,16,8,True
4948423,328,0,25,7511,306273803,1,0,0,307.66,8,312688.93,11,4,11,9,True
4993678,1459,1,10,7511,306273803,1,0,0,308.0,6,312996.93,11,5,4,9,True
5066036,328,0,-1,3849,306273803,1,1,0,307.72,1,312996.93,11,5,13,10,True
5093839,127,1,451,4892,306273803,1,0,0,308.0,7,312688.93,18,0,15,12,True
5362777,252,4,30,3849,306273803,1,0,0,307.69,8,312381.24,6,1,13,12,True
5543049,1304,0,-1,8751,306273803,1,1,0,307.96,1,312381.24,5,2,10,1,True
5756798,122,3,-1,7105,306273803,1,2,0,307.99,4,312381.24,18,3,14,1,True
5789151,1026,4,451,7105,306273803,1,0,0,307.91,7,312073.33,11,2,7,1,True
5815968,1304,0,-1,6464,306273803,1,1,0,308.07,1,312073.33,5,4,8,1,True
6208514,1304,0,451,8793,306273803,1,0,0,307.78,7,311765.55,5,0,11,3,True
6269119,344,3,30,8751,306273803,1,0,0,308.18,8,311457.37,24,5,1,5,True
6543938,328,0,30,3310,306273803,1,0,0,308.01,8,311149.36,11,2,19,6,True
6691428,344,3,451,8459,306273803,1,0,0,307.81,7,310841.55,24,4,13,6,True
7109068,344,3,25,8352,306273803,1,0,0,308.15,8,310533.4,24,4,7,7,True
7798386,603,0,20,9226,306273803,1,0,0,308.07,3,310225.33,24,4,13,7,True
8196479,454,1,10,7045,306273803,1,0,0,307.9,6,310533.23,13,3,17,7,True
8205017,1089,0,20,2854,306273803,1,0,0,307.99,3,310225.24,18,0,22,7,True
8240675,328,0,25,3970,306273803,1,0,0,307.8,8,309917.44,11,1,23,7,True
8733876,127,1,25,3310,306273803,1,0,0,308.21,8,309609.23,18,3,11,7,True
8786564,122,3,-1,7105,306273803,1,1,0,308.09,1,309609.23,18,5,17,8,True
8957073,1026,4,-1,7507,306273803,1,2,0,308.05,4,309609.23,11,4,6,8,False
8971320,1169,0,20,2413,306273803,1,0,0,308.1,3,309301.13,24,1,2,9,True
9085741,895,0,20,7753,306273803,1,0,0,308.25,5,308992.88,24,6,4,9,True
9293959,127,1,25,7105,306273803,1,0,0,308.3,8,308684.58,18,3,16,9,True
9535413,127,1,25,7511,306273803,1,0,0,307.92,8,308376.66,18,0,20,9,True
9627515,573,0,20,8751,306273803,1,0,0,307.92,3,308068.74,11,1,7,10,True
9665071,1066,4,451,3849,306273803,1,0,0,308.01,7,307760.73,11,6,10,10,True
9665157,122,3,-1,7511,306273803,1,1,0,308.3,4,307760.73,18,5,17,11,True
1036907,41,2,25,1111,394400803,0,0,0,289.24,8,409119.76,11,1,8,1,True
1077917,791,3,30,2554,394400803,0,0,0,289.12,8,408830.64,11,0,0,1,True
1117795,956,1,25,1862,394400803,0,0,0,288.9,8,408541.74,13,0,15,2,True
1755435,735,1,30,2554,394400803,0,0,0,288.78,8,408252.96,11,2,1,2,True
1879782,956,1,451,5105,394400803,0,0,0,289.15,7,407963.81,13,6,8,5,True
2046431,956,1,451,1111,394400803,0,0,0,288.87,7,407674.94,13,5,22,5,True
2298737,1179,0,10,5105,394400803,0,0,0,288.81,6,407963.75,24,6,10,6,True
2308582,791,3,30,9437,394400803,0,0,0,288.91,8,407674.84,11,3,17,6,True
2358012,956,1,451,8141,394400803,0,0,0,289.0,7,407385.84,13,1,2,6,True
2423934,914,2,20,8141,394400803,0,0,0,288.95,3,407096.89,18,4,2,6,True
2482212,735,1,451,1111,394400803,0,0,0,288.86,7,406808.03,11,0,16,6,True
2516502,570,2,20,9437,394400803,0,0,0,289.08,5,406518.95,11,2,1,7,False
2665462,1217,0,10,8341,394400803,0,0,0,289.16,6,406808.11,24,6,6,8,True
2853729,509,0,10,8194,394400803,0,0,0,289.13,0,407097.24,12,0,19,8,True
2988733,791,3,25,4989,394400803,0,0,0,288.97,8,406808.27,11,5,19,10,True
3001515,429,0,20,5120,394400803,0,0,0,289.06,5,406519.21,24,6,10,10,True
3009200,41,2,-1,5105,394400803,0,1,0,289.12,4,406519.21,11,0,20,11,True
3141059,41,2,451,8351,394400803,0,0,0,289.16,7,406230.05,11,3,21,11,True
3374426,791,3,451,7755,394400803,0,0,0,289.15,7,405940.9,11,6,16,11,True
3549864,818,1,30,7755,394400803,0,0,0,288.99,8,405651.91,18,2,2,11,True
3799379,204,0,10,8194,394400803,0,0,0,289.22,6,405941.13,9,5,15,11,True
3925089,1359,2,20,9437,394400803,0,0,0,288.9,5,405652.23,24,0,17,12,True
4541879,956,1,25,9437,394400803,0,0,0,288.99,8,405363.24,13,5,8,12,True
4642884,372,0,10,9993,394400803,0,0,0,288.8,6,405652.04,25,6,8,3,True
4801230,567,1,-1,3421,394400803,0,1,0,288.64,4,405652.04,11,2,9,4,True
4979598,502,0,10,1862,394400803,0,0,0,288.87,6,405940.91,12,2,22,5,True
5157825,104,4,25,5105,394400803,0,0,0,288.94,8,405651.97,3,1,21,5,True
5195929,826,1,10,1111,394400803,0,0,0,288.9,6,405940.87,18,5,7,6,True
5508881,41,2,25,3421,394400803,0,0,0,288.56,8,405652.31,11,0,11,6,True
5612821,512,0,10,9993,394400803,0,0,0,289.03,6,405941.34,12,5,15,6,True
5830104,818,1,30,2554,394400803,0,0,0,288.84,8,405652.5,18,0,2,6,True
5861795,956,1,-1,1044,394400803,0,1,0,289.04,4,405652.5,13,1,14,7,True
5972996,589,1,10,1111,394400803,0,0,0,288.9,6,405941.4,24,1,21,7,True
6188283,818,1,451,3421,394400803,0,0,0,289.06,7,405652.34,18,3,8,7,True
6329863,567,1,30,5105,394400803,0,0,0,288.91,8,405363.43,11,0,21,8,True
6357872,1192,2,20,9437,394400803,0,0,0,289.13,5,405074.3,24,5,0,8,True
6577469,818,1,-1,9993,394400803,0,1,0,288.9,4,405074.3,18,3,0,8,False
6953762,41,2,-1,2554,394400803,0,2,0,289.1,4,405074.3,11,1,16,8,True
6965975,791,3,25,3421,394400803,0,0,0,289.03,8,404785.27,11,6,7,9,True
7295853,567,1,25,9437,394400803,0,0,0,288.88,8,404496.39,11,0,16,9,True
7382378,1029,0,20,1044,394400803,0,0,0,289.07,3,404207.32,11,4,22,9,False
7583417,735,1,30,1111,394400803,0,0,0,289.21,8,403918.11,11,3,2,11,True
7943304,735,1,30,8141,394400803,0,0,0,288.92,8,403629.19,11,6,4,12,False
8105594,200,0,20,8141,394400803,0,0,0,289.2,5,403339.99,9,2,4,12,False
8233655,791,3,-1,9993,394400803,0,1,0,289.03,1,403339.99,11,2,20,1,True
8328698,735,1,25,8141,394400803,0,0,0,289.16,8,403050.83,11,6,23,1,True
8745513,818,1,30,9437,394400803,0,0,0,288.85,8,402761.98,18,4,14,1,True
8952745,567,1,451,9993,394400803,0,0,0,288.93,7,402473.05,11,3,12,2,True
9051880,956,1,-1,9437,394400803,0,1,0,288.96,4,402473.05,13,3,0,3,True
9148680,956,1,-1,3421,394400803,0,2,0,288.98,4,402473.05,13,4,1,3,True
9184822,1449,0,20,1862,394400803,0,0,0,288.96,5,402184.09,11,0,16,5,True
9249349,41,2,25,1111,394400803,0,0,0,288.69,8,401895.4,11,0,7,7,True
9306881,791,3,25,8194,394400803,0,0,0,288.94,8,401606.46,11,6,21,7,True
9424845,567,1,451,2554,394400803,0,0,0,288.9,7,401317.56,11,3,0,9,False
9697659,791,3,25,5105,394400803,0,0,0,288.89,8,401028.67,11,3,0,9,True
9795037,567,1,25,7755,394400803,0,0,0,289.15,8,400739.52,11,5,16,11,True
9809335,1201,0,20,4989,394400803,0,0,0,288.84,3,400450.68,24,2,22,11,True
1060381,439,4,-1,8895,728541688,0,1,0,1057.05,4,874786.0,24,0,3,1,True
1246194,159,2,20,1347,728541688,0,0,0,1057.23,3,873728.77,24,3,10,1,True
1464300,235,4,25,1296,728541688,0,0,0,1056.87,8,872671.9,26,4,11,3,True
1475249,235,4,25,1226,728541688,0,0,0,1057.08,8,871614.82,26,5,21,4,True
1883553,1363,0,30,6320,728541688,0,0,0,1057.14,8,870557.68,16,1,6,4,True
1994805,1363,0,451,4321,728541688,0,0,0,1057.3,7,869500.38,16,5,21,5,False
2912639,235,4,451,1226,728541688,0,0,0,1056.93,7,868443.45,26,3,16,8,True
2924460,120,4,451,7079,728541688,0,0,0,1057.13,7,867386.32,18,1,16,8,True
3132579,808,3,451,1347,728541688,0,0,0,1057.05,7,866329.27,11,0,10,8,True
3135503,897,0,20,6008,728541688,0,0,0,1056.9,5,865272.37,24,2,0,10,True
3394113,1312,0,30,8833,728541688,0,0,0,1057.07,8,864215.3,5,2,3,10,False
3507699,808,3,-1,8733,728541688,0,1,0,1056.68,4,864215.3,11,3,0,10,True
3544500,585,2,-1,6008,728541688,0,2,0,1057.08,4,864215.3,11,3,10,1,True
3630597,585,2,30,3266,728541688,0,0,0,1056.84,8,863158.46,11,4,6,1,True
3791168,120,4,25,8733,728541688,0,0,0,1056.85,8,862101.61,18,3,3,2,True
3814380,309,0,10,7092,728541688,0,0,0,1056.95,6,863158.56,4,5,16,4,True
3844228,883,0,20,3266,728541688,0,0,0,1056.86,5,862101.7,24,5,20,4,True
3862601,235,4,451,1753,728541688,0,0,0,1056.91,7,861044.79,26,6,10,4,True
3963758,585,2,451,7323,728541688,0,0,0,1056.79,7,859988.0,11,2,3,5,True
4298870,1312,0,25,9937,728541688,0,0,0,1057.05,8,858930.95,5,4,1,5,True
4347217,1363,0,-1,5602,728541688,0,1,0,1057.04,1,858930.95,16,3,21,5,True
4405627,320,1,451,7079,728541688,0,0,0,1057.03,7,857873.92,11,6,4,5,True
4406140,1312,0,25,5489,728541688,0,0,0,1056.53,8,856817.39,5,4,20,6,True
4451028,120,4,30,6010,728541688,0,0,0,1056.89,8,855760.5,18,5,4,6,True
4604767,1363,0,30,5602,728541688,0,0,0,1056.82,8,854703.68,16,3,18,6,True
4615862,950,0,10,7079,728541688,0,0,0,1056.97,0,855760.65,24,4,2,8,True
4832607,438,1,10,7092,728541688,0,0,0,1056.91,0,856817.56,24,1,9,9,True
4952723,858,1,10,1629,728541688,0,0,0,1056.85,6,857874.41,24,5,18,9,True
5020129,1445,2,20,3266,728541688,0,0,0,1057.21,5,856817.2,24,3,15,10,True
5232371,1363,0,25,8102,728541688,0,0,0,1057.16,8,855760.04,16,4,10,10,True
5309624,1312,0,451,1603,728541688,0,0,0,1056.99,7,854703.05,5,3,1,11,True
5313640,235,4,451,1347,728541688,0,0,0,1057.02,7,853646.03,26,0,10,1,True
5610368,320,1,30,1753,728541688,0,0,0,1056.79,8,852589.24,11,3,21,1,True
5618931,585,2,20,8092,728541688,0,0,0,1057.07,3,851532.17,11,1,8,1,True
5710191,235,4,451,8895,728541688,0,0,0,1057.02,7,850475.15,26,4,20,2,True
5897383,320,1,30,5602,728541688,0,0,0,1057.05,8,849418.1,11,6,3,2,True
5988889,120,4,451,6320,728541688,0,0,0,1057.11,7,848360.99,18,2,7,3,True
6016192,585,2,-1,3266,728541688,0,1,0,1057.15,4,848360.99,11,1,3,3,True
6732108,808,3,-1,1296,728541688,0,2,0,1057.04,4,848360.99,11,5,0,4,True
7654159,711,2,20,7079,728541688,0,0,0,1056.91,5,847304.08,18,1,7,4,True
7915732,378,0,10,5316,728541688,0,0,0,1056.95,0,848361.03,25,4,0,4,False
8053031,1363,0,30,8833,728541688,0,0,0,1056.77,8,847304.26,16,6,20,4,True
8242699,585,2,451,1603,728541688,0,0,0,1056.98,7,846247.28,11,3,22,5,True
8266487,439,4,30,8092,728541688,0,0,0,1057.04,8,845190.24,24,5,2,6,True
8284163,144,1,10,4321,728541688,0,0,0,1056.93,0,846247.17,18,3,19,7,True
8350708,235,4,25,1625,728541688,0,0,0,1056.79,8,845190.38,26,1,2,8,True
8543874,439,4,451,6008,728541688,0,0,0,1057.22,7,844133.16,24,2,0,8,True
9169973,235,4,25,7079,728541688,0,0,0,1056.86,8,843076.3,26,3,11,9,True
9405905,1363,0,25,9937,728541688,0,0,0,1056.81,8,842019.49,16,6,3,9,True
9449778,137,2,20,5602,728541688,0,0,0,1056.85,5,840962.64,18,2,3,9,True
9511710,1312,0,451,7092,728541688,0,0,0,1056.68,7,839905.96,5,6,0,10,True
9557828,1364,0,10,5489,728541688,0,0,0,1056.87,6,840962.83,16,3,17,10,True
1199459,328,0,10,4912,479950290,0,0,0,929.69,6,397622.69,11,5,20,1,True
1295758,585,2,30,2353,479950290,0,0,0,929.98,8,396692.71,11,2,8,1,True
1301598,730,4,25,3726,479950290,0,0,0,929.95,8,395762.76,11,6,7,3,True
2107421,360,0,20,5496,479950290,0,0,0,930.05,3,394832.71,24,3,21,4,True
2346526,411,2,30,5283,479950290,0,0,0,929.96,8,393902.75,18,5,7,4,True
2897126,259,4,451,2353,479950290,0,0,0,929.97,7,392972.78,6,4,8,5,True
3011706,572,0,20,5496,479950290,0,0,0,929.7,5,392043.08,11,1,17,5,True
3236666,411,2,451,6971,479950290,0,0,0,929.74,7,391113.34,18,1,1,6,True
3474948,1364,0,-1,1653,479950290,0,1,0,930.05,4,391113.34,16,3,9,6,True
3497192,1446,1,10,6811,479950290,0,0,0,929.87,0,392043.21,24,3,3,6,True
3506272,1364,0,30,5283,479950290,0,0,0,930.03,8,391113.18,16,2,8,7,True
3584490,259,4,25,5283,479950290,0,0,0,930.36,8,390182.82,6,0,20,8,True
3703025,411,2,25,8426,479950290,0,0,0,930.09,8,389252.73,18,5,11,8,True
3832808,259,4,451,8247,479950290,0,0,0,930.0,7,388322.73,6,0,6,10,True
3871811,730,4,-1,2771,479950290,0,1,0,930.05,1,388322.73,11,5,7,12,True
4123327,411,2,451,1653,479950290,0,0,0,929.74,7,387392.99,18,0,22,12,False
4213666,1364,0,25,8426,479950290,0,0,0,930.03,8,386462.96,16,3,2,1,True
4274454,411,2,451,9077,479950290,0,0,0,930.07,7,385532.89,18,4,20,1,True
4307090,1260,0,10,3493,479950290,0,0,0,930.06,6,386462.95,23,4,18,1,True
4526148,585,2,-1,8872,479950290,0,1,0,930.09,4,386462.95,11,6,2,4,True
4665738,1245,1,-1,3875,479950290,0,2,0,930.24,4,386462.95,18,1,4,4,True
4709949,1364,0,30,2191,479950290,0,0,0,929.78,8,385533.17,16,5,3,4,True
4937333,1245,1,30,4698,479950290,0,0,0,929.91,8,384603.26,18,3,22,5,True
5120768,1035,0,451,6398,479950290,0,0,0,930.35,7,383672.91,11,0,20,5,True
5224974,585,2,30,2771,479950290,0,0,0,929.99,8,382742.92,11,3,9,5,True
5240040,259,4,451,8247,479950290,0,0,0,929.99,7,381812.93,6,3,11,6,True
5260666,610,0,10,3726,479950290,0,0,0,929.85,6,382742.78,11,5,20,6,True
5378834,1245,1,451,5496,479950290,0,0,0,929.9,7,381812.88,18,0,19,7,True
5610864,411,2,451,8426,479950290,0,0,0,930.04,7,380882.84,18,3,10,7,True
5638217,1364,0,30,2191,479950290,0,0,0,929.96,8,379952.88,16,0,1,8,True
5681523,1035,0,30,5283,479950290,0,0,0,930.19,8,379022.69,11,3,20,8,True
5921473,484,0,20,8247,479950290,0,0,0,929.9,3,378092.79,5,4,8,9,True
6152329,1390,0,20,4912,479950290,0,0,0,930.06,5,377162.73,24,2,3,9,True
6310534,411,2,25,2607,479950290,0,0,0,929.95,8,376232.78,18,6,2,10,True
6497057,1035,0,451,3875,479950290,0,0,0,930.05,7,375302.73,11,2,13,10,True
6625641,909,2,20,3493,479950290,0,0,0,930.04,5,374372.69,18,5,14,10,True
6946890,1364,0,-1,5647,479950290,0,1,0,929.68,4,374372.69,16,0,6,10,True
6950649,585,2,451,7379,479950290,0,0,0,930.05,7,373442.64,11,2,7,11,True
6983902,730,4,25,4675,479950290,0,0,0,930.19,8,372512.45,11,5,19,11,True
7100109,1319,1,10,4193,479950290,0,0,0,930.06,6,373442.51,18,0,9,11,True
7748648,1035,0,30,3066,479950290,0,0,0,930.01,8,372512.5,11,0,0,1,True
8023573,259,4,451,5283,479950290,0,0,0,930.09,7,371582.41,6,5,12,2,True
8277985,1245,1,25,5496,479950290,0,0,0,929.99,8,370652.42,18,4,16,2,True
8353903,585,2,451,5496,479950290,0,0,0,930.03,7,369722.39,11,6,15,3,True
8518046,806,1,10,4675,479950290,0,0,0,930.02,0,370652.41,11,6,9,4,True
8664015,1245,1,-1,8426,479950290,0,1,0,930.01,4,370652.41,18,3,21,4,True
8863554,585,2,30,3066,479950290,0,0,0,930.01,8,369722.4,11,5,1,4,True
8934818,411,2,451,9077,479950290,0,0,0,930.23,7,368792.17,18,4,4,4,True
8944647,1445,2,20,4193,479950290,0,0,0,930.1,5,367862.07,24,3,10,5,True
8963967,1101,2,20,2353,479950290,0,0,0,930.1,5,366931.97,0,6,2,6,True
9347938,259,4,25,3726,479950290,0,0,0,930.06,8,366001.91,6,6,17,7,True
9439618,1041,0,20,7468,479950290,0,0,0,929.87,5,365072.04,11,6,17,7,True
9527597,1245,1,-1,8426,479950290,0,1,0,930.06,1,365072.04,18,0,1,7,True
9567992,585,2,451,9019,479950290,0,0,0,930.01,7,364142.03,11,1,8,9,True
9612812,23,0,10,2191,479950290,0,0,0,930.23,6,365072.26,11,3,10,9,True
9653326,259,4,30,7379,479950290,0,0,0,929.87,8,364142.39,6,5,13,9,True
9742759,411,2,451,2771,479950290,0,0,0,930.08,7,363212.31,18,4,8,9,True
9769853,454,1,10,7379,479950290,0,0,0,930.01,0,364142.32,13,2,18,11,True
1095637,1360,4,30,3842,150092926,1,0,0,513.12,8,966871.88,24,1,10,3,True
1219795,459,1,25,1581,150092926,1,0,0,513.12,8,966358.76,13,1,7,7,True
1496225,678,4,451,3842,150092926,1,0,0,513.14,7,965845.62,24,2,19,8,True
1784909,459,1,-1,2077,150092926,1,1,0,513.1,4,965845.62,13,5,9,9,True
1889204,1380,0,25,8202,150092926,1,0,0,513.16,8,965332.46,16,3,18,10,True
1902891,866,0,10,3551,150092926,1,0,0,512.91,6,965845.37,24,0,2,5,True
2245514,1380,0,-1,9326,150092926,1,1,0,513.08,1,965845.37,16,6,16,10,False
2383479,535,0,-1,7417,150092926,1,2,0,512.93,1,965845.37,18,3,4,2,False
2456146,77,4,-1,5623,150092926,1,3,1,513.0,4,965845.37,1,3,2,6,True
1054622,1383,4,30,6685,841076598,0,0,0,1104.87,8,86282.13,16,2,20,2,True
1228342,1388,1,25,9629,841076598,0,0,0,1105.08,8,85177.05,24,1,15,3,True
1435801,1235,1,10,7488,841076598,0,0,0,1105.03,6,86282.08,18,4,4,3,True
1685019,787,0,25,7488,841076598,0,0,0,1105.04,8,85177.04,14,3,22,3,True
2037555,929,0,10,4690,841076598,0,0,0,1104.81,6,86281.85,18,1,7,4,True
2226075,260,0,20,8234,841076598,0,0,0,1105.23,3,85176.62,6,6,19,5,True
2400411,1388,1,30,1509,841076598,0,0,0,1105.24,8,84071.38,24,3,23,5,True
2438483,642,0,-1,5359,841076598,0,1,0,1104.86,1,84071.38,24,1,23,6,True
2681976,607,2,20,7325,841076598,0,0,0,1105.07,3,82966.31,24,1,20,6,True
2814453,642,0,-1,1036,841076598,0,1,0,1104.93,1,82966.31,24,2,13,6,True
3407005,642,0,-1,4690,841076598,0,2,0,1105.03,4,82966.31,24,4,6,8,True
3712370,642,0,451,7325,841076598,0,0,0,1104.92,7,81861.39,24,5,1,8,True
3770708,1388,1,-1,9629,841076598,0,1,0,1104.8,4,81861.39,24,5,21,8,True
3881036,620,3,451,7325,841076598,0,0,0,1104.81,7,80756.58,11,2,19,8,True
4204521,767,0,10,1509,841076598,0,0,0,1104.82,0,81861.4,14,2,23,10,True
4234665,787,0,451,4062,841076598,0,0,0,1105.02,7,80756.38,14,5,13,11,True
4296131,398,0,10,3604,841076598,0,0,0,1105.02,6,81861.4,10,2,1,11,True
4560942,1388,1,30,7488,841076598,0,0,0,1104.92,8,80756.48,24,2,22,12,True
5061573,458,3,30,5359,841076598,0,0,0,1105.07,8,79651.41,13,6,3,1,True
5155818,588,0,20,4110,841076598,0,0,0,1104.85,5,78546.56,24,0,1,3,True
5252063,688,0,20,6730,841076598,0,0,0,1104.91,5,77441.65,24,0,6,3,True
5286801,1388,1,30,7325,841076598,0,0,0,1104.76,8,76336.89,24,3,5,3,True
5506171,642,0,451,1890,841076598,0,0,0,1104.81,7,75232.08,24,6,11,3,True
5860585,1388,1,30,3399,841076598,0,0,0,1105.01,8,74127.07,24,1,7,3,True
5957555,1388,1,-1,9629,841076598,0,1,0,1104.81,1,74127.07,24,3,17,5,True
6090217,787,0,30,1509,841076598,0,0,0,1105.04,8,73022.03,14,3,12,5,True
6294314,1041,0,20,4062,841076598,0,0,0,1104.9,3,71917.13,11,3,20,5,True
6364308,1388,1,451,9629,841076598,0,0,0,1104.84,7,70812.29,24,4,13,6,True
6395662,1388,1,451,5431,841076598,0,0,0,1104.85,7,69707.44,24,1,5,6,True
6423430,1170,0,20,4468,841076598,0,0,0,1105.02,3,68602.42,24,1,9,6,True
6463709,458,3,30,5431,841076598,0,0,0,1104.88,8,67497.54,13,0,22,6,True
6464109,1119,0,10,5431,841076598,0,0,0,1105.14,0,68602.68,24,2,22,6,True
6975014,300,0,10,7488,841076598,0,0,0,1104.87,6,69707.55,4,6,17,7,False
7036484,620,3,-1,1832,841076598,0,1,0,1104.91,1,69707.55,11,3,19,8,True
7065031,620,3,451,1509,841076598,0,0,0,1105.03,7,68602.52,11,5,8,8,True
7116073,787,0,30,1832,841076598,0,0,0,1105.24,8,67497.28,14,0,1,8,True
7739317,1383,4,451,4915,841076598,0,0,0,1105.03,7,66392.25,16,5,22,9,True
8032532,458,3,-1,4690,841076598,0,1,0,1105.21,4,66392.25,13,6,6,10,True
8051696,642,0,30,5359,841076598,0,0,0,1104.88,8,65287.37,24,2,12,1,True
8391147,620,3,451,5431,841076598,0,0,0,1104.83,7,64182.54,11,6,1,1,True
8411453,458,3,30,8608,841076598,0,0,0,1104.95,8,63077.59,13,2,4,2,True
8473895,620,3,451,8387,841076598,0,0,0,1105.16,7,61972.43,11,3,3,2,True
8587461,97,0,20,5182,841076598,0,0,0,1104.86,5,60867.57,3,4,19,3,True
8845758,642,0,30,8234,841076598,0,0,0,1104.92,8,59762.65,24,3,23,4,True
8853499,269,0,10,1890,841076598,0,0,0,1104.68,6,60867.33,24,1,0,5,True
9263072,1388,1,30,4690,841076598,0,0,0,1104.94,8,59762.39,24,0,1,5,True
9327680,309,0,20,8608,841076598,0,0,0,1104.87,5,58657.52,4,2,10,5,True
9405582,458,3,451,6730,841076598,0,0,0,1105.29,7,57552.23,13,2,11,6,True
9475431,1388,1,451,5431,841076598,0,0,0,1105.01,7,56447.22,24,2,18,7,True
9494778,620,3,451,4298,841076598,0,0,0,1104.93,7,55342.29,11,3,2,7,True
9794026,642,0,30,6685,841076598,0,0,0,1105.18,8,54237.11,24,0,11,8,True
9912543,458,3,25,5359,841076598,0,0,0,1104.97,8,53132.14,13,0,14,8,True
9976722,642,0,25,7482,841076598,0,0,0,1105.15,8,52026.99,24,4,18,8,True
1123867,425,4,451,4991,850944455,1,0,0,1122.0,7,230850.0,18,6,8,1,True
1177884,320,1,10,8705,850944455,1,0,0,1122.24,6,231972.24,11,5,6,1,True
1208110,1311,2,30,9269,850944455,1,0,0,1121.99,8,230850.25,5,2,14,4,True
1284516,1380,0,30,6106,850944455,1,0,0,1122.1,8,229728.15,16,6,10,5,True
1291952,664,2,25,7502,850944455,1,0,0,1121.96,8,228606.19,18,1,5,5,True
1323700,1186,2,20,6764,850944455,1,0,0,1122.34,5,227483.85,24,5,10,8,True
1534746,425,4,25,1820,850944455,1,0,0,1121.78,8,226362.07,18,0,14,9,False
1552801,425,4,-1,6905,850944455,1,1,0,1121.94,4,226362.07,18,0,3,10,True
1697939,1146,2,20,1112,850944455,1,0,0,1121.94,5,225240.13,15,0,19,10,True
1739336,1219,1,30,3865,850944455,1,0,0,1121.85,8,224118.28,24,2,11,11,True
1757240,558,0,25,2424,850944455,1,0,0,1122.08,8,222996.2,17,5,1,11,True
1856987,558,0,451,6671,850944455,1,0,0,1121.88,7,221874.32,17,0,8,11,True
1872546,425,4,-1,9177,850944455,1,1,0,1121.92,4,221874.32,18,4,22,12,True
1942176,254,0,10,9269,850944455,1,0,0,1122.11,0,222996.43,6,4,3,1,True
2045052,558,0,451,6605,850944455,1,0,0,1122.13,7,221874.3,17,6,17,1,True
2046487,1219,1,-1,1820,850944455,1,1,0,1121.71,4,221874.3,24,6,4,1,True
2164927,1219,1,30,6764,850944455,1,0,0,1121.83,8,220752.47,24,0,8,2,True
2249298,425,4,451,9177,850944455,1,0,0,1122.08,7,219630.39,18,3,10,2,True
2297114,551,0,10,6905,850944455,1,0,0,1122.09,0,220752.48,17,4,3,2,True
2461156,1380,0,-1,1820,850944455,1,1,0,1121.76,4,220752.48,16,1,18,2,True
2601341,757,0,30,3478,850944455,1,0,0,1121.99,8,219630.49,24,2,13,2,True
2626789,1219,1,25,9177,850944455,1,0,0,1121.96,8,218508.53,24,2,13,3,True
2879483,664,2,451,6364,850944455,1,0,0,1121.94,7,217386.59,18,5,20,4,True
2946032,664,2,25,7502,850944455,1,0,0,1121.71,8,216264.88,18,0,0,5,True
3508802,1219,1,25,9269,850944455,1,0,0,1121.97,8,215142.91,24,0,10,6,True
3574315,558,0,451,8705,850944455,1,0,0,1122.3,7,214020.61,17,6,4,6,True
3662541,664,2,451,7463,850944455,1,0,0,1122.0,7,212898.61,18,5,11,7,True
4030679,538,0,20,1461,850944455,1,0,0,1121.96,5,211776.65,18,0,17,7,True
4108239,1219,1,-1,9269,850944455,1,1,0,1121.96,1,211776.65,24,3,4,8,True
4538089,1219,1,451,7184,850944455,1,0,0,1121.97,7,210654.68,24,1,5,8,True
4566155,664,2,451,1461,850944455,1,0,0,1121.98,7,209532.7,18,1,1,9,True
4819836,757,0,25,3865,850944455,1,0,0,1121.94,8,208410.76,24,1,1,9,True
5048890,1311,2,-1,6764,850944455,1,1,0,1121.94,4,208410.76,5,4,18,9,True
5203207,734,0,20,4991,850944455,1,0,0,1121.95,3,207288.81,11,2,13,10,True
5596159,1219,1,451,7502,850944455,1,0,0,1121.91,7,206166.9,24,3,3,10,False
5759267,1311,2,451,7502,850944455,1,0,0,1121.74,7,205045.16,5,2,8,11,True
5807184,334,0,10,1461,850944455,1,0,0,1122.02,6,206167.18,11,4,21,12,True
6310234,68,0,20,7463,850944455,1,0,0,1122.15,5,205045.03,20,1,19,12,True
6575263,998,0,10,1820,850944455,1,0,0,1121.87,6,206166.9,26,2,2,12,True
6975084,1219,1,30,9177,850944455,1,0,0,1122.05,8,205044.85,24,2,6,1,True
7596132,558,0,-1,9269,850944455,1,1,0,1121.86,4,205044.85,17,3,14,1,True
7714171,1219,1,25,1820,850944455,1,0,0,1121.88,8,203922.97,24,5,10,2,True
7907508,1363,0,10,6671,850944455,1,0,0,1122.11,6,205045.08,16,6,23,2,False
8696682,664,2,451,1820,850944455,1,0,0,1121.73,7,203923.35,18,5,12,3,True
8896886,1219,1,-1,6106,850944455,1,1,0,1122.1,4,203923.35,24,6,2,4,True
8897672,1380,0,30,1820,850944455,1,0,0,1122.1,8,202801.25,16,3,17,4,True
9044924,664,2,451,2691,850944455,1,0,0,1121.89,7,201679.36,18,5,8,5,True
9151001,76,0,10,6905,850944455,1,0,0,1121.77,6,202801.13,20,4,8,5,True
9344442,558,0,30,7463,850944455,1,0,0,1122.21,8,201678.92,17,1,5,6,True
9414547,664,2,-1,1461,850944455,1,1,0,1121.96,4,201678.92,18,5,23,7,True
9551056,664,2,451,3865,850944455,1,0,0,1121.98,7,200556.94,18,5,10,8,True
9771627,1311,2,25,9269,850944455,1,0,0,1121.9,8,199435.04,5,1,7,8,True
9811072,757,0,25,6191,850944455,1,0,0,1122.16,8,198312.88,24,0,22,8,True
9816258,1311,2,451,6364,850944455,1,0,0,1122.13,7,197190.75,5,6,5,10,False
9829232,558,0,-1,6364,850944455,1,1,0,1121.94,4,197190.75,17,5,18,10,True
9957279,664,2,25,5640,850944455,1,0,0,1121.87,8,196068.88,18,1,21,10,True
9998366,558,0,30,6764,850944455,1,0,0,1122.18,8,194946.7,17,5,21,11,True
1185525,965,4,451,6999,524606111,0,0,0,778.04,7,764455.96,13,1,23,1,True
1272924,1315,0,30,9227,524606111,0,0,0,777.85,8,763678.11,5,4,20,2,False
1306132,965,4,25,4633,524606111,0,0,0,777.94,8,762900.17,13,4,1,4,True
1401687,965,4,451,4871,524606111,0,0,0,778.19,7,762121.98,13,1,11,5,True
1807674,524,1,451,1461,524606111,0,0,0,778.02,7,761343.96,18,3,13,5,True
2159821,524,1,25,5084,524606111,0,0,0,778.11,8,760565.85,18,6,10,6,True
2186576,1233,0,25,1461,524606111,0,0,0,778.04,8,759787.81,18,6,11,7,True
2425392,652,0,20,2624,524606111,0,0,0,778.18,5,759009.63,24,1,6,8,True
2745568,1303,0,10,5890,524606111,0,0,0,777.66,0,759787.29,5,0,9,8,True
3355161,1315,0,-1,2624,524606111,0,1,0,778.12,4,759787.29,5,2,2,9,True
3406671,126,1,10,2624,524606111,0,0,0,777.87,6,760565.16,18,4,3,9,True
3916066,524,1,451,4633,524606111,0,0,0,777.91,7,759787.25,18,5,11,10,True
3938432,1315,0,451,4871,524606111,0,0,0,778.23,7,759009.02,5,1,6,10,True
4071710,1315,0,451,5890,524606111,0,0,0,777.82,7,758231.2,5,1,20,10,True
4299780,208,0,20,2624,524606111,0,0,0,777.95,5,757453.25,9,3,12,10,True
4316868,1315,0,30,5644,524606111,0,0,0,778.12,8,756675.13,5,1,11,11,True
4389394,16,4,451,6692,524606111,0,0,0,777.95,7,755897.18,24,3,5,11,True
4418097,965,4,30,6946,524606111,0,0,0,778.13,8,755119.05,13,5,14,11,True
4683594,260,0,20,2624,524606111,0,0,0,778.17,5,754340.88,6,4,15,12,True
4697546,968,3,451,6946,524606111,0,0,0,777.8,7,753563.08,13,0,1,1,True
4721693,228,0,10,6999,524606111,0,0,0,777.93,6,754341.01,26,2,21,2,True
4791841,968,3,30,5084,524606111,0,0,0,778.13,8,753562.88,13,5,0,2,True
4975443,16,4,451,6999,524606111,0,0,0,778.01,7,752784.87,24,3,17,5,True
5039923,1364,0,20,6692,524606111,0,0,0,777.87,3,752007.0,16,4,16,5,True
5047645,42,2,20,6946,524606111,0,0,0,778.02,5,751228.98,24,6,5,6,True
5094859,1315,0,451,6946,524606111,0,0,0,778.2,7,750450.78,5,1,20,6,True
5341373,968,3,25,5890,524606111,0,0,0,778.24,8,749672.54,13,6,9,7,True
5453723,965,4,451,6692,524606111,0,0,0,777.97,7,748894.57,13,1,2,8,True
5572519,1052,0,10,4633,524606111,0,0,0,777.88,0,749672.45,11,3,15,8,True
5880406,350,0,10,4585,524606111,0,0,0,778.01,6,750450.46,24,1,3,9,True
5927436,965,4,30,5644,524606111,0,0,0,777.83,8,749672.63,13,1,8,10,True
5982222,16,4,-1,5084,524606111,0,1,0,778.06,4,749672.63,24,3,2,1,True
6241430,1315,0,-1,4871,524606111,0,2,0,777.63,4,749672.63,5,6,10,1,True
6283604,275,0,20,4871,524606111,0,0,0,777.95,5,748894.68,24,4,3,1,True
6340763,1272,0,20,4585,524606111,0,0,0,778.21,5,748116.47,24,3,0,1,True
6553807,728,1,10,6692,524606111,0,0,0,778.15,0,748894.62,11,6,7,2,True
6748233,656,2,20,5644,524606111,0,0,0,778.02,5,748116.6,18,6,4,4,True
7229036,1315,0,451,6946,524606111,0,0,0,777.84,7,747338.76,5,0,8,4,True
7399047,1233,0,451,5084,524606111,0,0,0,777.82,7,746560.94,18,2,10,4,True
7646363,524,1,451,4585,524606111,0,0,0,777.82,7,745783.12,18,4,4,5,True
7843702,16,4,-1,5084,524606111,0,1,0,777.94,4,745783.12,24,1,2,7,True
8160660,253,2,20,4633,524606111,0,0,0,778.09,5,745005.03,6,2,6,7,True
8238781,297,0,20,6999,524606111,0,0,0,777.93,5,744227.1,4,1,12,7,True
9287245,968,3,30,6999,524606111,0,0,0,777.98,8,743449.12,13,6,15,8,True
9336043,1233,0,25,6692,524606111,0,0,0,777.94,8,742671.18,18,3,4,8,False
9388453,1315,0,451,1461,524606111,0,0,0,777.97,7,741893.21,5,1,9,10,True
9631531,1233,0,451,9227,524606111,0,0,0,778.3,7,741114.91,18,2,12,10,True
9633223,1315,0,30,6692,524606111,0,0,0,777.84,8,740337.07,5,5,0,11,True
9756470,965,4,25,9721,524606111,0,0,0,778.22,8,739558.85,13,6,14,11,True
9991040,968,3,451,1461,524606111,0,0,0,778.25,7,738780.6,13,6,9,11,True
1068124,612,4,30,2159,404249033,1,0,0,295.06,8,651737.94,11,1,9,1,True
1104019,238,0,20,1757,404249033,1,0,0,294.96,5,651442.98,26,1,2,3,True
1539978,177,4,30,2079,404249033,1,0,0,294.77,8,651148.21,24,1,20,3,True
1545518,612,4,30,5697,404249033,1,0,0,295.06,8,650853.15,11,1,20,4,True
1759499,837,3,30,7250,404249033,1,0,0,295.04,8,650558.11,5,1,7,5,True
2020398,612,4,25,4360,404249033,1,0,0,294.93,8,650263.18,11,5,13,5,True
2021767,612,4,25,1743,404249033,1,0,0,294.97,8,649968.21,11,1,21,5,True
2228160,787,0,10,1757,404249033,1,0,0,294.73,6,650262.94,14,6,2,5,True
2336396,837,3,-1,6011,404249033,1,1,0,295.09,4,650262.94,5,6,20,6,True
2396717,255,2,20,4089,404249033,1,0,0,294.85,3,649968.09,6,4,9,7,True
2466240,564,0,20,1743,404249033,1,0,0,294.85,5,649673.24,17,6,7,9,False
2626997,612,4,451,4956,404249033,1,0,0,294.84,7,649378.4,11,4,17,10,True
2639500,1152,0,20,4956,404249033,1,0,0,295.24,5,649083.16,15,5,8,10,True
2805245,866,0,10,4956,404249033,1,0,0,295.38,6,649378.54,24,3,14,10,True
2862434,1408,1,10,4360,404249033,1,0,0,295.19,6,649673.73,24,0,4,10,True
3196179,502,0,20,1753,404249033,1,0,0,294.92,3,649378.81,12,1,2,11,True
3378734,1114,1,10,4100,404249033,1,0,0,294.89,6,649673.7,0,2,1,11,True
3520516,448,0,10,4360,404249033,1,0,0,295.01,6,649968.71,13,5,11,12,True
4313436,177,4,30,7250,404249033,1,0,0,295.06,8,649673.65,24,4,18,12,True
4475050,342,0,20,9142,404249033,1,0,0,294.96,3,649378.69,24,3,9,1,True
4517903,22,3,25,5697,404249033,1,0,0,295.05,8,649083.64,11,0,17,2,True
4653227,22,3,-1,1757,404249033,1,1,0,294.78,1,649083.64,11,0,11,4,True
4785233,837,3,30,1743,404249033,1,0,0,295.03,8,648788.61,5,2,17,4,True
5373829,177,4,30,1309,404249033,1,0,0,295.08,8,648493.53,24,1,18,6,True
5630239,1406,0,20,9142,404249033,1,0,0,295.03,5,648198.5,24,2,6,6,True
5671407,883,0,20,9142,404249033,1,0,0,294.72,5,647903.78,24,6,5,7,True
5697350,22,3,25,4100,404249033,1,0,0,295.12,8,647608.66,11,2,23,7,True
5718948,612,4,25,4100,404249033,1,0,0,295.16,8,647313.5,11,6,23,8,True
5862028,177,4,451,5697,404249033,1,0,0,294.81,7,647018.69,24,4,21,9,True
5880388,612,4,30,1757,404249033,1,0,0,294.96,8,646723.73,11,1,7,10,True
6244653,612,4,30,1757,404249033,1,0,0,294.81,8,646428.92,11,4,22,10,True
6802189,227,4,-1,5697,404249033,1,1,0,294.94,4,646428.92,26,6,15,10,True
6914711,227,4,451,6011,404249033,1,0,0,295.33,7,646133.59,26,0,17,10,True
7250455,22,3,-1,5697,404249033,1,1,0,295.16,4,646133.59,11,3,8,11,True
7359679,177,4,451,5697,404249033,1,0,0,295.11,7,645838.48,24,3,15,11,False
7660879,406,1,10,7250,404249033,1,0,0,294.89,6,646133.37,10,1,3,12,True
7890218,215,0,10,5697,404249033,1,0,0,295.23,6,646428.6,9,5,0,12,True
7949651,509,0,10,4956,404249033,1,0,0,294.8,6,646723.4,12,5,5,12,True
8172556,837,3,451,4360,404249033,1,0,0,295.23,7,646428.17,5,0,16,1,True
8224529,227,4,451,1743,404249033,1,0,0,294.96,7,646133.21,26,2,15,1,True
8369967,628,0,10,7250,404249033,1,0,0,294.84,0,646428.05,11,2,17,2,True
8475935,837,3,451,5438,404249033,1,0,0,294.71,7,646133.34,5,6,7,2,True
8488633,276,0,20,1309,404249033,1,0,0,295.11,5,645838.23,24,5,1,2,True
8551372,177,4,30,9142,404249033,1,0,0,295.06,8,645543.17,24,1,19,3,True
8674585,837,3,451,7250,404249033,1,0,0,295.22,7,645247.95,5,2,22,3,True
9022537,22,3,25,4100,404249033,1,0,0,294.91,8,644953.04,11,4,23,3,True
9100427,759,0,10,4956,404249033,1,0,0,295.04,0,645248.08,24,2,15,4,True
9154837,612,4,-1,4089,404249033,1,1,0,294.96,4,645248.08,11,3,15,4,True
9438732,612,4,451,1757,404249033,1,0,0,295.07,7,644953.01,11,0,20,6,False
9780065,747,1,10,4360,404249033,1,0,0,294.91,6,645247.92,24,4,10,7,True
9781619,1231,2,20,1743,404249033,1,0,0,295.04,3,644952.88,18,6,13,8,True
9812474,227,4,451,1757,404249033,1,0,0,294.69,7,644658.19,26,3,8,9,True
9836506,612,4,25,6011,404249033,1,0,0,295.16,8,644363.03,11,1,0,10,False
9891620,22,3,25,2159,404249033,1,0,0,294.94,8,644068.09,11,1,6,10,True
9952042,177,4,-1,6011,404249033,1,1,0,294.94,4,644068.09,24,2,8,10,True
1085616,180,0,10,1544,574657739,1,0,0,1088.9,6,993065.9,18,2,8,1,True
1153479,402,3,30,9876,574657739,1,0,0,1088.86,8,991977.04,10,3,2,2,True
1736659,630,0,-1,9876,574657739,1,1,0,1088.9,4,991977.04,11,5,18,2,True
1793936,402,3,30,3587,574657739,1,0,0,1089.2,8,990887.84,10,6,1,4,True
1832105,1260,0,10,6972,574657739,1,0,0,1089.03,6,991976.87,23,0,21,4,False
1943992,456,4,25,8543,574657739,1,0,0,1088.97,8,990887.9,13,0,6,4,True
1971392,402,3,451,7316,574657739,1,0,0,1088.94,7,989798.96,10,0,18,5,True
2274726,630,0,25,3587,574657739,1,0,0,1089.01,8,988709.95,11,5,16,5,True
2538394,630,0,25,4031,574657739,1,0,0,1088.98,8,987620.97,11,5,10,7,True
2683578,226,4,30,2105,574657739,1,0,0,1089.05,8,986531.92,26,3,20,8,True
2996224,1034,1,30,5012,574657739,1,0,0,1088.98,8,985442.94,11,1,19,8,True
3317655,76,0,10,8543,574657739,1,0,0,1089.07,0,986532.01,20,2,22,8,True
3468223,498,0,20,6188,574657739,1,0,0,1089.03,5,985442.98,12,5,4,9,True
3486994,525,0,10,6972,574657739,1,0,0,1089.15,6,986532.13,18,2,17,10,True
3672629,951,0,20,9561,574657739,1,0,0,1089.21,3,985442.92,24,6,18,11,True
3720165,456,4,25,2361,574657739,1,0,0,1089.31,8,984353.61,13,6,19,12,True
3861484,1034,1,-1,1425,574657739,1,1,0,1089.08,4,984353.61,11,6,9,12,True
3875051,456,4,-1,9561,574657739,1,2,0,1089.13,4,984353.61,13,4,7,12,True
3882036,402,3,30,8221,574657739,1,0,0,1088.73,8,983264.88,10,5,0,12,True
3921039,630,0,-1,3587,574657739,1,1,0,1089.02,4,983264.88,11,2,19,1,True
4230200,278,1,-1,2888,574657739,1,2,0,1089.04,1,983264.88,24,4,4,1,True
4413555,278,1,451,7988,574657739,1,0,0,1089.13,7,982175.75,24,1,0,2,True
4713439,278,1,25,3810,574657739,1,0,0,1089.12,8,981086.63,24,6,4,4,True
4809819,226,4,-1,8963,574657739,1,1,0,1088.92,1,981086.63,26,3,10,4,True
4902640,456,4,-1,9298,574657739,1,2,0,1088.98,4,981086.63,13,4,6,4,True
4954346,630,0,451,8221,574657739,1,0,0,1089.02,7,979997.61,11,4,21,5,True
5488685,402,3,451,8543,574657739,1,0,0,1088.76,7,978908.85,10,4,22,5,True
5490176,895,0,20,3587,574657739,1,0,0,1088.91,3,977819.94,24,6,5,6,True
5553638,226,4,25,7988,574657739,1,0,0,1088.89,8,976731.05,26,0,13,6,True
5587961,1034,1,25,5012,574657739,1,0,0,1089.12,8,975641.93,11,5,20,8,True
6069597,402,3,30,5012,574657739,1,0,0,1088.8,8,974553.13,10,2,12,8,True
6081652,226,4,451,8009,574657739,1,0,0,1089.23,7,973463.9,26,4,0,10,True
6087288,630,0,25,4216,574657739,1,0,0,1089.2,8,972374.7,11,2,9,10,True
6240386,599,0,20,2361,574657739,1,0,0,1089.15,5,971285.55,24,5,22,10,True
6365895,456,4,451,4216,574657739,1,0,0,1088.79,7,970196.76,13,1,5,10,True
6365996,1000,0,10,1425,574657739,1,0,0,1089.27,6,971286.03,26,6,9,11,True
6626866,456,4,25,2484,574657739,1,0,0,1089.14,8,970196.89,13,1,10,11,True
6934398,630,0,30,7988,574657739,1,0,0,1089.12,8,969107.77,11,2,5,12,True
7000200,792,1,10,4216,574657739,1,0,0,1089.08,6,970196.85,11,1,18,12,True
7017345,630,0,-1,9561,574657739,1,1,0,1088.91,4,970196.85,11,1,23,1,True
7058005,456,4,30,4216,574657739,1,0,0,1088.9,8,969107.95,13,3,10,1,True
7106811,226,4,25,8963,574657739,1,0,0,1089.06,8,968018.89,26,6,20,2,True
7564960,159,2,20,4216,574657739,1,0,0,1089.09,5,966929.8,24,4,10,4,True
7875799,456,4,-1,3587,574657739,1,1,0,1088.87,1,966929.8,13,2,15,4,True
7994529,630,0,25,8009,574657739,1,0,0,1088.95,8,965840.85,11,6,10,4,True
8287332,402,3,-1,6972,574657739,1,1,0,1089.31,1,965840.85,10,0,19,5,True
8406566,402,3,451,8543,574657739,1,0,0,1088.93,7,964751.92,10,0,9,7,True
8531837,402,3,25,1063,574657739,1,0,0,1088.93,8,963662.99,10,4,12,10,True
8594733,456,4,30,4216,574657739,1,0,0,1089.0,8,962573.99,13,1,4,10,True
8815209,616,1,10,5883,574657739,1,0,0,1089.02,6,963663.01,11,1,19,10,True
8936053,51,0,20,6188,574657739,1,0,0,1088.82,5,962574.19,20,4,8,10,True
9087111,456,4,25,7316,574657739,1,0,0,1088.94,8,961485.25,13,2,1,11,True
9408102,630,0,451,9123,574657739,1,0,0,1089.03,7,960396.22,11,3,0,11,True
9415552,402,3,-1,7988,574657739,1,1,0,1089.04,4,960396.22,10,5,12,11,True
9420009,1399,0,10,2361,574657739,1,0,0,1089.13,0,961485.35,24,2,0,11,True
9549586,226,4,30,2888,574657739,1,0,0,1089.18,8,960396.17,26,3,18,11,True
1005179,678,4,451,2448,484096083,0,0,0,796.15,7,266333.85,24,6,14,1,True
1387838,610,0,10,8863,484096083,0,0,0,795.87,0,267129.72,11,2,14,1,True
1682732,191,3,451,6631,484096083,0,0,0,795.84,7,266333.88,18,4,22,1,True
1699569,191,3,25,5505,484096083,0,0,0,795.82,8,265538.06,18,0,2,2,True
2174615,485,1,10,8543,484096083,0,0,0,795.62,6,266333.68,5,4,17,2,True
2327547,1141,4,451,4094,484096083,0,0,0,796.19,7,265537.49,15,4,12,7,True
2394243,429,0,10,5092,484096083,0,0,0,796.03,6,266333.52,24,5,13,10,True
2522135,1247,0,10,5505,484096083,0,0,0,795.91,6,267129.43,23,3,12,11,True
2572152,59,0,25,8812,484096083,0,0,0,796.14,8,266333.29,20,6,10,11,True
2593258,1298,0,20,1216,484096083,0,0,0,796.08,5,265537.21,5,6,17,12,True
2642846,678,4,30,1216,484096083,0,0,0,796.04,8,264741.17,24,1,3,12,True
2671638,939,0,10,4466,484096083,0,0,0,795.96,6,265537.13,24,3,6,12,True
2711700,1141,4,25,7785,484096083,0,0,0,796.25,8,264740.88,15,2,2,12,True
2764234,1363,0,20,8543,484096083,0,0,0,795.94,5,263944.94,16,6,9,1,True
2787821,117,1,10,8812,484096083,0,0,0,796.04,6,264740.98,18,4,21,2,True
2966343,437,4,30,8772,484096083,0,0,0,796.13,8,263944.85,24,0,5,5,True
2985551,59,0,451,5242,484096083,0,0,0,795.83,7,263149.02,20,4,18,6,True
3071161,1141,4,30,5962,484096083,0,0,0,795.96,8,262353.06,15,3,7,6,True
3146535,678,4,451,5486,484096083,0,0,0,795.97,7,261557.09,24,1,17,6,True
3712524,678,4,451,4320,484096083,0,0,0,796.02,7,260761.07,24,3,15,7,True
3861445,437,4,-1,6233,484096083,0,1,0,796.08,4,260761.07,24,0,12,8,True
3909293,437,4,451,8543,484096083,0,0,0,796.14,7,259964.93,24,0,22,8,True
4054077,558,0,10,9781,484096083,0,0,0,796.0,6,260760.93,17,2,2,9,True
4341004,1238,0,10,6631,484096083,0,0,0,795.76,6,261556.69,18,0,4,10,True
4719196,929,0,20,4466,484096083,0,0,0,795.77,5,260760.92,18,1,1,11,True
4741529,678,4,-1,2448,484096083,0,1,0,795.85,1,260760.92,24,1,17,11,True
4756010,59,0,451,9744,484096083,0,0,0,796.03,7,259964.89,20,1,3,11,True
4922356,678,4,25,2493,484096083,0,0,0,795.9,8,259168.99,24,3,1,12,True
4977152,482,1,10,5034,484096083,0,0,0,795.94,6,259964.93,5,4,2,3,True
5045014,1141,4,30,9744,484096083,0,0,0,796.24,8,259168.69,15,0,4,4,True
5045216,437,4,25,2493,484096083,0,0,0,795.68,8,258373.01,24,4,7,6,True
5130701,191,3,25,5505,484096083,0,0,0,795.93,8,257577.08,18,0,16,8,True
5323171,512,0,10,3061,484096083,0,0,0,796.01,0,258373.09,12,0,4,8,True
5687229,678,4,30,6233,484096083,0,0,0,796.12,8,257576.97,24,5,2,9,True
6203258,191,3,-1,8772,484096083,0,1,0,795.83,1,257576.97,18,1,10,9,True
6736101,59,0,-1,2448,484096083,0,2,0,796.29,4,257576.97,20,6,19,11,True
6737617,678,4,-1,5032,484096083,0,3,1,796.12,1,0.0,24,6,20,11,True
1026153,1383,4,451,9967,201963321,0,0,0,1156.81,7,634973.19,16,3,17,2,True
1046281,1383,4,451,1204,201963321,0,0,0,1157.27,7,633815.92,16,1,1,3,True
1560646,46,1,451,5745,201963321,0,0,0,1156.98,7,632658.94,24,1,5,3,True
1620445,267,0,20,1204,201963321,0,0,0,1156.99,5,631501.95,6,4,16,4,True
1756633,414,4,25,4737,201963321,0,0,0,1157.44,8,630344.51,18,3,15,4,True
1828805,269,0,20,4631,201963321,0,0,0,1156.98,5,629187.53,24,5,7,4,True
2157537,1383,4,-1,9494,201963321,0,1,0,1156.93,1,629187.53,16,0,21,5,True
2205742,263,3,25,1204,201963321,0,0,0,1157.0,8,628030.53,6,0,0,7,False
2371710,877,2,20,3594,201963321,0,0,0,1156.98,3,626873.55,24,6,7,7,True
2481301,263,3,451,7237,201963321,0,0,0,1156.96,7,625716.59,6,0,6,9,True
2563767,414,4,30,9494,201963321,0,0,0,1157.17,8,624559.42,18,1,15,9,True
2605073,328,0,25,1877,201963321,0,0,0,1157.05,8,623402.37,11,6,12,9,True
2620185,990,0,20,8012,201963321,0,0,0,1157.05,3,622245.32,22,4,9,9,True
2646335,1122,1,25,4125,201963321,0,0,0,1157.01,8,621088.31,24,1,20,10,True
2776906,1383,4,-1,7237,201963321,0,1,0,1157.02,1,621088.31,16,4,5,10,True
2790742,328,0,30,3594,201963321,0,0,0,1157.01,8,619931.3,11,4,23,10,True
3135614,328,0,451,3833,201963321,0,0,0,1157.07,7,618774.23,11,6,19,10,True
3205087,897,0,20,9314,201963321,0,0,0,1157.01,5,617617.22,24,3,1,11,True
3300221,1383,4,-1,8933,201963321,0,1,0,1157.14,4,617617.22,16,3,17,12,True
3338971,46,1,30,2957,201963321,0,0,0,1157.03,8,616460.19,24,4,12,12,True
3410795,328,0,451,4676,201963321,0,0,0,1156.97,7,615303.22,11,2,10,1,True
3464378,688,0,10,9494,201963321,0,0,0,1156.73,6,616459.95,24,5,2,2,True
3473459,1155,0,10,4910,201963321,0,0,0,1156.52,6,617616.47,15,1,2,5,True
3526366,1426,1,10,1877,201963321,0,0,0,1157.07,6,618773.54,24,2,9,5,True
3811360,1383,4,25,3832,201963321,0,0,0,1157.18,8,617616.36,16,5,20,5,False
4414034,1092,1,10,5381,201963321,0,0,0,1156.82,6,618773.18,18,0,13,5,True
4657899,1383,4,30,4125,201963321,0,0,0,1157.08,8,617616.1,16,3,4,5,True
4751935,1434,0,20,7474,201963321,0,0,0,1157.21,5,616458.89,24,4,11,6,True
5141507,328,0,25,7237,201963321,0,0,0,1157.29,8,615301.6,11,4,13,6,True
5195125,263,3,30,6904,201963321,0,0,0,1156.97,8,614144.63,6,1,21,7,True
5305625,1383,4,-1,8012,201963321,0,1,0,1157.27,4,614144.63,16,3,11,8,True
5591525,414,4,30,9494,201963321,0,0,0,1157.12,8,612987.51,18,0,21,9,True
5726627,46,1,-1,6570,201963321,0,1,0,1156.78,1,612987.51,24,6,6,9,True
5878449,414,4,30,5876,201963321,0,0,0,1156.86,8,611830.65,18,1,16,10,True
5996156,328,0,25,9314,201963321,0,0,0,1156.89,8,610673.76,11,5,16,11,True
6244292,703,0,20,9314,201963321,0,0,0,1156.87,5,609516.89,18,3,9,11,True
6370942,414,4,-1,9314,201963321,0,1,0,1156.79,4,609516.89,18,4,12,12,True
6531383,328,0,451,7237,201963321,0,0,0,1157.22,7,608359.67,11,4,0,1,True
6631057,644,0,20,1456,201963321,0,0,0,1156.65,5,607203.02,24,0,17,1,True
6782792,664,2,20,1204,201963321,0,0,0,1157.17,3,606045.85,18,1,13,1,True
6791985,1363,0,20,4125,201963321,0,0,0,1156.91,5,604888.94,16,5,14,1,True
6911259,328,0,-1,1456,201963321,0,1,0,1157.11,1,604888.94,11,4,19,2,True
7329601,59,0,10,3832,201963321,0,0,0,1157.04,6,606045.98,20,4,7,3,True
7335929,263,3,25,3594,201963321,0,0,0,1157.14,8,604888.84,6,4,9,3,True
7444826,414,4,30,9985,201963321,0,0,0,1157.25,8,603731.59,18,5,9,3,True
7716982,653,1,10,7164,201963321,0,0,0,1157.12,6,604888.71,24,0,8,3,True
7807834,1122,1,451,4676,201963321,0,0,0,1156.91,7,603731.8,24,4,13,3,True
8533112,1322,2,20,5876,201963321,0,0,0,1157.04,5,602574.76,18,6,18,4,True
8806462,664,2,20,2957,201963321,0,0,0,1157.05,5,601417.71,18,3,6,9,True
9110493,278,1,10,2957,201963321,0,0,0,1157.03,6,602574.74,24,2,8,10,True
9465082,780,0,20,3594,201963321,0,0,0,1157.12,3,601417.62,14,0,3,10,True
1574335,239,1,10,1759,570739912,0,0,0,484.0,6,657657.0,26,4,11,2,True
1712781,238,0,10,2306,570739912,0,0,0,484.04,6,658141.04,26,0,11,2,True
1819390,739,1,10,7029,570739912,0,0,0,483.87,0,658624.91,24,0,10,6,True
1963463,816,0,30,7992,570739912,0,0,0,484.08,8,658140.83,18,4,14,6,True
2065477,816,0,25,8150,570739912,0,0,0,484.15,8,657656.68,18,3,22,6,True
2413196,816,0,-1,7992,570739912,0,1,0,484.39,1,657656.68,18,2,19,7,True
2444418,649,0,20,8150,570739912,0,0,0,484.12,5,657172.56,24,4,7,7,True
2970354,1495,3,30,7992,570739912,0,0,0,483.88,8,656688.68,24,4,11,7,True
3070291,1305,2,20,9117,570739912,0,0,0,484.15,5,656204.53,5,5,20,8,True
3195874,1478,4,30,1916,570739912,0,0,0,484.16,8,655720.37,24,6,11,9,True
3427150,224,3,25,1717,570739912,0,0,0,484.17,8,655236.2,26,3,16,9,False
3477076,1140,0,20,1916,570739912,0,0,0,484.07,3,654752.13,15,3,10,9,True
3753084,224,3,451,4852,570739912,0,0,0,484.07,7,654268.06,26,6,6,10,True
3755075,1036,1,451,8150,570739912,0,0,0,484.04,7,653784.02,11,6,10,10,True
3831585,913,0,25,5387,570739912,0,0,0,484.03,8,653299.99,18,0,1,10,True
3918063,1495,3,25,1916,570739912,0,0,0,484.16,8,652815.83,24,3,0,10,True
4153804,931,0,10,4103,570739912,0,0,0,483.55,6,653299.38,24,5,21,10,True
4322333,816,0,-1,3153,570739912,0,1,0,484.41,4,653299.38,18,3,8,12,True
4748204,816,0,-1,7029,570739912,0,2,0,484.33,4,653299.38,18,6,20,12,True
4802366,820,1,10,1717,570739912,0,0,0,483.78,6,653783.16,18,5,11,12,True
4921722,883,0,10,8150,570739912,0,0,0,484.27,0,654267.43,24,4,18,1,True
4979406,1495,3,451,2306,570739912,0,0,0,484.17,7,653783.26,24,6,14,1,True
5077068,224,3,25,7029,570739912,0,0,0,483.97,8,653299.29,26,0,5,1,False
5107798,224,3,30,4852,570739912,0,0,0,484.19,8,652815.1,26,6,2,2,True
5394219,580,0,20,7109,570739912,0,0,0,483.64,5,652331.46,11,0,17,4,True
5416959,913,0,25,3163,570739912,0,0,0,483.99,8,651847.47,18,1,5,5,True
5508710,551,0,20,9092,570739912,0,0,0,484.08,3,651363.39,17,0,21,6,True
5720582,1017,2,20,8150,570739912,0,0,0,483.97,5,650879.42,26,0,18,7,True
5813380,1315,0,20,1717,570739912,0,0,0,484.12,5,650395.3,5,3,14,9,True
6071051,1478,4,-1,7109,570739912,0,1,0,483.91,1,650395.3,24,3,16,9,True
6190550,816,0,451,1916,570739912,0,0,0,483.88,7,649911.42,18,2,23,10,True
6264452,1262,0,10,7109,570739912,0,0,0,483.81,0,650395.23,23,3,13,10,False
6374172,799,2,20,9117,570739912,0,0,0,484.11,3,649911.12,11,6,14,12,True
6647735,1036,1,25,4103,570739912,0,0,0,483.77,8,649427.35,11,0,4,12,True
6786714,1478,4,-1,7029,570739912,0,1,0,483.81,1,649427.35,24,2,8,12,True
6922715,1495,3,451,5387,570739912,0,0,0,483.92,7,648943.43,24,5,17,1,True
7019926,816,0,451,4852,570739912,0,0,0,484.18,7,648459.25,18,0,11,1,True
7058279,913,0,25,2464,570739912,0,0,0,483.96,8,647975.29,18,4,10,2,True
7072263,1036,1,-1,2464,570739912,0,1,0,484.06,1,647975.29,11,3,21,3,True
7345022,677,0,20,9117,570739912,0,0,0,484.23,5,647491.06,24,5,13,3,True
7349564,1036,1,25,8150,570739912,0,0,0,483.78,8,647007.28,11,1,8,4,True
7532895,1495,3,451,4852,570739912,0,0,0,483.95,7,646523.33,24,2,23,4,False
7567352,913,0,25,7992,570739912,0,0,0,483.87,8,646039.46,18,2,13,5,True
7611653,913,0,25,9117,570739912,0,0,0,484.29,8,645555.17,18,1,18,5,True
7823459,1364,0,10,3163,570739912,0,0,0,483.99,0,646039.16,16,3,19,6,True
7838958,816,0,30,4852,570739912,0,0,0,483.76,8,645555.4,18,1,6,8,True
8464832,224,3,451,7029,570739912,0,0,0,484.24,7,645071.16,26,0,6,9,True
8712331,275,0,10,9092,570739912,0,0,0,483.89,6,645555.05,24,3,0,9,True
9413042,816,0,-1,4103,570739912,0,1,0,483.91,4,645555.05,18,0,15,10,True
9492743,889,0,10,3163,570739912,0,0,0,483.72,6,646038.77,27,5,9,11,True
1313049,342,0,451,6315,202812510,0,0,0,288.89,7,894207.11,24,6,23,1,True
1704462,375,4,451,6222,202812510,0,0,0,288.91,7,893918.2,25,1,11,2,True
2068673,342,0,451,1656,202812510,0,0,0,288.93,7,893629.27,24,2,17,3,True
2126374,342,0,451,6222,202812510,0,0,0,288.79,7,893340.48,24,6,16,3,True
2291734,375,4,451,6222,202812510,0,0,0,288.88,7,893051.6,25,3,14,4,True
2654614,743,4,-1,6222,202812510,0,1,0,288.71,1,893051.6,24,1,21,4,True
2734239,68,0,20,7438,202812510,0,0,0,288.84,3,892762.76,20,3,4,4,True
2904713,664,2,20,6315,202812510,0,0,0,289.12,3,892473.64,18,6,18,5,True
2998657,375,4,451,3688,202812510,0,0,0,288.76,7,892184.88,25,0,7,5,True
3033368,375,4,451,4603,202812510,0,0,0,288.95,7,891895.93,25,0,16,5,True
3246756,375,4,451,4231,202812510,0,0,0,288.88,7,891607.05,25,4,23,5,True
3326877,743,4,30,6813,202812510,0,0,0,289.28,8,891317.77,24,0,14,7,False
3330512,392,4,451,1656,202812510,0,0,0,288.84,7,891028.93,10,2,23,8,True
3344351,644,0,20,7438,202812510,0,0,0,289.05,3,890739.88,24,2,22,9,True
3453961,392,4,-1,4777,202812510,0,1,0,288.91,1,890739.88,10,1,3,9,True
3590962,743,4,451,5739,202812510,0,0,0,288.96,7,890450.92,24,6,4,10,True
3711218,375,4,25,5369,202812510,0,0,0,288.9,8,890162.02,25,1,13,11,True
3809658,168,0,10,4231,202812510,0,0,0,288.7,6,890450.72,24,0,2,11,True
3880793,743,4,30,6315,202812510,0,0,0,288.92,8,890161.8,24,0,17,11,True
4162064,796,2,20,6315,202812510,0,0,0,288.91,5,889872.89,11,6,2,2,True
4307657,1115,1,10,7128,202812510,0,0,0,289.11,6,890162.0,0,0,21,2,True
4533136,392,4,451,4777,202812510,0,0,0,288.9,7,889873.1,10,5,14,3,True
4621298,392,4,451,7438,202812510,0,0,0,289.03,7,889584.07,10,0,14,4,True
4628332,342,0,25,4777,202812510,0,0,0,289.2,8,889294.87,24,4,19,5,True
4639986,365,0,30,6222,202812510,0,0,0,288.94,8,889005.93,25,1,21,5,True
4837061,342,0,25,6222,202812510,0,0,0,289.02,8,888716.91,24,4,18,7,True
4985350,392,4,25,7128,202812510,0,0,0,288.88,8,888428.03,10,1,16,9,True
5029617,365,0,25,6813,202812510,0,0,0,288.69,8,888139.34,25,4,7,9,True
5883688,375,4,25,6299,202812510,0,0,0,288.68,8,887850.66,25,3,0,10,True
6029083,342,0,25,4231,202812510,0,0,0,289.05,8,887561.61,24,4,14,10,True
6174142,342,0,25,6315,202812510,0,0,0,288.96,8,887272.65,24,4,3,10,True
6191318,342,0,451,5369,202812510,0,0,0,289.18,7,886983.47,24,3,20,10,True
6317030,342,0,451,7128,202812510,0,0,0,289.16,7,886694.31,24,4,11,12,True
6405762,743,4,30,5739,202812510,0,0,0,289.03,8,886405.28,24,3,4,12,True
6841494,743,4,451,6222,202812510,0,0,0,289.29,7,886115.99,24,6,13,1,True
6931416,254,0,20,4231,202812510,0,0,0,289.1,3,885826.89,6,0,8,3,True
7126458,365,0,25,5369,202812510,0,0,0,288.98,8,885537.91,25,2,8,3,True
7295052,365,0,-1,5739,202812510,0,1,0,289.11,1,885537.91,25,4,23,3,True
7319006,58,2,20,4777,202812510,0,0,0,289.02,5,885248.89,20,5,5,3,True
7492717,167,2,20,1656,202812510,0,0,0,289.23,5,884959.66,24,1,9,3,True
7739655,392,4,-1,2898,202812510,0,1,0,288.88,4,884959.66,10,6,8,3,True
7942623,1460,2,20,6299,202812510,0,0,0,289.28,5,884670.38,11,6,14,4,True
8496217,743,4,451,5739,202812510,0,0,0,289.09,7,884381.29,24,2,22,6,True
8762166,392,4,25,8950,202812510,0,0,0,288.89,8,884092.4,10,0,12,6,True
9030433,376,0,20,6813,202812510,0,0,0,289.14,5,883803.26,25,5,14,7,True
9042851,365,0,30,7438,202812510,0,0,0,288.8,8,883514.46,25,1,9,7,True
9108476,1090,0,10,6299,202812510,0,0,0,289.01,6,883803.47,18,4,17,7,True
9206775,1421,0,20,4603,202812510,0,0,0,289.14,5,883514.33,24,4,12,8,True
9258334,511,1,10,7128,202812510,0,0,0,289.15,6,883803.48,12,0,2,8,True
9288069,392,4,451,4777,202812510,0,0,0,288.91,7,883514.57,10,3,2,9,True
9500978,375,4,451,1656,202812510,0,0,0,289.14,7,883225.43,25,4,19,9,True
9519746,1017,2,20,2305,202812510,0,0,0,288.92,3,882936.51,26,5,15,9,True
9614469,1321,0,10,8950,202812510,0,0,0,288.85,6,883225.36,18,2,2,9,True
9671811,743,4,25,6222,202812510,0,0,0,289.02,8,882936.34,24,5,12,10,True
9941651,342,0,30,6315,202812510,0,0,0,289.1,8,882647.24,24,0,7,11,True
9963967,342,0,30,1677,202812510,0,0,0,288.77,8,882358.47,24,4,12,11,False
1092981,205,0,20,8383,521934472,0,0,0,1119.97,5,577348.03,9,0,18,1,True
1095355,681,2,20,5865,521934472,0,0,0,1119.97,5,576228.06,24,5,13,2,True
1190505,287,0,451,2275,521934472,0,0,0,1120.0,7,575108.06,24,6,3,3,True
1569176,767,0,10,4090,521934472,0,0,0,1119.87,0,576227.93,14,6,9,3,True
1664682,1315,0,20,9122,521934472,0,0,0,1119.87,5,575108.06,5,0,4,3,True
1683022,96,0,451,8383,521934472,0,0,0,1119.96,7,573988.1,1,3,6,3,True
1953744,276,0,10,4722,521934472,0,0,0,1119.98,6,575108.08,24,3,21,3,True
2045455,1089,0,20,9900,521934472,0,0,0,1120.09,5,573987.99,18,0,22,5,True
2212847,998,0,451,5865,521934472,0,0,0,1120.02,7,572867.97,26,5,12,5,True
2544934,599,0,20,5222,521934472,0,0,0,1120.09,3,571747.88,24,0,20,6,True
2726222,488,3,25,8889,521934472,0,0,0,1119.87,8,570628.01,12,0,11,7,True
2875776,364,4,30,5222,521934472,0,0,0,1120.0,8,569508.01,25,4,19,7,True
2989079,1050,4,451,5222,521934472,0,0,0,1120.11,7,568387.9,11,0,3,8,True
3000407,703,0,10,7133,521934472,0,0,0,1119.73,6,569507.63,18,3,22,8,True
3015406,1399,0,10,5750,521934472,0,0,0,1120.27,0,570627.9,24,3,5,9,True
3548511,1050,4,30,8798,521934472,0,0,0,1119.96,8,569507.94,11,5,10,10,True
3771636,889,0,20,4577,521934472,0,0,0,1119.98,3,568387.96,27,6,12,10,True
3989013,535,0,10,9802,521934472,0,0,0,1120.03,6,569507.99,18,1,10,11,True
4064098,1224,4,451,8383,521934472,0,0,0,1119.86,7,568388.13,24,0,8,1,True
4148282,488,3,25,5865,521934472,0,0,0,1120.14,8,567267.99,12,6,13,2,True
4166442,156,4,30,8798,521934472,0,0,0,1120.19,8,566147.8,18,4,0,2,True
4173670,123,0,20,1521,521934472,0,0,0,1120.02,5,565027.78,18,4,20,3,True
4377131,1224,4,25,5750,521934472,0,0,0,1120.1,8,563907.68,24,5,19,3,True
4646219,287,0,-1,2968,521934472,0,1,0,1119.96,4,563907.68,24,0,14,3,True
4702366,287,0,30,5744,521934472,0,0,0,1120.07,8,562787.61,24,6,17,4,True
4872238,471,0,-1,7479,521934472,0,1,0,1119.89,4,562787.61,5,5,6,5,True
4882400,1050,4,25,5865,521934472,0,0,0,1119.7,8,561667.91,11,4,22,7,True
5537760,1224,4,30,3977,521934472,0,0,0,1119.82,8,560548.09,24,6,13,7,True
6289801,287,0,451,8383,521934472,0,0,0,1120.02,7,559428.07,24,3,14,8,True
6404894,1260,0,10,4722,521934472,0,0,0,1119.93,6,560548.0,23,4,7,8,True
6814048,1297,0,20,9122,521934472,0,0,0,1120.24,5,559427.76,5,1,19,9,True
6852668,287,0,451,5750,521934472,0,0,0,1120.13,7,558307.63,24,4,2,10,True
7097368,471,0,30,6996,521934472,0,0,0,1120.0,8,557187.63,5,0,14,10,True
7216095,488,3,30,9907,521934472,0,0,0,1120.15,8,556067.48,12,6,20,12,True
7390955,364,4,25,5222,521934472,0,0,0,1119.96,8,554947.52,25,5,1,12,True
7394699,364,4,-1,9907,521934472,0,1,0,1120.01,1,554947.52,25,6,16,12,True
7453791,96,0,451,8455,521934472,0,0,0,1119.87,7,553827.65,1,1,6,1,True
7566340,471,0,-1,5941,521934472,0,1,0,1120.19,4,553827.65,5,3,2,1,True
7689720,913,0,10,4680,521934472,0,0,0,1119.89,6,554947.54,18,3,17,1,True
7713503,998,0,25,2275,521934472,0,0,0,1119.78,8,553827.76,26,5,15,2,True
8153025,488,3,451,8889,521934472,0,0,0,1120.15,7,552707.61,12,6,23,2,True
8185290,156,4,25,5941,521934472,0,0,0,1119.95,8,551587.66,18,6,15,3,True
8200990,1050,4,-1,3977,521934472,0,1,0,1120.01,1,551587.66,11,2,0,4,True
8904211,1224,4,-1,4058,521934472,0,2,0,1120.02,4,551587.66,24,3,14,5,True
8908707,364,4,25,1521,521934472,0,0,0,1119.97,8,550467.69,25,4,14,5,True
8933675,1224,4,451,4530,521934472,0,0,0,1120.04,7,549347.65,24,0,17,6,True
9172232,605,0,20,4058,521934472,0,0,0,1120.13,5,548227.52,24,5,11,7,True
9295382,1224,4,-1,3726,521934472,0,1,0,1119.9,4,548227.52,24,6,18,8,True
9421011,1224,4,25,4090,521934472,0,0,0,1119.87,8,547107.65,24,0,10,8,True
9443399,998,0,451,8561,521934472,0,0,0,1120.16,7,545987.49,26,2,2,8,True
9469873,471,0,25,9802,521934472,0,0,0,1119.93,8,544867.56,5,6,21,9,True
9795018,156,4,451,5865,521934472,0,0,0,1120.16,7,543747.4,18,2,4,10,True
9862601,205,0,10,9122,521934472,0,0,0,1119.92,6,544867.32,9,5,0,10,True
9941970,1318,0,10,6996,521934472,0,0,0,1119.93,0,545987.25,18,5,15,11,True
1741913,989,1,30,9618,763187731,0,0,0,365.76,8,877069.24,22,5,22,1,True
1836231,963,4,25,7497,763187731,0,0,0,366.04,8,876703.2,13,1,3,1,True
1946070,823,4,25,2365,763187731,0,0,0,365.95,8,876337.25,18,6,11,1,True
1975960,1027,0,20,4444,763187731,0,0,0,365.89,3,875971.36,11,0,3,1,True
2012976,963,4,25,2365,763187731,0,0,0,365.94,8,875605.42,13,3,6,1,True
2099193,1010,0,451,5987,763187731,0,0,0,365.91,7,875239.51,26,4,13,2,True
2292630,1436,0,10,3596,763187731,0,0,0,366.13,6,875605.64,24,6,15,2,True
2550879,278,1,30,9997,763187731,0,0,0,366.07,8,875239.57,24,4,13,2,True
2694241,523,2,20,6379,763187731,0,0,0,366.08,5,874873.49,18,4,10,3,True
3291018,180,0,20,5285,763187731,0,0,0,366.21,3,874507.28,18,6,21,4,True
3624725,720,4,25,1699,763187731,0,0,0,365.6,8,874141.68,11,0,20,8,True
3707483,858,1,451,1070,763187731,0,0,0,365.65,7,873776.03,24,0,15,8,True
3781844,823,4,25,4559,763187731,0,0,0,366.02,8,873410.01,18,6,22,8,True
4098313,14,2,20,9618,763187731,0,0,0,365.89,3,873044.12,24,0,13,8,True
4105642,1010,0,30,1868,763187731,0,0,0,365.94,8,872678.18,26,5,23,9,True
4120042,989,1,30,6896,763187731,0,0,0,366.16,8,872312.02,22,4,16,9,False
4546109,720,4,25,1868,763187731,0,0,0,366.01,8,871946.01,11,0,2,11,True
4777061,1010,0,30,7955,763187731,0,0,0,366.2,8,871579.81,26,6,2,11,True
4901818,1010,0,25,4559,763187731,0,0,0,365.94,8,871213.87,26,5,5,11,True
5308919,1010,0,30,1410,763187731,0,0,0,366.32,8,870847.55,26,1,7,12,True
5614749,895,0,20,9618,763187731,0,0,0,366.14,5,870481.41,24,5,20,12,True
5638537,278,1,30,6896,763187731,0,0,0,365.86,8,870115.55,24,6,14,1,True
5955621,1377,0,10,5228,763187731,0,0,0,365.87,6,870481.42,16,0,4,1,True
6397751,137,2,20,1410,763187731,0,0,0,365.84,5,870115.58,18,5,22,2,True
6492452,278,1,30,1868,763187731,0,0,0,365.98,8,869749.6,24,2,13,2,True
6608383,720,4,451,7507,763187731,0,0,0,365.96,7,869383.64,11,2,16,3,True
7214589,989,1,30,5987,763187731,0,0,0,366.01,8,869017.63,22,4,2,3,True
7315132,1010,0,451,6108,763187731,0,0,0,365.95,7,868651.68,26,6,22,3,True
7859110,1010,0,-1,7955,763187731,0,1,0,365.93,1,868651.68,26,0,9,4,False
7996568,761,2,20,9618,763187731,0,0,0,366.05,5,868285.63,24,1,6,4,True
8040761,1119,0,20,6129,763187731,0,0,0,365.87,5,867919.76,24,2,19,5,True
8138245,1010,0,25,5711,763187731,0,0,0,366.15,8,867553.61,26,5,1,6,True
8150100,823,4,-1,6379,763187731,0,1,0,365.96,4,867553.61,18,2,4,6,True
8221386,989,1,30,7679,763187731,0,0,0,365.87,8,867187.74,22,0,16,7,True
8251269,963,4,451,5987,763187731,0,0,0,365.82,7,866821.92,13,5,18,8,True
8277811,445,0,10,1868,763187731,0,0,0,365.82,6,867187.74,13,3,3,9,True
8330285,1010,0,25,7710,763187731,0,0,0,366.4,8,866821.34,26,2,12,10,True
8534470,720,4,25,5285,763187731,0,0,0,365.64,8,866455.7,11,2,22,12,True
8661248,278,1,451,2365,763187731,0,0,0,366.02,7,866089.68,24,5,16,1,True
8844386,963,4,30,5299,763187731,0,0,0,365.88,8,865723.8,13,2,2,1,True
8986504,980,1,10,4559,763187731,0,0,0,366.16,0,866089.96,22,2,2,1,True
9049195,963,4,451,2365,763187731,0,0,0,366.05,7,865723.91,13,6,4,2,True
9172930,989,1,30,7497,763187731,0,0,0,366.23,8,865357.68,22,4,2,5,True
9293615,278,1,451,1868,763187731,0,0,0,365.99,7,864991.69,24,0,4,6,True
9368495,509,0,10,7710,763187731,0,0,0,366.05,6,865357.74,12,3,16,6,True
9580507,1010,0,30,5299,763187731,0,0,0,366.02,8,864991.72,26,1,16,7,True
9663776,996,0,10,7710,763187731,0,0,0,366.27,6,865357.99,26,2,21,8,True
9723518,989,1,25,7679,763187731,0,0,0,366.04,8,864991.95,22,5,8,8,True
9727348,278,1,10,6896,763187731,0,0,0,365.71,6,865357.66,24,6,4,10,True
9808135,1010,0,30,9618,763187731,0,0,0,365.95,8,864991.71,26,1,18,11,True
9826541,551,0,10,4559,763187731,0,0,0,366.02,6,865357.73,17,2,16,11,True
1148742,235,4,451,3222,818078390,0,0,0,202.12,7,672219.88,26,3,20,1,True
1254716,742,4,451,5671,818078390,0,0,0,202.19,7,672017.69,24,0,1,2,True
1290090,372,0,30,9639,818078390,0,0,0,201.93,8,671815.76,25,5,22,2,True
1342242,1416,4,25,2045,818078390,0,0,0,202.08,8,671613.68,24,0,7,2,True
1369006,824,2,451,7327,818078390,0,0,0,202.16,7,671411.52,18,3,4,3,True
1636690,438,1,30,2045,818078390,0,0,0,202.04,8,671209.48,24,6,14,3,True
1974145,1416,4,-1,3222,818078390,0,1,0,201.96,4,671209.48,24,0,8,3,True
2033705,343,1,10,8958,818078390,0,0,0,202.16,6,671411.64,24,6,0,5,True
2056351,874,4,451,3222,818078390,0,0,0,202.09,7,671209.55,24,2,14,5,True
2149694,297,0,20,5495,818078390,0,0,0,202.24,5,671007.31,4,4,21,5,True
2271374,276,0,10,9639,818078390,0,0,0,201.97,6,671209.28,24,5,8,6,True
2373245,372,0,-1,9639,818078390,0,1,0,202.15,1,671209.28,25,6,1,7,True
2393565,1322,2,20,4135,818078390,0,0,0,202.02,3,671007.26,18,6,7,7,True
2578511,742,4,451,8958,818078390,0,0,0,202.11,7,670805.15,24,4,13,7,True
2643589,742,4,30,5495,818078390,0,0,0,202.1,8,670603.05,24,1,15,8,True
3145677,1092,1,10,6937,818078390,0,0,0,201.88,6,670804.93,18,5,1,8,True
3192154,438,1,451,7327,818078390,0,0,0,201.98,7,670602.95,24,3,21,9,True
3239085,564,0,20,9873,818078390,0,0,0,201.79,5,670401.16,17,1,2,10,True
3336763,438,1,30,5495,818078390,0,0,0,202.09,8,670199.07,24,1,23,1,True
3434985,874,4,451,7769,818078390,0,0,0,202.03,7,669997.04,24,2,6,2,True
3909411,255,2,20,4589,818078390,0,0,0,201.97,5,669795.07,6,5,15,2,True
4430790,742,4,30,5587,818078390,0,0,0,201.89,8,669593.18,24,1,6,6,True
4445055,235,4,-1,2045,818078390,0,1,0,202.02,1,669593.18,26,4,20,8,True
4463534,874,4,451,9873,818078390,0,0,0,202.0,7,669391.18,24,0,22,8,True
4671305,372,0,451,7489,818078390,0,0,0,201.97,7,669189.21,25,5,13,9,True
4935031,1416,4,30,3222,818078390,0,0,0,202.12,8,668987.09,24,6,18,9,True
5607035,1416,4,-1,5587,818078390,0,1,0,202.13,4,668987.09,24,0,22,10,True
5679141,824,2,-1,7769,818078390,0,2,0,201.91,4,668987.09,18,0,8,12,True
5703443,235,4,30,2045,818078390,0,0,0,201.94,8,668785.15,26,5,9,12,True
5847038,752,0,10,7327,818078390,0,0,0,201.53,6,668986.68,24,5,0,1,True
5882603,235,4,30,3222,818078390,0,0,0,201.93,8,668784.75,26,3,3,1,False
5940689,712,0,20,3222,818078390,0,0,0,201.88,3,668582.87,18,6,21,2,True
6093833,1213,2,20,5671,818078390,0,0,0,201.89,3,668380.98,24,1,7,2,True
6452211,130,0,10,6937,818078390,0,0,0,201.83,0,668582.81,18,2,16,2,True
6689565,874,4,30,8958,818078390,0,0,0,201.93,8,668380.88,24,5,14,3,True
6901914,681,2,20,4135,818078390,0,0,0,201.92,3,668178.96,24,3,0,3,True
7233774,537,0,20,5587,818078390,0,0,0,202.05,5,667976.91,18,5,0,3,True
7371303,302,1,10,2045,818078390,0,0,0,201.99,6,668178.9,4,0,10,4,True
7617775,372,0,25,7327,818078390,0,0,0,201.9,8,667977.0,25,1,1,4,True
7639059,445,0,20,9873,818078390,0,0,0,201.98,5,667775.02,13,0,2,4,True
8089648,874,4,30,4135,818078390,0,0,0,201.93,8,667573.09,24,1,16,4,True
8260610,235,4,451,4135,818078390,0,0,0,201.56,7,667371.53,26,6,2,5,True
8537662,742,4,25,3222,818078390,0,0,0,201.92,8,667169.61,24,4,3,5,True
8571203,757,0,10,9873,818078390,0,0,0,202.24,6,667371.85,24,4,22,8,True
8761150,438,1,451,6937,818078390,0,0,0,201.82,7,667170.03,24,3,14,9,True
8879382,874,4,25,9236,818078390,0,0,0,202.15,8,666967.88,24,2,1,9,True
9038177,742,4,25,4589,818078390,0,0,0,202.0,8,666765.88,24,1,9,9,True
9070578,1416,4,-1,4135,818078390,0,1,0,202.11,4,666765.88,24,1,18,9,True
9631046,824,2,-1,3012,818078390,0,2,0,201.98,4,666765.88,18,6,22,10,True
9706295,874,4,30,6937,818078390,0,0,0,201.87,8,666564.01,24,0,2,10,True
9779012,438,1,30,9873,818078390,0,0,0,202.09,8,666361.92,24,3,12,10,False
9813607,874,4,25,6937,818078390,0,0,0,202.06,8,666159.86,24,1,12,11,True
9989079,874,4,-1,5495,818078390,0,1,0,202.1,1,666159.86,24,1,5,11,True
1170728,688,0,25,9203,823468214,1,0,0,212.1,8,540846.9,24,3,2,1,False
1392578,528,3,25,6545,823468214,1,0,0,211.67,8,540635.23,18,5,3,2,True
1406442,167,2,451,5062,823468214,1,0,0,211.98,7,540423.25,24,4,9,3,True
1467378,688,0,30,7693,823468214,1,0,0,212.28,8,540210.97,24,3,18,4,True
1735862,587,2,25,3238,823468214,1,0,0,212.15,8,539998.82,24,6,23,5,True
2052404,457,0,20,9292,823468214,1,0,0,212.08,3,539786.74,13,2,19,6,True
2244625,1370,4,451,5436,823468214,1,0,0,212.31,7,539574.43,16,2,16,6,True
2939901,167,2,25,2191,823468214,1,0,0,212.18,8,539362.25,24,0,8,6,True
2952500,728,1,10,7865,823468214,1,0,0,211.78,6,539574.03,11,6,21,7,True
3093664,167,2,25,8609,823468214,1,0,0,212.19,8,539361.84,24,4,3,8,True
3117823,1461,0,20,8246,823468214,1,0,0,212.07,5,539149.77,11,6,22,9,True
3261904,167,2,30,5062,823468214,1,0,0,211.91,8,538937.86,24,1,10,10,True
3440995,587,2,451,7865,823468214,1,0,0,212.13,7,538725.73,24,1,16,10,True
3484244,1370,4,-1,8128,823468214,1,1,0,212.05,4,538725.73,16,1,14,11,True
3594236,343,1,451,6545,823468214,1,0,0,212.31,7,538513.42,24,5,22,11,True
3925774,147,0,10,6545,823468214,1,0,0,212.2,6,538725.62,18,0,8,12,True
4048125,1370,4,30,5733,823468214,1,0,0,212.13,8,538513.49,16,3,8,1,True
4158624,587,2,451,8609,823468214,1,0,0,211.92,7,538301.57,24,4,13,1,True
4254298,562,1,10,5436,823468214,1,0,0,212.31,6,538513.88,17,2,7,2,True
4290409,348,0,10,9292,823468214,1,0,0,212.07,0,538725.95,24,5,6,2,True
4308141,882,0,451,4998,823468214,1,0,0,212.05,7,538513.9,27,0,22,4,True
4410110,688,0,30,2191,823468214,1,0,0,211.91,8,538301.99,24,1,2,4,True
4771784,376,0,10,6545,823468214,1,0,0,212.05,6,538514.04,25,6,8,5,True
4907553,167,2,25,9203,823468214,1,0,0,211.98,8,538302.06,24,0,18,5,True
4968735,587,2,25,2104,823468214,1,0,0,211.76,8,538090.3,24,3,10,5,True
5123838,1370,4,451,6033,823468214,1,0,0,211.9,7,537878.4,16,6,2,6,True
5144118,343,1,30,1618,823468214,1,0,0,211.95,8,537666.45,24,6,22,6,True
5145992,1127,0,20,8128,823468214,1,0,0,211.96,3,537454.49,24,0,23,6,True
5479060,167,2,-1,6033,823468214,1,1,0,212.02,4,537454.49,24,2,4,6,True
5555351,776,3,25,6625,823468214,1,0,0,211.94,8,537242.55,14,1,2,7,True
5783837,297,0,10,4998,823468214,1,0,0,212.09,0,537454.64,4,1,12,8,True
6039983,528,3,25,8128,823468214,1,0,0,212.08,8,537242.56,18,4,20,8,True
6185856,167,2,451,5082,823468214,1,0,0,212.18,7,537030.38,24,5,18,8,True
6390421,776,3,25,3238,823468214,1,0,0,212.1,8,536818.28,14,1,0,8,True
6392792,1289,1,10,5062,823468214,1,0,0,212.29,6,537030.57,24,6,11,9,True
6785335,343,1,-1,5082,823468214,1,1,0,212.0,1,537030.57,24,2,16,10,True
6828929,343,1,25,2191,823468214,1,0,0,211.78,8,536818.79,24,3,12,10,True
7084538,1270,1,10,5436,823468214,1,0,0,211.96,6,537030.75,23,3,7,12,True
7208036,528,3,-1,7865,823468214,1,1,0,212.04,4,537030.75,18,2,10,1,True
7400467,1467,0,20,7865,823468214,1,0,0,212.01,5,536818.74,11,4,6,1,True
7434673,343,1,451,5082,823468214,1,0,0,212.44,7,536606.3,24,0,5,4,True
7513218,587,2,-1,6545,823468214,1,1,0,211.92,1,536606.3,24,1,18,4,True
7523090,776,3,30,8128,823468214,1,0,0,212.04,8,536394.26,14,1,10,4,True
7710962,776,3,451,2191,823468214,1,0,0,211.98,7,536182.28,14,5,23,5,True
7741091,776,3,-1,6033,823468214,1,1,0,211.97,4,536182.28,14,6,0,5,True
7839630,1488,0,10,6625,823468214,1,0,0,211.89,6,536394.17,24,6,14,6,True
7969195,144,1,10,7865,823468214,1,0,0,212.12,0,536606.29,18,2,7,7,True
8205694,167,2,451,3700,823468214,1,0,0,212.03,7,536394.26,24,3,2,7,True
8426623,587,2,30,5062,823468214,1,0,0,212.22,8,536182.04,24,6,18,8,True
8602158,688,0,30,3238,823468214,1,0,0,211.94,8,535970.1,24,0,8,8,False
8731678,807,0,20,3596,823468214,1,0,0,212.09,3,535758.01,11,4,2,8,True
8844760,587,2,451,8128,823468214,1,0,0,212.02,7,535545.99,24,6,23,8,True
8895282,776,3,-1,8128,823468214,1,1,0,211.9,4,535545.99,14,0,18,8,True
9282719,343,1,30,5062,823468214,1,0,0,212.02,8,535333.97,24,3,3,9,True
9478010,1370,4,451,3461,823468214,1,0,0,211.91,7,535122.06,16,6,2,9,False
9578941,343,1,30,5082,823468214,1,0,0,211.94,8,534910.12,24,1,22,10,False
9597895,944,2,20,9292,823468214,1,0,0,211.95,3,534698.17,24,2,4,10,True
9783684,528,3,451,9203,823468214,1,0,0,211.98,7,534486.19,18,4,20,10,True
9903406,167,2,451,8609,823468214,1,0,0,212.01,7,534274.18,24,0,13,11,True
1043043,665,2,451,5705,147314088,0,0,0,123.0,7,137917.0,18,0,10,1,True
1379445,86,4,25,2168,147314088,0,0,0,122.86,8,137794.14,1,3,14,1,True
1530033,1087,4,451,5870,147314088,0,0,0,123.06,7,137671.08,18,5,12,2,False
1861323,729,0,20,5870,147314088,0,0,0,122.84,5,137548.24,11,2,13,3,True
2040792,86,4,451,5870,147314088,0,0,0,123.03,7,137425.21,1,4,11,3,True
2330031,1163,4,451,8424,147314088,0,0,0,123.16,7,137302.05,24,3,23,4,True
2353085,1413,0,20,8424,147314088,0,0,0,122.84,5,137179.21,24,4,3,6,True
2461263,631,3,25,2336,147314088,0,0,0,122.98,8,137056.23,11,0,8,6,True
2609857,705,1,10,3102,147314088,0,0,0,123.07,0,137179.3,18,5,11,7,True
2683138,850,1,10,9982,147314088,0,0,0,122.97,6,137302.27,5,4,13,7,True
2734673,1227,0,25,2056,147314088,0,0,0,123.15,8,137179.12,18,5,5,7,True
2967095,631,3,25,1121,147314088,0,0,0,123.07,8,137056.05,11,1,22,8,False
3222886,287,0,10,5097,147314088,0,0,0,122.87,6,137178.92,24,5,19,8,True
3281082,1163,4,451,6883,147314088,0,0,0,122.93,7,137055.99,24,2,15,10,True
3355145,665,2,25,1352,147314088,0,0,0,122.99,8,136933.0,18,0,0,10,True
3468249,735,1,10,1614,147314088,0,0,0,123.16,6,137056.16,11,2,16,11,False
3559847,86,4,451,1352,147314088,0,0,0,122.99,7,136933.17,1,4,9,11,True
3603914,631,3,30,4374,147314088,0,0,0,123.01,8,136810.16,11,4,12,12,True
3664460,665,2,-1,1614,147314088,0,1,0,122.87,4,136810.16,18,3,4,12,True
3697483,254,0,20,2336,147314088,0,0,0,123.03,3,136687.13,6,1,22,1,False
3759964,1227,0,30,3176,147314088,0,0,0,122.88,8,136564.25,18,6,22,1,True
3922706,208,0,10,2056,147314088,0,0,0,122.91,6,136687.16,9,2,0,1,True
3946326,1227,0,451,7366,147314088,0,0,0,123.15,7,136564.01,18,2,22,3,True
4198570,1227,0,25,1508,147314088,0,0,0,123.26,8,136440.75,18,0,23,4,True
4339349,86,4,30,3176,147314088,0,0,0,122.84,8,136317.91,1,3,3,4,True
4688908,535,0,20,8424,147314088,0,0,0,122.97,5,136194.94,18,3,1,4,True
4934190,895,0,20,1352,147314088,0,0,0,123.13,5,136071.81,24,0,22,5,True
5131262,929,0,20,6883,147314088,0,0,0,122.98,3,135948.83,18,4,3,5,True
5316250,1227,0,451,3176,147314088,0,0,0,122.81,7,135826.02,18,6,8,6,True
5357355,1227,0,30,6883,147314088,0,0,0,122.94,8,135703.08,18,2,12,6,True
5484533,1163,4,30,3176,147314088,0,0,0,123.13,8,135579.95,24,3,17,8,True
5842705,1087,4,451,1614,147314088,0,0,0,122.83,7,135457.12,18,2,23,9,True
5870740,1148,4,30,2336,147314088,0,0,0,122.77,8,135334.35,15,3,4,12,True
6225245,1163,4,451,8424,147314088,0,0,0,122.92,7,135211.43,24,0,7,12,True
6259004,1087,4,-1,4675,147314088,0,1,0,122.73,1,135211.43,18,4,11,12,True
6275523,967,1,10,2372,147314088,0,0,0,122.86,6,135334.29,13,3,23,2,True
6973440,86,4,451,2372,147314088,0,0,0,123.04,7,135211.25,1,0,3,2,True
6990412,365,0,20,7366,147314088,0,0,0,122.85,5,135088.4,25,6,10,4,True
7145671,203,0,20,7366,147314088,0,0,0,122.93,5,134965.47,9,5,5,4,True
7201362,304,0,30,1614,147314088,0,0,0,123.07,8,134842.4,4,3,1,4,True
7661766,1148,4,30,7366,147314088,0,0,0,122.92,8,134719.48,15,5,9,5,True
7860954,865,0,20,1121,147314088,0,0,0,123.21,3,134596.27,24,2,7,5,True
8027250,631,3,25,7893,147314088,0,0,0,122.94,8,134473.33,11,3,18,5,True
8067590,1284,2,20,9189,147314088,0,0,0,122.93,3,134350.4,24,6,12,6,True
8349754,184,0,10,4675,147314088,0,0,0,123.27,0,134473.67,18,4,4,6,True
8450674,631,3,451,6301,147314088,0,0,0,122.93,7,134350.74,11,2,11,6,True
8477333,1087,4,451,8692,147314088,0,0,0,123.13,7,134227.61,18,4,22,6,True
8754401,631,3,451,9052,147314088,0,0,0,122.89,7,134104.72,11,5,22,7,True
8914205,1015,0,30,1508,147314088,0,0,0,122.76,8,133981.96,26,1,20,7,True
8921211,309,0,10,5097,147314088,0,0,0,123.08,0,134105.04,4,3,18,8,True
8996664,1163,4,-1,2056,147314088,0,1,0,123.03,4,134105.04,24,4,10,8,True
9340406,86,4,30,1121,147314088,0,0,0,123.1,8,133981.94,1,1,13,9,True
9486271,1148,4,25,9982,147314088,0,0,0,123.06,8,133858.88,15,6,18,9,True
9569849,1227,0,25,9189,147314088,0,0,0,123.09,8,133735.79,18,1,12,10,True
9671604,457,0,10,6883,147314088,0,0,0,122.76,6,133858.55,13,2,16,10,False
9820988,694,2,20,1352,147314088,0,0,0,122.91,5,133735.64,24,5,14,11,True
1222001,1267,2,30,6692,611596623,0,0,0,711.98,8,747908.02,23,0,13,1,True
1435206,435,4,25,1563,611596623,0,0,0,711.94,8,747196.08,24,3,1,1,True
1654122,140,3,451,6938,611596623,0,0,0,712.2,7,746483.88,18,6,20,5,True
2291685,435,4,451,2006,611596623,0,0,0,712.07,7,745771.81,24,3,18,5,True
2446811,435,4,451,5944,611596623,0,0,0,711.9,7,745059.91,24,1,4,7,True
2796185,140,3,-1,6230,611596623,0,1,0,712.1,1,745059.91,18,1,16,7,True
3252677,1267,2,30,1049,611596623,0,0,0,711.77,8,744348.14,23,1,4,8,True
3372192,140,3,-1,5410,611596623,0,1,0,711.86,1,744348.14,18,3,18,8,True
3462725,734,0,-1,1563,611596623,0,2,0,711.54,4,744348.14,11,3,18,9,True
3465820,1254,4,451,1925,611596623,0,0,0,711.7,7,743636.44,23,4,16,9,False
3558089,1062,3,25,2552,611596623,0,0,0,711.97,8,742924.47,11,3,23,9,True
3770033,140,3,451,3789,611596623,0,0,0,711.93,7,742212.54,18,6,0,10,True
3882663,1254,4,30,8708,611596623,0,0,0,712.03,8,741500.51,23,2,1,10,True
3993648,594,0,10,3693,611596623,0,0,0,712.03,6,742212.54,24,1,13,11,True
4115778,734,0,25,3789,611596623,0,0,0,712.05,8,741500.49,11,3,15,11,True
4509765,734,0,25,4944,611596623,0,0,0,711.98,8,740788.51,11,6,3,12,True
4839728,435,4,-1,5434,611596623,0,1,0,712.14,1,740788.51,24,3,20,12,True
5277175,965,4,451,3693,611596623,0,0,0,711.92,7,740076.59,13,5,22,1,True
5472894,1062,3,30,8679,611596623,0,0,0,712.2,8,739364.39,11,1,10,3,True
5809137,1446,1,10,2316,611596623,0,0,0,711.81,6,740076.2,24,5,10,4,True
5819982,435,4,-1,5434,611596623,0,1,0,712.0,4,740076.2,24,2,14,4,True
5985813,1254,4,25,1925,611596623,0,0,0,712.11,8,739364.09,23,6,0,5,True
6096055,1254,4,451,1925,611596623,0,0,0,711.87,7,738652.22,23,0,6,7,True
6151673,140,3,-1,4570,611596623,0,1,0,711.96,4,738652.22,18,0,7,9,True
6331429,435,4,25,5410,611596623,0,0,0,711.79,8,737940.43,24,0,17,9,True
6596481,1254,4,30,3693,611596623,0,0,0,712.12,8,737228.31,23,6,10,10,True
6712452,269,0,10,1925,611596623,0,0,0,711.84,0,737940.15,24,1,22,10,True
6820887,1363,0,20,9993,611596623,0,0,0,712.0,3,737228.15,16,2,22,10,True
7207606,1254,4,30,2552,611596623,0,0,0,712.22,8,736515.93,23,0,10,11,True
7218785,1254,4,25,2552,611596623,0,0,0,711.92,8,735804.01,23,4,19,11,True
7298876,734,0,25,1437,611596623,0,0,0,712.11,8,735091.9,11,3,21,11,True
7388991,965,4,30,5944,611596623,0,0,0,712.3,8,734379.6,13,0,14,12,True
7750864,1254,4,25,2871,611596623,0,0,0,712.03,8,733667.57,23,0,23,12,True
7787906,1062,3,30,4545,611596623,0,0,0,711.84,8,732955.73,11,1,20,12,True
8208412,965,4,-1,1049,611596623,0,1,0,712.12,1,732955.73,13,0,1,1,True
8264516,611,0,10,5434,611596623,0,0,0,712.23,6,733667.96,11,6,18,1,True
8341946,1213,2,20,6692,611596623,0,0,0,712.17,5,732955.79,24,3,2,3,True
8536620,1062,3,25,3653,611596623,0,0,0,712.01,8,732243.78,11,4,4,3,True
8740258,435,4,30,3789,611596623,0,0,0,711.91,8,731531.87,24,2,1,4,True
8740816,1267,2,451,5944,611596623,0,0,0,712.18,7,730819.69,23,2,7,4,True
8784401,471,0,20,6230,611596623,0,0,0,711.76,3,730107.93,5,5,16,6,True
9068154,965,4,30,3693,611596623,0,0,0,711.79,8,729396.14,13,6,6,6,True
9502938,931,0,10,1049,611596623,0,0,0,712.04,6,730108.18,24,4,11,8,True
9645931,1267,2,30,1563,611596623,0,0,0,711.71,8,729396.47,23,3,19,9,True
9716522,435,4,451,7637,611596623,0,0,0,711.92,7,728684.55,24,2,11,9,True
9755440,965,4,30,3457,611596623,0,0,0,711.85,8,727972.7,13,3,19,9,True
9761736,1150,0,20,6043,611596623,0,0,0,712.11,5,727260.59,15,3,19,10,True
9823892,1062,3,30,8708,611596623,0,0,0,712.26,8,726548.33,11,0,22,11,True
9861621,734,0,-1,7637,611596623,0,1,0,712.0,4,726548.33,11,1,4,11,True
9875038,1007,2,20,3457,611596623,0,0,0,712.37,5,725835.96,26,4,6,11,True
9888948,965,4,-1,1563,611596623,0,1,0,712.12,4,725835.96,13,0,1,11,True
1046289,785,0,20,4268,197038936,0,0,0,1066.18,5,741857.82,14,3,10,1,True
1537951,324,4,-1,3618,197038936,0,1,0,1066.2,4,741857.82,11,2,17,1,True
1872963,104,4,25,3343,197038936,0,0,0,1065.88,8,740791.94,3,6,7,1,True
2018844,637,4,30,2838,197038936,0,0,0,1065.99,8,739725.95,24,0,6,2,True
2281855,327,0,20,5777,197038936,0,0,0,1065.81,5,738660.14,11,6,5,2,True
2332348,759,0,10,6499,197038936,0,0,0,1065.88,6,739726.02,24,4,12,2,True
2515363,263,3,30,6026,197038936,0,0,0,1066.09,8,738659.93,6,4,14,2,False
2666171,560,2,30,1622,197038936,0,0,0,1066.1,8,737593.83,17,2,3,5,True
2666516,104,4,30,7721,197038936,0,0,0,1066.04,8,736527.79,3,3,10,5,True
2671250,1351,4,30,1622,197038936,0,0,0,1065.94,8,735461.85,24,6,0,6,True
2930323,263,3,25,6317,197038936,0,0,0,1066.03,8,734395.82,6,6,5,7,True
3005467,1345,2,20,1622,197038936,0,0,0,1065.86,5,733329.96,24,2,8,7,True
3148365,579,0,20,4268,197038936,0,0,0,1065.92,3,732264.04,11,0,2,7,True
3274876,324,4,25,4268,197038936,0,0,0,1066.02,8,731198.02,11,2,18,7,True
3288621,1351,4,451,9109,197038936,0,0,0,1066.16,7,730131.86,24,4,1,8,True
3454945,637,4,30,7795,197038936,0,0,0,1065.98,8,729065.88,24,0,8,9,True
4114477,560,2,451,9109,197038936,0,0,0,1065.96,7,727999.92,17,3,0,10,True
4115513,263,3,25,4661,197038936,0,0,0,1065.95,8,726933.97,6,6,23,10,False
4432900,438,1,10,4268,197038936,0,0,0,1065.96,6,727999.93,24,2,10,12,True
4742366,1351,4,451,3258,197038936,0,0,0,1065.89,7,726934.04,24,5,3,12,True
4835828,333,1,10,3618,197038936,0,0,0,1065.92,6,727999.96,11,2,11,12,True
4887861,104,4,-1,1622,197038936,0,1,0,1066.18,4,727999.96,3,2,2,1,True
5092694,637,4,30,4936,197038936,0,0,0,1065.95,8,726934.01,24,4,7,1,False
5153311,324,4,25,4936,197038936,0,0,0,1066.22,8,725867.79,11,2,23,2,True
5284124,399,2,20,3343,197038936,0,0,0,1066.03,5,724801.76,10,2,3,2,True
5725886,127,1,10,8029,197038936,0,0,0,1066.04,6,725867.8,18,4,2,2,True
5730796,104,4,30,7791,197038936,0,0,0,1066.25,8,724801.55,3,3,1,3,True
5962190,1351,4,451,4936,197038936,0,0,0,1065.79,7,723735.76,24,4,2,5,True
6042398,263,3,25,4788,197038936,0,0,0,1065.78,8,722669.98,6,3,15,5,True
6133605,560,2,30,2182,197038936,0,0,0,1066.09,8,721603.89,17,5,21,6,True
6200333,1351,4,25,4936,197038936,0,0,0,1065.89,8,720538.0,24,1,20,6,True
6367873,1271,0,20,8029,197038936,0,0,0,1065.83,3,719472.17,23,6,22,7,True
6815081,324,4,25,4936,197038936,0,0,0,1065.63,8,718406.54,11,6,8,7,True
6922998,694,2,20,2182,197038936,0,0,0,1066.01,5,717340.53,24,6,16,7,True
6934778,1304,0,20,3618,197038936,0,0,0,1066.28,5,716274.25,5,3,5,7,True
7229295,1351,4,30,1441,197038936,0,0,0,1066.07,8,715208.18,24,0,18,9,True
7300937,104,4,25,2838,197038936,0,0,0,1066.0,8,714142.18,3,0,0,10,True
7489726,1351,4,-1,1826,197038936,0,1,0,1066.11,4,714142.18,24,0,9,10,True
7700674,560,2,25,8029,197038936,0,0,0,1066.26,8,713075.92,17,3,12,11,False
7944190,324,4,-1,8029,197038936,0,1,0,1065.9,4,713075.92,11,4,6,11,True
8010116,560,2,25,3618,197038936,0,0,0,1066.02,8,712009.9,17,4,21,11,True
8110899,637,4,25,9584,197038936,0,0,0,1065.77,8,710944.13,24,5,5,11,True
8428079,324,4,-1,1888,197038936,0,1,0,1065.88,4,710944.13,11,3,0,11,True
8488806,324,4,30,4936,197038936,0,0,0,1066.09,8,709878.04,11,3,17,11,True
8504777,1351,4,30,1622,197038936,0,0,0,1065.8,8,708812.24,24,0,3,12,True
8720064,560,2,451,4788,197038936,0,0,0,1065.91,7,707746.33,17,2,13,12,True
8749205,1351,4,-1,7791,197038936,0,1,0,1066.0,4,707746.33,24,1,16,12,True
8854949,637,4,30,8335,197038936,0,0,0,1065.9,8,706680.43,24,2,16,1,False
9072884,637,4,30,1888,197038936,0,0,0,1065.98,8,705614.45,24,0,6,1,True
9098068,324,4,25,3147,197038936,0,0,0,1065.94,8,704548.51,11,6,9,1,True
9124902,673,0,20,1888,197038936,0,0,0,1065.97,5,703482.54,18,5,11,3,True
9423801,641,0,20,2182,197038936,0,0,0,1066.15,5,702416.39,24,1,22,4,True
9459102,560,2,30,4268,197038936,0,0,0,1065.87,8,701350.52,17,1,9,4,True
9500870,560,2,451,4661,197038936,0,0,0,1065.94,7,700284.58,17,3,0,4,True
9625217,263,3,25,4268,197038936,0,0,0,1066.13,8,699218.45,6,3,13,6,True
9631474,1041,0,20,6317,197038936,0,0,0,1066.17,3,698152.28,11,6,19,7,True
9912277,1351,4,451,1441,197038936,0,0,0,1065.87,7,697086.41,24,2,16,8,False
9920007,1086,0,20,7795,197038936,0,0,0,1065.94,5,696020.47,18,0,10,9,False
1053768,1039,1,-1,1319,243732473,1,1,0,466.96,4,421993.0,11,5,23,1,True
1116190,1039,1,30,5691,243732473,1,0,0,467.23,8,421525.77,11,3,8,2,True
1231401,763,3,451,5106,243732473,1,0,0,467.02,7,421058.75,14,5,6,3,True
1746575,275,0,-1,1319,243732473,1,1,0,467.22,1,421058.75,24,1,2,3,True
1787721,1264,0,30,1028,243732473,1,0,0,466.92,8,420591.83,23,3,14,4,True
1827390,701,2,-1,5644,243732473,1,1,0,467.02,4,420591.83,18,4,5,5,True
2155662,139,4,30,5644,243732473,1,0,0,466.99,8,420124.84,18,0,4,5,False
2308625,713,0,20,5260,243732473,1,0,0,467.18,5,419657.66,18,4,18,5,True
2313253,763,3,-1,8918,243732473,1,1,0,467.15,4,419657.66,14,6,21,5,True
2355469,1039,1,30,5637,243732473,1,0,0,466.89,8,419190.77,11,3,12,5,True
2565825,1264,0,451,7177,243732473,1,0,0,466.84,7,418723.93,23,2,1,5,True
2662087,701,2,30,8204,243732473,1,0,0,467.11,8,418256.82,18,1,3,6,True
2750012,1039,1,30,5637,243732473,1,0,0,467.05,8,417789.77,11,6,9,6,True
3006327,227,4,25,1028,243732473,1,0,0,466.85,8,417322.92,26,4,20,7,True
3189881,1039,1,451,2967,243732473,1,0,0,466.74,7,416856.18,11,3,3,7,True
3236024,1082,3,451,5260,243732473,1,0,0,467.02,7,416389.16,18,4,5,7,True
3275998,1408,1,10,7713,243732473,1,0,0,466.95,0,416856.11,24,4,0,8,True
3530685,139,4,451,3594,243732473,1,0,0,466.84,7,416389.27,18,3,4,9,True
3845405,1231,2,20,5260,243732473,1,0,0,467.1,5,415922.17,18,3,12,9,True
4104414,139,4,451,5150,243732473,1,0,0,466.88,7,415455.29,18,5,5,11,True
4197606,1264,0,30,6828,243732473,1,0,0,466.92,8,414988.37,23,2,20,11,True
4814253,679,0,10,2581,243732473,1,0,0,467.17,6,415455.54,24,4,1,12,True
4992790,627,0,10,7713,243732473,1,0,0,467.07,6,415922.61,11,5,11,12,True
5019849,341,0,10,7560,243732473,1,0,0,466.97,6,416389.58,24,3,5,12,True
5022016,701,2,30,1028,243732473,1,0,0,467.2,8,415922.38,18,1,23,3,True
5028889,139,4,-1,2352,243732473,1,1,0,466.93,4,415922.38,18,1,11,5,True
5058169,378,0,20,5150,243732473,1,0,0,466.71,3,415455.67,25,4,22,5,True
5108122,549,1,10,7713,243732473,1,0,0,466.84,6,415922.51,17,1,20,6,True
5258343,701,2,451,5637,243732473,1,0,0,466.97,7,415455.54,18,1,5,6,True
5294539,502,0,20,5691,243732473,1,0,0,466.83,5,414988.71,12,1,13,7,True
5655135,1039,1,451,5644,243732473,1,0,0,467.03,7,414521.68,11,6,16,7,True
5657652,889,0,20,2581,243732473,1,0,0,466.79,5,414054.89,27,3,2,8,True
5657968,275,0,30,1028,243732473,1,0,0,466.94,8,413587.95,24,3,1,8,True
6266455,1010,0,20,3066,243732473,1,0,0,466.93,5,413121.02,26,3,20,10,True
6278899,763,3,-1,8918,243732473,1,1,0,467.09,4,413121.02,14,5,20,10,True
6322676,139,4,451,3066,243732473,1,0,0,466.98,7,412654.04,18,1,20,11,True
6432725,1082,3,25,1319,243732473,1,0,0,466.93,8,412187.11,18,4,3,12,True
6446531,275,0,451,2352,243732473,1,0,0,466.92,7,411720.19,24,4,10,12,True
6660544,227,4,25,7782,243732473,1,0,0,467.08,8,411253.11,26,1,4,1,True
7152136,1264,0,25,6393,243732473,1,0,0,467.24,8,410785.87,23,1,9,1,True
7180907,1264,0,25,1028,243732473,1,0,0,466.97,8,410318.9,23,3,0,2,True
7190364,689,0,10,5644,243732473,1,0,0,466.87,0,410785.77,24,0,2,2,True
7234388,312,0,10,6828,243732473,1,0,0,466.83,6,411252.6,4,3,17,2,True
7762266,227,4,30,2581,243732473,1,0,0,467.01,8,410785.59,26,4,6,4,True
7828174,588,0,10,5637,243732473,1,0,0,467.14,0,411252.73,24,5,18,4,True
8362792,275,0,451,5691,243732473,1,0,0,466.96,7,410785.77,24,0,9,4,True
8410618,701,2,451,7177,243732473,1,0,0,467.14,7,410318.63,18,2,7,6,True
8567270,1039,1,-1,8918,243732473,1,1,0,466.94,4,410318.63,11,0,6,7,True
8576012,227,4,451,5106,243732473,1,0,0,466.87,7,409851.76,26,5,0,7,True
8578737,763,3,451,5150,243732473,1,0,0,467.02,7,409384.74,14,4,16,8,True
8779998,139,4,-1,7560,243732473,1,1,0,466.91,4,409384.74,18,4,10,9,True
9109043,227,4,25,2967,243732473,1,0,0,467.15,8,408917.59,26,6,15,9,False
9334876,763,3,451,1319,243732473,1,0,0,466.85,7,408450.74,14,6,22,10,True
9361468,763,3,451,7713,243732473,1,0,0,466.93,7,407983.81,14,4,10,10,True
9519440,727,0,10,1319,243732473,1,0,0,466.84,0,408450.65,11,3,1,10,True
9801407,471,0,10,3594,243732473,1,0,0,467.05,6,408917.7,5,3,16,10,True
9827470,701,2,25,7560,243732473,1,0,0,467.06,8,408450.64,18,5,17,10,True
9899750,701,2,25,2967,243732473,1,0,0,466.86,8,407983.78,18,3,0,11,True
1256209,279,2,20,4369,366001526,1,0,0,831.99,5,870089.01,24,6,21,1,True
1352419,1376,3,30,2266,366001526,1,0,0,832.08,8,869256.93,16,1,16,1,True
1454127,1218,4,25,5875,366001526,1,0,0,831.93,8,868425.0,24,6,4,2,True
1912233,1397,4,451,5875,366001526,1,0,0,832.0,7,867593.0,24,1,16,3,True
1994406,1376,3,451,8708,366001526,1,0,0,832.09,7,866760.91,16,2,18,3,True
2232568,445,0,20,6126,366001526,1,0,0,832.07,5,865928.84,13,5,9,3,True
2836281,1477,2,20,6126,366001526,1,0,0,832.09,3,865096.75,24,1,3,3,True
2866859,829,4,451,2915,366001526,1,0,0,832.06,7,864264.69,18,0,15,4,True
3010894,1090,0,10,6702,366001526,1,0,0,831.98,6,865096.67,18,5,14,4,True
3055119,850,1,10,6501,366001526,1,0,0,832.11,6,865928.78,5,6,6,5,True
3077448,679,0,10,6112,366001526,1,0,0,832.06,6,866760.84,24,6,20,5,True
3235096,610,0,10,4965,366001526,1,0,0,831.92,6,867592.76,11,2,2,6,True
3256464,931,0,20,2844,366001526,1,0,0,832.12,5,866760.64,24,5,17,6,False
3314549,467,0,10,6501,366001526,1,0,0,832.17,0,867592.81,5,5,11,6,True
3476077,1218,4,25,4965,366001526,1,0,0,831.94,8,866760.87,24,3,14,6,True
3573018,850,1,10,4652,366001526,1,0,0,831.65,6,867592.52,5,1,13,6,True
3625512,1376,3,-1,6501,366001526,1,1,0,831.9,4,867592.52,16,2,14,7,True
3703707,610,0,451,2682,366001526,1,0,0,832.01,7,866760.51,11,6,18,7,True
3750491,365,0,20,6501,366001526,1,0,0,832.24,5,865928.27,25,5,14,9,True
3769978,610,0,30,1856,366001526,1,0,0,832.13,8,865096.14,11,0,22,10,True
3780882,1397,4,30,8840,366001526,1,0,0,832.13,8,864264.01,24,5,19,12,True
3876930,85,2,25,2260,366001526,1,0,0,832.2,8,863431.81,1,4,16,12,True
4119837,829,4,451,2266,366001526,1,0,0,831.85,7,862599.96,18,6,9,2,True
4509005,829,4,30,3623,366001526,1,0,0,832.23,8,861767.73,18,5,19,4,True
4741729,1376,3,25,6126,366001526,1,0,0,832.08,8,860935.65,16,5,18,4,True
4981077,85,2,25,1987,366001526,1,0,0,832.25,8,860103.4,1,5,17,5,True
5497186,829,4,-1,2260,366001526,1,1,0,832.05,4,860103.4,18,0,21,8,True
5583387,829,4,451,2915,366001526,1,0,0,831.93,7,859271.47,18,6,19,9,True
5722753,829,4,451,6501,366001526,1,0,0,831.97,7,858439.5,18,2,4,9,True
5774864,1119,0,20,4446,366001526,1,0,0,831.99,5,857607.51,24,2,5,9,True
5810565,1218,4,451,2915,366001526,1,0,0,832.24,7,856775.27,24,2,22,10,True
5812335,85,2,451,7442,366001526,1,0,0,832.27,7,855943.0,1,0,14,11,True
5939219,1376,3,30,7442,366001526,1,0,0,832.0,8,855111.0,16,0,22,11,True
6089211,1376,3,451,4965,366001526,1,0,0,831.99,7,854279.01,16,0,1,12,True
6116313,85,2,451,4652,366001526,1,0,0,832.14,7,853446.87,1,4,2,12,True
6118552,829,4,-1,2844,366001526,1,1,0,831.85,4,853446.87,18,0,13,1,True
6295903,1169,0,20,2844,366001526,1,0,0,831.77,3,852615.1,24,2,2,1,True
6332322,1397,4,451,5319,366001526,1,0,0,831.88,7,851783.22,24,5,14,2,True
6837674,829,4,451,6501,366001526,1,0,0,832.06,7,850951.16,18,3,22,2,True
6965936,255,2,20,2915,366001526,1,0,0,831.95,5,850119.21,6,4,18,2,True
7035781,610,0,451,6501,366001526,1,0,0,832.11,7,849287.1,11,0,8,3,True
7191702,1218,4,25,2266,366001526,1,0,0,831.8,8,848455.3,24,4,14,3,True
7558943,1218,4,25,2260,366001526,1,0,0,831.95,8,847623.35,24,3,14,3,True
7668254,85,2,451,7438,366001526,1,0,0,831.81,7,846791.54,1,3,4,6,True
7759182,550,0,10,7438,366001526,1,0,0,832.14,6,847623.68,17,4,23,7,True
8077048,1397,4,25,2682,366001526,1,0,0,832.05,8,846791.63,24,6,1,8,True
8203218,610,0,-1,1856,366001526,1,1,0,832.22,4,846791.63,11,1,23,8,True
8213907,1376,3,30,3623,366001526,1,0,0,832.14,8,845959.49,16,6,7,9,True
8657561,1128,2,20,2260,366001526,1,0,0,832.11,5,845127.38,24,5,23,9,True
8733011,1034,1,10,6112,366001526,1,0,0,831.8,6,845959.18,11,3,7,9,True
8881204,1376,3,451,5875,366001526,1,0,0,832.11,7,845127.07,16,0,0,10,True
9267980,829,4,451,5319,366001526,1,0,0,832.23,7,844294.84,18,5,23,10,True
9371972,85,2,25,7442,366001526,1,0,0,831.78,8,843463.06,1,4,4,11,True
9762177,325,0,20,4652,366001526,1,0,0,832.09,3,842630.97,11,5,14,11,True
9796892,85,2,30,5319,366001526,1,0,0,831.79,8,841799.18,1,6,10,11,True
9947432,85,2,451,6112,366001526,1,0,0,831.52,7,840967.66,1,2,19,11,True
1071903,637,4,-1,7921,280721386,0,1,0,644.97,1,811490.0,24,3,0,1,True
1081938,284,3,-1,1459,280721386,0,2,0,645.11,1,811490.0,24,3,12,2,True
1159635,529,2,20,2288,280721386,0,0,0,645.03,5,810844.97,18,6,15,3,False
1199833,1356,2,25,2334,280721386,0,0,0,645.17,8,810199.8,24,2,2,3,True
1581364,64,0,20,8265,280721386,0,0,0,644.87,3,809554.93,20,4,22,5,True
1687448,365,0,10,2419,280721386,0,0,0,645.2,6,810200.13,25,5,8,5,True
1734888,1356,2,25,8265,280721386,0,0,0,644.79,8,809555.34,24,5,0,6,True
1868535,637,4,451,2419,280721386,0,0,0,645.11,7,808910.23,24,5,20,7,True
2260367,284,3,25,9210,280721386,0,0,0,644.98,8,808265.25,24,5,7,9,True
3000541,518,2,451,3125,280721386,0,0,0,645.29,7,807619.96,18,3,19,9,True
3088300,518,2,451,3461,280721386,0,0,0,644.94,7,806975.02,18,2,15,10,True
3514097,518,2,-1,6219,280721386,0,1,0,645.07,1,806975.02,18,3,13,10,True
3580592,572,0,10,9527,280721386,0,0,0,644.9,6,807619.92,11,2,14,11,True
3583590,732,0,20,4347,280721386,0,0,0,645.03,3,806974.89,11,4,16,11,True
3592743,518,2,25,5894,280721386,0,0,0,645.01,8,806329.88,18,2,16,1,False
3601010,518,2,451,6219,280721386,0,0,0,645.01,7,805684.87,18,6,21,1,True
3775258,1124,0,20,1439,280721386,0,0,0,645.02,5,805039.85,24,0,17,3,True
4219792,637,4,451,6219,280721386,0,0,0,644.97,7,804394.88,24,1,19,3,True
4575537,994,4,451,5772,280721386,0,0,0,644.84,7,803750.04,22,0,16,4,True
4813807,284,3,25,3461,280721386,0,0,0,644.87,8,803105.17,24,6,2,4,True
4992092,284,3,-1,1439,280721386,0,1,0,644.91,4,803105.17,24,3,20,5,True
5098410,637,4,-1,2419,280721386,0,2,0,644.88,1,803105.17,24,4,14,6,True
5419412,637,4,451,9210,280721386,0,0,0,644.97,7,802460.2,24,5,13,6,True
5595989,637,4,451,3125,280721386,0,0,0,644.81,7,801815.39,24,5,14,6,True
5635720,637,4,-1,5772,280721386,0,1,0,644.97,4,801815.39,24,1,2,7,True
5848150,518,2,451,2288,280721386,0,0,0,645.06,7,801170.33,18,4,14,8,False
6030231,637,4,-1,3461,280721386,0,1,0,645.12,1,801170.33,24,6,17,9,True
6095881,637,4,30,5894,280721386,0,0,0,645.04,8,800525.29,24,3,2,9,False
6493048,1217,0,10,4846,280721386,0,0,0,644.97,6,801170.26,24,6,12,9,True
7093355,284,3,25,4530,280721386,0,0,0,644.89,8,800525.37,24,6,17,10,True
7393445,1119,0,10,8265,280721386,0,0,0,644.78,0,801170.15,24,6,14,11,False
7403182,284,3,451,9527,280721386,0,0,0,644.74,7,800525.41,24,0,1,11,True
7582414,703,0,20,8361,280721386,0,0,0,644.79,5,799880.62,18,2,0,11,True
7620562,994,4,25,7921,280721386,0,0,0,645.27,8,799235.35,22,2,16,12,True
7748077,284,3,30,2288,280721386,0,0,0,644.89,8,798590.46,24,5,17,12,True
7832350,994,4,451,6875,280721386,0,0,0,645.06,7,797945.4,22,4,7,12,True
8039630,637,4,451,1838,280721386,0,0,0,645.2,7,797300.2,24,1,0,1,True
8153785,1356,2,451,2288,280721386,0,0,0,645.07,7,796655.13,24,4,9,2,True
8242594,1303,0,20,8265,280721386,0,0,0,644.95,3,796010.18,5,2,20,2,True
8269469,728,1,10,6812,280721386,0,0,0,644.92,6,796655.1,11,5,19,3,True
8455926,1356,2,-1,6681,280721386,0,1,0,644.85,4,796655.1,24,6,21,3,True
8535244,994,4,451,8886,280721386,0,0,0,644.94,7,796010.16,22,1,2,4,True
8548874,637,4,-1,6812,280721386,0,1,0,645.27,1,796010.16,24,6,2,5,True
8657220,637,4,30,8361,280721386,0,0,0,645.08,8,795365.08,24,3,23,5,True
8762488,1356,2,451,7921,280721386,0,0,0,644.93,7,794720.15,24,0,20,5,True
9041860,284,3,30,6875,280721386,0,0,0,645.14,8,794075.01,24,5,0,6,True
9427425,284,3,-1,1838,280721386,0,1,0,644.82,1,794075.01,24,5,11,6,True
9480190,284,3,451,6681,280721386,0,0,0,644.81,7,793430.2,24,5,22,6,True
9492786,518,2,-1,3125,280721386,0,1,0,645.16,4,793430.2,18,1,16,8,True
9494261,637,4,-1,8886,280721386,0,2,0,645.07,1,793430.2,24,3,15,8,True
9521854,518,2,25,5894,280721386,0,0,0,644.98,8,792785.22,18,4,0,8,True
9763792,284,3,-1,4530,280721386,0,1,0,645.04,1,792785.22,24,1,1,9,True
9885925,518,2,451,8265,280721386,0,0,0,645.29,7,792139.93,18,1,6,9,True
9937642,994,4,30,1736,280721386,0,0,0,645.05,8,791494.88,22,2,8,11,True
9944321,284,3,25,1439,280721386,0,0,0,644.83,8,790850.05,24,2,23,11,True
1291106,573,0,451,9827,903240159,0,0,0,998.2,7,990431.8,11,4,5,2,True
1361879,402,3,451,6033,903240159,0,0,0,998.14,7,989433.66,10,6,0,2,True
1456579,627,0,10,2922,903240159,0,0,0,998.09,6,990431.75,11,2,17,3,True
1525354,787,0,10,2601,903240159,0,0,0,998.26,6,991430.01,14,3,22,3,True
1652950,44,4,30,7126,903240159,0,0,0,998.05,8,990431.96,24,2,8,4,True
1795243,895,0,10,5658,903240159,0,0,0,998.0,6,991429.96,24,4,6,4,True
2228126,276,0,20,7291,903240159,0,0,0,997.89,5,990432.07,24,2,23,4,True
2788962,44,4,451,2922,903240159,0,0,0,998.34,7,989433.73,24,0,15,5,True
2807874,1483,0,10,5120,903240159,0,0,0,998.0,6,990431.73,24,3,3,6,True
2904162,885,3,25,5721,903240159,0,0,0,997.97,8,989433.76,24,3,12,6,True
3118501,325,0,20,5658,903240159,0,0,0,998.2,5,988435.56,11,5,1,8,True
3181671,885,3,451,5120,903240159,0,0,0,997.79,7,987437.77,24,1,0,8,True
3281698,402,3,30,7126,903240159,0,0,0,998.06,8,986439.71,10,0,9,8,True
3714505,421,3,451,5658,903240159,0,0,0,997.78,7,985441.93,18,4,14,9,True
3853288,628,0,25,5120,903240159,0,0,0,997.94,8,984443.99,11,6,22,9,True
4105655,421,3,25,9827,903240159,0,0,0,998.11,8,983445.88,18,6,20,9,True
4264532,703,0,451,8377,903240159,0,0,0,998.02,7,982447.86,18,4,18,10,True
4322650,885,3,30,6833,903240159,0,0,0,997.93,8,981449.93,24,0,14,11,True
4570064,703,0,-1,8377,903240159,0,1,0,998.11,4,981449.93,18,1,1,2,True
4572124,628,0,451,6833,903240159,0,0,0,998.03,7,980451.9,11,6,18,3,True
4633660,979,0,20,5843,903240159,0,0,0,997.95,5,979453.95,22,6,7,4,True
4727004,39,3,25,5658,903240159,0,0,0,998.18,8,978455.77,11,3,21,4,True
4950146,402,3,25,5476,903240159,0,0,0,998.09,8,977457.68,10,6,13,6,True
4953903,703,0,25,5476,903240159,0,0,0,998.15,8,976459.53,18,1,12,7,True
5109583,716,0,10,4149,903240159,0,0,0,998.13,6,977457.66,18,1,2,7,True
5217054,267,0,10,5120,903240159,0,0,0,997.86,6,978455.52,6,5,18,7,True
5352321,44,4,30,5843,903240159,0,0,0,997.96,8,977457.56,24,3,14,8,True
5519822,421,3,25,3731,903240159,0,0,0,998.36,8,976459.2,18,4,4,8,True
5663293,703,0,25,2055,903240159,0,0,0,997.95,8,975461.25,18,4,16,8,True
5709370,44,4,-1,2922,903240159,0,1,0,997.93,4,975461.25,24,3,20,8,True
5807602,993,0,10,2922,903240159,0,0,0,998.08,6,976459.33,22,6,10,8,True
5881601,1463,2,20,3229,903240159,0,0,0,997.99,5,975461.34,11,0,18,10,True
5907318,703,0,-1,5120,903240159,0,1,0,998.1,1,975461.34,18,2,0,11,True
5909116,421,3,451,4149,903240159,0,0,0,998.1,7,974463.24,18,2,10,11,True
6724278,703,0,-1,9464,903240159,0,1,0,998.05,4,974463.24,18,4,21,11,True
6948745,628,0,30,4304,903240159,0,0,0,997.99,8,973465.25,11,2,20,12,True
7489418,628,0,25,5120,903240159,0,0,0,997.94,8,972467.31,11,6,22,12,True
7541252,573,0,25,3731,903240159,0,0,0,998.04,8,971469.27,11,4,6,1,True
7561848,369,1,10,5843,903240159,0,0,0,998.08,0,972467.35,25,5,15,1,True
7593324,402,3,25,6054,903240159,0,0,0,997.92,8,971469.43,10,0,10,3,True
7644837,1406,0,20,5843,903240159,0,0,0,997.89,5,970471.54,24,6,2,3,True
7716891,703,0,451,5658,903240159,0,0,0,997.98,7,969473.56,18,3,2,4,True
7850720,39,3,30,6033,903240159,0,0,0,997.81,8,968475.75,11,1,9,4,True
8007699,885,3,30,4304,903240159,0,0,0,998.13,8,967477.62,24,4,23,5,True
8056342,628,0,451,5658,903240159,0,0,0,998.16,7,966479.46,11,6,21,6,True
8196534,703,0,25,7126,903240159,0,0,0,997.97,8,965481.49,18,4,16,6,True
8383342,44,4,-1,8377,903240159,0,1,0,998.09,1,965481.49,24,5,17,7,True
8682808,470,1,451,7126,903240159,0,0,0,998.21,7,964483.28,5,1,1,7,True
8900068,14,2,20,6833,903240159,0,0,0,997.96,3,963485.32,24,2,22,9,True
9025345,160,0,10,3731,903240159,0,0,0,997.96,6,964483.28,24,3,6,9,True
9243344,1352,1,10,8377,903240159,0,0,0,997.89,6,965481.17,24,2,17,10,True
9836922,421,3,25,1154,903240159,0,0,0,997.83,8,964483.34,18,0,13,10,True
1149997,520,4,-1,9723,674536747,1,1,0,448.85,4,438033.0,18,2,7,2,False
1181977,1277,2,20,7235,674536747,1,0,0,449.2,5,437583.8,24,0,8,2,True
1229472,952,0,30,7235,674536747,1,0,0,449.23,8,437134.57,13,1,3,2,True
1475775,520,4,451,3293,674536747,1,0,0,448.98,7,436685.59,18,0,2,2,True
1481752,318,0,-1,1436,674536747,1,1,0,449.02,4,436685.59,11,2,3,3,True
1506102,520,4,25,4762,674536747,1,0,0,449.19,8,436236.4,18,6,11,3,False
1578161,752,0,10,9600,674536747,1,0,0,449.05,6,436685.45,24,2,23,5,True
1599628,520,4,451,6420,674536747,1,0,0,448.81,7,436236.64,18,1,1,5,True
1703441,318,0,25,5200,674536747,1,0,0,449.09,8,435787.55,11,3,9,6,True
2110033,520,4,25,1872,674536747,1,0,0,448.66,8,435338.89,18,2,21,7,False
2177241,464,1,25,1061,674536747,1,0,0,448.83,8,434890.06,13,2,9,8,True
2430161,464,1,30,4981,674536747,1,0,0,449.46,8,434440.6,13,3,0,9,True
3154986,594,0,-1,7961,674536747,1,1,0,449.01,4,434440.6,24,0,13,9,True
3190964,520,4,-1,1872,674536747,1,2,0,448.98,4,434440.6,18,3,6,9,True
3299895,520,4,451,4251,674536747,1,0,0,449.04,7,433991.56,18,4,6,11,True
3639185,1454,1,10,4780,674536747,1,0,0,448.9,6,434440.46,11,3,13,11,True
3643171,318,0,25,8187,674536747,1,0,0,449.04,8,433991.42,11,5,19,1,False
4043408,287,0,20,8284,674536747,1,0,0,448.98,5,433542.44,24,0,8,2,True
4096863,818,1,451,5217,674536747,1,0,0,449.1,7,433093.34,18,2,21,2,True
4155316,818,1,451,2263,674536747,1,0,0,448.72,7,432644.62,18,3,3,2,True
4277241,464,1,451,6958,674536747,1,0,0,449.29,7,432195.33,13,1,9,3,True
4510978,1179,0,20,9723,674536747,1,0,0,448.92,5,431746.41,24,3,21,4,True
4887212,818,1,25,9455,674536747,1,0,0,449.05,8,431297.36,18,4,12,4,True
5269213,952,0,451,5217,674536747,1,0,0,448.92,7,430848.44,13,0,0,5,True
5528816,594,0,30,4620,674536747,1,0,0,449.26,8,430399.18,24,0,12,5,True
5704960,860,1,10,5217,674536747,1,0,0,449.06,0,430848.24,24,4,20,6,True
6119191,594,0,451,4762,674536747,1,0,0,449.14,7,430399.1,24,0,7,6,True
6138985,952,0,451,4141,674536747,1,0,0,449.2,7,429949.9,13,0,21,8,False
6143448,952,0,451,8284,674536747,1,0,0,448.83,7,429501.07,13,6,0,9,True
6378457,520,4,25,5849,674536747,1,0,0,449.16,8,429051.91,18,6,7,9,True
6421079,511,1,10,2170,674536747,1,0,0,448.96,0,429500.87,12,3,2,10,False
6453995,254,0,30,9723,674536747,1,0,0,448.61,8,429052.26,6,2,2,10,True
6570698,818,1,25,8187,674536747,1,0,0,448.63,8,428603.63,18,3,6,10,True
6693989,1164,0,20,4141,674536747,1,0,0,448.89,5,428154.74,24,6,17,10,True
6815931,254,0,451,3293,674536747,1,0,0,449.09,7,427705.65,6,4,18,10,True
6962393,952,0,451,1872,674536747,1,0,0,448.95,7,427256.7,13,0,13,11,True
7250283,989,1,10,1436,674536747,1,0,0,449.07,0,427705.77,22,5,4,11,True
7365566,318,0,451,3293,674536747,1,0,0,449.2,7,427256.57,11,2,13,12,True
7385185,464,1,451,4141,674536747,1,0,0,448.83,7,426807.74,13,5,10,12,True
7405468,254,0,451,4762,674536747,1,0,0,448.7,7,426359.04,6,0,14,12,True
7419796,594,0,30,1587,674536747,1,0,0,449.12,8,425909.92,24,0,21,1,True
7712028,318,0,451,4062,674536747,1,0,0,449.15,7,425460.77,11,6,8,1,True
7889501,318,0,451,5196,674536747,1,0,0,449.01,7,425011.76,11,6,20,3,True
7943547,520,4,451,9723,674536747,1,0,0,449.13,7,424562.63,18,5,10,4,True
8186941,318,0,25,3293,674536747,1,0,0,449.02,8,424113.61,11,0,13,4,True
8228287,21,0,10,3293,674536747,1,0,0,448.74,6,424562.35,11,1,21,4,True
8725200,523,2,20,4454,674536747,1,0,0,448.94,3,424113.41,18,5,18,4,True
9120564,254,0,451,5217,674536747,1,0,0,449.05,7,423664.36,6,2,9,5,True
9225301,831,1,10,4981,674536747,1,0,0,449.0,6,424113.36,5,3,7,5,True
9292410,318,0,451,9455,674536747,1,0,0,448.82,7,423664.54,11,3,13,5,True
9315160,952,0,25,7235,674536747,1,0,0,449.01,8,423215.53,13,3,15,5,True
9418841,464,1,451,2274,674536747,1,0,0,449.06,7,422766.47,13,4,10,5,True
9790259,464,1,-1,6923,674536747,1,1,0,449.17,4,422766.47,13,2,22,7,True
9895141,889,0,20,4620,674536747,1,0,0,449.05,5,422317.42,27,3,21,10,False
9901242,464,1,451,7235,674536747,1,0,0,449.14,7,421868.28,13,0,14,11,True
1234688,892,4,451,8654,978801717,0,0,0,917.88,7,233315.12,24,0,20,4,True
1418747,1352,1,30,2292,978801717,0,0,0,917.98,8,232397.14,24,6,17,4,True
1694363,1352,1,451,8654,978801717,0,0,0,918.15,7,231478.99,24,0,6,5,True
1805935,122,3,451,5965,978801717,0,0,0,918.22,7,230560.77,18,5,23,5,True
1877920,148,1,10,4791,978801717,0,0,0,917.96,0,231478.73,18,4,13,6,True
2019980,294,3,451,9191,978801717,0,0,0,917.96,7,230560.77,4,2,23,6,True
2224094,122,3,30,8654,978801717,0,0,0,918.13,8,229642.64,18,5,15,7,False
2270643,122,3,451,2392,978801717,0,0,0,918.05,7,228724.59,18,3,14,8,True
2287084,1140,0,30,5965,978801717,0,0,0,917.78,8,227806.81,15,6,3,8,True
2392689,40,4,451,9050,978801717,0,0,0,918.01,7,226888.8,11,0,5,8,False
2611576,122,3,30,8654,978801717,0,0,0,918.08,8,225970.72,18,1,4,8,True
3043723,1352,1,30,7365,978801717,0,0,0,918.09,8,225052.63,24,0,21,8,True
3153241,122,3,30,7829,978801717,0,0,0,918.1,8,224134.53,18,2,9,8,True
3245871,711,2,20,7829,978801717,0,0,0,918.13,3,223216.4,18,2,8,9,True
3391135,40,4,30,9126,978801717,0,0,0,918.24,8,222298.16,11,5,7,9,True
3490923,892,4,451,4234,978801717,0,0,0,917.93,7,221380.23,24,2,1,10,True
3714510,1111,0,10,4234,978801717,0,0,0,918.01,0,222298.24,0,0,2,11,True
4023741,518,2,451,7829,978801717,0,0,0,918.01,7,221380.23,18,4,21,12,True
4149169,550,0,10,7365,978801717,0,0,0,917.99,6,222298.22,17,2,12,1,True
4160274,194,1,10,2392,978801717,0,0,0,918.1,6,223216.32,18,1,4,2,False
4360512,518,2,451,9126,978801717,0,0,0,917.97,7,222298.35,18,4,3,2,True
4550778,40,4,25,9126,978801717,0,0,0,918.01,8,221380.34,11,5,17,2,True
4585987,294,3,451,7365,978801717,0,0,0,918.09,7,220462.25,4,5,20,3,True
4637382,294,3,25,8654,978801717,0,0,0,917.79,8,219544.46,4,6,10,3,True
4797078,294,3,451,2995,978801717,0,0,0,917.83,7,218626.63,4,1,1,3,True
5057341,122,3,30,7072,978801717,0,0,0,918.02,8,217708.61,18,5,3,4,True
5356400,518,2,30,9039,978801717,0,0,0,917.94,8,216790.67,18,0,10,4,True
5445756,1155,0,10,8654,978801717,0,0,0,917.9,6,217708.57,15,4,22,4,True
5617954,40,4,25,4234,978801717,0,0,0,918.07,8,216790.5,11,3,5,6,True
5666601,294,3,451,2995,978801717,0,0,0,918.0,7,215872.5,4,1,18,6,True
5700185,679,0,20,9050,978801717,0,0,0,917.85,5,214954.65,24,3,7,6,True
5808656,205,0,10,4682,978801717,0,0,0,918.04,6,215872.69,9,1,22,7,True
5839287,892,4,451,7829,978801717,0,0,0,918.01,7,214954.68,24,6,3,9,True
5865204,804,0,20,8654,978801717,0,0,0,918.23,5,214036.45,11,6,22,9,True
5872817,1140,0,-1,5965,978801717,0,1,0,917.99,4,214036.45,15,1,23,10,True
6005691,1284,2,20,7829,978801717,0,0,0,918.37,5,213118.08,24,6,6,10,True
6013700,1352,1,25,4348,978801717,0,0,0,917.88,8,212200.2,24,4,3,10,True
6067923,40,4,25,5965,978801717,0,0,0,918.15,8,211282.05,11,4,0,11,True
6445209,122,3,30,5965,978801717,0,0,0,917.8,8,210364.25,18,6,7,11,True
6757317,1352,1,-1,4791,978801717,0,1,0,917.8,4,210364.25,24,3,23,11,True
7288331,1140,0,-1,5899,978801717,0,2,0,918.03,4,210364.25,15,3,21,11,False
7439821,1352,1,25,8654,978801717,0,0,0,918.14,8,209446.11,24,4,14,12,True
7466927,1352,1,451,9191,978801717,0,0,0,918.02,7,208528.09,24,3,7,1,True
7488469,892,4,-1,5965,978801717,0,1,0,918.03,4,208528.09,24,6,11,3,True
7577235,799,2,20,4234,978801717,0,0,0,918.11,5,207609.98,11,0,18,4,True
7600973,122,3,-1,9126,978801717,0,1,0,918.14,1,207609.98,18,5,21,4,True
8132181,59,0,20,5965,978801717,0,0,0,917.98,5,206692.0,20,2,5,5,True
8261394,294,3,25,4234,978801717,0,0,0,918.04,8,205773.96,4,4,18,5,True
8512133,40,4,25,2392,978801717,0,0,0,918.06,8,204855.9,11,3,17,6,True
8662077,40,4,30,4791,978801717,0,0,0,918.03,8,203937.87,11,1,4,6,True
8705833,199,0,25,7072,978801717,0,0,0,918.07,8,203019.8,18,0,22,7,True
8738637,40,4,451,5965,978801717,0,0,0,917.93,7,202101.87,11,3,13,7,True
8776683,294,3,30,4348,978801717,0,0,0,917.78,8,201184.09,4,0,15,8,True
8964264,1140,0,25,9050,978801717,0,0,0,917.92,8,200266.17,15,0,12,9,True
9059641,1140,0,30,5965,978801717,0,0,0,917.94,8,199348.23,15,5,18,9,True
9068002,199,0,-1,4348,978801717,0,1,0,918.25,4,199348.23,18,4,12,9,True
9420447,892,4,30,7829,978801717,0,0,0,917.98,8,198430.25,24,0,14,10,True
9553372,122,3,30,8654,978801717,0,0,0,918.1,8,197512.15,18,1,3,10,True
1135791,294,3,-1,8587,949492860,1,1,0,967.94,1,681926.0,4,4,5,1,True
1245231,185,1,451,6702,949492860,1,0,0,968.35,7,680957.65,18,4,16,2,True
1282620,1467,0,10,9722,949492860,1,0,0,967.81,6,681925.46,11,3,3,2,True
1504110,1474,0,20,6773,949492860,1,0,0,968.32,5,680957.14,24,0,22,4,True
1572339,799,2,20,9722,949492860,1,0,0,968.03,5,679989.11,11,5,3,4,True
1650627,1445,2,30,8587,949492860,1,0,0,967.98,8,679021.13,24,3,13,4,True
1837207,148,1,10,1615,949492860,1,0,0,968.02,6,679989.15,18,5,9,4,False
1941511,185,1,451,6702,949492860,1,0,0,968.25,7,679020.9,18,1,20,5,True
2021806,159,2,20,1815,949492860,1,0,0,967.79,3,678053.11,24,2,7,5,True
2363287,1274,4,-1,2513,949492860,1,1,0,967.94,1,678053.11,24,4,9,5,True
2387792,185,1,451,8101,949492860,1,0,0,967.89,7,677085.22,18,6,15,6,True
2541447,446,1,30,2198,949492860,1,0,0,968.05,8,676117.17,13,0,4,7,True
2635560,294,3,25,1815,949492860,1,0,0,967.99,8,675149.18,4,6,22,7,True
2791384,318,0,451,3547,949492860,1,0,0,967.67,7,674181.51,11,1,17,8,True
2843618,318,0,30,1294,949492860,1,0,0,967.89,8,673213.62,11,4,1,8,True
2958988,1445,2,451,2198,949492860,1,0,0,968.05,7,672245.57,24,4,22,9,False
2978846,185,1,25,6702,949492860,1,0,0,968.01,8,671277.56,18,2,20,11,False
3124846,550,0,20,1294,949492860,1,0,0,967.97,3,670309.59,17,5,8,11,True
3187804,917,0,20,8527,949492860,1,0,0,968.05,5,669341.54,18,3,2,12,True
3369698,1445,2,30,9722,949492860,1,0,0,967.82,8,668373.72,24,5,0,12,True
3477201,185,1,-1,6702,949492860,1,1,0,968.26,4,668373.72,18,5,13,12,True
3604710,327,0,10,3448,949492860,1,0,0,967.97,0,669341.69,11,4,17,1,True
3637723,185,1,451,6702,949492860,1,0,0,968.13,7,668373.56,18,2,8,2,True
3944468,1445,2,451,4309,949492860,1,0,0,967.79,7,667405.77,24,3,19,2,True
4554464,294,3,451,2198,949492860,1,0,0,968.02,7,666437.75,4,1,19,2,True
4775457,294,3,451,7605,949492860,1,0,0,968.04,7,665469.71,4,4,16,4,True
4829413,446,1,25,8587,949492860,1,0,0,968.01,8,664501.7,13,1,15,5,True
4866190,318,0,-1,7605,949492860,1,1,0,967.77,4,664501.7,11,1,12,5,True
5306988,1377,0,10,2513,949492860,1,0,0,967.98,6,665469.68,16,3,3,5,True
5486709,446,1,-1,2198,949492860,1,1,0,968.1,4,665469.68,13,1,5,6,True
5504371,97,0,20,1294,949492860,1,0,0,968.18,5,664501.5,3,1,5,6,True
5538153,1445,2,25,3547,949492860,1,0,0,967.86,8,663533.64,24,5,7,7,True
5698759,714,2,20,4843,949492860,1,0,0,967.93,5,662565.71,18,3,18,8,True
5824170,1274,4,451,8951,949492860,1,0,0,968.0,7,661597.71,24,2,0,8,True
5907315,185,1,451,3547,949492860,1,0,0,968.1,7,660629.61,18,3,1,8,True
6170188,956,1,10,2513,949492860,1,0,0,967.74,0,661597.35,13,0,17,9,True
6247115,851,1,10,1815,949492860,1,0,0,967.94,6,662565.29,5,5,22,9,True
6318640,1445,2,30,1615,949492860,1,0,0,968.01,8,661597.28,24,3,13,10,True
6458064,318,0,451,1615,949492860,1,0,0,968.05,7,660629.23,11,3,21,10,True
6461854,446,1,451,2513,949492860,1,0,0,968.11,7,659661.12,13,4,23,10,True
6561457,642,0,10,3448,949492860,1,0,0,967.84,6,660628.96,24,5,16,10,True
6671768,1274,4,30,1294,949492860,1,0,0,967.89,8,659661.07,24,5,13,11,True
6956720,267,0,20,9722,949492860,1,0,0,967.98,5,658693.09,6,5,2,1,True
7011451,253,2,20,2513,949492860,1,0,0,968.11,3,657724.98,6,0,7,1,True
7216341,446,1,30,6773,949492860,1,0,0,968.16,8,656756.82,13,2,2,2,True
7679679,294,3,-1,1294,949492860,1,1,0,968.09,1,656756.82,4,6,16,2,True
7821131,318,0,25,8562,949492860,1,0,0,967.86,8,655788.96,11,1,3,2,True
8016529,538,0,10,8587,949492860,1,0,0,967.99,6,656756.95,18,0,8,2,True
8044692,185,1,25,8562,949492860,1,0,0,967.9,8,655789.05,18,0,2,3,True
8092029,1336,2,20,6702,949492860,1,0,0,968.01,5,654821.04,18,1,5,4,True
8372826,446,1,451,2513,949492860,1,0,0,968.0,7,653853.04,13,2,11,4,True
8497301,318,0,-1,6702,949492860,1,1,0,967.86,1,653853.04,11,4,7,4,True
9248276,1445,2,-1,9722,949492860,1,2,0,968.08,4,653853.04,24,3,4,7,True
9255477,294,3,25,7605,949492860,1,0,0,968.03,8,652885.01,4,1,17,7,True
9435045,677,0,10,8587,949492860,1,0,0,968.01,6,653853.02,24,5,12,8,True
9681754,1445,2,-1,8951,949492860,1,1,0,967.89,1,653853.02,24,6,2,10,True
9999635,185,1,30,3448,949492860,1,0,0,968.42,8,652884.6,18,5,18,10,True
1078283,298,4,451,9545,674157653,0,0,0,1145.42,7,946442.58,4,0,10,1,True
1343507,298,4,25,4003,674157653,0,0,0,1145.11,8,945297.47,4,5,15,2,True
1352298,300,0,20,5002,674157653,0,0,0,1145.0,3,944152.47,4,1,3,3,True
1516838,580,0,10,6731,674157653,0,0,0,1144.97,0,945297.44,11,1,7,3,True
1664587,1128,2,30,3386,674157653,0,0,0,1144.96,8,944152.48,24,2,11,4,True
1693518,1132,0,10,1709,674157653,0,0,0,1145.08,6,945297.56,24,4,7,5,True
1854955,726,0,20,4282,674157653,0,0,0,1145.02,5,944152.54,11,5,0,6,True
2194282,63,3,451,7028,674157653,0,0,0,1144.99,7,943007.55,20,5,16,7,True
2342675,63,3,451,3984,674157653,0,0,0,1145.32,7,941862.23,20,5,13,8,True
2690675,662,1,30,5340,674157653,0,0,0,1145.16,8,940717.07,18,4,20,8,True
2716097,1128,2,25,4806,674157653,0,0,0,1144.88,8,939572.19,24,5,0,9,True
3032467,662,1,25,4596,674157653,0,0,0,1144.96,8,938427.23,18,6,19,9,True
3242305,68,0,20,4124,674157653,0,0,0,1144.82,5,937282.41,20,6,18,11,True
3303323,298,4,451,9070,674157653,0,0,0,1144.95,7,936137.46,4,5,4,12,True
3367679,530,0,10,9545,674157653,0,0,0,1144.88,6,937282.34,18,5,12,12,True
3395645,889,0,10,9198,674157653,0,0,0,1145.04,0,938427.38,27,0,16,12,True
3535722,96,0,20,2244,674157653,0,0,0,1145.17,5,937282.21,1,2,5,1,True
3650213,662,1,30,2515,674157653,0,0,0,1144.88,8,936137.33,18,4,19,2,True
3729327,298,4,25,6608,674157653,0,0,0,1145.0,8,934992.33,4,2,6,2,True
3756564,1404,2,20,5369,674157653,0,0,0,1144.74,5,933847.59,24,5,8,2,True
3799588,1128,2,25,5788,674157653,0,0,0,1145.22,8,932702.37,24,1,5,2,True
4155133,63,3,-1,5369,674157653,0,1,0,1145.17,1,932702.37,20,5,10,3,True
4298189,662,1,25,4596,674157653,0,0,0,1144.93,8,931557.44,18,0,16,5,True
4305864,1128,2,451,7231,674157653,0,0,0,1145.3,7,930412.14,24,1,20,5,True
4420825,1128,2,451,9198,674157653,0,0,0,1144.85,7,929267.29,24,1,10,6,True
4602362,298,4,451,9070,674157653,0,0,0,1145.01,7,928122.28,4,5,18,7,True
4788679,662,1,25,6608,674157653,0,0,0,1144.57,8,926977.71,18,3,16,7,True
5095126,298,4,451,7028,674157653,0,0,0,1145.09,7,925832.62,4,2,11,8,True
5096581,20,0,451,5788,674157653,0,0,0,1144.8,7,924687.82,24,5,11,9,True
5134431,662,1,25,3027,674157653,0,0,0,1145.22,8,923542.6,18,1,10,9,True
5466958,20,0,30,6731,674157653,0,0,0,1145.06,8,922397.54,24,1,22,9,True
5544537,1017,2,20,2244,674157653,0,0,0,1144.96,5,921252.58,26,1,3,10,True
5626475,298,4,25,4124,674157653,0,0,0,1144.81,8,920107.77,4,0,17,10,True
5671730,1128,2,-1,9198,674157653,0,1,0,1145.06,4,920107.77,24,5,0,11,True
5869726,160,0,20,7028,674157653,0,0,0,1145.08,5,918962.69,24,6,6,11,True
6081504,298,4,25,5002,674157653,0,0,0,1144.89,8,917817.8,4,6,20,11,True
6395142,63,3,-1,4003,674157653,0,1,0,1144.87,1,917817.8,20,5,12,12,True
6415461,298,4,-1,6608,674157653,0,2,0,1145.23,4,917817.8,4,6,3,12,True
6418121,298,4,30,4124,674157653,0,0,0,1145.04,8,916672.76,4,3,12,12,True
6612933,298,4,-1,4596,674157653,0,1,0,1145.25,4,916672.76,4,0,14,12,True
6940668,298,4,-1,7028,674157653,0,2,0,1144.75,1,916672.76,4,5,22,2,True
7293122,63,3,451,3027,674157653,0,0,0,1145.39,7,915527.37,20,5,9,3,True
7675292,298,4,-1,5671,674157653,0,1,0,1144.8,4,915527.37,4,2,5,4,True
7769054,63,3,30,6608,674157653,0,0,0,1144.94,8,914382.43,20,6,22,4,True
7830324,63,3,30,9545,674157653,0,0,0,1144.86,8,913237.57,20,6,16,5,True
8497621,20,0,30,8009,674157653,0,0,0,1144.73,8,912092.84,24,6,21,5,True
9140012,298,4,30,5788,674157653,0,0,0,1144.89,8,910947.95,4,5,20,6,True
9144105,63,3,30,5002,674157653,0,0,0,1145.15,8,909802.8,20,0,4,6,True
9154396,1128,2,25,9545,674157653,0,0,0,1145.03,8,908657.77,24,3,8,7,True
9188611,63,3,25,2244,674157653,0,0,0,1145.33,8,907512.44,20,5,11,7,True
9191726,63,3,25,8009,674157653,0,0,0,1144.79,8,906367.65,20,5,9,9,True
9693142,20,0,25,5788,674157653,0,0,0,1144.86,8,905222.79,24,1,13,10,True
9740745,1128,2,-1,5671,674157653,0,1,0,1145.13,1,905222.79,24,1,1,10,True
9823559,20,0,25,4806,674157653,0,0,0,1144.92,8,904077.87,24,4,18,11,True
9908781,967,1,10,7696,674157653,0,0,0,1144.93,6,905222.8,13,4,23,11,True
1301125,1483,0,10,3052,203482113,0,0,0,336.87,6,768989.87,24,5,1,2,True
1444849,203,0,10,6445,203482113,0,0,0,337.08,0,769326.95,9,5,10,3,True
1551433,553,1,451,2792,203482113,0,0,0,337.07,7,768989.88,17,2,2,3,True
1613763,553,1,451,5115,203482113,0,0,0,337.14,7,768652.74,17,5,7,4,True
2093804,250,4,451,9172,203482113,0,0,0,337.33,7,768315.41,6,4,9,5,True
2133776,482,1,25,6586,203482113,0,0,0,337.14,8,767978.27,5,5,5,5,True
2458010,971,4,25,8298,203482113,0,0,0,337.11,8,767641.16,13,4,11,7,True
2735949,971,4,-1,5115,203482113,0,1,0,336.86,1,767641.16,13,1,21,8,True
2842648,81,0,10,3901,203482113,0,0,0,337.02,6,767978.18,1,3,22,8,True
3020808,394,0,10,3901,203482113,0,0,0,337.11,6,768315.29,10,3,23,8,True
3116229,1174,3,451,6586,203482113,0,0,0,336.92,7,767978.37,24,1,7,9,True
3144578,1390,0,20,2905,203482113,0,0,0,336.99,5,767641.38,24,1,21,9,True
3262098,250,4,451,8857,203482113,0,0,0,336.96,7,767304.42,6,5,7,10,True
3580449,250,4,-1,6104,203482113,0,1,0,337.04,4,767304.42,6,5,5,10,True
3820267,482,1,25,9964,203482113,0,0,0,336.97,8,766967.45,5,6,17,11,True
3823236,1404,2,451,8298,203482113,0,0,0,336.93,7,766630.52,24,6,3,1,True
3874184,553,1,25,6445,203482113,0,0,0,336.94,8,766293.58,17,2,12,2,False
3897849,250,4,451,3901,203482113,0,0,0,337.16,7,765956.42,6,2,16,3,True
3908247,971,4,451,3901,203482113,0,0,0,336.9,7,765619.52,13,6,23,4,True
3927943,250,4,30,2905,203482113,0,0,0,337.26,8,765282.26,6,2,8,4,True
4069387,553,1,25,3173,203482113,0,0,0,336.96,8,764945.3,17,6,1,4,True
4439660,612,4,-1,2010,203482113,0,1,0,336.99,1,764945.3,11,5,11,5,True
4833349,1174,3,451,5577,203482113,0,0,0,337.01,7,764608.29,24,1,10,5,True
4840499,553,1,451,9964,203482113,0,0,0,336.86,7,764271.43,17,4,18,5,True
4906313,553,1,25,3901,203482113,0,0,0,337.06,8,763934.37,17,1,4,5,True
4946859,250,4,451,9964,203482113,0,0,0,337.07,7,763597.3,6,1,22,6,True
5200093,612,4,451,6104,203482113,0,0,0,337.12,7,763260.18,11,5,22,7,True
5289189,579,0,20,2010,203482113,0,0,0,336.98,5,762923.2,11,5,1,8,True
5432476,1174,3,-1,6445,203482113,0,1,0,336.83,1,762923.2,24,3,9,9,True
5500179,1174,3,25,2010,203482113,0,0,0,337.09,8,762586.11,24,3,14,9,True
5792290,917,0,20,6586,203482113,0,0,0,336.92,3,762249.19,18,6,0,10,True
6087181,612,4,30,5115,203482113,0,0,0,337.12,8,761912.07,11,0,10,10,True
6097942,971,4,25,5577,203482113,0,0,0,337.0,8,761575.07,13,5,1,11,True
6113960,649,0,10,6104,203482113,0,0,0,336.92,6,761911.99,24,1,11,11,True
6206777,482,1,25,5115,203482113,0,0,0,337.1,8,761574.89,5,4,9,12,True
6243527,1174,3,451,2010,203482113,0,0,0,337.05,7,761237.84,24,3,6,12,True
6536701,398,0,10,6445,203482113,0,0,0,336.74,6,761574.58,10,6,19,12,True
6560936,567,1,10,5115,203482113,0,0,0,336.83,6,761911.41,11,2,22,1,True
6569162,398,0,10,3901,203482113,0,0,0,336.82,0,762248.23,10,2,3,2,True
6735315,250,4,25,8433,203482113,0,0,0,336.82,8,761911.41,6,1,8,4,True
6857906,482,1,451,8298,203482113,0,0,0,337.03,7,761574.38,5,0,15,4,True
7074877,305,1,10,3173,203482113,0,0,0,337.09,6,761911.47,4,5,18,6,True
7225481,971,4,451,3052,203482113,0,0,0,337.21,7,761574.26,13,0,5,6,True
7329620,971,4,451,2010,203482113,0,0,0,336.78,7,761237.48,13,2,14,6,True
7332114,1404,2,451,3173,203482113,0,0,0,337.09,7,760900.39,24,0,6,7,True
7421912,1210,0,20,3052,203482113,0,0,0,337.03,3,760563.36,24,6,22,9,True
7747266,97,0,10,2905,203482113,0,0,0,337.02,6,760900.38,3,6,4,9,True
7957749,482,1,451,8857,203482113,0,0,0,336.7,7,760563.68,5,5,6,10,True
8489709,553,1,30,9172,203482113,0,0,0,336.97,8,760226.71,17,1,6,10,True
8498366,971,4,30,8433,203482113,0,0,0,336.89,8,759889.82,13,1,16,11,True
8583581,1285,1,10,5577,203482113,0,0,0,336.85,0,760226.67,24,4,1,11,True
9239072,482,1,30,3901,203482113,0,0,0,336.73,8,759889.94,5,1,13,11,True
9818267,1174,3,25,3173,203482113,0,0,0,336.76,8,759553.18,24,2,8,11,True
1447626,1419,1,25,5963,418757019,1,0,0,645.25,8,795660.75,24,5,18,1,True
1821564,1387,1,10,4486,418757019,1,0,0,644.94,0,796305.69,24,2,8,1,True
1896477,672,4,30,9236,418757019,1,0,0,645.05,8,795660.64,18,0,11,1,True
1906625,874,4,25,6539,418757019,1,0,0,644.91,8,795015.73,24,4,8,3,True
1985967,1235,1,10,4214,418757019,1,0,0,645.17,6,795660.9,18,5,1,4,True
2006243,672,4,30,5029,418757019,1,0,0,645.14,8,795015.76,18,5,12,5,True
2287230,436,4,451,4214,418757019,1,0,0,645.03,7,794370.73,24,3,23,5,True
2318248,721,4,25,6948,418757019,1,0,0,645.06,8,793725.67,11,1,4,5,True
2386512,1393,3,-1,9470,418757019,1,1,0,644.92,1,793725.67,24,1,17,6,True
2429501,889,0,20,6948,418757019,1,0,0,644.82,5,793080.85,27,1,6,7,True
3178228,1419,1,451,8192,418757019,1,0,0,644.87,7,792435.98,24,0,22,7,True
3321978,1435,2,20,5029,418757019,1,0,0,645.03,3,791790.95,24,1,22,7,True
3330463,877,2,20,7366,418757019,1,0,0,645.31,5,791145.64,24,5,20,8,True
3469328,874,4,30,6539,418757019,1,0,0,644.98,8,790500.66,24,3,23,9,False
3532848,820,1,10,7949,418757019,1,0,0,645.06,0,791145.72,18,5,9,11,True
3624497,96,0,20,4214,418757019,1,0,0,645.15,3,790500.57,1,1,10,11,False
3707046,436,4,30,9236,418757019,1,0,0,644.81,8,789855.76,24,3,12,12,True
3854909,721,4,-1,9236,418757019,1,1,0,644.95,4,789855.76,11,0,8,1,True
3941663,672,4,25,6539,418757019,1,0,0,644.88,8,789210.88,18,0,0,1,True
4462651,874,4,30,7366,418757019,1,0,0,645.23,8,788565.65,24,2,5,1,True
4618010,1419,1,451,7865,418757019,1,0,0,645.02,7,787920.63,24,2,13,1,True
4892025,1419,1,30,7366,418757019,1,0,0,645.16,8,787275.47,24,4,11,1,True
4961581,672,4,451,1412,418757019,1,0,0,645.11,7,786630.36,18,1,11,2,True
5026423,327,0,20,5029,418757019,1,0,0,645.4,5,785984.96,11,6,14,2,True
5124846,681,2,20,3072,418757019,1,0,0,644.97,5,785339.99,24,1,12,2,True
5177637,1170,0,30,9046,418757019,1,0,0,644.82,8,784695.17,24,1,5,3,True
5546677,436,4,25,9046,418757019,1,0,0,644.66,8,784050.51,24,6,11,3,True
5776226,137,2,451,5778,418757019,1,0,0,644.94,7,783405.57,18,1,22,4,True
5904486,672,4,-1,9343,418757019,1,1,0,644.73,4,783405.57,18,1,17,4,True
5968731,1393,3,-1,3072,418757019,1,2,0,645.13,4,783405.57,24,5,11,4,True
6082574,672,4,30,4602,418757019,1,0,0,645.19,8,782760.38,18,5,13,4,True
6192800,137,2,25,3623,418757019,1,0,0,645.07,8,782115.31,18,6,11,4,False
6523276,58,2,20,4214,418757019,1,0,0,644.94,5,781470.37,20,4,6,5,True
6614133,502,0,10,5807,418757019,1,0,0,645.09,6,782115.46,12,0,8,5,True
6644437,1393,3,25,4486,418757019,1,0,0,645.02,8,781470.44,24,2,14,7,True
6868686,1393,3,451,9343,418757019,1,0,0,644.94,7,780825.5,24,5,6,8,True
6966749,1393,3,451,5061,418757019,1,0,0,645.01,7,780180.49,24,0,13,8,True
7128258,1393,3,451,8896,418757019,1,0,0,645.05,7,779535.44,24,6,21,9,True
7179945,688,0,20,9470,418757019,1,0,0,645.04,5,778890.4,24,2,8,9,True
7259870,672,4,-1,9343,418757019,1,1,0,645.03,4,778890.4,18,1,0,9,True
7333619,874,4,451,7366,418757019,1,0,0,645.21,7,778245.19,24,6,13,10,True
7382519,436,4,25,5778,418757019,1,0,0,644.9,8,777600.29,24,6,13,11,True
7466417,1393,3,-1,8896,418757019,1,1,0,645.22,4,777600.29,24,5,4,11,True
7583645,1419,1,25,7366,418757019,1,0,0,645.19,8,776955.1,24,2,18,1,True
7744441,1170,0,-1,8192,418757019,1,1,0,644.91,4,776955.1,24,2,8,1,True
8064255,1170,0,451,8192,418757019,1,0,0,644.91,7,776310.19,24,5,14,2,True
8123018,1170,0,25,1412,418757019,1,0,0,644.75,8,775665.44,24,0,4,2,True
8375872,1419,1,-1,7949,418757019,1,1,0,645.01,1,775665.44,24,4,18,3,True
8468336,215,0,20,3072,418757019,1,0,0,644.9,5,775020.54,9,1,12,4,True
8690390,1393,3,-1,4486,418757019,1,1,0,645.01,4,775020.54,24,5,18,5,True
8804685,819,2,20,9343,418757019,1,0,0,645.12,5,774375.42,18,3,7,6,True
8900835,721,4,451,5807,418757019,1,0,0,645.19,7,773730.23,11,3,15,6,True
8940970,1170,0,25,6539,418757019,1,0,0,644.82,8,773085.41,24,3,9,7,True
9043739,1393,3,-1,7167,418757019,1,1,0,644.94,4,773085.41,24,6,11,11,True
9441146,721,4,25,5778,418757019,1,0,0,645.14,8,772440.27,11,3,6,11,True
9798397,1170,0,451,7949,418757019,1,0,0,645.14,7,771795.13,24,2,17,11,True
1247256,1311,2,30,9286,517930210,0,0,0,379.99,8,328547.01,5,4,9,1,True
1781636,1198,4,30,3230,517930210,0,0,0,380.0,8,328167.01,24,1,15,1,True
1944526,832,3,451,1445,517930210,0,0,0,380.02,7,327786.99,5,5,16,2,True
2501671,1311,2,451,9187,517930210,0,0,0,380.07,7,327406.92,5,4,23,2,True
2533560,1198,4,451,3545,517930210,0,0,0,380.1,7,327026.82,24,3,20,3,True
2714831,689,0,20,8022,517930210,0,0,0,380.0,3,326646.82,24,5,2,4,False
2846049,1198,4,-1,2592,517930210,0,1,0,380.18,4,326646.82,24,4,13,5,True
2912369,1311,2,25,2592,517930210,0,0,0,380.09,8,326266.73,5,6,14,5,True
2953907,1069,1,25,8266,517930210,0,0,0,380.08,8,325886.65,18,3,2,5,True
2986125,1196,4,30,7675,517930210,0,0,0,380.14,8,325506.51,24,5,14,8,True
2991630,688,0,10,2705,517930210,0,0,0,380.02,6,325886.53,24,6,20,8,True
3098335,1311,2,30,8266,517930210,0,0,0,380.26,8,325506.27,5,6,15,9,True
3654267,1198,4,30,9286,517930210,0,0,0,379.83,8,325126.44,24,2,6,9,True
3904614,1311,2,451,2592,517930210,0,0,0,380.4,7,324746.04,5,4,7,10,True
4047611,1069,1,-1,2592,517930210,0,1,0,380.03,4,324746.04,18,6,11,10,True
4413035,1198,4,25,9187,517930210,0,0,0,380.3,8,324365.74,24,6,13,11,True
4454803,694,2,20,4589,517930210,0,0,0,380.06,5,323985.68,24,3,14,11,True
4493678,1198,4,25,7731,517930210,0,0,0,379.91,8,323605.77,24,0,17,11,True
4623720,1226,2,20,2008,517930210,0,0,0,380.24,5,323225.53,18,1,7,12,True
4793330,913,0,10,2615,517930210,0,0,0,379.96,6,323605.49,18,6,6,12,True
4821275,1217,0,20,2008,517930210,0,0,0,380.22,5,323225.27,24,0,5,12,True
5090641,509,0,20,1323,517930210,0,0,0,380.4,5,322844.87,12,5,11,12,True
5266174,832,3,-1,9187,517930210,0,1,0,380.04,4,322844.87,5,3,20,1,True
5333172,1196,4,451,2705,517930210,0,0,0,379.9,7,322464.97,24,4,2,1,True
5472474,1196,4,-1,2615,517930210,0,1,0,379.78,4,322464.97,24,5,11,1,True
5855393,542,0,10,7731,517930210,0,0,0,380.04,0,322845.01,17,3,6,2,True
5925318,1196,4,-1,4129,517930210,0,1,0,379.93,4,322845.01,24,2,22,3,True
6002403,1196,4,30,4129,517930210,0,0,0,379.87,8,322465.14,24,2,3,4,True
6037659,1311,2,25,3545,517930210,0,0,0,379.98,8,322085.16,5,4,23,4,True
6146291,1196,4,25,3834,517930210,0,0,0,380.17,8,321704.99,24,5,8,5,True
6205954,334,0,20,6768,517930210,0,0,0,380.14,3,321324.85,11,0,0,5,True
6287813,832,3,30,7675,517930210,0,0,0,380.0,8,320944.85,5,0,16,6,True
6290250,729,0,10,8022,517930210,0,0,0,380.02,0,321324.87,11,1,3,8,True
6310450,587,2,20,7675,517930210,0,0,0,380.14,5,320944.73,24,1,14,9,True
6627249,1311,2,30,2969,517930210,0,0,0,379.86,8,320564.87,5,1,1,9,False
6774790,979,0,20,2705,517930210,0,0,0,379.66,5,320185.21,22,2,23,11,True
6966769,832,3,30,6275,517930210,0,0,0,379.85,8,319805.36,5,5,21,11,True
7011672,260,0,10,2592,517930210,0,0,0,380.05,0,320185.41,6,0,4,12,True
7093136,1196,4,451,7523,517930210,0,0,0,379.77,7,319805.64,24,0,14,1,True
7181061,573,0,20,1445,517930210,0,0,0,379.93,5,319425.71,11,3,17,2,True
7408786,1196,4,25,2046,517930210,0,0,0,380.3,8,319045.41,24,0,14,3,True
7561982,1069,1,30,9868,517930210,0,0,0,380.03,8,318665.38,18,4,20,3,True
7589776,350,0,10,1323,517930210,0,0,0,380.04,6,319045.42,24,0,14,4,True
7655096,832,3,25,1323,517930210,0,0,0,380.08,8,318665.34,5,6,8,5,True
7807259,1069,1,30,1803,517930210,0,0,0,379.99,8,318285.35,18,4,16,6,True
7903851,129,0,10,3834,517930210,0,0,0,380.23,6,318665.58,18,6,14,6,True
8373543,1196,4,-1,4589,517930210,0,1,0,379.91,4,318665.58,24,2,9,7,True
8847661,1198,4,-1,1323,517930210,0,2,0,379.9,1,318665.58,24,5,19,7,True
8864574,1164,0,10,1803,517930210,0,0,0,380.01,0,319045.59,24,1,20,7,True
8911490,1198,4,30,3545,517930210,0,0,0,379.85,8,318665.74,24,3,15,7,True
8938571,1311,2,25,1445,517930210,0,0,0,380.09,8,318285.65,5,0,9,8,True
9233504,1198,4,25,8022,517930210,0,0,0,379.89,8,317905.76,24,1,7,8,True
9302973,708,2,20,7731,517930210,0,0,0,379.95,3,317525.81,18,3,6,9,True
9346353,1196,4,30,3230,517930210,0,0,0,379.9,8,317145.91,24,5,7,9,True
9450209,223,2,25,3834,517930210,0,0,0,379.96,8,316765.95,26,5,22,10,True
9538594,223,2,451,3230,517930210,0,0,0,380.13,7,316385.82,26,3,9,10,True
9691648,223,2,25,2615,517930210,0,0,0,379.96,8,316005.86,26,6,23,11,True
1145717,1064,0,451,1788,619523584,1,0,0,1068.9,7,831583.1,11,6,13,1,True
1432456,309,0,451,6091,619523584,1,0,0,1069.1,7,830514.0,4,6,16,1,True
1799102,1393,3,451,7616,619523584,1,0,0,1068.99,7,829445.01,24,3,7,2,True
1809082,799,2,25,4747,619523584,1,0,0,1069.17,8,828375.84,11,3,4,3,True
1963431,12,4,30,4896,619523584,1,0,0,1069.03,8,827306.81,24,5,9,4,True
2035562,1303,0,30,3226,619523584,1,0,0,1069.02,8,826237.79,5,0,10,4,True
2039520,1303,0,25,2367,619523584,1,0,0,1068.85,8,825168.94,5,1,10,4,True
2489479,1064,0,30,3065,619523584,1,0,0,1068.99,8,824099.95,11,5,18,5,True
2595685,1393,3,451,1653,619523584,1,0,0,1068.87,7,823031.08,24,0,15,5,True
2929355,1393,3,30,2757,619523584,1,0,0,1068.99,8,821962.09,24,0,14,6,True
2990284,677,0,-1,6564,619523584,1,1,0,1069.12,4,821962.09,24,3,19,6,True
3037676,1064,0,451,9070,619523584,1,0,0,1069.09,7,820893.0,11,1,14,7,True
3233480,12,4,-1,1418,619523584,1,1,0,1069.08,4,820893.0,24,4,22,7,True
3427732,1064,0,451,1418,619523584,1,0,0,1068.74,7,819824.26,11,2,1,8,True
3445834,926,4,25,9370,619523584,1,0,0,1068.87,8,818755.39,18,0,4,9,True
3491546,219,0,10,7267,619523584,1,0,0,1068.75,0,819824.14,9,1,1,9,True
3641904,1393,3,451,6676,619523584,1,0,0,1068.91,7,818755.23,24,1,0,9,True
3719794,1303,0,25,9370,619523584,1,0,0,1069.07,8,817686.16,5,3,20,10,True
3768705,689,0,10,3064,619523584,1,0,0,1069.07,6,818755.23,24,0,8,12,True
3803404,926,4,-1,3354,619523584,1,1,0,1068.91,4,818755.23,18,2,23,12,True
3964612,1303,0,-1,8519,619523584,1,2,0,1069.04,4,818755.23,5,3,13,12,True
4129378,799,2,451,9370,619523584,1,0,0,1069.04,7,817686.19,11,2,2,1,True
4175177,799,2,-1,6564,619523584,1,1,0,1068.83,1,817686.19,11,4,4,1,True
4214405,249,0,10,7185,619523584,1,0,0,1068.95,6,818755.14,6,1,22,1,True
4350250,309,0,30,1788,619523584,1,0,0,1068.92,8,817686.22,4,4,12,2,True
4725775,708,2,20,9370,619523584,1,0,0,1068.97,3,816617.25,18,2,10,3,True
4809539,1429,0,10,2367,619523584,1,0,0,1068.87,0,817686.12,24,3,22,3,True
5042591,12,4,30,4747,619523584,1,0,0,1069.01,8,816617.11,24,4,3,3,False
5045172,1012,0,20,2367,619523584,1,0,0,1069.15,5,815547.96,26,4,22,3,True
5113781,183,1,10,8519,619523584,1,0,0,1069.18,0,816617.14,18,1,16,4,True
5152547,679,0,20,3064,619523584,1,0,0,1068.86,3,815548.28,24,0,5,4,True
5200225,926,4,451,2367,619523584,1,0,0,1069.07,7,814479.21,18,2,13,4,True
5398477,1393,3,30,7616,619523584,1,0,0,1068.82,8,813410.39,24,4,19,4,True
5439334,799,2,451,2420,619523584,1,0,0,1069.05,7,812341.34,11,6,6,4,True
5677242,926,4,-1,6676,619523584,1,1,0,1069.08,4,812341.34,18,5,4,4,True
5723378,1064,0,25,6564,619523584,1,0,0,1068.97,8,811272.37,11,4,22,4,True
5972901,309,0,30,9070,619523584,1,0,0,1069.01,8,810203.36,4,1,8,6,True
6183458,1110,0,20,6179,619523584,1,0,0,1069.09,3,809134.27,0,4,7,8,True
6498568,1064,0,451,3065,619523584,1,0,0,1069.04,7,808065.23,11,4,17,9,True
6794822,249,0,10,4747,619523584,1,0,0,1068.97,6,809134.2,6,5,22,10,True
6877563,1303,0,30,6179,619523584,1,0,0,1069.24,8,808064.96,5,3,4,11,True
7033868,309,0,451,6091,619523584,1,0,0,1068.91,7,806996.05,4,1,14,11,True
7150624,1060,1,10,9370,619523584,1,0,0,1069.02,0,808065.07,11,1,8,11,True
7212820,677,0,451,2757,619523584,1,0,0,1069.04,7,806996.03,24,3,12,12,True
7229385,309,0,-1,7616,619523584,1,1,0,1068.97,1,806996.03,4,2,21,1,True
7265820,1297,0,10,3354,619523584,1,0,0,1068.93,0,808064.96,5,3,19,1,True
7300161,1262,0,20,1653,619523584,1,0,0,1069.3,5,806995.66,23,6,13,3,True
7464864,910,0,10,9070,619523584,1,0,0,1069.26,6,808064.92,18,2,16,4,True
7465798,799,2,30,4896,619523584,1,0,0,1068.81,8,806996.11,11,5,2,5,True
7625049,1393,3,30,1951,619523584,1,0,0,1068.86,8,805927.25,24,0,17,6,True
7875652,1303,0,30,1418,619523584,1,0,0,1068.99,8,804858.26,5,2,23,6,True
8070991,811,0,10,3226,619523584,1,0,0,1069.03,0,805927.29,18,3,18,7,True
8150866,799,2,451,6676,619523584,1,0,0,1069.03,7,804858.26,11,6,17,7,True
8321010,1303,0,25,9370,619523584,1,0,0,1069.03,8,803789.23,5,6,17,8,True
8473866,1064,0,451,8519,619523584,1,0,0,1069.07,7,802720.16,11,5,1,8,True
8794308,1393,3,25,6091,619523584,1,0,0,1068.89,8,801651.27,24,6,17,8,True
9498929,12,4,25,7616,619523584,1,0,0,1068.91,8,800582.36,24,1,0,9,True
9508452,799,2,30,3064,619523584,1,0,0,1069.16,8,799513.2,11,2,17,9,True
1634913,176,3,451,1584,730775143,0,0,0,712.23,7,385719.77,24,1,22,2,True
1961520,1170,0,-1,7376,730775143,0,1,0,712.06,4,385719.77,24,3,12,3,True
2181344,116,0,30,4512,730775143,0,0,0,712.19,8,385007.58,3,3,18,3,True
2321430,996,0,10,1967,730775143,0,0,0,711.81,6,385719.39,26,0,23,3,True
3269955,874,4,-1,8845,730775143,0,1,0,711.95,1,385719.39,24,5,9,3,False
3365748,346,0,10,1762,730775143,0,0,0,711.96,0,386431.35,24,2,10,5,True
3816593,1255,0,10,5949,730775143,0,0,0,712.06,6,387143.41,23,5,1,5,False
3994876,1170,0,30,2646,730775143,0,0,0,711.92,8,386431.49,24,2,3,5,True
4009481,874,4,451,1967,730775143,0,0,0,711.94,7,385719.55,24,4,1,6,True
4118585,116,0,25,9145,730775143,0,0,0,712.13,8,385007.42,3,0,12,7,True
4410867,952,0,451,7717,730775143,0,0,0,712.01,7,384295.41,13,3,1,8,True
4787398,1170,0,451,3279,730775143,0,0,0,711.95,7,383583.46,24,2,22,9,True
4816011,116,0,451,1248,730775143,0,0,0,712.07,7,382871.39,3,5,15,10,True
5068296,874,4,25,1866,730775143,0,0,0,712.03,8,382159.36,24,6,3,10,True
5134862,952,0,451,7376,730775143,0,0,0,712.13,7,381447.23,13,5,12,12,True
5137853,952,0,451,2646,730775143,0,0,0,712.05,7,380735.18,13,2,20,1,True
5168257,952,0,451,6646,730775143,0,0,0,711.92,7,380023.26,13,0,20,1,True
5572868,176,3,-1,6843,730775143,0,1,0,711.88,1,380023.26,24,4,2,3,True
5609521,176,3,25,5949,730775143,0,0,0,712.03,8,379311.23,24,1,9,3,True
5746820,874,4,30,5405,730775143,0,0,0,712.11,8,378599.12,24,3,18,3,True
5887129,266,2,20,1762,730775143,0,0,0,712.07,5,377887.05,6,4,2,3,True
5910138,176,3,25,2135,730775143,0,0,0,711.96,8,377175.09,24,4,4,4,True
5983019,603,0,20,4512,730775143,0,0,0,711.98,3,376463.11,24,0,11,5,True
6159890,951,0,20,2646,730775143,0,0,0,711.9,5,375751.21,24,4,8,6,True
6200921,176,3,451,9145,730775143,0,0,0,712.03,7,375039.18,24,1,0,6,True
6383874,116,0,-1,2646,730775143,0,1,0,712.2,4,375039.18,3,0,1,7,True
6458229,1155,0,10,7717,730775143,0,0,0,712.06,6,375751.24,15,4,0,7,True
6786635,759,0,20,5405,730775143,0,0,0,711.92,5,375039.32,24,0,14,7,True
6960869,116,0,451,7376,730775143,0,0,0,711.82,7,374327.5,3,2,23,8,True
7067358,952,0,-1,2135,730775143,0,1,0,712.05,4,374327.5,13,3,20,9,True
7108932,59,0,20,5949,730775143,0,0,0,712.1,5,373615.4,20,2,7,10,True
7251116,116,0,25,8720,730775143,0,0,0,712.21,8,372903.19,3,0,4,10,True
7439553,952,0,-1,1967,730775143,0,1,0,711.65,4,372903.19,13,1,17,11,True
7537920,688,0,20,8845,730775143,0,0,0,712.13,3,372191.06,24,5,19,11,True
7632099,952,0,25,8845,730775143,0,0,0,711.92,8,371479.14,13,5,12,12,True
7754312,874,4,-1,7376,730775143,0,1,0,711.8,4,371479.14,24,3,11,1,True
7900877,952,0,451,8845,730775143,0,0,0,712.09,7,370767.05,13,0,21,1,True
7957514,874,4,30,1248,730775143,0,0,0,712.0,8,370055.05,24,3,16,2,True
8406254,116,0,451,1584,730775143,0,0,0,711.91,7,369343.14,3,5,19,3,True
8625700,116,0,-1,3279,730775143,0,1,0,712.1,4,369343.14,3,5,16,3,True
8635760,952,0,451,1866,730775143,0,0,0,711.96,7,368631.18,13,6,11,4,True
8717794,874,4,30,3279,730775143,0,0,0,712.11,8,367919.07,24,5,13,4,True
8801707,1170,0,30,1866,730775143,0,0,0,712.03,8,367207.04,24,0,7,5,True
8904453,276,0,10,1967,730775143,0,0,0,712.19,6,367919.23,24,6,7,6,True
9107383,1170,0,30,8845,730775143,0,0,0,712.11,8,367207.12,24,0,16,6,True
9112680,300,0,20,9145,730775143,0,0,0,711.98,5,366495.14,4,3,23,7,True
9400302,1170,0,-1,5405,730775143,0,1,0,711.89,4,366495.14,24,5,2,7,True
9511806,116,0,451,7376,730775143,0,0,0,711.93,7,365783.21,3,3,17,7,True
9666587,1170,0,451,8720,730775143,0,0,0,712.06,7,365071.15,24,0,16,9,True
9991664,952,0,451,5405,730775143,0,0,0,711.81,7,364359.34,13,2,9,11,True
1042872,1037,0,10,2165,697084905,0,0,0,982.84,6,314728.84,11,1,5,1,True
1055532,1382,0,10,8126,697084905,0,0,0,982.85,6,315711.69,16,4,13,1,True
1503735,160,0,30,4858,697084905,0,0,0,983.12,8,314728.57,24,4,8,2,True
1606381,1455,2,451,5685,697084905,0,0,0,982.9,7,313745.67,11,5,5,5,True
1718170,462,4,25,2142,697084905,0,0,0,983.17,8,312762.5,13,4,4,6,False
1900718,1398,4,30,5590,697084905,0,0,0,982.98,8,311779.52,24,5,14,6,True
1969478,184,0,20,5590,697084905,0,0,0,982.82,3,310796.7,18,1,5,6,True
1997940,1398,4,-1,2165,697084905,0,1,0,982.85,4,310796.7,24,4,6,7,False
2087637,746,4,25,5590,697084905,0,0,0,983.18,8,309813.52,24,0,3,7,True
2129044,802,2,-1,7729,697084905,0,1,0,983.2,1,309813.52,11,0,22,7,True
2389722,1398,4,30,2165,697084905,0,0,0,983.2,8,308830.32,24,3,3,7,True
2407831,626,2,20,4858,697084905,0,0,0,983.09,5,307847.23,11,1,16,8,True
2530246,746,4,-1,5590,697084905,0,1,0,982.82,4,307847.23,24,5,22,9,True
2860631,882,0,10,5590,697084905,0,0,0,983.15,6,308830.38,27,3,4,9,True
3002282,1398,4,451,8768,697084905,0,0,0,982.77,7,307847.61,24,5,14,10,True
3023626,616,1,10,5495,697084905,0,0,0,983.28,6,308830.89,11,0,8,10,True
3265016,1455,2,-1,9186,697084905,0,1,0,982.86,1,308830.89,11,4,8,10,True
3434265,802,2,25,6292,697084905,0,0,0,983.22,8,307847.67,11,4,14,11,True
3693539,1455,2,30,9186,697084905,0,0,0,982.98,8,306864.69,11,5,15,11,True
3733360,350,0,20,3851,697084905,0,0,0,982.75,3,305881.94,24,0,13,11,True
3978774,195,1,451,2266,697084905,0,0,0,983.4,7,304898.54,18,1,14,11,True
4053614,1205,0,20,4165,697084905,0,0,0,982.99,5,303915.55,24,2,7,12,True
4512042,895,0,451,5590,697084905,0,0,0,983.01,7,302932.54,24,6,2,12,True
4775673,802,2,30,2165,697084905,0,0,0,983.06,8,301949.48,11,3,7,12,False
4929473,895,0,451,1118,697084905,0,0,0,983.34,7,300966.14,24,5,4,2,True
4932221,913,0,10,7265,697084905,0,0,0,983.01,6,301949.15,18,1,5,2,True
5051282,462,4,451,4165,697084905,0,0,0,982.93,7,300966.22,13,3,12,2,True
5106750,462,4,451,1010,697084905,0,0,0,983.09,7,299983.13,13,1,9,3,True
5182418,168,0,10,2266,697084905,0,0,0,983.05,6,300966.18,24,3,6,5,True
5313133,1398,4,451,5800,697084905,0,0,0,982.97,7,299983.21,24,5,3,5,True
5780196,1338,0,10,2266,697084905,0,0,0,982.98,6,300966.19,18,5,16,7,True
6026664,895,0,-1,2266,697084905,0,1,0,983.02,4,300966.19,24,2,8,7,True
6079065,267,0,20,5800,697084905,0,0,0,983.22,5,299982.97,6,0,14,8,True
6087328,812,0,20,3105,697084905,0,0,0,983.07,5,298999.9,18,0,5,8,True
6124971,1477,2,20,6320,697084905,0,0,0,983.49,3,298016.41,24,3,20,8,True
6650762,979,0,20,4721,697084905,0,0,0,983.11,3,297033.3,22,1,9,10,True
6719026,137,2,20,7384,697084905,0,0,0,983.06,5,296050.24,18,5,4,10,True
7109068,195,1,451,8566,697084905,0,0,0,983.15,7,295067.09,18,2,0,11,True
7260407,462,4,30,2266,697084905,0,0,0,983.03,8,294084.06,13,2,1,11,True
7262724,462,4,451,5800,697084905,0,0,0,983.04,7,293101.02,13,3,5,11,True
7401919,1398,4,-1,8768,697084905,0,1,0,982.89,4,293101.02,24,6,13,11,True
7673071,746,4,25,7265,697084905,0,0,0,982.83,8,292118.19,24,1,0,11,True
7778887,577,0,10,8566,697084905,0,0,0,983.17,6,293101.36,11,5,18,12,True
7862683,1206,0,20,2266,697084905,0,0,0,983.06,3,292118.3,24,0,20,1,True
7985283,895,0,30,5495,697084905,0,0,0,982.88,8,291135.42,24,5,18,3,True
8279081,538,0,10,5590,697084905,0,0,0,983.1,6,292118.52,18,6,11,4,True
8725211,802,2,451,4858,697084905,0,0,0,982.97,7,291135.55,11,0,14,5,True
8735133,1455,2,451,6320,697084905,0,0,0,982.96,7,290152.59,11,1,11,5,True
8772498,746,4,30,3105,697084905,0,0,0,982.87,8,289169.72,24,6,17,6,True
8906772,583,2,20,1914,697084905,0,0,0,983.1,3,288186.62,11,5,22,7,True
8963865,1455,2,30,4721,697084905,0,0,0,982.65,8,287203.97,11,1,4,7,True
9073155,591,0,10,7729,697084905,0,0,0,983.08,6,288187.05,24,2,16,9,True
9113703,895,0,25,6320,697084905,0,0,0,982.97,8,287204.08,24,2,6,11,True
9760156,1398,4,25,4858,697084905,0,0,0,982.82,8,286221.26,24,2,8,11,True
9890640,746,4,451,7384,697084905,0,0,0,982.67,7,285238.59,24,1,20,11,True
1298790,562,1,451,1595,138322584,1,0,0,503.1,7,787180.9,17,0,20,2,True
1708420,253,2,20,4961,138322584,1,0,0,503.15,3,786677.75,6,3,16,3,True
1828297,197,4,-1,7923,138322584,1,1,0,502.78,4,786677.75,18,6,22,4,True
1841535,1425,0,10,4739,138322584,1,0,0,503.09,6,787180.84,24,3,11,4,True
2407885,240,4,25,8332,138322584,1,0,0,502.99,8,786677.85,26,0,21,6,True
2799228,1087,4,25,9156,138322584,1,0,0,503.02,8,786174.83,18,2,11,7,True
2898572,240,4,-1,6433,138322584,1,1,0,502.9,1,786174.83,26,2,1,7,True
2951755,783,0,10,6916,138322584,1,0,0,503.02,0,786677.85,14,2,23,9,True
3043070,438,1,25,9211,138322584,1,0,0,503.2,8,786174.65,24,1,22,10,True
3227355,562,1,30,6916,138322584,1,0,0,503.18,8,785671.47,17,4,12,10,True
3327120,197,4,451,8875,138322584,1,0,0,502.86,7,785168.61,18,3,19,11,True
3728451,115,2,20,7055,138322584,1,0,0,503.01,5,784665.6,3,1,13,11,True
3820828,438,1,-1,8698,138322584,1,1,0,502.82,4,784665.6,24,6,1,11,True
3908231,438,1,30,8698,138322584,1,0,0,503.23,8,784162.37,24,2,19,12,False
3917526,197,4,30,7474,138322584,1,0,0,502.89,8,783659.48,18,4,21,12,True
4098692,562,1,451,1595,138322584,1,0,0,502.96,7,783156.52,17,1,21,1,True
4284664,1113,1,10,8698,138322584,1,0,0,503.17,6,783659.69,0,2,12,3,True
4308129,562,1,-1,8698,138322584,1,1,0,502.81,1,783659.69,17,2,7,3,True
4502525,967,1,10,8332,138322584,1,0,0,502.83,6,784162.52,13,3,11,4,True
4516093,562,1,25,2838,138322584,1,0,0,502.96,8,783659.56,17,0,5,4,True
4524405,190,4,451,3148,138322584,1,0,0,502.87,7,783156.69,18,6,1,4,True
4716132,240,4,451,4961,138322584,1,0,0,503.0,7,782653.69,26,5,0,5,True
5160807,190,4,30,7923,138322584,1,0,0,503.07,8,782150.62,18,4,2,5,True
5255328,190,4,451,9156,138322584,1,0,0,503.19,7,781647.43,18,0,22,6,True
5481425,228,0,20,1161,138322584,1,0,0,502.85,5,781144.58,26,5,20,8,True
5736496,240,4,451,4961,138322584,1,0,0,503.07,7,780641.51,26,0,5,8,True
6112751,197,4,451,1161,138322584,1,0,0,503.16,7,780138.35,18,3,1,10,True
6197656,1439,4,30,7474,138322584,1,0,0,502.94,8,779635.41,24,6,8,10,True
6257509,438,1,30,4961,138322584,1,0,0,502.78,8,779132.63,24,2,6,11,True
6387826,1060,1,10,6916,138322584,1,0,0,502.73,6,779635.36,11,2,7,11,True
6424717,1087,4,451,6916,138322584,1,0,0,502.87,7,779132.49,18,2,22,11,True
6472616,1439,4,451,4739,138322584,1,0,0,502.91,7,778629.58,24,1,11,1,True
6531701,1105,2,20,7055,138322584,1,0,0,503.06,3,778126.52,0,6,12,1,True
6791691,804,0,10,4764,138322584,1,0,0,503.18,6,778629.7,11,1,3,2,True
7035089,249,0,10,6916,138322584,1,0,0,502.82,0,779132.52,6,3,16,2,False
7328503,1404,2,20,8332,138322584,1,0,0,503.06,5,778629.46,24,1,13,2,True
7643772,562,1,25,4501,138322584,1,0,0,502.98,8,778126.48,17,0,10,3,True
7767635,562,1,30,9156,138322584,1,0,0,503.21,8,777623.27,17,6,19,5,True
8113158,1052,0,20,6433,138322584,1,0,0,503.02,3,777120.25,11,2,11,6,True
8201227,240,4,30,4656,138322584,1,0,0,503.11,8,776617.14,26,1,15,6,True
8236297,438,1,-1,3148,138322584,1,1,0,502.95,1,776617.14,24,5,15,7,True
8274259,562,1,451,9156,138322584,1,0,0,503.14,7,776114.0,17,4,3,7,True
8477826,1439,4,30,8875,138322584,1,0,0,502.77,8,775611.23,24,4,6,8,True
8522508,562,1,25,6433,138322584,1,0,0,502.82,8,775108.41,17,0,16,8,True
8676698,190,4,451,6433,138322584,1,0,0,503.04,7,774605.37,18,0,14,9,True
8987397,234,0,10,4764,138322584,1,0,0,503.12,6,775108.49,26,3,23,9,True
9346065,438,1,451,8332,138322584,1,0,0,502.97,7,774605.52,24,4,12,9,True
9400437,895,0,10,4739,138322584,1,0,0,503.36,6,775108.88,24,6,22,9,True
9406921,240,4,451,1595,138322584,1,0,0,503.04,7,774605.84,26,2,15,10,True
9957836,854,0,10,8698,138322584,1,0,0,502.81,6,775108.65,24,3,19,10,True
1145575,1160,0,451,5479,329445955,1,0,0,603.19,7,259055.81,15,3,8,3,True
1682150,1102,2,20,9450,329445955,1,0,0,603.1,3,258452.71,0,3,8,3,True
1862692,238,0,-1,1131,329445955,1,1,0,602.78,1,258452.71,26,3,23,3,True
1868799,562,1,10,9869,329445955,1,0,0,603.04,6,259055.75,17,6,18,4,True
1968484,677,0,20,1426,329445955,1,0,0,602.86,5,258452.89,24,2,14,4,True
1982211,452,4,451,5480,329445955,1,0,0,603.04,7,257849.85,13,6,4,4,True
2179804,688,0,451,5342,329445955,1,0,0,603.05,7,257246.8,24,4,14,5,True
2437190,452,4,451,9704,329445955,1,0,0,602.58,7,256644.22,13,3,1,6,True
2730714,357,4,-1,9450,329445955,1,1,0,603.15,4,256644.22,24,4,12,6,True
2787182,297,0,10,6542,329445955,1,0,0,602.86,6,257247.08,4,1,11,7,True
3034227,238,0,30,1980,329445955,1,0,0,602.99,8,256644.09,26,3,9,8,True
3038109,1160,0,30,9450,329445955,1,0,0,603.15,8,256040.94,15,1,17,8,True
3433791,267,0,20,6993,329445955,1,0,0,602.64,5,255438.3,6,6,4,9,True
3463599,357,4,451,3409,329445955,1,0,0,603.11,7,254835.19,24,0,7,9,True
3518473,1160,0,30,1980,329445955,1,0,0,603.21,8,254231.98,15,2,4,9,True
3586337,238,0,451,9450,329445955,1,0,0,602.74,7,253629.24,26,6,22,9,True
3742811,452,4,25,9450,329445955,1,0,0,603.24,8,253026.0,13,6,5,10,False
3767188,567,1,10,9704,329445955,1,0,0,602.91,0,253628.91,11,1,16,10,True
3767497,1436,0,30,3647,329445955,1,0,0,602.92,8,253025.99,24,1,23,11,True
3878123,1436,0,25,5342,329445955,1,0,0,602.7,8,252423.29,24,6,5,11,True
3909626,1436,0,25,2743,329445955,1,0,0,603.08,8,251820.21,24,3,15,11,True
3932123,688,0,25,2414,329445955,1,0,0,603.15,8,251217.06,24,6,14,11,True
3956362,452,4,25,9869,329445955,1,0,0,602.95,8,250614.11,13,0,9,12,True
3962297,444,2,20,8514,329445955,1,0,0,603.12,5,250010.99,24,5,9,1,False
3983014,452,4,-1,1980,329445955,1,1,0,603.03,1,250010.99,13,6,19,1,True
4824520,357,4,-1,3647,329445955,1,2,0,603.18,4,250010.99,24,5,9,1,True
4830549,1436,0,20,3409,329445955,1,0,0,603.02,5,249407.97,24,2,18,2,True
5199298,238,0,-1,8174,329445955,1,1,0,603.1,4,249407.97,26,2,6,2,True
5323247,452,4,451,9704,329445955,1,0,0,603.09,7,248804.88,13,5,19,2,True
5383897,238,0,25,2743,329445955,1,0,0,602.94,8,248201.94,26,1,9,4,True
5445356,452,4,451,6542,329445955,1,0,0,602.96,7,247598.98,13,6,1,4,True
5680488,357,4,30,9704,329445955,1,0,0,602.91,8,246996.07,24,3,2,5,True
6084241,1436,0,25,5342,329445955,1,0,0,603.08,8,246392.99,24,5,4,6,True
6086138,1380,0,20,2150,329445955,1,0,0,602.9,3,245790.09,16,5,19,6,True
6122250,357,4,451,9869,329445955,1,0,0,602.97,7,245187.12,24,4,16,6,True
6224080,1102,2,20,1426,329445955,1,0,0,603.07,3,244584.05,0,1,23,8,True
6629012,688,0,30,6993,329445955,1,0,0,602.94,8,243981.11,24,3,0,8,False
6675383,1436,0,451,3409,329445955,1,0,0,603.07,7,243378.04,24,2,9,10,True
7093950,238,0,-1,7245,329445955,1,1,0,602.99,1,243378.04,26,3,11,10,True
7104667,1160,0,451,2414,329445955,1,0,0,602.77,7,242775.27,15,4,13,12,True
7322195,688,0,-1,8174,329445955,1,1,0,603.32,4,242775.27,24,6,19,12,True
7381385,238,0,451,2253,329445955,1,0,0,603.21,7,242172.06,26,6,19,12,True
7423171,681,2,20,7245,329445955,1,0,0,602.91,3,241569.15,24,3,0,1,True
7465402,1160,0,30,9869,329445955,1,0,0,602.89,8,240966.26,15,0,22,1,True
7749507,688,0,451,9704,329445955,1,0,0,602.92,7,240363.34,24,3,23,2,True
7986156,1217,0,20,2253,329445955,1,0,0,603.02,3,239760.32,24,4,11,3,True
8226702,1072,0,20,2414,329445955,1,0,0,603.06,5,239157.26,18,5,2,3,True
8450414,234,0,10,2414,329445955,1,0,0,603.11,6,239760.37,26,2,18,4,True
8555640,688,0,451,1426,329445955,1,0,0,603.2,7,239157.17,24,6,9,4,True
8655591,1160,0,451,3409,329445955,1,0,0,603.06,7,238554.11,15,4,8,4,True
9064206,238,0,25,7245,329445955,1,0,0,603.02,8,237951.09,26,0,19,4,True
9316374,357,4,451,3647,329445955,1,0,0,602.96,7,237348.13,24,0,2,6,False
9355703,1435,2,20,7257,329445955,1,0,0,602.88,5,236745.25,24,6,11,6,True
9402779,688,0,451,2253,329445955,1,0,0,602.9,7,236142.35,24,2,16,7,True
9412344,452,4,30,1426,329445955,1,0,0,602.8,8,235539.55,13,5,18,7,True
9439609,1160,0,30,5342,329445955,1,0,0,603.17,8,234936.38,15,4,18,10,True
9570589,452,4,25,5342,329445955,1,0,0,602.94,8,234333.44,13,5,8,10,False
9589448,1160,0,451,1131,329445955,1,0,0,602.97,7,233730.47,15,2,23,10,True
1011610,562,1,10,4006,485841243,0,0,0,538.87,6,635507.87,17,6,21,1,True
1159657,744,4,30,4006,485841243,0,0,0,538.86,8,634969.01,24,6,8,2,True
1232518,665,2,20,1304,485841243,0,0,0,538.94,5,634430.07,18,0,22,2,True
1234948,97,0,20,8670,485841243,0,0,0,539.32,5,633890.75,3,1,0,3,True
1238263,642,0,20,2510,485841243,0,0,0,539.07,5,633351.68,24,5,19,3,True
1399138,1032,4,25,6566,485841243,0,0,0,538.98,8,632812.7,11,4,19,5,True
1702621,540,4,451,9802,485841243,0,0,0,539.07,7,632273.63,17,6,12,6,True
1771476,674,4,30,5854,485841243,0,0,0,538.81,8,631734.82,24,6,10,6,True
1840421,300,0,20,9802,485841243,0,0,0,539.19,5,631195.63,4,6,10,6,True
1849946,180,0,10,1304,485841243,0,0,0,538.75,0,631734.38,18,5,13,7,True
2249202,892,4,451,9622,485841243,0,0,0,538.89,7,631195.49,24,3,19,9,True
2433938,540,4,-1,1304,485841243,0,1,0,538.78,4,631195.49,17,3,11,9,True
2658570,919,4,451,6566,485841243,0,0,0,538.85,7,630656.64,18,4,14,10,True
2747246,1377,0,20,9054,485841243,0,0,0,539.12,3,630117.52,16,4,20,10,True
2747929,744,4,30,8197,485841243,0,0,0,539.0,8,629578.52,24,2,2,11,False
2902252,674,4,-1,2510,485841243,0,1,0,539.14,4,629578.52,24,4,13,12,True
3262985,703,0,20,8834,485841243,0,0,0,539.24,5,629039.28,18,2,19,12,True
3379844,744,4,30,7679,485841243,0,0,0,539.17,8,628500.11,24,3,14,12,True
3387959,1363,0,20,9979,485841243,0,0,0,539.11,5,627961.0,16,3,23,12,True
3418837,674,4,451,9622,485841243,0,0,0,539.38,7,627421.62,24,3,9,1,True
3503198,919,4,30,7145,485841243,0,0,0,538.9,8,626882.72,18,0,7,2,True
3525919,962,0,20,8834,485841243,0,0,0,539.11,5,626343.61,13,6,8,3,True
3576117,744,4,-1,4006,485841243,0,1,0,538.89,4,626343.61,24,2,23,4,True
3677712,674,4,451,2906,485841243,0,0,0,539.07,7,625804.54,24,0,22,5,True
3677742,184,0,10,7679,485841243,0,0,0,539.29,0,626343.83,18,6,7,7,True
4020645,1032,4,451,3582,485841243,0,0,0,539.02,7,625804.81,11,3,14,7,True
4060911,744,4,30,9622,485841243,0,0,0,538.9,8,625265.91,24,5,4,7,True
4196576,919,4,451,2510,485841243,0,0,0,538.85,7,624727.06,18,6,0,8,True
4274429,919,4,451,8834,485841243,0,0,0,539.01,7,624188.05,18,6,2,9,True
4453665,314,0,20,9979,485841243,0,0,0,539.09,5,623648.96,4,6,5,10,True
4774578,744,4,451,9979,485841243,0,0,0,539.08,7,623109.88,24,2,0,10,True
4802677,744,4,25,9054,485841243,0,0,0,539.1,8,622570.78,24,5,20,11,True
4892360,892,4,451,7145,485841243,0,0,0,539.16,7,622031.62,24,0,3,11,True
5194343,892,4,30,9054,485841243,0,0,0,539.07,8,621492.55,24,3,23,11,True
5390990,744,4,-1,4006,485841243,0,1,0,538.95,1,621492.55,24,3,17,11,True
5410317,299,1,10,9054,485841243,0,0,0,538.71,6,622031.26,4,6,20,12,True
5452283,674,4,451,8660,485841243,0,0,0,539.09,7,621492.17,24,2,8,12,True
5820171,674,4,30,9054,485841243,0,0,0,538.98,8,620953.19,24,3,15,2,True
5932576,585,2,20,2510,485841243,0,0,0,538.87,5,620414.32,11,5,14,2,True
6525435,335,4,-1,1304,485841243,0,1,0,539.33,4,620414.32,11,6,1,2,True
6528532,687,0,20,2906,485841243,0,0,0,539.25,5,619875.07,24,2,18,2,True
6691836,744,4,25,9979,485841243,0,0,0,539.09,8,619335.98,24,0,16,3,True
7034396,182,1,10,1304,485841243,0,0,0,538.72,6,619874.7,18,0,17,3,False
7097027,1032,4,451,9802,485841243,0,0,0,539.17,7,619335.53,11,6,2,3,True
7349374,497,0,20,3211,485841243,0,0,0,539.09,5,618796.44,12,6,11,3,True
7442160,919,4,30,4006,485841243,0,0,0,539.09,8,618257.35,18,3,7,4,False
7690058,540,4,30,9622,485841243,0,0,0,538.84,8,617718.51,17,4,16,4,True
8075513,674,4,-1,6566,485841243,0,1,0,539.13,1,617718.51,24,1,11,4,True
8411407,744,4,30,9979,485841243,0,0,0,539.07,8,617179.44,24,6,17,5,True
8515111,287,0,20,6566,485841243,0,0,0,539.07,5,616640.37,24,5,23,6,True
8838886,327,0,20,4006,485841243,0,0,0,539.06,5,616101.31,11,0,1,7,True
8862784,540,4,-1,9054,485841243,0,1,0,538.71,1,616101.31,17,1,13,7,True
8863603,892,4,30,3582,485841243,0,0,0,539.12,8,615562.19,24,3,18,7,True
8943904,744,4,30,6861,485841243,0,0,0,539.14,8,615023.05,24,0,0,9,True
9009535,335,4,-1,2906,485841243,0,1,0,539.02,4,615023.05,11,0,18,10,True
9086989,1032,4,25,2191,485841243,0,0,0,538.89,8,614484.16,11,4,1,10,True
9518468,892,4,-1,4006,485841243,0,1,0,539.1,4,614484.16,24,4,4,11,True
1117189,475,4,25,9617,281074905,1,0,0,300.0,8,445557.0,5,4,8,1,True
1195244,920,4,30,3095,281074905,1,0,0,300.05,8,445256.95,18,2,4,4,True
1239243,192,2,30,7241,281074905,1,0,0,299.94,8,444957.01,18,4,21,5,False
1488933,475,4,451,6742,281074905,1,0,0,300.03,7,444656.98,5,2,21,6,True
1597628,104,4,451,4831,281074905,1,0,0,300.04,7,444356.94,3,0,10,7,True
1723150,1166,2,25,7241,281074905,1,0,0,299.85,8,444057.09,24,2,11,7,True
2084106,937,0,10,7241,281074905,1,0,0,300.19,6,444357.28,24,5,21,7,True
2193385,1063,0,10,9617,281074905,1,0,0,300.06,0,444657.34,11,6,10,7,True
2341569,104,4,30,3095,281074905,1,0,0,300.08,8,444357.26,3,0,5,8,True
2498434,340,4,30,2112,281074905,1,0,0,300.07,8,444057.19,24,2,4,8,True
2556252,1262,0,10,6237,281074905,1,0,0,300.1,0,444357.29,23,2,13,8,True
2579460,716,0,10,7241,281074905,1,0,0,300.09,6,444657.38,18,6,0,8,True
2774038,1227,0,20,9617,281074905,1,0,0,300.0,5,444357.38,18,1,19,9,True
2791996,920,4,-1,9301,281074905,1,1,0,300.15,4,444357.38,18,5,20,10,True
2899774,104,4,30,3095,281074905,1,0,0,299.98,8,444057.4,3,3,19,11,True
3158216,950,0,20,8747,281074905,1,0,0,299.83,3,443757.57,24,2,19,11,True
3236183,920,4,25,9855,281074905,1,0,0,300.03,8,443457.54,18,1,18,12,True
3389587,1166,2,25,6237,281074905,1,0,0,300.03,8,443157.51,24,0,9,12,True
3454352,1166,2,451,4831,281074905,1,0,0,300.12,7,442857.39,24,4,8,12,True
3756198,1166,2,451,6237,281074905,1,0,0,299.9,7,442557.49,24,5,18,12,True
3781328,475,4,451,6237,281074905,1,0,0,300.21,7,442257.28,5,2,1,3,True
4134242,327,0,20,8747,281074905,1,0,0,300.09,5,441957.19,11,6,6,3,True
4230976,927,4,30,4831,281074905,1,0,0,300.27,8,441656.92,18,5,16,4,True
4292749,645,0,20,7241,281074905,1,0,0,299.98,3,441356.94,24,2,16,4,True
4388179,1413,0,20,6168,281074905,1,0,0,300.16,5,441056.78,24,3,22,5,True
4438562,1346,4,30,6341,281074905,1,0,0,299.89,8,440756.89,24,3,7,6,True
4639299,1166,2,-1,3095,281074905,1,1,0,300.07,4,440756.89,24,2,8,6,True
4666887,940,1,10,5014,281074905,1,0,0,299.91,0,441056.8,24,6,18,7,True
4671018,910,0,20,7867,281074905,1,0,0,299.93,5,440756.87,18,0,22,7,True
5847653,1346,4,451,4831,281074905,1,0,0,299.95,7,440456.92,24,1,18,7,True
5973007,192,2,451,6237,281074905,1,0,0,299.99,7,440156.93,18,3,23,8,True
6289551,920,4,25,6168,281074905,1,0,0,300.04,8,439856.89,18,6,6,8,True
6562210,920,4,451,3852,281074905,1,0,0,300.22,7,439556.67,18,4,23,9,True
6703826,927,4,451,6742,281074905,1,0,0,299.92,7,439256.75,18,4,17,11,True
6886680,920,4,451,6237,281074905,1,0,0,300.27,7,438956.48,18,2,4,12,True
6974312,927,4,30,8747,281074905,1,0,0,300.02,8,438656.46,18,0,9,12,True
7227973,104,4,30,2112,281074905,1,0,0,300.05,8,438356.41,3,5,0,1,True
7313941,1186,2,20,5763,281074905,1,0,0,299.99,3,438056.42,24,0,4,4,True
7454985,920,4,451,6341,281074905,1,0,0,300.05,7,437756.37,18,6,22,4,True
7710092,340,4,-1,9855,281074905,1,1,0,299.97,1,437756.37,24,0,19,5,True
7711260,1346,4,-1,6469,281074905,1,2,0,299.93,4,437756.37,24,5,23,6,True
8069184,192,2,451,4831,281074905,1,0,0,300.25,7,437456.12,18,6,18,7,True
8179127,192,2,451,5014,281074905,1,0,0,299.91,7,437156.21,18,6,8,7,True
8583223,340,4,451,5763,281074905,1,0,0,300.03,7,436856.18,24,2,17,7,True
8612887,1346,4,451,6341,281074905,1,0,0,300.21,7,436555.97,24,4,0,8,True
8745753,673,0,20,4831,281074905,1,0,0,299.85,3,436256.12,18,6,5,8,True
8855696,939,0,451,6168,281074905,1,0,0,299.93,7,435956.19,24,5,22,9,True
9086571,1166,2,-1,9301,281074905,1,1,0,300.09,4,435956.19,24,1,15,9,True
9122077,104,4,30,9855,281074905,1,0,0,300.13,8,435656.06,3,2,0,9,True
9135694,192,2,451,9855,281074905,1,0,0,299.98,7,435356.08,18,1,13,10,True
9415471,1346,4,-1,9617,281074905,1,1,0,299.87,1,435356.08,24,5,17,10,True
9459142,192,2,25,6237,281074905,1,0,0,299.94,8,435056.14,18,6,10,11,True
9902269,1346,4,30,5763,281074905,1,0,0,300.29,8,434755.85,24,6,9,11,True
9966240,192,2,30,7241,281074905,1,0,0,300.03,8,434455.82,18,2,2,11,True
1319127,289,4,451,6239,377490942,1,0,0,914.89,7,82595.11,24,1,16,1,True
1551614,613,4,25,3484,377490942,1,0,0,915.0,8,81680.11,11,2,3,1,True
1797063,1044,0,451,8267,377490942,1,0,0,915.19,7,80764.92,11,6,8,1,True
1921030,1488,0,20,1049,377490942,1,0,0,914.92,5,79850.0,24,1,2,2,True
2198574,289,4,451,2455,377490942,1,0,0,915.06,7,78934.94,24,0,21,2,True
2212392,1398,4,25,7571,377490942,1,0,0,915.05,8,78019.89,24,6,0,3,True
2239801,370,4,-1,9332,377490942,1,1,0,914.94,1,78019.89,25,2,9,4,True
2872587,1398,4,-1,9085,377490942,1,2,0,915.13,4,78019.89,24,5,1,4,True
2890557,594,0,10,4972,377490942,1,0,0,914.99,0,78934.88,24,2,12,4,True
2891434,1110,0,10,2157,377490942,1,0,0,914.83,0,79849.71,0,4,18,5,True
2978550,1152,0,20,7381,377490942,1,0,0,915.17,3,78934.54,15,5,11,7,True
3347901,1399,0,451,6239,377490942,1,0,0,914.89,7,78019.65,24,6,18,8,False
3491325,613,4,-1,8552,377490942,1,1,0,914.86,4,78019.65,11,6,21,9,True
3623950,1044,0,25,8267,377490942,1,0,0,914.97,8,77104.68,11,3,23,9,True
3724188,1398,4,-1,4972,377490942,1,1,0,915.05,4,77104.68,24,4,2,9,True
3793298,1044,0,30,2476,377490942,1,0,0,914.67,8,76190.01,11,0,10,9,True
3830381,1398,4,451,2057,377490942,1,0,0,914.93,7,75275.08,24,1,21,11,True
3883332,909,2,-1,7571,377490942,1,1,0,915.03,1,75275.08,18,4,20,12,True
4057456,1090,0,10,8552,377490942,1,0,0,915.28,6,76190.36,18,5,8,12,True
4149807,71,1,10,4972,377490942,1,0,0,914.87,6,77105.23,20,4,23,12,True
4440078,909,2,30,2360,377490942,1,0,0,915.19,8,76190.04,18,6,7,1,True
4515815,476,1,10,5824,377490942,1,0,0,914.94,0,77104.98,5,6,9,1,True
4886376,289,4,30,2455,377490942,1,0,0,914.88,8,76190.1,24,3,9,2,True
5008523,998,0,20,3837,377490942,1,0,0,915.05,5,75275.05,26,1,2,2,True
5014337,1399,0,451,7381,377490942,1,0,0,914.8,7,74360.25,24,4,8,3,True
5077526,1140,0,30,6239,377490942,1,0,0,914.92,8,73445.33,15,6,6,5,True
5246920,1398,4,451,8895,377490942,1,0,0,915.0,7,72530.33,24,4,11,6,True
5345270,1399,0,-1,8963,377490942,1,1,0,915.0,1,72530.33,24,4,17,7,True
5368580,1359,2,20,3484,377490942,1,0,0,915.2,5,71615.13,24,0,13,7,True
5621196,1044,0,30,6418,377490942,1,0,0,915.16,8,70699.97,11,4,6,8,True
5665172,1044,0,30,3837,377490942,1,0,0,915.07,8,69784.9,11,0,5,10,True
5832616,370,4,30,4668,377490942,1,0,0,914.99,8,68869.91,25,5,23,10,True
6169477,1446,1,10,6418,377490942,1,0,0,915.01,6,69784.92,24,6,19,11,True
6248199,641,0,20,8963,377490942,1,0,0,915.05,5,68869.87,24,1,9,11,True
6325333,909,2,451,7381,377490942,1,0,0,914.75,7,67955.12,18,0,0,1,True
6353592,613,4,451,6152,377490942,1,0,0,915.22,7,67039.9,11,1,7,1,True
6411378,370,4,25,8267,377490942,1,0,0,915.01,8,66124.89,25,2,1,2,True
6460026,370,4,-1,8895,377490942,1,1,0,914.88,1,66124.89,25,0,4,3,True
6573332,1044,0,30,8267,377490942,1,0,0,914.92,8,65209.97,11,4,20,3,True
6655793,370,4,30,3484,377490942,1,0,0,915.16,8,64294.81,25,4,7,4,True
6885106,1399,0,25,2057,377490942,1,0,0,914.95,8,63379.86,24,0,0,4,True
7081460,1398,4,451,9332,377490942,1,0,0,915.06,7,62464.8,24,6,8,5,True
7163229,429,0,10,9332,377490942,1,0,0,914.8,6,63379.6,24,2,22,5,True
8132461,1271,0,10,6815,377490942,1,0,0,915.09,6,64294.69,23,6,2,5,True
8236999,370,4,25,6239,377490942,1,0,0,915.35,8,63379.34,25,6,17,6,True
8588652,1044,0,451,8267,377490942,1,0,0,914.78,7,62464.56,11,3,22,7,True
8745478,613,4,30,8552,377490942,1,0,0,914.94,8,61549.62,11,0,2,9,True
8772463,909,2,-1,1049,377490942,1,1,0,915.25,4,61549.62,18,4,4,9,True
9269683,1398,4,451,4668,377490942,1,0,0,914.82,7,60634.8,24,5,8,10,True
9320359,289,4,451,6418,377490942,1,0,0,914.9,7,59719.9,24,1,12,11,True
1442425,1233,0,20,4991,640012988,1,0,0,476.28,5,678689.72,18,1,21,1,True
1514244,222,2,451,4818,640012988,1,0,0,476.16,7,678213.56,26,5,20,1,True
1562605,844,1,451,8608,640012988,1,0,0,476.19,7,677737.37,5,1,3,2,True
1795797,1318,0,10,4818,640012988,1,0,0,475.96,6,678213.33,18,3,16,2,True
2066496,1380,0,30,2231,640012988,1,0,0,475.89,8,677737.44,16,2,1,2,True
2477291,831,1,10,4306,640012988,1,0,0,475.9,6,678213.34,5,4,9,6,True
2499676,998,0,30,4306,640012988,1,0,0,475.99,8,677737.35,26,6,18,7,True
2689537,1306,4,-1,6764,640012988,1,1,0,476.12,1,677737.35,5,5,2,7,True
2705222,998,0,10,2295,640012988,1,0,0,476.07,0,678213.42,26,2,8,8,True
2719721,85,2,30,2295,640012988,1,0,0,476.09,8,677737.33,1,2,10,8,True
2811339,398,0,-1,1576,640012988,1,1,0,476.01,1,677737.33,10,1,12,9,True
3404866,1380,0,451,2295,640012988,1,0,0,475.95,7,677261.38,16,6,15,10,True
3853605,712,0,10,9699,640012988,1,0,0,476.05,6,677737.43,18,3,22,10,True
3961377,998,0,25,2231,640012988,1,0,0,475.77,8,677261.66,26,5,3,11,True
4014364,416,2,20,4306,640012988,1,0,0,475.91,3,676785.75,18,2,0,11,True
4349963,1306,4,25,1576,640012988,1,0,0,475.84,8,676309.91,5,5,17,12,True
4352162,85,2,-1,2872,640012988,1,1,0,476.18,4,676309.91,1,5,3,12,True
4559503,222,2,451,4991,640012988,1,0,0,476.06,7,675833.85,26,0,1,12,True
4571287,398,0,-1,1309,640012988,1,1,0,476.05,1,675833.85,10,3,15,12,True
4680275,573,0,10,1576,640012988,1,0,0,475.89,6,676309.74,11,4,14,1,True
4838445,715,0,30,4818,640012988,1,0,0,475.83,8,675833.91,18,0,6,2,True
5033441,715,0,451,5757,640012988,1,0,0,476.06,7,675357.85,18,0,7,2,False
5182819,199,0,10,9727,640012988,1,0,0,475.77,6,675833.62,18,0,18,2,True
5195738,222,2,30,6806,640012988,1,0,0,475.99,8,675357.63,26,3,17,3,True
5207397,998,0,-1,5757,640012988,1,1,0,476.13,1,675357.63,26,2,2,3,True
5556325,378,0,10,1309,640012988,1,0,0,475.81,6,675833.44,25,4,15,3,False
6010220,85,2,451,7292,640012988,1,0,0,475.89,7,675357.55,1,0,3,3,True
6203281,222,2,451,2287,640012988,1,0,0,475.76,7,674881.79,26,2,8,4,True
6231487,739,1,10,1576,640012988,1,0,0,476.05,6,675357.84,24,4,11,5,True
6699125,360,0,20,1309,640012988,1,0,0,476.17,5,674881.67,24,6,0,5,True
6713219,1173,1,10,8537,640012988,1,0,0,475.83,6,675357.5,24,0,14,5,True
6771602,715,0,451,6806,640012988,1,0,0,476.27,7,674881.23,18,0,16,6,True
6892087,471,0,10,2295,640012988,1,0,0,475.8,6,675357.03,5,2,3,7,True
7103636,715,0,30,5148,640012988,1,0,0,476.12,8,674880.91,18,2,19,8,True
7575779,222,2,451,5148,640012988,1,0,0,475.81,7,674405.1,26,4,2,9,True
7816139,844,1,-1,1576,640012988,1,1,0,475.87,4,674405.1,5,3,22,10,True
7893683,715,0,451,5757,640012988,1,0,0,476.03,7,673929.07,18,1,23,10,True
8314690,1380,0,25,7292,640012988,1,0,0,476.1,8,673452.97,16,2,15,11,True
8367903,696,2,20,1309,640012988,1,0,0,475.88,5,672977.09,24,1,16,5,True
8485234,1380,0,451,4306,640012988,1,0,0,475.94,7,672501.15,16,5,17,5,True
8537899,998,0,451,4818,640012988,1,0,0,476.13,7,672025.02,26,2,2,6,True
8936259,398,0,30,6806,640012988,1,0,0,476.02,8,671549.0,10,1,13,6,True
9099986,1306,4,451,5148,640012988,1,0,0,476.13,7,671072.87,5,0,2,7,True
9106304,85,2,451,9727,640012988,1,0,0,475.95,7,670596.92,1,5,0,7,True
9398587,715,0,-1,2548,640012988,1,1,0,476.08,4,670596.92,18,3,23,8,True
9411644,652,0,20,9699,640012988,1,0,0,476.2,5,670120.72,24,6,0,8,True
9603742,398,0,25,6806,640012988,1,0,0,475.94,8,669644.78,10,2,0,9,True
9700705,85,2,25,2231,640012988,1,0,0,475.65,8,669169.13,1,2,2,9,True
9813646,98,0,20,7278,640012988,1,0,0,475.99,5,668693.14,3,5,14,9,True
9817999,998,0,451,9699,640012988,1,0,0,475.93,7,668217.21,26,3,19,10,True
9934129,715,0,-1,4306,640012988,1,1,0,476.09,4,668217.21,18,6,1,11,True
1148406,115,2,25,8710,310951145,0,0,0,1025.78,8,237801.22,3,5,23,1,True
1739561,666,4,451,3916,310951145,0,0,0,1026.32,7,236774.9,18,2,3,1,True
2101637,21,0,30,6357,310951145,0,0,0,1025.8,8,235749.1,11,6,10,1,True
2178003,21,0,30,9786,310951145,0,0,0,1025.69,8,234723.41,11,4,11,3,True
2752992,1287,4,25,5424,310951145,0,0,0,1025.81,8,233697.6,24,3,14,4,True
3111132,666,4,30,3405,310951145,0,0,0,1025.9,8,232671.7,18,0,12,5,True
3210529,1287,4,451,5277,310951145,0,0,0,1026.11,7,231645.59,24,6,9,8,True
3281433,583,2,20,6357,310951145,0,0,0,1025.9,5,230619.69,11,5,13,8,True
3544969,115,2,25,1404,310951145,0,0,0,1026.28,8,229593.41,3,6,11,9,True
3564351,666,4,-1,4511,310951145,0,1,0,1026.15,1,229593.41,18,1,2,9,True
3712178,1287,4,451,7322,310951145,0,0,0,1026.0,7,228567.41,24,5,11,10,True
3759819,21,0,30,8161,310951145,0,0,0,1025.9,8,227541.51,11,6,10,2,True
3930340,1271,0,20,9724,310951145,0,0,0,1025.95,3,226515.56,23,3,23,3,True
4061883,666,4,451,3505,310951145,0,0,0,1025.86,7,225489.7,18,2,18,6,True
4087626,698,4,451,4993,310951145,0,0,0,1026.14,7,224463.56,18,6,17,8,True
4099794,716,0,20,1715,310951145,0,0,0,1025.97,5,223437.59,18,1,1,8,True
4440928,698,4,451,3405,310951145,0,0,0,1025.92,7,222411.67,18,1,4,9,True
4457595,114,0,10,5424,310951145,0,0,0,1025.95,6,223437.62,3,1,8,9,True
4635208,882,0,20,4160,310951145,0,0,0,1025.94,5,222411.68,27,3,8,11,False
4643262,1287,4,451,3916,310951145,0,0,0,1025.98,7,221385.7,24,0,19,3,True
4667394,1287,4,451,3916,310951145,0,0,0,1025.83,7,220359.87,24,6,20,5,True
4749152,538,0,10,1404,310951145,0,0,0,1025.87,0,221385.74,18,1,6,5,True
4759588,115,2,25,9786,310951145,0,0,0,1026.05,8,220359.69,3,3,13,5,True
4825691,309,0,20,6543,310951145,0,0,0,1025.89,5,219333.8,4,5,10,6,True
4915546,666,4,-1,5277,310951145,0,1,0,1025.96,1,219333.8,18,5,0,8,True
5170837,666,4,-1,1715,310951145,0,2,0,1025.77,4,219333.8,18,2,9,9,True
5502365,1434,0,10,5277,310951145,0,0,0,1025.79,0,220359.59,24,1,5,10,True
5679544,195,1,10,2203,310951145,0,0,0,1025.85,6,221385.44,18,2,23,10,True
5792005,115,2,-1,4993,310951145,0,1,0,1026.01,4,221385.44,3,4,12,10,True
5871913,666,4,-1,1715,310951145,0,2,0,1025.96,1,221385.44,18,3,5,10,True
5880599,1287,4,-1,9786,310951145,0,3,1,1026.01,1,0.0,24,6,12,11,True
1124749,291,3,30,5070,836536926,0,0,0,1150.02,8,506188.98,24,1,21,1,True
1235438,534,4,451,4808,836536926,0,0,0,1149.81,7,505039.17,18,5,9,1,False
1550592,266,2,20,2171,836536926,0,0,0,1149.78,3,503889.39,6,0,10,2,False
2120087,393,1,10,5344,836536926,0,0,0,1149.95,6,505039.34,10,5,17,2,True
2150761,665,2,-1,5017,836536926,0,1,0,1149.79,1,505039.34,18,3,16,3,True
2302638,420,4,30,5071,836536926,0,0,0,1149.99,8,503889.35,18,3,3,4,True
2696277,665,2,30,6824,836536926,0,0,0,1149.96,8,502739.39,18,0,10,4,True
2886758,339,4,451,6525,836536926,0,0,0,1150.14,7,501589.25,11,3,7,5,True
3059422,857,1,25,5344,836536926,0,0,0,1150.08,8,500439.17,24,0,1,6,True
3444385,1238,0,20,5017,836536926,0,0,0,1150.29,3,499288.88,18,1,12,6,True
3867983,857,1,-1,3282,836536926,0,1,0,1149.78,4,499288.88,24,2,23,7,True
3893496,420,4,25,9143,836536926,0,0,0,1150.11,8,498138.77,18,6,20,7,True
3966460,339,4,-1,5071,836536926,0,1,0,1149.8,1,498138.77,11,5,21,8,True
4384240,420,4,451,4403,836536926,0,0,0,1150.14,7,496988.63,18,0,13,8,True
4581683,339,4,451,5071,836536926,0,0,0,1149.85,7,495838.78,11,5,5,8,True
4874194,857,1,-1,6525,836536926,0,1,0,1149.91,4,495838.78,24,1,0,8,True
5214149,339,4,30,3730,836536926,0,0,0,1149.76,8,494689.02,11,6,1,9,True
5355781,665,2,30,4403,836536926,0,0,0,1149.93,8,493539.09,18,2,3,9,True
5373287,665,2,451,9107,836536926,0,0,0,1149.99,7,492389.1,18,3,4,10,True
5398674,201,1,10,2841,836536926,0,0,0,1149.85,0,493538.95,9,1,21,10,True
5485977,956,1,10,9136,836536926,0,0,0,1150.28,6,494689.23,13,6,12,10,True
5749658,75,3,25,7642,836536926,0,0,0,1149.71,8,493539.52,20,6,22,10,True
6068585,1035,0,20,6295,836536926,0,0,0,1149.81,3,492389.71,11,3,12,11,True
6352446,1205,0,10,9136,836536926,0,0,0,1150.16,0,493539.87,24,6,0,12,True
6617539,64,0,10,5071,836536926,0,0,0,1149.94,6,494689.81,20,6,17,12,True
6667410,854,0,20,5071,836536926,0,0,0,1149.78,5,493540.03,24,5,4,2,True
6680010,75,3,30,9136,836536926,0,0,0,1150.01,8,492390.02,20,5,16,2,True
6762250,420,4,30,3730,836536926,0,0,0,1149.98,8,491240.04,18,6,5,3,True
6920534,534,4,451,9143,836536926,0,0,0,1150.05,7,490089.99,18,3,15,4,True
6968027,1127,0,10,5344,836536926,0,0,0,1150.02,6,491240.01,24,4,11,5,True
7106173,857,1,451,2841,836536926,0,0,0,1150.09,7,490089.92,24,1,7,5,True
7147255,339,4,25,7642,836536926,0,0,0,1149.9,8,488940.02,11,4,1,5,True
7437371,950,0,10,7804,836536926,0,0,0,1150.28,6,490090.3,24,4,21,6,True
7504795,534,4,25,9107,836536926,0,0,0,1150.0,8,488940.3,18,4,3,6,True
7844931,420,4,25,6525,836536926,0,0,0,1149.9,8,487790.4,18,3,9,10,True
7852608,534,4,451,5017,836536926,0,0,0,1149.87,7,486640.53,18,2,14,10,True
8077005,1192,2,20,5070,836536926,0,0,0,1149.93,3,485490.6,24,3,12,11,True
8159035,420,4,451,5071,836536926,0,0,0,1149.97,7,484340.63,18,6,14,12,True
8221862,849,1,10,8463,836536926,0,0,0,1150.1,0,485490.73,5,2,5,12,True
8259927,1050,4,451,7804,836536926,0,0,0,1149.94,7,484340.79,11,2,18,12,True
8441238,727,0,10,3730,836536926,0,0,0,1149.89,0,485490.68,11,5,12,12,True
8467114,291,3,451,9143,836536926,0,0,0,1149.86,7,484340.82,24,3,4,1,True
8500195,665,2,30,5344,836536926,0,0,0,1150.34,8,483190.48,18,4,11,1,True
8570316,75,3,451,8463,836536926,0,0,0,1150.01,7,482040.47,20,5,9,2,True
8689839,665,2,30,7372,836536926,0,0,0,1149.79,8,480890.68,18,3,11,2,True
8953944,665,2,25,9107,836536926,0,0,0,1149.88,8,479740.8,18,4,18,2,True
9127219,420,4,451,9143,836536926,0,0,0,1149.97,7,478590.83,18,3,7,3,False
9227698,291,3,451,5070,836536926,0,0,0,1150.14,7,477440.69,24,5,20,4,True
9403946,75,3,30,4403,836536926,0,0,0,1150.2,8,476290.49,20,0,23,6,True
9489986,398,0,20,9143,836536926,0,0,0,1149.83,5,475140.66,10,1,13,8,True
9532666,665,2,25,6295,836536926,0,0,0,1150.14,8,473990.52,18,6,22,9,True
9659343,511,1,10,5344,836536926,0,0,0,1149.8,6,475140.32,12,4,13,9,True
9671517,312,0,20,5071,836536926,0,0,0,1149.77,3,473990.55,4,4,9,10,True
9745024,857,1,451,9107,836536926,0,0,0,1150.06,7,472840.49,24,6,23,10,True
9778163,1111,0,10,2171,836536926,0,0,0,1150.03,6,473990.52,0,1,6,10,True
9820761,75,3,30,4403,836536926,0,0,0,1149.92,8,472840.6,20,0,20,11,True
9857300,353,1,10,6824,836536926,0,0,0,1150.12,6,473990.72,24,6,17,11,True
1137006,633,4,-1,6537,590833996,1,1,0,1007.09,1,144940.0,11,3,3,1,False
1316582,544,3,30,7615,590833996,1,0,0,1007.23,8,143932.77,17,2,7,2,True
1348613,594,0,10,8047,590833996,1,0,0,1007.09,6,144939.86,24,1,4,2,True
1409074,1377,0,10,1682,590833996,1,0,0,1006.71,6,145946.57,16,2,21,2,True
1758138,633,4,25,2305,590833996,1,0,0,1006.98,8,144939.59,11,3,0,3,True
1901829,1093,0,451,1682,590833996,1,0,0,1006.81,7,143932.78,18,5,16,4,True
2117174,1351,4,-1,2305,590833996,1,1,0,1006.92,4,143932.78,24,2,3,4,True
2259560,1034,1,25,8047,590833996,1,0,0,1006.95,8,142925.83,11,0,23,4,True
2357220,1351,4,30,7615,590833996,1,0,0,1006.99,8,141918.84,24,0,11,5,True
2549340,1034,1,25,9279,590833996,1,0,0,1007.22,8,140911.62,11,6,20,5,True
2713479,1351,4,25,3492,590833996,1,0,0,1007.03,8,139904.59,24,0,0,5,True
2851134,1155,0,10,3121,590833996,1,0,0,1007.06,6,140911.65,15,0,2,6,True
2932859,1034,1,30,7309,590833996,1,0,0,1007.01,8,139904.64,11,1,14,6,True
2979909,544,3,451,1682,590833996,1,0,0,1006.87,7,138897.77,17,2,5,8,True
3053874,1093,0,451,8047,590833996,1,0,0,1006.91,7,137890.86,18,3,18,9,False
3138641,783,0,-1,6537,590833996,1,1,0,1006.9,4,137890.86,14,2,22,10,True
3336031,783,0,451,9279,590833996,1,0,0,1007.22,7,136883.64,14,1,13,11,True
3718703,312,0,20,6682,590833996,1,0,0,1007.17,5,135876.47,4,2,23,11,True
3774676,783,0,25,8047,590833996,1,0,0,1006.82,8,134869.65,14,0,21,3,True
4062344,783,0,30,3195,590833996,1,0,0,1007.09,8,133862.56,14,5,17,3,True
4234617,633,4,25,6537,590833996,1,0,0,1007.12,8,132855.44,11,5,11,4,True
4399289,1351,4,30,7615,590833996,1,0,0,1006.78,8,131848.66,24,1,7,4,True
4480220,498,0,10,2978,590833996,1,0,0,1006.88,0,132855.54,12,4,19,4,True
4627242,184,0,10,4835,590833996,1,0,0,1007.05,0,133862.59,18,0,11,6,True
4712366,783,0,-1,8397,590833996,1,1,0,1007.12,4,133862.59,14,3,16,6,True
4713349,1351,4,-1,8397,590833996,1,2,0,1007.08,4,133862.59,24,6,20,6,True
5003882,1076,1,10,7386,590833996,1,0,0,1007.07,6,134869.66,18,4,2,7,True
5062576,628,0,10,6537,590833996,1,0,0,1007.08,6,135876.74,11,3,0,8,True
5161896,1351,4,30,5120,590833996,1,0,0,1006.99,8,134869.75,24,3,2,9,True
5352588,463,1,10,4835,590833996,1,0,0,1007.16,6,135876.91,13,3,20,9,True
5545833,544,3,451,6682,590833996,1,0,0,1007.14,7,134869.77,17,6,22,10,True
5719688,544,3,451,1682,590833996,1,0,0,1006.93,7,133862.84,17,0,13,10,True
5827215,1351,4,30,4748,590833996,1,0,0,1007.03,8,132855.81,24,2,22,10,True
5890507,444,2,20,8047,590833996,1,0,0,1007.0,3,131848.81,24,4,10,10,True
6051503,85,2,20,6682,590833996,1,0,0,1007.06,5,130841.75,1,2,5,11,True
6068665,633,4,451,7615,590833996,1,0,0,1006.98,7,129834.77,11,2,13,11,True
6168123,1351,4,30,7615,590833996,1,0,0,1006.97,8,128827.8,24,0,16,11,True
6496147,644,0,20,1803,590833996,1,0,0,1007.16,3,127820.64,24,0,2,1,True
6554923,1034,1,451,4177,590833996,1,0,0,1007.05,7,126813.59,11,3,19,2,True
6616943,1034,1,25,8397,590833996,1,0,0,1007.1,8,125806.49,11,5,2,2,True
6631281,544,3,30,8047,590833996,1,0,0,1006.87,8,124799.62,17,6,6,2,True
6793454,783,0,451,8893,590833996,1,0,0,1006.81,7,123792.81,14,2,6,3,True
6939321,783,0,-1,7615,590833996,1,1,0,1007.02,4,123792.81,14,0,14,3,True
7659888,783,0,30,6911,590833996,1,0,0,1006.98,8,122785.83,14,6,20,3,True
7740581,633,4,451,8047,590833996,1,0,0,1006.93,7,121778.9,11,0,7,4,True
7885662,1093,0,30,6682,590833996,1,0,0,1006.96,8,120771.94,18,2,22,5,True
8701191,967,1,10,2305,590833996,1,0,0,1007.22,6,121779.16,13,3,10,6,True
9121779,1015,0,20,7386,590833996,1,0,0,1006.97,5,120772.19,26,4,2,6,True
9133872,498,0,20,1803,590833996,1,0,0,1006.76,3,119765.43,12,1,19,7,True
9160006,1388,1,10,3492,590833996,1,0,0,1006.89,6,120772.32,24,5,14,7,True
9192176,544,3,-1,6911,590833996,1,1,0,1007.01,1,120772.32,17,5,17,8,True
9480852,1102,2,20,2305,590833996,1,0,0,1007.05,5,119765.27,0,1,14,10,True
9513238,1093,0,451,3195,590833996,1,0,0,1006.79,7,118758.48,18,2,7,10,True
9688834,1351,4,451,1218,590833996,1,0,0,1007.03,7,117751.45,24,3,22,10,True
9726688,1093,0,451,2305,590833996,1,0,0,1006.98,7,116744.47,18,3,23,11,True
1284543,920,4,451,1290,319177944,0,0,0,899.88,7,383974.12,18,6,8,1,True
1291471,1205,0,451,3214,319177944,0,0,0,899.89,7,383074.23,24,0,19,1,True
1365388,1277,2,25,8569,319177944,0,0,0,900.16,8,382174.07,24,1,4,1,True
1738402,328,0,20,1290,319177944,0,0,0,899.84,5,381274.23,11,1,16,1,True
2009352,1205,0,451,3991,319177944,0,0,0,899.96,7,380374.27,24,3,22,3,True
2023821,627,0,-1,1841,319177944,0,1,0,899.69,4,380374.27,11,0,12,4,True
2029341,34,1,25,2871,319177944,0,0,0,900.11,8,379474.16,11,0,16,5,True
2371893,920,4,451,7470,319177944,0,0,0,900.16,7,378574.0,18,1,21,5,True
2751924,385,1,25,1086,319177944,0,0,0,900.55,8,377673.45,25,3,19,5,True
2840988,627,0,451,3991,319177944,0,0,0,900.23,7,376773.22,11,6,11,7,True
2977513,920,4,-1,4104,319177944,0,1,0,899.97,1,376773.22,18,2,17,7,True
3010637,1252,4,451,4104,319177944,0,0,0,899.86,7,375873.36,23,3,22,7,True
3463949,1205,0,30,5896,319177944,0,0,0,900.02,8,374973.34,24,4,15,7,True
3520368,920,4,451,8931,319177944,0,0,0,900.34,7,374073.0,18,3,20,8,True
3796404,1252,4,30,4955,319177944,0,0,0,899.95,8,373173.05,23,6,17,8,True
4088902,1252,4,25,5040,319177944,0,0,0,900.06,8,372272.99,23,2,23,8,True
4266156,385,1,-1,1841,319177944,0,1,0,900.07,4,372272.99,25,5,4,9,False
4883062,37,3,451,2871,319177944,0,0,0,899.94,7,371373.05,11,5,18,9,False
4955545,1354,0,10,1290,319177944,0,0,0,899.72,0,372272.77,24,5,18,10,True
5064532,1211,4,451,4805,319177944,0,0,0,899.96,7,371372.81,24,5,16,10,False
5230579,920,4,30,3308,319177944,0,0,0,899.91,8,370472.9,18,6,18,11,True
5281018,1211,4,451,5183,319177944,0,0,0,899.75,7,369573.15,24,4,21,12,True
5704764,1252,4,30,8980,319177944,0,0,0,899.92,8,368673.23,23,6,3,1,True
5778530,1211,4,30,1869,319177944,0,0,0,899.99,8,367773.24,24,0,8,1,True
6283965,385,1,25,1869,319177944,0,0,0,900.06,8,366873.18,25,0,16,1,True
6316580,385,1,451,8569,319177944,0,0,0,899.86,7,365973.32,25,3,1,2,True
6361450,627,0,451,5896,319177944,0,0,0,900.06,7,365073.26,11,5,18,4,True
6513527,1211,4,451,3213,319177944,0,0,0,900.03,7,364173.23,24,1,9,5,True
6584842,37,3,-1,8980,319177944,0,1,0,899.96,4,364173.23,11,3,0,6,True
6663566,599,0,20,6345,319177944,0,0,0,899.92,3,363273.31,24,2,5,7,True
6896519,627,0,451,1919,319177944,0,0,0,900.07,7,362373.24,11,5,21,8,True
7014982,37,3,451,1841,319177944,0,0,0,900.06,7,361473.18,11,0,6,9,True
7155747,37,3,25,5896,319177944,0,0,0,900.22,8,360572.96,11,2,21,9,True
7614936,920,4,30,2871,319177944,0,0,0,900.18,8,359672.78,18,0,19,10,True
7683273,443,2,20,4474,319177944,0,0,0,900.15,3,358772.63,24,6,22,10,True
7708231,1179,0,20,3214,319177944,0,0,0,900.37,3,357872.26,24,0,13,10,True
7712162,1192,2,20,5896,319177944,0,0,0,900.02,5,356972.24,24,1,6,10,True
7820730,1201,0,20,8931,319177944,0,0,0,899.9,5,356072.34,24,4,2,11,True
7848058,97,0,20,3308,319177944,0,0,0,900.23,5,355172.11,3,2,17,11,True
7899709,37,3,-1,5315,319177944,0,1,0,900.12,4,355172.11,11,0,13,11,True
8201138,1277,2,30,8569,319177944,0,0,0,899.74,8,354272.37,24,1,5,12,True
8302719,1252,4,451,3991,319177944,0,0,0,899.94,7,353372.43,23,5,20,1,True
8341530,1262,0,10,4955,319177944,0,0,0,899.81,6,354272.24,23,0,1,2,True
8812247,1205,0,30,8569,319177944,0,0,0,900.11,8,353372.13,24,5,8,4,True
8946853,37,3,451,1841,319177944,0,0,0,899.87,7,352472.26,11,4,9,4,True
8961828,37,3,-1,1841,319177944,0,1,0,899.91,1,352472.26,11,5,20,6,True
9049178,1252,4,-1,5040,319177944,0,2,0,900.01,1,352472.26,23,3,23,7,True
9131101,27,0,20,1086,319177944,0,0,0,899.8,3,351572.46,11,4,4,7,True
9553938,1211,4,25,5183,319177944,0,0,0,899.85,8,350672.61,24,5,2,10,True
9592144,627,0,451,5183,319177944,0,0,0,900.04,7,349772.57,11,4,20,11,True
9663821,198,0,20,3213,319177944,0,0,0,899.99,3,348872.58,18,0,2,11,True
1032024,1214,4,451,8924,401725586,1,0,0,481.92,7,573872.08,24,0,4,1,True
1087426,48,4,-1,3823,401725586,1,1,0,481.95,1,573872.08,24,4,9,1,True
1112215,1214,4,-1,4084,401725586,1,2,0,482.17,1,573872.08,24,3,1,1,True
1122719,1390,0,20,9312,401725586,1,0,0,482.1,3,573389.98,24,3,12,1,True
1228326,557,1,10,3823,401725586,1,0,0,482.0,6,573871.98,17,6,3,1,True
1472784,443,2,20,7276,401725586,1,0,0,481.78,5,573390.2,24,3,13,3,True
1866303,200,0,20,7276,401725586,1,0,0,481.63,5,572908.57,9,1,20,4,True
2103386,797,3,30,5230,401725586,1,0,0,482.22,8,572426.35,11,6,18,4,True
2477642,481,3,451,3997,401725586,1,0,0,481.98,7,571944.37,5,2,4,5,True
2543937,48,4,-1,4084,401725586,1,1,0,482.03,4,571944.37,24,6,2,5,True
2639482,499,3,30,9324,401725586,1,0,0,482.08,8,571462.29,12,1,9,5,True
2969135,1070,4,30,8924,401725586,1,0,0,482.11,8,570980.18,18,0,23,6,True
3802370,797,3,451,5821,401725586,1,0,0,481.8,7,570498.38,11,3,15,7,True
3877813,405,4,25,7606,401725586,1,0,0,482.01,8,570016.37,10,4,9,7,True
3918727,1214,4,25,5673,401725586,1,0,0,482.06,8,569534.31,24,0,1,9,True
4015279,1214,4,451,8924,401725586,1,0,0,481.85,7,569052.46,24,2,2,9,False
4440316,481,3,-1,5673,401725586,1,1,0,482.03,1,569052.46,5,1,12,10,False
4629290,234,0,20,6672,401725586,1,0,0,481.89,5,568570.57,26,5,1,10,True
4675034,907,0,10,7245,401725586,1,0,0,482.05,6,569052.62,2,6,19,10,True
4793406,499,3,-1,2243,401725586,1,1,0,482.11,1,569052.62,12,0,6,10,True
5070538,325,0,20,5821,401725586,1,0,0,482.1,5,568570.52,11,4,7,10,True
5215628,405,4,25,6453,401725586,1,0,0,481.88,8,568088.64,10,6,19,12,True
5224887,1025,1,30,4781,401725586,1,0,0,482.05,8,567606.59,11,4,14,12,True
5406386,48,4,25,4781,401725586,1,0,0,481.93,8,567124.66,24,1,3,12,True
5456159,429,0,10,4781,401725586,1,0,0,482.0,0,567606.66,24,4,10,1,True
5565537,1025,1,25,1436,401725586,1,0,0,481.77,8,567124.89,11,6,9,1,True
6031308,677,0,20,3033,401725586,1,0,0,482.13,5,566642.76,24,3,17,2,True
6398765,790,0,20,5607,401725586,1,0,0,481.87,5,566160.89,11,4,9,2,True
6403025,499,3,451,3997,401725586,1,0,0,481.97,7,565678.92,12,5,12,2,True
6498100,467,0,20,5607,401725586,1,0,0,482.25,5,565196.67,5,1,4,5,True
6537624,48,4,30,2243,401725586,1,0,0,482.18,8,564714.49,24,0,21,5,True
6633979,797,3,451,5821,401725586,1,0,0,482.22,7,564232.27,11,6,16,7,True
7055634,319,0,20,5110,401725586,1,0,0,482.25,5,563750.02,11,0,5,7,True
7398375,797,3,451,2243,401725586,1,0,0,481.9,7,563268.12,11,5,8,8,True
7497464,1214,4,-1,3997,401725586,1,1,0,482.18,1,563268.12,24,6,5,8,True
7807602,1070,4,451,3997,401725586,1,0,0,482.18,7,562785.94,18,0,12,9,True
7926129,198,0,20,3997,401725586,1,0,0,482.05,5,562303.89,18,3,17,11,True
8058659,48,4,-1,9130,401725586,1,1,0,481.76,4,562303.89,24,2,10,11,True
8327845,1025,1,30,6672,401725586,1,0,0,482.04,8,561821.85,11,4,14,1,True
8350926,1025,1,451,5607,401725586,1,0,0,481.85,7,561340.0,11,0,13,2,True
8385747,481,3,451,8537,401725586,1,0,0,481.97,7,560858.03,5,1,16,2,True
8548929,1214,4,25,2388,401725586,1,0,0,482.14,8,560375.89,24,6,14,3,True
8707852,1214,4,451,5110,401725586,1,0,0,482.19,7,559893.7,24,0,12,3,True
8903033,14,2,20,2243,401725586,1,0,0,482.08,3,559411.62,24,2,18,3,True
8904245,1070,4,30,7276,401725586,1,0,0,481.66,8,558929.96,18,6,5,5,True
9217408,797,3,451,5230,401725586,1,0,0,481.88,7,558448.08,11,0,11,5,True
9603351,1214,4,25,9130,401725586,1,0,0,482.09,8,557965.99,24,0,9,8,True
9624434,215,0,20,3033,401725586,1,0,0,482.06,5,557483.93,9,3,7,8,True
9723822,1070,4,30,6424,401725586,1,0,0,482.11,8,557001.82,18,1,18,10,True
9919625,916,0,20,5493,401725586,1,0,0,482.21,3,556519.61,18,5,20,11,True
1066356,178,4,451,9462,986635933,0,0,0,1187.94,7,256869.06,24,1,0,1,True
1110953,58,2,20,5463,986635933,0,0,0,1188.09,3,255680.97,20,5,14,1,True
1326069,1285,1,10,9098,986635933,0,0,0,1187.88,6,256868.85,24,6,21,1,True
1396223,1320,3,25,3091,986635933,0,0,0,1187.96,8,255680.89,18,2,11,2,True
1939465,1320,3,25,2983,986635933,0,0,0,1188.01,8,254492.88,18,6,3,3,True
1997448,523,2,25,2004,986635933,0,0,0,1188.08,8,253304.8,18,5,20,3,True
2079942,614,4,451,3392,986635933,0,0,0,1187.79,7,252117.01,11,4,0,3,True
2240624,114,0,20,5463,986635933,0,0,0,1188.04,3,250928.97,3,6,23,4,True
2474837,614,4,25,7986,986635933,0,0,0,1187.73,8,249741.24,11,3,3,6,True
2729455,614,4,451,2242,986635933,0,0,0,1188.2,7,248553.04,11,4,2,6,True
2755500,614,4,-1,9098,986635933,0,1,0,1188.28,4,248553.04,11,2,14,6,True
2771404,523,2,25,2101,986635933,0,0,0,1187.9,8,247365.14,18,1,3,7,True
2810081,178,4,451,3602,986635933,0,0,0,1188.16,7,246176.98,24,3,20,7,True
3114123,1336,2,-1,2983,986635933,0,1,0,1188.05,4,246176.98,18,3,1,8,True
3209687,523,2,451,2004,986635933,0,0,0,1188.18,7,244988.8,18,1,23,11,True
3218606,1336,2,451,7986,986635933,0,0,0,1188.2,7,243800.6,18,4,6,12,True
3420510,523,2,451,5212,986635933,0,0,0,1188.03,7,242612.57,18,4,17,12,True
3427766,712,0,10,1544,986635933,0,0,0,1188.05,0,243800.62,18,6,5,1,True
3467641,626,2,20,3392,986635933,0,0,0,1188.12,5,242612.5,11,5,4,1,True
3540885,1320,3,30,5212,986635933,0,0,0,1188.16,8,241424.34,18,4,7,1,False
3922362,1336,2,30,3392,986635933,0,0,0,1187.91,8,240236.43,18,6,9,2,True
4232941,523,2,451,9462,986635933,0,0,0,1188.2,7,239048.23,18,3,5,2,True
4299047,523,2,451,2242,986635933,0,0,0,1188.06,7,237860.17,18,2,6,3,True
4530170,716,0,20,2242,986635933,0,0,0,1187.93,5,236672.24,18,2,2,4,True
4660952,1256,2,20,3392,986635933,0,0,0,1188.27,3,235483.97,23,1,17,4,False
4701049,1336,2,25,2101,986635933,0,0,0,1188.04,8,234295.93,18,2,4,4,True
4883453,614,4,451,5463,986635933,0,0,0,1188.15,7,233107.78,11,5,6,5,True
5335936,879,1,10,2101,986635933,0,0,0,1187.87,6,234295.65,27,3,22,5,True
5340232,1336,2,451,5463,986635933,0,0,0,1187.81,7,233107.84,18,2,1,6,True
5421782,1336,2,25,5212,986635933,0,0,0,1187.64,8,231920.2,18,0,4,6,True
5706456,614,4,30,7001,986635933,0,0,0,1187.98,8,230732.22,11,3,0,6,True
5717358,1320,3,25,5463,986635933,0,0,0,1188.04,8,229544.18,18,2,23,7,True
5976217,523,2,30,2983,986635933,0,0,0,1188.0,8,228356.18,18,2,2,8,True
6030100,523,2,25,3091,986635933,0,0,0,1188.02,8,227168.16,18,3,13,9,True
6046670,178,4,30,7986,986635933,0,0,0,1188.11,8,225980.05,24,6,6,9,True
6234616,752,0,10,9098,986635933,0,0,0,1187.99,6,227168.04,24,6,14,9,True
6302405,523,2,-1,5689,986635933,0,1,0,1187.97,4,227168.04,18,2,10,9,True
6413294,1336,2,451,5689,986635933,0,0,0,1188.05,7,225979.99,18,3,2,9,True
6548207,614,4,-1,5689,986635933,0,1,0,1188.09,4,225979.99,11,4,7,10,True
6648847,1260,0,10,2101,986635933,0,0,0,1188.22,0,227168.21,23,2,14,11,True
7272631,1320,3,-1,7001,986635933,0,1,0,1188.16,4,227168.21,18,0,19,12,True
7521882,614,4,-1,1544,986635933,0,2,0,1188.2,1,227168.21,11,6,14,1,True
7524515,1320,3,30,2101,986635933,0,0,0,1187.82,8,225980.39,18,2,1,2,True
7696556,1090,0,10,5819,986635933,0,0,0,1187.75,0,227168.14,18,5,6,3,True
7785889,178,4,30,2831,986635933,0,0,0,1187.72,8,225980.42,24,1,13,3,True
7999421,914,2,20,3392,986635933,0,0,0,1188.28,3,224792.14,18,2,9,3,True
8321952,523,2,25,9098,986635933,0,0,0,1187.95,8,223604.19,18,6,2,4,True
8329307,1336,2,30,9098,986635933,0,0,0,1188.08,8,222416.11,18,2,13,5,True
8536850,1128,2,20,7001,986635933,0,0,0,1187.99,3,221228.12,24,4,0,7,True
8588438,614,4,451,5689,986635933,0,0,0,1187.73,7,220040.39,11,1,23,7,True
9174181,523,2,-1,2242,986635933,0,1,0,1187.96,4,220040.39,18,5,14,8,False
9318515,1336,2,25,5463,986635933,0,0,0,1187.95,8,218852.44,18,0,4,9,True
9433948,1336,2,30,5463,986635933,0,0,0,1187.96,8,217664.48,18,2,16,9,True
9537182,1320,3,-1,2004,986635933,0,1,0,1188.05,1,217664.48,18,2,2,9,True
9950874,350,0,10,5689,986635933,0,0,0,1187.93,6,218852.41,24,2,9,10,True
9993578,614,4,30,3392,986635933,0,0,0,1188.12,8,217664.29,11,2,0,10,True
1135881,1349,3,25,7966,111722266,0,0,0,708.28,8,380652.72,24,2,3,1,True
1192519,400,4,25,2907,111722266,0,0,0,707.77,8,379944.95,10,5,11,1,True
1251322,457,0,20,7996,111722266,0,0,0,708.05,5,379236.9,13,1,11,1,True
1312225,1169,0,10,7161,111722266,0,0,0,707.76,6,379944.66,24,4,11,2,True
1695220,907,0,451,6160,111722266,0,0,0,707.87,7,379236.79,2,6,15,2,True
2101082,907,0,451,5253,111722266,0,0,0,707.96,7,378528.83,2,3,0,2,True
2495962,1238,0,10,7966,111722266,0,0,0,707.92,6,379236.75,18,1,9,3,True
2673825,1317,4,25,6062,111722266,0,0,0,707.9,8,378528.85,18,3,7,4,True
3327053,1349,3,451,3115,111722266,0,0,0,707.8,7,377821.05,24,4,1,4,True
3923057,1285,1,10,7286,111722266,0,0,0,707.86,6,378528.91,24,4,12,5,True
4173696,509,0,10,7996,111722266,0,0,0,707.88,6,379236.79,12,1,10,5,True
4327258,907,0,25,5726,111722266,0,0,0,707.96,8,378528.83,2,0,4,8,True
4440419,1025,1,10,7025,111722266,0,0,0,708.08,0,379236.91,11,0,20,9,True
4456940,337,1,10,5726,111722266,0,0,0,708.03,0,379944.94,11,0,18,9,True
4509746,1349,3,25,1309,111722266,0,0,0,707.95,8,379236.99,24,0,23,9,True
4713264,1390,0,30,2238,111722266,0,0,0,707.8,8,378529.19,24,4,13,11,True
5075757,1317,4,-1,7996,111722266,0,1,0,708.1,4,378529.19,18,5,15,11,True
5095029,1390,0,25,9516,111722266,0,0,0,707.85,8,377821.34,24,2,19,11,True
5376202,907,0,451,1309,111722266,0,0,0,707.93,7,377113.41,2,4,6,12,True
5711572,511,1,10,9075,111722266,0,0,0,707.95,0,377821.36,12,5,16,12,True
6008410,944,2,30,7025,111722266,0,0,0,708.18,8,377113.18,24,2,21,1,True
6295937,689,0,20,6723,111722266,0,0,0,708.28,5,376404.9,24,3,13,2,True
6300158,400,4,451,3370,111722266,0,0,0,707.64,7,375697.26,10,5,1,3,True
6462070,1349,3,25,3370,111722266,0,0,0,707.9,8,374989.36,24,6,14,3,True
6501813,1317,4,-1,5774,111722266,0,1,0,708.02,1,374989.36,18,0,12,4,True
6692137,1317,4,451,8166,111722266,0,0,0,708.23,7,374281.13,18,5,1,5,True
6798885,944,2,25,1916,111722266,0,0,0,708.16,8,373572.97,24,0,22,5,True
6892758,1349,3,25,6160,111722266,0,0,0,708.1,8,372864.87,24,0,5,6,True
6893870,542,0,20,8799,111722266,0,0,0,707.94,5,372156.93,17,2,18,7,True
7102987,1186,2,20,3370,111722266,0,0,0,708.01,5,371448.92,24,4,21,8,True
7186316,998,0,20,5198,111722266,0,0,0,707.79,5,370741.13,26,6,15,8,True
7316357,944,2,-1,8799,111722266,0,1,0,708.08,4,370741.13,24,5,6,8,True
7331619,850,1,10,3548,111722266,0,0,0,708.09,6,371449.22,5,5,15,8,True
7530311,1317,4,-1,5726,111722266,0,1,0,708.06,1,371449.22,18,1,2,9,True
7928228,962,0,20,5774,111722266,0,0,0,708.09,5,370741.13,13,3,4,9,True
8063772,1317,4,25,1916,111722266,0,0,0,707.84,8,370033.29,18,5,23,9,True
8548281,1010,0,10,3370,111722266,0,0,0,708.1,0,370741.39,26,2,16,10,True
8615792,907,0,451,8799,111722266,0,0,0,708.25,7,370033.14,2,3,17,10,True
8659680,907,0,-1,7161,111722266,0,1,0,708.04,4,370033.14,2,4,20,10,True
8666980,1390,0,-1,2238,111722266,0,2,0,707.98,4,370033.14,24,3,23,10,True
8821137,1170,0,10,2581,111722266,0,0,0,707.87,0,370741.01,24,2,23,11,True
8867602,350,0,20,2581,111722266,0,0,0,707.95,5,370033.06,24,4,17,11,True
8869539,917,0,10,5726,111722266,0,0,0,708.24,0,370741.3,18,4,23,12,True
8924345,400,4,25,1855,111722266,0,0,0,707.75,8,370033.55,10,2,7,12,True
8965599,944,2,451,5198,111722266,0,0,0,707.97,7,369325.58,24,5,3,1,True
9035706,1317,4,30,1309,111722266,0,0,0,707.79,8,368617.79,18,2,10,4,True
9484505,916,0,10,2907,111722266,0,0,0,708.0,6,369325.79,18,2,20,6,False
9542926,944,2,451,9075,111722266,0,0,0,708.27,7,368617.52,24,2,9,8,True
9569194,944,2,30,2581,111722266,0,0,0,708.06,8,367909.46,24,2,15,9,True
9629747,400,4,25,9075,111722266,0,0,0,708.04,8,367201.42,10,0,3,9,True
1070461,475,4,-1,3156,864850098,0,1,0,871.05,4,829838.0,5,3,2,2,True
1250235,1287,4,25,7713,864850098,0,0,0,870.79,8,828967.21,24,5,1,3,False
1533943,444,2,20,2777,864850098,0,0,0,870.93,3,828096.28,24,3,21,3,False
1623278,219,0,20,5749,864850098,0,0,0,871.01,3,827225.27,9,3,23,3,False
1668088,342,0,10,1844,864850098,0,0,0,871.08,0,828096.35,24,3,11,4,True
1714078,1244,4,30,3377,864850098,0,0,0,870.71,8,827225.64,18,5,17,4,False
1876332,1189,2,451,8131,864850098,0,0,0,870.84,7,826354.8,24,0,6,6,True
2083062,1474,0,-1,5749,864850098,0,1,0,870.86,4,826354.8,24,4,5,6,True
2267901,1189,2,451,3156,864850098,0,0,0,870.83,7,825483.97,24,1,21,6,True
2456661,475,4,25,1844,864850098,0,0,0,871.07,8,824612.9,5,3,11,8,True
2605040,1474,0,25,6797,864850098,0,0,0,871.01,8,823741.89,24,3,13,8,True
2688095,135,2,20,5272,864850098,0,0,0,871.22,5,822870.67,18,3,18,8,True
2943019,942,0,10,6425,864850098,0,0,0,871.12,6,823741.79,24,5,1,8,True
3519102,1474,0,451,7489,864850098,0,0,0,870.94,7,822870.85,24,1,12,9,True
3595029,739,1,10,7489,864850098,0,0,0,870.88,6,823741.73,24,3,21,9,True
3854994,1287,4,30,4106,864850098,0,0,0,870.97,8,822870.76,24,2,1,10,True
4084330,701,2,30,2777,864850098,0,0,0,870.89,8,821999.87,18,1,15,11,True
4117708,1474,0,25,8075,864850098,0,0,0,870.97,8,821128.9,24,2,12,12,True
4395531,1244,4,451,5055,864850098,0,0,0,870.91,7,820257.99,18,6,6,1,True
4486362,1189,2,-1,8131,864850098,0,1,0,871.14,1,820257.99,24,0,9,1,True
4555917,1287,4,451,8075,864850098,0,0,0,871.12,7,819386.87,24,4,7,1,True
4788115,1189,2,30,5055,864850098,0,0,0,870.78,8,818516.09,24,2,6,2,True
4886455,701,2,451,8540,864850098,0,0,0,871.09,7,817645.0,18,1,18,3,True
5013126,1287,4,451,9058,864850098,0,0,0,871.25,7,816773.75,24,2,4,4,True
5162080,475,4,25,5055,864850098,0,0,0,871.1,8,815902.65,5,3,22,5,True
5308101,228,0,10,5016,864850098,0,0,0,871.12,6,816773.77,26,4,19,7,True
5609171,1474,0,30,7489,864850098,0,0,0,870.95,8,815902.82,24,2,1,8,True
5739997,1244,4,451,8075,864850098,0,0,0,871.14,7,815031.68,18,1,4,8,True
5847785,199,0,20,1844,864850098,0,0,0,870.98,5,814160.7,18,3,7,8,True
6173401,1189,2,25,7619,864850098,0,0,0,871.37,8,813289.33,24,1,5,9,True
6201593,1189,2,25,5348,864850098,0,0,0,871.16,8,812418.17,24,2,10,10,True
6528601,1189,2,25,9068,864850098,0,0,0,871.09,8,811547.08,24,1,5,11,True
6588979,1189,2,-1,8540,864850098,0,1,0,871.03,1,811547.08,24,6,22,12,True
6783844,475,4,451,7736,864850098,0,0,0,871.1,7,810675.98,5,3,3,12,True
6866187,848,2,20,2530,864850098,0,0,0,870.91,5,809805.07,5,0,5,12,True
6992330,1474,0,451,8131,864850098,0,0,0,871.1,7,808933.97,24,6,13,1,True
7020726,1189,2,30,2349,864850098,0,0,0,870.85,8,808063.12,24,6,23,1,True
7051745,219,0,20,5749,864850098,0,0,0,870.84,5,807192.28,9,1,20,1,True
7078973,1474,0,30,7619,864850098,0,0,0,871.18,8,806321.1,24,4,13,3,False
7173329,701,2,30,7446,864850098,0,0,0,871.12,8,805449.98,18,2,10,3,True
7613724,701,2,25,5552,864850098,0,0,0,871.26,8,804578.72,18,1,11,3,True
7725529,701,2,30,7736,864850098,0,0,0,870.86,8,803707.86,18,6,4,4,True
7969799,898,1,10,5552,864850098,0,0,0,870.78,6,804578.64,24,3,11,4,True
8182679,701,2,451,7446,864850098,0,0,0,870.93,7,803707.71,18,5,10,4,True
8200162,1474,0,25,9404,864850098,0,0,0,870.98,8,802836.73,24,2,7,5,True
8261131,701,2,25,5348,864850098,0,0,0,871.23,8,801965.5,18,0,18,5,True
8455715,1244,4,30,5016,864850098,0,0,0,871.18,8,801094.32,18,1,13,6,True
8740664,1189,2,25,5642,864850098,0,0,0,871.15,8,800223.17,24,4,19,6,True
8857166,1189,2,30,3377,864850098,0,0,0,870.95,8,799352.22,24,5,8,7,True
9086782,591,0,20,5055,864850098,0,0,0,871.0,3,798481.22,24,3,6,8,True
9262153,1189,2,25,2530,864850098,0,0,0,870.92,8,797610.3,24,2,16,8,True
9288058,1244,4,25,5016,864850098,0,0,0,870.73,8,796739.57,18,5,22,8,True
9390119,866,0,20,8075,864850098,0,0,0,871.12,5,795868.45,24,4,22,10,True
9435835,1150,0,10,6425,864850098,0,0,0,871.26,6,796739.71,15,5,0,10,True
9855688,424,1,10,7489,864850098,0,0,0,871.13,6,797610.84,18,0,18,10,True
9860498,1474,0,25,5348,864850098,0,0,0,870.98,8,796739.86,24,6,21,11,False
1295381,370,4,25,4913,328916497,0,0,0,151.79,8,260722.21,25,2,5,1,True
1364658,185,1,10,2324,328916497,0,0,0,151.63,6,260873.84,18,3,10,1,True
1584325,530,0,30,8044,328916497,0,0,0,151.9,8,260721.94,18,5,7,1,True
1840139,403,0,451,4618,328916497,0,0,0,152.35,7,260569.59,10,2,23,3,True
2029930,391,3,25,3309,328916497,0,0,0,152.02,8,260417.57,10,0,8,3,True
2099900,530,0,451,5158,328916497,0,0,0,151.97,7,260265.6,18,1,4,3,True
2107450,1284,2,20,7350,328916497,0,0,0,151.95,5,260113.65,24,0,12,4,True
2345784,403,0,30,7190,328916497,0,0,0,152.15,8,259961.5,10,2,16,5,True
2360896,391,3,30,9319,328916497,0,0,0,152.11,8,259809.39,10,2,22,6,True
2481936,403,0,30,2302,328916497,0,0,0,152.04,8,259657.35,10,0,23,6,True
2782221,584,0,20,4913,328916497,0,0,0,151.88,5,259505.47,11,2,4,6,True
2861549,1160,0,10,6502,328916497,0,0,0,152.06,0,259657.53,15,1,21,6,True
3443559,907,0,30,3309,328916497,0,0,0,152.4,8,259505.13,2,3,14,7,True
3447615,444,2,451,8109,328916497,0,0,0,152.17,7,259352.96,24,2,2,7,True
3455248,370,4,451,2324,328916497,0,0,0,152.0,7,259200.96,25,2,11,7,True
3634968,652,0,10,6787,328916497,0,0,0,152.2,6,259353.16,24,6,14,8,True
3876235,391,3,25,9319,328916497,0,0,0,151.98,8,259201.18,10,2,7,8,True
4015678,1169,0,10,3743,328916497,0,0,0,152.12,0,259353.3,24,3,15,9,True
4298399,444,2,-1,3743,328916497,0,1,0,151.96,4,259353.3,24,3,20,9,True
4438343,176,3,30,3309,328916497,0,0,0,152.02,8,259201.28,24,3,16,9,True
4449378,907,0,30,6502,328916497,0,0,0,152.19,8,259049.09,2,6,9,10,True
4514800,1134,1,10,9319,328916497,0,0,0,152.18,6,259201.27,24,6,14,10,True
4658617,391,3,451,5158,328916497,0,0,0,152.04,7,259049.23,10,4,23,11,True
4694269,1072,0,10,3743,328916497,0,0,0,151.95,6,259201.18,18,5,6,12,True
5073881,444,2,451,8044,328916497,0,0,0,152.3,7,259048.88,24,4,3,12,True
5115372,530,0,-1,8223,328916497,0,1,0,152.1,4,259048.88,18,0,5,1,True
5359204,739,1,10,7696,328916497,0,0,0,152.19,6,259201.07,24,0,9,1,True
5433651,444,2,25,7696,328916497,0,0,0,151.76,8,259049.31,24,1,2,1,True
5541244,176,3,-1,3309,328916497,0,1,0,151.77,1,259049.31,24,2,16,1,True
5615100,176,3,30,8109,328916497,0,0,0,152.08,8,258897.23,24,0,23,2,True
6102456,444,2,30,2302,328916497,0,0,0,152.4,8,258744.83,24,4,2,3,True
6187739,712,0,10,8044,328916497,0,0,0,152.22,6,258897.05,18,2,15,4,True
6207339,370,4,451,8223,328916497,0,0,0,152.2,7,258744.85,25,0,2,4,True
6227554,1311,2,20,5158,328916497,0,0,0,151.96,3,258592.89,5,1,11,5,True
6255501,605,0,10,2324,328916497,0,0,0,152.07,6,258744.96,24,6,21,5,True
6334868,403,0,30,8044,328916497,0,0,0,152.05,8,258592.91,10,3,18,5,True
6348294,176,3,451,8223,328916497,0,0,0,152.17,7,258440.74,24,3,21,8,True
6537565,811,0,20,6502,328916497,0,0,0,152.07,5,258288.67,18,6,12,8,False
6586239,176,3,451,9319,328916497,0,0,0,152.08,7,258136.59,24,1,0,10,False
6733392,116,0,10,3743,328916497,0,0,0,152.05,0,258288.64,3,6,16,10,True
7375579,370,4,451,9319,328916497,0,0,0,151.94,7,258136.7,25,2,22,10,False
7633422,391,3,-1,7350,328916497,0,1,0,151.94,1,258136.7,10,1,11,10,False
7933290,530,0,25,6502,328916497,0,0,0,152.04,8,257984.66,18,0,6,10,True
8163620,907,0,-1,7696,328916497,0,1,0,151.95,1,257984.66,2,5,10,11,True
8342156,530,0,-1,9319,328916497,0,2,0,152.0,4,257984.66,18,6,0,12,True
8352977,530,0,30,7350,328916497,0,0,0,151.98,8,257832.68,18,4,5,3,False
8423592,530,0,25,9319,328916497,0,0,0,152.17,8,257680.51,18,5,5,4,True
8423880,342,0,10,2302,328916497,0,0,0,152.1,6,257832.61,24,5,7,4,True
8531947,530,0,30,4355,328916497,0,0,0,151.76,8,257680.85,18,4,8,5,True
8705124,1113,1,10,9319,328916497,0,0,0,151.87,6,257832.72,0,1,16,6,True
8786381,391,3,451,4913,328916497,0,0,0,152.24,7,257680.48,10,2,1,7,True
9044193,757,0,20,7190,328916497,0,0,0,152.11,3,257528.37,24,0,11,9,True
9119983,403,0,451,8044,328916497,0,0,0,151.84,7,257376.53,10,0,19,9,True
9208906,444,2,-1,2623,328916497,0,1,0,151.88,4,257376.53,24,5,11,9,True
9470858,530,0,30,5158,328916497,0,0,0,151.78,8,257224.75,18,5,10,10,True
9677270,403,0,30,3309,328916497,0,0,0,151.95,8,257072.8,10,3,12,10,True
1045353,1094,0,451,7287,676100474,0,0,0,724.97,7,366259.03,0,3,3,2,True
1248207,1322,2,20,9111,676100474,0,0,0,724.99,3,365534.04,18,6,11,3,True
1304174,1314,2,451,8048,676100474,0,0,0,725.13,7,364808.91,5,6,13,4,True
1333921,1094,0,25,4775,676100474,0,0,0,724.78,8,364084.13,0,5,5,5,True
1349543,317,4,25,4775,676100474,0,0,0,725.07,8,363359.06,4,2,13,6,True
1595449,757,0,451,3798,676100474,0,0,0,725.03,7,362634.03,24,3,16,6,True
1674364,317,4,30,7205,676100474,0,0,0,724.78,8,361909.25,4,1,7,7,True
1751986,47,1,10,3798,676100474,0,0,0,724.59,6,362633.84,24,1,14,7,True
1934338,960,3,30,9926,676100474,0,0,0,725.1,8,361908.74,13,0,8,8,True
1957846,317,4,451,9997,676100474,0,0,0,725.05,7,361183.69,4,6,1,8,True
2014650,263,3,451,9372,676100474,0,0,0,725.04,7,360458.65,6,6,16,8,True
2096559,757,0,25,9111,676100474,0,0,0,725.18,8,359733.47,24,1,4,11,True
2402276,757,0,-1,2016,676100474,0,1,0,725.01,4,359733.47,24,1,8,11,True
2456325,263,3,25,8048,676100474,0,0,0,725.09,8,359008.38,6,3,13,12,True
2466038,1411,0,10,3299,676100474,0,0,0,724.95,0,359733.33,24,6,9,1,True
2579325,1277,2,20,5908,676100474,0,0,0,724.99,5,359008.34,24,2,11,2,True
2593572,1094,0,451,4066,676100474,0,0,0,725.02,7,358283.32,0,3,11,2,True
2786633,840,3,-1,3867,676100474,0,1,0,725.28,1,358283.32,5,0,3,3,True
3111628,960,3,451,8023,676100474,0,0,0,724.95,7,357558.37,13,6,13,4,True
3115013,263,3,30,4066,676100474,0,0,0,725.07,8,356833.3,6,4,10,4,True
3279861,757,0,25,7205,676100474,0,0,0,725.07,8,356108.23,24,1,15,6,True
3659021,317,4,30,8023,676100474,0,0,0,724.98,8,355383.25,4,1,20,6,True
4054118,317,4,451,9997,676100474,0,0,0,724.88,7,354658.37,4,4,0,6,True
4074892,840,3,30,6126,676100474,0,0,0,724.99,8,353933.38,5,2,8,7,True
4085023,263,3,25,7287,676100474,0,0,0,725.26,8,353208.12,6,0,9,7,True
4482455,1170,0,10,6470,676100474,0,0,0,724.96,6,353933.08,24,1,0,8,True
4928919,1314,2,451,2114,676100474,0,0,0,725.03,7,353208.05,5,4,13,8,True
5009313,317,4,25,2914,676100474,0,0,0,725.06,8,352482.99,4,3,1,9,True
5354831,960,3,25,6470,676100474,0,0,0,725.01,8,351757.98,13,4,15,9,True
5797556,573,0,10,5908,676100474,0,0,0,724.8,6,352482.78,11,3,15,10,True
5907009,376,0,20,2914,676100474,0,0,0,724.88,3,351757.9,25,5,21,11,True
5912979,317,4,451,9849,676100474,0,0,0,725.1,7,351032.8,4,2,14,11,True
6069504,1314,2,30,3798,676100474,0,0,0,725.13,8,350307.67,5,2,14,12,True
6286495,320,1,10,3867,676100474,0,0,0,724.75,6,351032.42,11,6,10,12,True
6881519,840,3,30,7287,676100474,0,0,0,725.02,8,350307.4,5,5,3,12,True
7275331,757,0,30,6126,676100474,0,0,0,725.05,8,349582.35,24,4,5,1,True
7919168,263,3,30,3299,676100474,0,0,0,724.69,8,348857.66,6,5,21,1,True
8180212,317,4,25,8048,676100474,0,0,0,725.2,8,348132.46,4,2,5,2,True
8181103,1094,0,-1,4066,676100474,0,1,0,725.05,4,348132.46,0,5,9,3,True
8503979,59,0,20,6126,676100474,0,0,0,724.92,5,347407.54,20,2,19,3,True
8587086,664,2,20,8048,676100474,0,0,0,724.99,3,346682.55,18,4,12,3,True
8742601,1094,0,30,1578,676100474,0,0,0,724.94,8,345957.61,0,4,1,4,True
8756518,454,1,10,1073,676100474,0,0,0,725.09,6,346682.7,13,4,16,5,True
8976427,1060,1,10,3798,676100474,0,0,0,725.13,6,347407.83,11,5,17,7,True
9116942,1206,0,20,6126,676100474,0,0,0,725.12,3,346682.71,24,5,10,7,True
9245206,317,4,451,8023,676100474,0,0,0,724.89,7,345957.82,4,3,2,7,True
9612493,757,0,451,9372,676100474,0,0,0,724.86,7,345232.96,24,3,15,7,True
9775809,757,0,-1,6126,676100474,0,1,0,725.23,4,345232.96,24,4,8,8,True
9853977,480,0,20,6470,676100474,0,0,0,724.88,5,344508.08,5,1,19,9,True
9973168,1314,2,25,3867,676100474,0,0,0,724.82,8,343783.26,5,6,16,10,True
1029965,1021,4,451,9251,908893847,1,0,0,585.24,7,127430.76,11,0,13,1,True
1112707,1471,0,10,2859,908893847,1,0,0,585.0,6,128015.76,24,1,19,1,True
1486738,1321,0,451,2772,908893847,1,0,0,584.96,7,127430.8,18,0,2,2,True
1647037,1477,2,20,7687,908893847,1,0,0,584.84,3,126845.96,24,5,19,2,True
1685210,666,4,451,8710,908893847,1,0,0,585.07,7,126260.89,18,2,7,3,True
1707830,666,4,30,1692,908893847,1,0,0,585.2,8,125675.69,18,5,7,4,True
1851463,666,4,-1,2757,908893847,1,1,0,584.69,4,125675.69,18,4,8,5,True
2036890,761,2,30,2859,908893847,1,0,0,585.13,8,125090.56,24,0,13,6,True
2070956,158,2,-1,5193,908893847,1,1,0,585.06,4,125090.56,24,3,8,6,True
2161808,175,3,-1,2757,908893847,1,2,0,585.07,1,125090.56,24,4,1,6,True
2438803,175,3,30,3377,908893847,1,0,0,585.03,8,124505.53,24,0,5,7,True
2485737,175,3,451,5290,908893847,1,0,0,585.02,7,123920.51,24,1,3,7,True
2488731,158,2,451,9453,908893847,1,0,0,584.82,7,123335.69,24,2,19,7,True
2673087,448,0,-1,2772,908893847,1,1,0,585.19,1,123335.69,13,3,3,8,True
2936148,300,0,20,5118,908893847,1,0,0,585.09,5,122750.6,4,1,16,8,True
3104659,167,2,20,9453,908893847,1,0,0,584.89,5,122165.71,24,5,17,9,True
3323055,158,2,451,8710,908893847,1,0,0,585.1,7,121580.61,24,5,7,9,True
3336473,23,0,20,7687,908893847,1,0,0,584.88,5,120995.73,11,1,1,11,True
3485120,175,3,30,2859,908893847,1,0,0,584.79,8,120410.94,24,2,2,11,True
3671178,806,1,10,8575,908893847,1,0,0,584.91,0,120995.85,11,1,15,12,True
3983463,666,4,30,2772,908893847,1,0,0,584.91,8,120410.94,18,5,13,12,True
4179001,448,0,-1,2772,908893847,1,1,0,584.75,4,120410.94,13,0,10,1,True
4290308,448,0,25,8496,908893847,1,0,0,585.05,8,119825.89,13,2,2,1,True
4502201,158,2,30,8496,908893847,1,0,0,584.89,8,119241.0,24,1,2,1,True
4523835,1321,0,30,1443,908893847,1,0,0,584.8,8,118656.2,18,6,6,2,True
4922238,761,2,25,9811,908893847,1,0,0,585.42,8,118070.78,24,0,22,2,True
5141046,1321,0,451,7851,908893847,1,0,0,585.06,7,117485.72,18,0,19,3,True
5535755,568,1,10,6283,908893847,1,0,0,584.88,0,118070.6,11,3,0,3,True
5806484,158,2,25,8496,908893847,1,0,0,584.92,8,117485.68,24,2,0,4,True
5859246,539,4,451,5118,908893847,1,0,0,585.31,7,116900.37,18,4,4,4,True
5909628,767,0,20,2757,908893847,1,0,0,584.87,3,116315.5,14,4,14,4,True
6000384,539,4,25,5290,908893847,1,0,0,584.99,8,115730.51,18,0,1,5,True
6003310,761,2,25,8496,908893847,1,0,0,584.85,8,115145.66,24,3,23,5,True
6153971,1321,0,30,8710,908893847,1,0,0,584.8,8,114560.86,18,6,3,5,True
6183639,448,0,30,2859,908893847,1,0,0,584.78,8,113976.08,13,5,22,8,True
6250827,175,3,-1,3732,908893847,1,1,0,585.07,1,113976.08,24,5,18,9,True
6449693,1321,0,30,5118,908893847,1,0,0,584.83,8,113391.25,18,3,1,10,True
6515103,696,2,20,5290,908893847,1,0,0,585.05,5,112806.2,24,4,22,11,True
6518709,716,0,20,8575,908893847,1,0,0,585.19,5,112221.01,18,1,1,11,True
6849723,1305,2,20,6244,908893847,1,0,0,584.68,3,111636.33,5,2,12,12,True
7004862,666,4,30,7851,908893847,1,0,0,584.84,8,111051.49,18,2,4,2,True
7198337,1377,0,20,5290,908893847,1,0,0,585.0,5,110466.49,16,0,20,3,True
7455024,666,4,451,2772,908893847,1,0,0,585.04,7,109881.45,18,4,18,3,False
7832297,175,3,-1,8575,908893847,1,1,0,584.9,1,109881.45,24,2,12,5,True
7964905,1321,0,25,7687,908893847,1,0,0,584.89,8,109296.56,18,3,22,5,True
8000952,429,0,20,3732,908893847,1,0,0,584.99,3,108711.57,24,3,2,5,True
8153312,1321,0,30,6244,908893847,1,0,0,585.22,8,108126.35,18,6,11,6,True
8561557,448,0,-1,7851,908893847,1,1,0,584.89,1,108126.35,13,0,22,7,True
8580069,761,2,451,1001,908893847,1,0,0,585.39,7,107540.96,24,6,14,7,False
8770454,1021,4,451,3377,908893847,1,0,0,584.79,7,106956.17,11,3,19,8,True
8833467,666,4,30,9811,908893847,1,0,0,584.78,8,106371.39,18,5,4,9,True
8995429,448,0,451,7851,908893847,1,0,0,585.03,7,105786.36,13,4,0,9,True
9011312,539,4,-1,7254,908893847,1,1,0,585.05,4,105786.36,18,5,20,9,True
9219033,761,2,451,2757,908893847,1,0,0,584.99,7,105201.37,24,4,4,9,True
9356442,448,0,451,3732,908893847,1,0,0,584.96,7,104616.41,13,0,8,9,False
9698456,234,0,10,9873,908893847,1,0,0,584.91,6,105201.32,26,1,0,10,False
9807136,1260,0,10,3377,908893847,1,0,0,584.81,0,105786.13,23,1,10,11,False
1038450,475,4,30,5507,659781448,1,0,0,888.91,8,312561.09,5,1,7,1,True
1080603,655,3,30,9121,659781448,1,0,0,888.98,8,311672.11,18,3,12,2,True
1213039,475,4,30,4417,659781448,1,0,0,889.17,8,310782.94,5,1,8,3,True
1251759,1318,0,451,5502,659781448,1,0,0,888.94,7,309894.0,18,4,14,4,True
1522369,475,4,451,5507,659781448,1,0,0,889.1,7,309004.9,5,2,15,4,True
1587515,535,0,10,1794,659781448,1,0,0,889.06,6,309893.96,18,3,3,4,True
1999069,249,0,10,4417,659781448,1,0,0,888.92,6,310782.88,6,4,16,4,True
2089868,1264,0,10,8994,659781448,1,0,0,889.04,6,311671.92,23,2,2,6,True
2224000,814,4,25,1113,659781448,1,0,0,888.96,8,310782.96,18,5,3,6,True
2347094,1187,4,451,9121,659781448,1,0,0,889.13,7,309893.83,24,4,20,7,True
2384068,1187,4,25,5189,659781448,1,0,0,889.43,8,309004.4,24,2,21,7,True
2444125,1187,4,30,9121,659781448,1,0,0,888.94,8,308115.46,24,3,1,7,True
2636486,814,4,451,8029,659781448,1,0,0,888.78,7,307226.68,18,2,0,7,True
2784382,1318,0,30,9636,659781448,1,0,0,888.98,8,306337.7,18,0,6,8,False
2910388,814,4,451,9121,659781448,1,0,0,889.01,7,305448.69,18,5,9,12,True
3176192,475,4,25,5971,659781448,1,0,0,889.09,8,304559.6,5,1,22,12,True
3254064,1422,1,10,1113,659781448,1,0,0,889.05,6,305448.65,24,0,12,1,True
3444644,1318,0,-1,5189,659781448,1,1,0,888.96,4,305448.65,18,5,13,2,True
3729417,320,1,10,1113,659781448,1,0,0,889.01,0,306337.66,11,3,19,3,False
3811113,655,3,-1,5507,659781448,1,1,0,889.12,1,306337.66,18,0,12,3,True
4172339,1318,0,451,4417,659781448,1,0,0,888.88,7,305448.78,18,2,4,3,True
4257308,814,4,451,5507,659781448,1,0,0,889.11,7,304559.67,18,2,16,4,True
4259937,475,4,25,3548,659781448,1,0,0,888.94,8,303670.73,5,5,0,4,True
4348103,222,2,20,2465,659781448,1,0,0,889.29,3,302781.44,26,0,10,5,True
4364641,376,0,20,5971,659781448,1,0,0,888.91,5,301892.53,25,0,10,5,True
4528352,734,0,10,9121,659781448,1,0,0,888.88,6,302781.41,11,5,13,5,True
4686151,475,4,451,3548,659781448,1,0,0,888.66,7,301892.75,5,4,21,6,True
4857039,814,4,30,8994,659781448,1,0,0,888.89,8,301003.86,18,5,12,6,True
4981504,655,3,-1,3548,659781448,1,1,0,889.22,1,301003.86,18,1,10,6,True
5555920,1318,0,451,2465,659781448,1,0,0,888.91,7,300114.95,18,3,7,7,True
5864339,1179,0,10,4417,659781448,1,0,0,888.99,6,301003.94,24,0,0,7,False
6019915,1187,4,451,5507,659781448,1,0,0,888.97,7,300114.97,24,1,23,8,True
6427037,23,0,10,5971,659781448,1,0,0,889.19,6,301004.16,11,1,2,8,True
6448764,1187,4,-1,1113,659781448,1,1,0,889.13,4,301004.16,24,0,14,9,True
6745456,475,4,451,5502,659781448,1,0,0,888.81,7,300115.35,5,6,8,10,True
7395261,1187,4,30,3548,659781448,1,0,0,888.8,8,299226.55,24,0,15,12,True
7649128,1318,0,-1,8029,659781448,1,1,0,888.79,1,299226.55,18,3,7,1,True
7707151,655,3,451,5189,659781448,1,0,0,889.23,7,298337.32,18,6,17,1,True
7808973,1187,4,451,4417,659781448,1,0,0,888.82,7,297448.5,24,2,21,1,True
7933698,814,4,451,5502,659781448,1,0,0,889.21,7,296559.29,18,2,2,1,True
8169184,475,4,451,9636,659781448,1,0,0,889.05,7,295670.24,5,0,12,1,True
8208550,1187,4,30,9636,659781448,1,0,0,888.9,8,294781.34,24,2,20,2,True
8437440,228,0,20,9121,659781448,1,0,0,889.17,5,293892.17,26,0,7,4,True
8515226,475,4,-1,9121,659781448,1,1,0,888.91,1,293892.17,5,3,19,4,True
8716631,1187,4,30,5502,659781448,1,0,0,889.27,8,293002.9,24,6,3,5,True
8974587,1318,0,25,9636,659781448,1,0,0,888.99,8,292113.91,18,0,7,6,True
9094009,475,4,-1,9121,659781448,1,1,0,889.15,4,292113.91,5,6,6,6,True
9152836,1318,0,30,9121,659781448,1,0,0,889.24,8,291224.67,18,4,17,8,True
9288897,215,0,20,9636,659781448,1,0,0,888.74,5,290335.93,9,6,15,9,True
9374452,1187,4,30,8029,659781448,1,0,0,888.8,8,289447.13,24,1,15,10,True
9386739,1421,0,20,8344,659781448,1,0,0,889.06,5,288558.07,24,6,9,10,True
9502958,814,4,25,8994,659781448,1,0,0,889.06,8,287669.01,18,3,21,10,True
9770725,98,0,20,5502,659781448,1,0,0,888.89,3,286780.12,3,0,9,11,False
1042533,1092,1,451,5806,396964211,0,0,0,426.12,7,234151.88,18,1,19,1,True
1203949,64,0,20,6656,396964211,0,0,0,425.74,3,233726.14,20,3,18,1,True
1211608,1092,1,25,3758,396964211,0,0,0,426.15,8,233299.99,18,4,14,2,True
1323943,104,4,451,4202,396964211,0,0,0,426.03,7,232873.96,3,6,8,2,True
1616776,216,4,451,8720,396964211,0,0,0,425.81,7,232448.15,9,6,16,2,True
1686799,1092,1,25,3961,396964211,0,0,0,426.1,8,232022.05,18,3,12,3,True
1981806,216,4,25,2254,396964211,0,0,0,426.11,8,231595.94,9,2,4,3,True
2342140,1342,3,-1,5806,396964211,0,1,0,425.9,4,231595.94,24,4,23,3,True
2402968,216,4,451,3717,396964211,0,0,0,425.98,7,231169.96,9,4,0,4,True
2497352,104,4,25,2254,396964211,0,0,0,426.01,8,230743.95,3,1,20,4,True
2713129,145,0,10,4118,396964211,0,0,0,425.99,6,231169.94,18,3,0,4,True
2860241,1342,3,451,4118,396964211,0,0,0,425.98,7,230743.96,24,4,13,4,True
3362018,1262,0,20,1935,396964211,0,0,0,426.12,5,230317.84,23,1,13,5,True
3368833,348,0,25,1935,396964211,0,0,0,425.85,8,229891.99,24,0,16,7,True
3414244,1342,3,451,5970,396964211,0,0,0,426.16,7,229465.83,24,3,23,8,True
3444261,1092,1,451,4035,396964211,0,0,0,425.85,7,229039.98,18,0,10,8,True
3594269,1199,4,25,3793,396964211,0,0,0,426.08,8,228613.9,24,1,3,8,True
3636869,1133,4,30,3689,396964211,0,0,0,425.89,8,228188.01,24,2,21,10,True
3649278,1199,4,25,7877,396964211,0,0,0,426.12,8,227761.89,24,6,1,10,True
3890159,1342,3,451,3520,396964211,0,0,0,425.95,7,227335.94,24,2,0,11,True
3992374,1092,1,30,9649,396964211,0,0,0,426.0,8,226909.94,18,2,7,11,True
4008703,1092,1,30,6656,396964211,0,0,0,425.94,8,226484.0,18,3,0,11,True
4015785,367,1,10,5353,396964211,0,0,0,425.95,6,226909.95,25,6,6,12,True
4105866,205,0,20,3758,396964211,0,0,0,426.01,3,226483.94,9,0,1,1,True
4242297,305,1,10,5806,396964211,0,0,0,425.83,6,226909.77,4,3,11,2,True
4462926,1238,0,10,2522,396964211,0,0,0,426.22,6,227335.99,18,1,7,3,True
4867123,522,0,10,4035,396964211,0,0,0,425.81,6,227761.8,18,3,20,3,True
4902495,1092,1,25,3021,396964211,0,0,0,425.89,8,227335.91,18,1,15,3,True
5008203,348,0,10,1935,396964211,0,0,0,425.95,6,227761.86,24,4,13,3,True
5176110,294,3,-1,4118,396964211,0,1,0,425.93,4,227761.86,4,4,1,5,True
5354756,216,4,30,5289,396964211,0,0,0,426.03,8,227335.83,9,2,22,5,True
5393449,1114,1,10,4118,396964211,0,0,0,425.9,0,227761.73,0,5,5,6,False
5400786,1199,4,25,5289,396964211,0,0,0,425.89,8,227335.84,24,3,3,6,True
5492185,1342,3,451,7619,396964211,0,0,0,426.06,7,226909.78,24,2,21,7,True
5493577,1199,4,451,1935,396964211,0,0,0,425.65,7,226484.13,24,6,11,8,True
5572129,1342,3,25,4202,396964211,0,0,0,425.87,8,226058.26,24,0,5,9,True
5577969,1133,4,30,2254,396964211,0,0,0,426.26,8,225632.0,24,6,19,10,True
5686406,129,0,20,3736,396964211,0,0,0,425.88,5,225206.12,18,0,3,10,True
5689090,294,3,30,4202,396964211,0,0,0,426.14,8,224779.98,4,3,12,1,True
6022716,394,0,20,3689,396964211,0,0,0,426.34,5,224353.64,10,4,7,1,True
6139524,348,0,451,6656,396964211,0,0,0,425.98,7,223927.66,24,6,18,1,True
6192639,1342,3,451,8720,396964211,0,0,0,425.97,7,223501.69,24,4,8,2,True
6267602,645,0,10,7150,396964211,0,0,0,426.0,6,223927.69,24,5,9,2,True
6352586,1092,1,-1,3961,396964211,0,1,0,425.83,4,223927.69,18,6,8,2,True
6484504,1133,4,25,3736,396964211,0,0,0,425.93,8,223501.76,24,3,5,3,True
6855447,104,4,30,3520,396964211,0,0,0,426.03,8,223075.73,3,3,11,4,True
7035228,1092,1,451,7819,396964211,0,0,0,425.78,7,222649.95,18,1,22,4,True
7553326,1092,1,30,7619,396964211,0,0,0,425.99,8,222223.96,18,3,11,5,True
7860044,348,0,-1,7877,396964211,0,1,0,426.1,1,222223.96,24,3,5,5,True
7893624,294,3,30,3717,396964211,0,0,0,426.16,8,221797.8,4,4,12,6,True
8026507,1092,1,-1,5353,396964211,0,1,0,425.92,4,221797.8,18,6,7,7,True
8140404,1092,1,30,9649,396964211,0,0,0,425.94,8,221371.86,18,0,3,8,False
8384661,348,0,451,9649,396964211,0,0,0,425.77,7,220946.09,24,3,10,8,True
8981194,1342,3,25,5806,396964211,0,0,0,425.91,8,220520.18,24,5,0,9,True
9004853,1092,1,451,5289,396964211,0,0,0,426.13,7,220094.05,18,1,17,10,True
9084001,1089,0,20,2471,396964211,0,0,0,426.08,5,219667.97,18,5,14,11,True
9197681,1133,4,30,5970,396964211,0,0,0,425.9,8,219242.07,24,3,1,11,True
1081325,1226,2,20,4615,666942287,1,0,0,883.1,5,200718.9,18,3,13,1,True
1352808,1404,2,20,3884,666942287,1,0,0,883.12,5,199835.78,24,5,4,3,True
1632274,12,4,-1,3884,666942287,1,1,0,883.03,4,199835.78,24,6,9,3,True
1750319,1191,4,25,2085,666942287,1,0,0,883.11,8,198952.67,24,2,11,3,False
2215340,14,2,20,4573,666942287,1,0,0,882.96,5,198069.71,24,6,9,4,True
2418760,159,2,20,7131,666942287,1,0,0,882.91,3,197186.8,24,1,10,5,True
2533170,1191,4,451,4573,666942287,1,0,0,883.04,7,196303.76,24,5,17,5,True
2690844,286,1,-1,5062,666942287,1,1,0,882.91,4,196303.76,24,4,10,7,True
2907516,98,0,20,2732,666942287,1,0,0,882.75,5,195421.01,3,3,23,7,True
3024144,757,0,20,8429,666942287,1,0,0,883.3,3,194537.71,24,0,2,8,True
3172445,267,0,30,4964,666942287,1,0,0,883.05,8,193654.66,6,6,12,8,True
3191945,1325,0,20,5062,666942287,1,0,0,882.74,5,192771.92,18,3,6,8,False
3195603,464,1,10,7950,666942287,1,0,0,883.02,6,193654.94,13,5,4,9,True
3243989,1191,4,30,3865,666942287,1,0,0,883.17,8,192771.77,24,3,20,9,True
3492508,1093,0,-1,3689,666942287,1,1,0,882.95,1,192771.77,18,4,8,10,True
3510677,588,0,20,4615,666942287,1,0,0,882.84,5,191888.93,24,6,12,10,True
3696451,286,1,451,8793,666942287,1,0,0,882.91,7,191006.02,24,3,14,11,True
3848874,1191,4,30,3623,666942287,1,0,0,883.12,8,190122.9,24,3,2,11,True
3859153,286,1,-1,7131,666942287,1,1,0,882.81,1,190122.9,24,4,6,12,True
3933598,851,1,10,8793,666942287,1,0,0,882.95,6,191005.85,5,3,15,12,True
4125466,1191,4,451,3865,666942287,1,0,0,883.04,7,190122.81,24,5,8,12,True
4177289,286,1,451,8793,666942287,1,0,0,882.98,7,189239.83,24,3,19,1,True
4193873,1191,4,30,2732,666942287,1,0,0,883.15,8,188356.68,24,5,5,1,True
4266397,677,0,10,2085,666942287,1,0,0,883.01,6,189239.69,24,1,12,2,True
4535774,286,1,30,3884,666942287,1,0,0,883.14,8,188356.55,24,0,14,2,True
4588253,267,0,25,2732,666942287,1,0,0,883.03,8,187473.52,6,0,0,2,True
4923363,267,0,-1,2085,666942287,1,1,0,882.57,4,187473.52,6,6,14,3,True
4989171,1160,0,10,3884,666942287,1,0,0,882.78,0,188356.3,15,4,7,3,True
5029305,12,4,451,4836,666942287,1,0,0,882.99,7,187473.31,24,5,8,3,True
5270381,286,1,451,3884,666942287,1,0,0,883.0,7,186590.31,24,4,3,4,True
5348477,1191,4,25,5062,666942287,1,0,0,883.06,8,185707.25,24,2,11,4,True
5605710,286,1,25,4573,666942287,1,0,0,882.72,8,184824.53,24,6,2,5,True
5764960,12,4,451,1358,666942287,1,0,0,882.87,7,183941.66,24,5,12,8,True
6305588,1191,4,-1,2085,666942287,1,1,0,883.13,1,183941.66,24,2,0,10,True
6384536,303,0,20,8429,666942287,1,0,0,882.75,5,183058.91,4,3,6,1,True
6450569,267,0,-1,3689,666942287,1,1,0,882.81,4,183058.91,6,5,10,1,True
6537716,12,4,451,7131,666942287,1,0,0,882.96,7,182175.95,24,4,14,3,True
6554420,1191,4,25,2732,666942287,1,0,0,882.97,8,181292.98,24,3,6,3,True
6619398,267,0,451,4615,666942287,1,0,0,882.86,7,180410.12,6,1,20,4,True
7185766,1191,4,-1,2085,666942287,1,1,0,882.99,4,180410.12,24,6,14,4,True
7555192,286,1,451,3623,666942287,1,0,0,882.98,7,179527.14,24,3,5,5,True
7652516,1191,4,-1,8429,666942287,1,1,0,883.02,4,179527.14,24,6,16,5,True
7871164,267,0,451,8429,666942287,1,0,0,883.0,7,178644.14,6,4,17,5,True
8056039,1191,4,-1,6975,666942287,1,1,0,882.97,4,178644.14,24,0,18,5,True
8678794,1191,4,25,3865,666942287,1,0,0,883.03,8,177761.11,24,1,11,7,True
8818545,267,0,451,8429,666942287,1,0,0,882.94,7,176878.17,6,3,20,8,True
8835664,1191,4,451,3884,666942287,1,0,0,883.19,7,175994.98,24,5,5,8,True
9183805,286,1,25,4836,666942287,1,0,0,882.88,8,175112.1,24,5,5,8,True
9302173,841,1,10,7131,666942287,1,0,0,882.92,6,175995.02,5,2,20,8,True
9340093,12,4,451,2732,666942287,1,0,0,883.11,7,175111.91,24,2,14,9,True
9401936,1093,0,30,4836,666942287,1,0,0,883.16,8,174228.75,18,2,12,10,True
9542147,1093,0,451,8429,666942287,1,0,0,882.88,7,173345.87,18,5,8,11,True
9782384,429,0,20,2085,666942287,1,0,0,883.02,3,172462.85,24,4,6,11,False
1065579,16,4,451,5408,436169573,0,0,0,745.02,7,971729.98,24,2,6,2,True
1446348,826,1,-1,6094,436169573,0,1,0,745.2,4,971729.98,18,2,1,2,True
1604732,802,2,20,9309,436169573,0,0,0,745.0,5,970984.98,11,6,13,2,True
1754916,883,0,10,6707,436169573,0,0,0,744.83,0,971729.81,24,3,15,3,True
1833614,389,3,451,7981,436169573,0,0,0,745.01,7,970984.8,10,6,14,4,True
1969594,826,1,451,2689,436169573,0,0,0,745.05,7,970239.75,18,5,16,4,False
2017490,58,2,20,2646,436169573,0,0,0,744.87,3,969494.88,20,5,17,4,True
2222835,16,4,30,6477,436169573,0,0,0,744.84,8,968750.04,24,0,13,6,True
2503063,16,4,-1,5408,436169573,0,1,0,744.89,1,968750.04,24,0,3,6,True
2513628,621,2,20,7725,436169573,0,0,0,745.09,3,968004.95,11,6,10,7,True
2643775,1272,0,10,6707,436169573,0,0,0,745.05,6,968750.0,24,2,9,7,True
2715349,389,3,30,2689,436169573,0,0,0,745.16,8,968004.84,10,1,1,8,True
2737143,422,4,25,8928,436169573,0,0,0,745.14,8,967259.7,18,2,14,9,True
2933208,422,4,-1,7725,436169573,0,1,0,745.05,1,967259.7,18,5,17,9,True
3080930,64,0,10,3191,436169573,0,0,0,745.14,6,968004.84,20,2,18,9,True
3157776,1226,2,-1,6750,436169573,0,1,0,745.09,1,968004.84,18,6,2,9,True
3427640,15,4,451,5589,436169573,0,0,0,745.0,7,967259.84,24,6,18,9,True
3626639,826,1,451,3424,436169573,0,0,0,745.23,7,966514.61,18,4,10,10,True
3780660,1226,2,451,6065,436169573,0,0,0,745.21,7,965769.4,18,5,19,10,True
3934702,362,0,20,6065,436169573,0,0,0,745.02,5,965024.38,24,0,6,11,True
4161958,21,0,10,6065,436169573,0,0,0,744.87,6,965769.25,11,1,10,11,True
4380387,1226,2,30,1199,436169573,0,0,0,745.07,8,965024.18,18,2,5,12,True
4677765,530,0,20,8928,436169573,0,0,0,745.11,5,964279.07,18,4,5,12,True
4830552,422,4,451,4935,436169573,0,0,0,745.25,7,963533.82,18,2,5,12,True
5205445,422,4,-1,1387,436169573,0,1,0,745.23,4,963533.82,18,2,15,1,True
5492863,15,4,30,7981,436169573,0,0,0,744.91,8,962788.91,24,1,4,1,True
5537195,422,4,25,6707,436169573,0,0,0,744.96,8,962043.95,18,2,15,3,True
5605661,16,4,451,9309,436169573,0,0,0,744.92,7,961299.03,24,2,10,4,True
5659381,16,4,451,2689,436169573,0,0,0,744.82,7,960554.21,24,5,18,4,True
5698065,997,3,30,3424,436169573,0,0,0,744.87,8,959809.34,26,1,7,5,True
6082400,997,3,451,5408,436169573,0,0,0,744.91,7,959064.43,26,3,8,5,True
6356672,1226,2,451,9235,436169573,0,0,0,745.05,7,958319.38,18,0,3,5,True
6431740,389,3,-1,5408,436169573,0,1,0,744.85,4,958319.38,10,5,2,6,True
6443426,997,3,451,6195,436169573,0,0,0,745.03,7,957574.35,26,3,14,7,True
6546529,826,1,30,6750,436169573,0,0,0,744.99,8,956829.36,18,3,10,8,True
6693086,826,1,30,7207,436169573,0,0,0,745.03,8,956084.33,18,4,12,8,True
7004123,997,3,30,6195,436169573,0,0,0,744.92,8,955339.41,26,6,8,9,True
7282130,1226,2,25,4935,436169573,0,0,0,745.17,8,954594.24,18,3,23,9,True
7435557,997,3,451,4935,436169573,0,0,0,744.82,7,953849.42,26,3,13,10,True
8031548,422,4,25,9235,436169573,0,0,0,745.08,8,953104.34,18,5,1,11,True
8048896,16,4,451,6477,436169573,0,0,0,744.96,7,952359.38,24,6,15,11,True
8100003,389,3,25,9309,436169573,0,0,0,745.03,8,951614.35,10,5,0,12,True
8135697,15,4,-1,6707,436169573,0,1,0,744.76,4,951614.35,24,5,17,1,True
8798084,16,4,451,7971,436169573,0,0,0,745.07,7,950869.28,24,1,4,1,True
8829986,997,3,451,3855,436169573,0,0,0,744.96,7,950124.32,26,5,6,1,False
8951421,997,3,25,6195,436169573,0,0,0,745.17,8,949379.15,26,4,6,2,True
8978106,1226,2,451,5408,436169573,0,0,0,745.08,7,948634.07,18,4,6,3,True
9003552,826,1,451,6195,436169573,0,0,0,744.8,7,947889.27,18,6,1,5,True
9132755,1140,0,10,4935,436169573,0,0,0,745.15,6,948634.42,15,1,0,7,False
9306933,826,1,-1,1387,436169573,0,1,0,745.25,4,948634.42,18,4,0,8,True
9925780,389,3,30,3855,436169573,0,0,0,745.31,8,947889.11,10,0,1,9,True
9960404,15,4,30,6065,436169573,0,0,0,745.15,8,947143.96,24,1,12,11,True
1028706,1199,4,-1,8096,705361847,1,1,0,982.93,4,655909.0,24,3,20,2,True
1088421,1122,1,10,4584,705361847,1,0,0,983.04,6,656892.04,24,2,7,2,False
1151061,643,4,451,1176,705361847,1,0,0,982.87,7,655909.17,24,4,1,3,True
1181808,1486,2,451,8096,705361847,1,0,0,982.76,7,654926.41,24,2,0,4,True
1216932,643,4,-1,8816,705361847,1,1,0,983.08,4,654926.41,24,2,14,4,True
1693705,337,1,10,6308,705361847,1,0,0,983.12,0,655909.53,11,2,5,5,True
1985239,282,2,451,6438,705361847,1,0,0,982.97,7,654926.56,24,3,18,5,True
2004068,643,4,-1,4455,705361847,1,1,0,982.8,4,654926.56,24,3,4,5,True
2054431,892,4,30,4455,705361847,1,0,0,982.86,8,653943.7,24,5,8,8,True
2056648,1199,4,451,8096,705361847,1,0,0,982.8,7,652960.9,24,4,4,9,True
2228338,643,4,25,2839,705361847,1,0,0,982.92,8,651977.98,24,6,20,11,True
2251539,372,0,20,6438,705361847,1,0,0,983.1,5,650994.88,25,0,11,11,True
2431284,1159,0,10,8816,705361847,1,0,0,982.94,6,651977.82,15,0,21,12,True
2903104,643,4,25,8816,705361847,1,0,0,983.31,8,650994.51,24,2,18,3,True
3709067,892,4,30,6438,705361847,1,0,0,982.95,8,650011.56,24,4,9,3,True
3937364,643,4,30,2508,705361847,1,0,0,983.14,8,649028.42,24,0,4,4,True
3956550,962,0,10,6800,705361847,1,0,0,983.04,6,650011.46,13,3,23,5,True
4073009,1486,2,-1,4076,705361847,1,1,0,983.12,1,650011.46,24,2,18,5,True
4173941,643,4,25,5590,705361847,1,0,0,983.23,8,649028.23,24,3,2,6,True
4428101,1486,2,451,4076,705361847,1,0,0,982.83,7,648045.4,24,4,6,7,True
4509874,1181,2,20,4863,705361847,1,0,0,982.99,5,647062.41,24,1,1,7,True
4745324,643,4,-1,4455,705361847,1,1,0,982.78,4,647062.41,24,4,22,7,True
5005755,1486,2,30,7806,705361847,1,0,0,982.97,8,646079.44,24,1,0,9,True
5281512,282,2,451,7642,705361847,1,0,0,982.87,7,645096.57,24,5,13,12,True
5335209,1199,4,30,6071,705361847,1,0,0,982.87,8,644113.7,24,4,15,12,True
5370804,892,4,-1,8693,705361847,1,1,0,983.12,4,644113.7,24,0,14,12,True
5622590,1199,4,30,7806,705361847,1,0,0,983.09,8,643130.61,24,5,6,12,True
6354722,892,4,30,4076,705361847,1,0,0,982.82,8,642147.79,24,3,12,1,True
6556813,1027,0,10,8096,705361847,1,0,0,983.0,0,643130.79,11,3,19,2,True
6647803,1075,0,10,1176,705361847,1,0,0,983.24,0,644114.03,18,4,18,2,True
6786555,1052,0,10,4584,705361847,1,0,0,982.95,6,645096.98,11,6,23,2,True
7207495,643,4,30,6308,705361847,1,0,0,983.09,8,644113.89,24,0,7,3,True
7297256,282,2,451,8096,705361847,1,0,0,982.66,7,643131.23,24,5,23,4,True
7353472,282,2,451,8096,705361847,1,0,0,982.99,7,642148.24,24,2,7,4,True
7375801,643,4,25,7806,705361847,1,0,0,983.18,8,641165.06,24,6,3,5,True
7472483,1199,4,451,6308,705361847,1,0,0,983.03,7,640182.03,24,2,8,5,True
7496964,1486,2,451,4455,705361847,1,0,0,983.04,7,639198.99,24,0,14,5,True
7534917,1486,2,30,4455,705361847,1,0,0,983.16,8,638215.83,24,2,12,6,True
7672952,282,2,30,7642,705361847,1,0,0,983.19,8,637232.64,24,2,0,6,True
7823238,282,2,30,6359,705361847,1,0,0,983.19,8,636249.45,24,5,1,6,True
7880575,892,4,30,6308,705361847,1,0,0,983.11,8,635266.34,24,2,16,7,True
7974060,869,2,20,7806,705361847,1,0,0,983.08,5,634283.26,24,5,15,7,True
8016677,867,0,10,7642,705361847,1,0,0,983.04,6,635266.3,24,5,19,7,True
8132166,1486,2,451,8693,705361847,1,0,0,983.19,7,634283.11,24,5,23,7,True
8397111,1297,0,10,4584,705361847,1,0,0,982.96,6,635266.07,5,1,7,7,True
8553115,1390,0,10,8096,705361847,1,0,0,982.92,0,636248.99,24,3,15,9,True
8592952,1116,0,10,6438,705361847,1,0,0,983.01,0,637232.0,24,5,15,9,True
8640873,282,2,25,8693,705361847,1,0,0,982.86,8,636249.14,24,3,18,9,True
8716252,892,4,25,4863,705361847,1,0,0,983.1,8,635266.04,24,3,11,10,True
8734667,892,4,451,6359,705361847,1,0,0,983.37,7,634282.67,24,0,21,10,True
8749460,643,4,-1,4076,705361847,1,1,0,983.32,1,634282.67,24,3,16,10,True
8840467,1199,4,451,6438,705361847,1,0,0,982.79,7,633299.88,24,6,13,11,True
9598230,643,4,451,6438,705361847,1,0,0,982.98,7,632316.9,24,1,14,11,True
9626794,200,0,20,6800,705361847,1,0,0,983.11,3,631333.79,9,2,11,11,True
9823491,282,2,451,7642,705361847,1,0,0,982.82,7,630350.97,24,3,23,11,True
1102133,1114,1,30,8876,341975582,0,0,0,1041.09,8,452299.91,0,5,10,1,True
1229233,847,3,-1,5385,341975582,0,1,0,1040.82,4,452299.91,5,1,7,2,True
1267751,1416,4,451,1554,341975582,0,0,0,1041.19,7,451258.72,24,6,15,2,True
1366477,490,4,-1,1554,341975582,0,1,0,1040.91,4,451258.72,12,0,3,2,True
1570810,96,0,10,2235,341975582,0,0,0,1040.88,0,452299.6,1,2,0,4,True
1883570,490,4,-1,3835,341975582,0,1,0,1040.68,4,452299.6,12,0,9,5,True
1934627,847,3,25,5179,341975582,0,0,0,1040.97,8,451258.63,5,1,2,5,True
2190420,1446,1,10,1370,341975582,0,0,0,1041.18,6,452299.81,24,4,17,6,True
2787025,518,2,20,8425,341975582,0,0,0,1040.96,5,451258.85,18,2,1,6,True
2882084,1114,1,25,1684,341975582,0,0,0,1041.41,8,450217.44,0,2,17,6,True
3082959,490,4,25,1370,341975582,0,0,0,1040.87,8,449176.57,12,3,9,6,True
3529747,847,3,451,7825,341975582,0,0,0,1041.06,7,448135.51,5,5,18,7,True
4199422,811,0,20,2235,341975582,0,0,0,1041.19,3,447094.32,18,3,7,7,True
4297938,1114,1,30,3835,341975582,0,0,0,1041.06,8,446053.26,0,5,12,7,True
4464453,1114,1,451,6462,341975582,0,0,0,1040.94,7,445012.32,0,6,15,8,True
4468139,1112,1,25,4230,341975582,0,0,0,1040.89,8,443971.43,0,4,20,9,True
4751993,847,3,25,2235,341975582,0,0,0,1040.78,8,442930.65,5,2,13,9,True
4797492,95,2,20,3835,341975582,0,0,0,1040.95,5,441889.7,1,3,7,10,True
4823869,1112,1,451,7825,341975582,0,0,0,1040.9,7,440848.8,0,3,12,10,True
4874574,1416,4,451,6462,341975582,0,0,0,1041.03,7,439807.77,24,2,5,11,True
4876772,1114,1,25,7825,341975582,0,0,0,1040.97,8,438766.8,0,0,20,1,True
5108348,1114,1,451,1554,341975582,0,0,0,1041.02,7,437725.78,0,3,8,1,True
5260127,761,2,20,3835,341975582,0,0,0,1041.08,3,436684.7,24,0,1,1,True
5301935,1416,4,451,8431,341975582,0,0,0,1041.04,7,435643.66,24,3,21,1,True
5306940,1114,1,25,5733,341975582,0,0,0,1041.09,8,434602.57,0,4,10,1,True
5356287,579,0,10,2235,341975582,0,0,0,1040.98,0,435643.55,11,5,21,2,True
5393093,1112,1,451,7825,341975582,0,0,0,1041.26,7,434602.29,0,5,0,4,True
5716159,1112,1,451,5385,341975582,0,0,0,1040.87,7,433561.42,0,6,12,5,True
5829511,1114,1,25,8876,341975582,0,0,0,1041.0,8,432520.42,0,1,12,5,False
5835033,962,0,20,9016,341975582,0,0,0,1041.11,3,431479.31,13,5,14,6,True
5854181,847,3,25,6462,341975582,0,0,0,1041.1,8,430438.21,5,3,4,9,True
5916402,1112,1,25,3835,341975582,0,0,0,1040.98,8,429397.23,0,4,0,9,True
6335712,1416,4,25,8876,341975582,0,0,0,1041.28,8,428355.95,24,3,3,10,True
6345910,537,0,10,5733,341975582,0,0,0,1040.85,6,429396.8,18,6,7,10,True
6357443,1114,1,451,1488,341975582,0,0,0,1041.21,7,428355.59,0,0,10,10,True
6459282,1114,1,451,4230,341975582,0,0,0,1041.13,7,427314.46,0,6,11,12,True
6634939,1112,1,451,1370,341975582,0,0,0,1041.04,7,426273.42,0,2,4,1,True
7317771,1114,1,30,1554,341975582,0,0,0,1041.2,8,425232.22,0,4,18,1,True
7424527,1416,4,30,5733,341975582,0,0,0,1041.07,8,424191.15,24,4,23,1,True
7550937,490,4,25,1684,341975582,0,0,0,1040.79,8,423150.36,12,5,8,2,True
7564488,1114,1,25,8458,341975582,0,0,0,1040.92,8,422109.44,0,0,18,4,True
8230846,1416,4,451,8876,341975582,0,0,0,1040.96,7,421068.48,24,4,7,4,True
8280471,570,2,20,9016,341975582,0,0,0,1041.12,5,420027.36,11,1,14,5,True
8512184,1146,2,20,1370,341975582,0,0,0,1041.15,5,418986.21,15,5,7,6,True
8577571,1112,1,25,1488,341975582,0,0,0,1041.01,8,417945.2,0,5,3,6,True
8583666,1416,4,451,2812,341975582,0,0,0,1041.05,7,416904.15,24,5,22,6,True
9431395,931,0,10,7825,341975582,0,0,0,1041.09,0,417945.24,24,5,12,8,True
9669880,1009,0,10,2235,341975582,0,0,0,1041.02,6,418986.26,26,6,23,9,True
9738378,1114,1,-1,2812,341975582,0,1,0,1041.04,4,418986.26,0,1,3,9,False
9792422,1114,1,451,9849,341975582,0,0,0,1040.77,7,417945.49,0,2,2,11,True
1552125,1112,1,10,9073,174756931,0,0,0,1045.05,0,90722.05,0,6,2,1,True
1588876,631,3,451,9413,174756931,0,0,0,1044.95,7,89677.1,11,2,15,2,True
1637318,44,4,451,7212,174756931,0,0,0,1044.98,7,88632.12,24,2,9,2,True
1775207,802,2,-1,9413,174756931,0,1,0,1045.0,4,88632.12,11,5,13,3,True
1842224,1334,3,30,9413,174756931,0,0,0,1044.85,8,87587.27,18,4,17,4,False
1934516,393,1,10,7253,174756931,0,0,0,1044.94,0,88632.21,10,3,2,4,True
2146787,1334,3,30,9214,174756931,0,0,0,1045.11,8,87587.1,18,3,4,4,True
2448174,1334,3,-1,9173,174756931,0,1,0,1044.79,4,87587.1,18,2,14,4,True
2497364,802,2,30,6059,174756931,0,0,0,1045.09,8,86542.01,11,5,10,4,True
2508526,1334,3,25,3847,174756931,0,0,0,1045.21,8,85496.8,18,6,1,5,True
2550052,1267,2,20,9052,174756931,0,0,0,1044.91,3,84451.89,23,4,6,7,True
2550674,44,4,-1,4935,174756931,0,1,0,1044.79,4,84451.89,24,0,14,7,True
2976592,1012,0,20,9214,174756931,0,0,0,1045.15,5,83406.74,26,4,1,8,True
3370192,445,0,10,3847,174756931,0,0,0,1045.06,6,84451.8,13,1,3,8,True
3732300,631,3,451,1883,174756931,0,0,0,1044.81,7,83406.99,11,6,8,8,True
3777683,134,4,-1,7253,174756931,0,1,0,1045.22,4,83406.99,18,0,6,9,True
3935446,1334,3,451,3029,174756931,0,0,0,1045.0,7,82361.99,18,3,12,9,True
3994158,445,0,10,7704,174756931,0,0,0,1045.17,6,83407.16,13,5,16,10,True
4008310,802,2,-1,9547,174756931,0,1,0,1044.89,4,83407.16,11,4,6,11,True
4050026,44,4,30,9214,174756931,0,0,0,1045.09,8,82362.07,24,3,23,12,True
4631739,1152,0,20,7253,174756931,0,0,0,1045.1,5,81316.97,15,6,5,1,True
4712373,802,2,-1,4438,174756931,0,1,0,1045.09,4,81316.97,11,6,7,2,True
4909096,1035,0,20,4291,174756931,0,0,0,1045.06,5,80271.91,11,4,0,2,True
5004373,987,4,451,7212,174756931,0,0,0,1045.26,7,79226.65,22,4,23,3,True
5089941,134,4,-1,5803,174756931,0,1,0,1044.81,1,79226.65,18,5,11,4,True
5129197,802,2,30,9646,174756931,0,0,0,1044.68,8,78181.97,11,2,4,4,True
5270063,44,4,451,4935,174756931,0,0,0,1044.85,7,77137.12,24,5,22,4,True
5281094,987,4,451,9413,174756931,0,0,0,1044.69,7,76092.43,22,0,17,5,True
5440359,134,4,25,9328,174756931,0,0,0,1044.99,8,75047.44,18,4,19,6,True
5572186,1052,0,20,6923,174756931,0,0,0,1045.06,5,74002.38,11,1,5,7,True
5615651,1334,3,451,4935,174756931,0,0,0,1045.0,7,72957.38,18,1,12,8,True
5864806,1334,3,451,7212,174756931,0,0,0,1045.04,7,71912.34,18,5,2,8,True
5905023,394,0,20,9547,174756931,0,0,0,1045.07,5,70867.27,10,4,15,8,True
6210112,44,4,451,9328,174756931,0,0,0,1045.19,7,69822.08,24,2,4,9,True
6245060,44,4,-1,3029,174756931,0,1,0,1044.95,1,69822.08,24,1,15,9,True
6636049,631,3,30,4438,174756931,0,0,0,1044.88,8,68777.2,11,3,5,9,True
6687422,802,2,451,9328,174756931,0,0,0,1045.08,7,67732.12,11,2,13,10,False
7085610,802,2,25,9073,174756931,0,0,0,1045.14,8,66686.98,11,0,18,11,True
7104399,1115,1,10,9547,174756931,0,0,0,1044.96,6,67731.94,0,6,19,12,True
7206575,137,2,20,4479,174756931,0,0,0,1045.43,5,66686.51,18,0,20,12,True
7347083,631,3,451,4042,174756931,0,0,0,1045.13,7,65641.38,11,3,3,12,True
7563011,134,4,451,9173,174756931,0,0,0,1045.13,7,64596.25,18,0,20,2,True
7718743,199,0,20,6059,174756931,0,0,0,1045.12,5,63551.13,18,3,12,2,False
7753700,987,4,451,8811,174756931,0,0,0,1045.15,7,62505.98,22,1,9,3,True
7811775,802,2,-1,9052,174756931,0,1,0,1044.94,4,62505.98,11,3,17,3,True
7839593,1334,3,451,9214,174756931,0,0,0,1045.27,7,61460.71,18,6,0,4,False
8419570,278,1,10,9413,174756931,0,0,0,1045.19,0,62505.9,24,5,9,6,True
8499690,44,4,30,6059,174756931,0,0,0,1045.18,8,61460.72,24,5,4,7,True
8935813,987,4,451,9173,174756931,0,0,0,1044.97,7,60415.75,22,2,16,7,True
9170008,1297,0,20,9328,174756931,0,0,0,1044.97,5,59370.78,5,0,1,8,True
9270926,987,4,-1,9328,174756931,0,1,0,1044.63,1,59370.78,22,6,7,8,True
9316345,987,4,-1,9328,174756931,0,2,0,1045.24,4,59370.78,22,4,22,8,True
9339256,44,4,-1,7212,174756931,0,3,1,1045.05,4,0.0,24,4,18,9,False
1014269,1262,0,10,3908,989786011,1,0,0,341.94,6,479810.94,23,2,10,1,True
1041658,267,0,30,5517,989786011,1,0,0,341.91,8,479469.03,6,0,3,1,True
1183678,1359,2,451,5566,989786011,1,0,0,342.37,7,479126.66,24,4,22,1,True
1515589,662,1,451,9010,989786011,1,0,0,341.8,7,478784.86,18,2,9,3,True
1750749,1451,1,30,9940,989786011,1,0,0,341.98,8,478442.88,11,1,8,3,True
2131711,1451,1,451,9010,989786011,1,0,0,341.79,7,478101.09,11,1,7,3,True
2755996,182,1,10,8526,989786011,1,0,0,342.09,0,478443.18,18,1,22,3,True
3030387,810,4,451,8526,989786011,1,0,0,341.97,7,478101.21,18,0,18,4,True
3121966,200,0,10,5700,989786011,1,0,0,342.04,6,478443.25,9,3,8,5,True
3186549,810,4,451,3956,989786011,1,0,0,342.08,7,478101.17,18,6,8,6,True
3623016,1451,1,30,3868,989786011,1,0,0,342.1,8,477759.07,11,1,23,6,True
3652723,254,0,20,7528,989786011,1,0,0,342.22,5,477416.85,6,5,0,6,False
3706138,1451,1,451,2770,989786011,1,0,0,342.24,7,477074.61,11,5,16,7,True
3788061,1359,2,451,5960,989786011,1,0,0,342.02,7,476732.59,24,6,0,8,True
4188440,267,0,451,9010,989786011,1,0,0,342.14,7,476390.45,6,5,9,9,True
4254856,135,2,20,9478,989786011,1,0,0,342.36,5,476048.09,18,2,2,9,True
4316358,810,4,25,6064,989786011,1,0,0,341.98,8,475706.11,18,6,10,9,True
4343997,1179,0,-1,1234,989786011,1,1,0,342.08,4,475706.11,24,0,21,10,True
4399370,498,0,20,6377,989786011,1,0,0,342.01,5,475364.1,12,5,11,10,True
4655504,267,0,451,3820,989786011,1,0,0,341.95,7,475022.15,6,5,3,12,True
4883536,267,0,25,1842,989786011,1,0,0,341.88,8,474680.27,6,2,14,12,True
4893384,687,0,10,9078,989786011,1,0,0,341.99,0,475022.26,24,5,3,12,True
5021252,1315,0,20,8629,989786011,1,0,0,341.99,3,474680.27,5,5,22,12,True
5207551,679,0,10,3908,989786011,1,0,0,341.86,0,475022.13,24,4,17,1,True
5340474,1451,1,451,5960,989786011,1,0,0,342.2,7,474679.93,11,4,17,2,True
5418751,810,4,451,3956,989786011,1,0,0,342.05,7,474337.88,18,0,21,2,False
5436217,1359,2,451,4485,989786011,1,0,0,341.91,7,473995.97,24,5,4,4,True
5725153,1179,0,451,4270,989786011,1,0,0,342.07,7,473653.9,24,0,13,4,True
5965000,1264,0,10,6064,989786011,1,0,0,342.12,6,473996.02,23,2,13,5,True
5979072,1435,2,20,1234,989786011,1,0,0,341.92,3,473654.1,24,0,3,5,True
5999138,1179,0,451,8629,989786011,1,0,0,342.13,7,473311.97,24,6,14,5,True
6054562,810,4,451,4270,989786011,1,0,0,341.88,7,472970.09,18,5,20,6,True
6503739,267,0,-1,8526,989786011,1,1,0,341.96,1,472970.09,6,1,6,7,True
6543896,1352,1,451,1842,989786011,1,0,0,342.07,7,472628.02,24,5,22,7,True
6665593,958,2,20,1234,989786011,1,0,0,341.84,5,472286.18,13,4,19,8,True
6742058,267,0,-1,9940,989786011,1,1,0,342.0,4,472286.18,6,2,1,10,True
6813431,810,4,451,7534,989786011,1,0,0,342.04,7,471944.14,18,2,3,11,True
7734927,1352,1,-1,6377,989786011,1,1,0,341.91,4,471944.14,24,0,4,12,True
7968256,148,1,10,6064,989786011,1,0,0,341.9,0,472286.04,18,2,17,12,True
8138573,1359,2,25,5960,989786011,1,0,0,342.18,8,471943.86,24,5,9,12,True
8211287,1359,2,-1,5517,989786011,1,1,0,341.73,4,471943.86,24,4,0,4,True
8218372,147,0,20,1842,989786011,1,0,0,342.01,5,471601.85,18,3,13,5,True
8433690,1352,1,-1,6377,989786011,1,1,0,342.05,4,471601.85,24,3,19,5,True
8472166,734,0,10,9078,989786011,1,0,0,342.07,6,471943.92,11,2,1,6,True
8609649,1352,1,30,1234,989786011,1,0,0,342.01,8,471601.91,24,5,17,6,True
8691102,1451,1,25,2826,989786011,1,0,0,341.82,8,471260.09,11,0,5,7,True
8882536,1451,1,30,6377,989786011,1,0,0,342.13,8,470917.96,11,1,13,7,True
8909681,834,0,20,7528,989786011,1,0,0,342.2,3,470575.76,5,4,1,7,True
9037717,1421,0,20,9700,989786011,1,0,0,342.28,3,470233.48,24,6,12,7,True
9040726,448,0,20,3691,989786011,1,0,0,342.26,5,469891.22,13,3,20,8,True
9145444,1359,2,30,9519,989786011,1,0,0,342.03,8,469549.19,24,1,14,9,True
9170319,1352,1,451,9078,989786011,1,0,0,341.61,7,469207.58,24,0,1,9,False
9170654,703,0,20,8757,989786011,1,0,0,341.82,5,468865.76,18,2,13,10,True
9317905,790,0,20,7705,989786011,1,0,0,342.12,5,468523.64,11,5,4,10,True
9417311,312,0,10,9700,989786011,1,0,0,341.88,6,468865.52,4,3,21,10,True
9421106,810,4,451,9700,989786011,1,0,0,341.92,7,468523.6,18,6,4,10,True
9568720,662,1,30,9261,989786011,1,0,0,341.97,8,468181.63,18,2,8,10,True
1642528,1252,4,-1,7874,900867232,0,1,0,592.99,4,239786.0,23,0,0,1,True
1708591,1137,1,10,2800,900867232,0,0,0,592.69,6,240378.69,24,4,13,1,True
1918339,665,2,20,4155,900867232,0,0,0,593.17,5,239785.52,18,3,15,1,True
1993544,1009,0,10,1115,900867232,0,0,0,593.04,6,240378.56,26,0,23,1,True
2163567,1252,4,25,9558,900867232,0,0,0,593.05,8,239785.51,23,0,11,1,True
2314244,560,2,30,2800,900867232,0,0,0,593.05,8,239192.46,17,2,2,5,True
2498516,498,0,25,8520,900867232,0,0,0,592.78,8,238599.68,12,1,9,8,True
2966782,428,0,10,8120,900867232,0,0,0,593.18,6,239192.86,18,4,11,8,True
3050372,1436,0,-1,8602,900867232,0,1,0,592.93,4,239192.86,24,1,1,9,True
3137078,348,0,10,7774,900867232,0,0,0,593.01,6,239785.87,24,6,16,9,False
3176258,1027,0,10,3763,900867232,0,0,0,592.96,6,240378.83,11,1,3,10,True
3292635,560,2,25,3763,900867232,0,0,0,592.74,8,239786.09,17,6,17,10,True
3294755,498,0,451,8120,900867232,0,0,0,593.25,7,239192.84,12,6,16,11,True
3450354,498,0,451,7561,900867232,0,0,0,592.93,7,238599.91,12,6,15,1,True
3828004,1436,0,451,8520,900867232,0,0,0,592.96,7,238006.95,24,4,13,1,True
3871435,866,0,20,9722,900867232,0,0,0,592.84,5,237414.11,24,6,21,2,True
4032693,1482,3,451,8322,900867232,0,0,0,592.91,7,236821.2,24,1,15,3,True
4226358,1406,0,20,8161,900867232,0,0,0,592.93,5,236228.27,24,2,9,3,True
4245278,1045,4,451,8602,900867232,0,0,0,593.13,7,235635.14,11,0,14,4,True
4370556,757,0,20,4307,900867232,0,0,0,592.98,5,235042.16,24,2,2,4,True
4459491,1192,2,20,4307,900867232,0,0,0,593.15,5,234449.01,24,6,16,5,True
4819543,1045,4,30,8120,900867232,0,0,0,592.96,8,233856.05,11,5,4,6,True
5007317,1436,0,451,5740,900867232,0,0,0,593.24,7,233262.81,24,1,23,8,True
5021362,502,0,20,8998,900867232,0,0,0,592.97,5,232669.84,12,0,19,8,True
5177395,184,0,20,8551,900867232,0,0,0,593.28,5,232076.56,18,1,2,9,True
5288215,1252,4,30,7070,900867232,0,0,0,592.79,8,231483.77,23,2,7,10,True
5302287,406,1,10,9938,900867232,0,0,0,592.67,6,232076.44,10,1,12,10,True
5898776,238,0,20,9722,900867232,0,0,0,593.15,5,231483.29,26,5,9,11,True
6103515,560,2,25,7774,900867232,0,0,0,593.04,8,230890.25,17,0,15,12,True
6247406,560,2,-1,8551,900867232,0,1,0,592.92,4,230890.25,17,5,23,12,True
6258680,498,0,30,8520,900867232,0,0,0,593.19,8,230297.06,12,4,14,1,True
6375698,1045,4,451,7504,900867232,0,0,0,592.95,7,229704.11,11,2,7,1,True
6459860,498,0,-1,1949,900867232,0,1,0,592.98,4,229704.11,12,4,19,2,True
6991376,1436,0,451,2703,900867232,0,0,0,593.09,7,229111.02,24,5,15,2,True
7004655,1482,3,451,9722,900867232,0,0,0,593.25,7,228517.77,24,0,14,3,True
7035793,549,1,10,8551,900867232,0,0,0,592.99,6,229110.76,17,3,17,3,True
7159304,51,0,20,7874,900867232,0,0,0,593.22,5,228517.54,20,1,10,3,True
7190332,1436,0,25,2800,900867232,0,0,0,593.28,8,227924.26,24,0,15,4,True
7440092,1436,0,451,7561,900867232,0,0,0,593.04,7,227331.22,24,2,20,4,True
7503154,1252,4,25,8520,900867232,0,0,0,592.84,8,226738.38,23,1,22,5,True
7532174,560,2,30,8998,900867232,0,0,0,592.71,8,226145.67,17,4,16,5,True
7743752,560,2,25,3932,900867232,0,0,0,593.15,8,225552.52,17,1,18,5,True
7751868,1045,4,25,8251,900867232,0,0,0,593.06,8,224959.46,11,4,4,5,True
8139415,679,0,10,8322,900867232,0,0,0,593.35,0,225552.81,24,6,9,6,True
8396719,1436,0,451,9722,900867232,0,0,0,593.06,7,224959.75,24,2,8,7,True
8415703,1045,4,30,9722,900867232,0,0,0,592.9,8,224366.85,11,1,15,7,True
8426295,560,2,-1,7874,900867232,0,1,0,592.86,4,224366.85,17,6,4,7,True
8501069,1482,3,451,7504,900867232,0,0,0,592.87,7,223773.98,24,5,22,9,True
8598901,1325,0,10,5740,900867232,0,0,0,592.94,6,224366.92,18,6,5,10,True
9130037,1252,4,-1,7774,900867232,0,1,0,593.06,4,224366.92,23,2,0,10,True
9553934,1482,3,25,5218,900867232,0,0,0,592.97,8,223773.95,24,2,17,10,True
9810719,804,0,10,5740,900867232,0,0,0,592.97,6,224366.92,11,5,12,11,True
1005390,1068,2,451,3839,542158484,1,0,0,428.95,7,837733.05,18,5,4,1,True
1092416,538,0,10,9285,542158484,1,0,0,428.82,0,838161.87,18,5,15,1,True
1098720,395,4,-1,7299,542158484,1,1,0,428.87,1,838161.87,10,3,13,2,True
1339881,1243,2,20,3839,542158484,1,0,0,428.87,5,837733.0,18,0,15,2,True
1406845,977,4,25,9267,542158484,1,0,0,429.13,8,837303.87,22,2,17,3,True
1525604,802,2,20,2336,542158484,1,0,0,428.91,5,836874.96,11,6,22,3,True
1613236,1043,4,451,4067,542158484,1,0,0,429.17,7,836445.79,11,3,20,4,True
1842957,132,2,20,2076,542158484,1,0,0,429.01,3,836016.78,18,3,14,4,False
2526617,977,4,451,1923,542158484,1,0,0,428.76,7,835588.02,22,6,9,5,True
2837020,949,4,451,1520,542158484,1,0,0,428.76,7,835159.26,24,6,8,5,True
2839559,879,1,10,3776,542158484,1,0,0,428.86,6,835588.12,27,0,10,5,True
3003767,949,4,30,1923,542158484,1,0,0,428.98,8,835159.14,24,5,3,5,False
3021227,977,4,25,3723,542158484,1,0,0,429.01,8,834730.13,22,4,0,7,True
3221487,642,0,20,8852,542158484,1,0,0,428.81,5,834301.32,24,4,13,8,True
3255705,1232,1,10,9285,542158484,1,0,0,428.94,6,834730.26,18,1,8,8,False
3550438,1068,2,25,5889,542158484,1,0,0,429.13,8,834301.13,18,5,8,10,False
3597949,977,4,451,3839,542158484,1,0,0,429.06,7,833872.07,22,4,17,12,False
3773022,816,0,10,1923,542158484,1,0,0,428.94,6,834301.01,18,0,2,12,True
3995684,443,2,20,9267,542158484,1,0,0,428.89,5,833872.12,24,5,19,12,True
4031645,989,1,30,2336,542158484,1,0,0,428.86,8,833443.26,22,2,17,12,True
4322785,1068,2,30,1379,542158484,1,0,0,428.96,8,833014.3,18,2,20,12,True
4756071,252,4,-1,9317,542158484,1,1,0,428.89,4,833014.3,6,6,7,1,True
5046262,861,4,30,4928,542158484,1,0,0,429.31,8,832584.99,24,2,0,1,True
5189123,76,0,20,3839,542158484,1,0,0,428.81,5,832156.18,20,4,22,1,True
5482278,977,4,25,8852,542158484,1,0,0,429.11,8,831727.07,22,2,14,2,True
5857018,861,4,-1,4558,542158484,1,1,0,428.94,4,831727.07,24,3,1,3,True
5889816,1043,4,451,4263,542158484,1,0,0,428.93,7,831298.14,11,3,3,4,True
6021366,395,4,30,2988,542158484,1,0,0,428.76,8,830869.38,10,0,8,5,True
6407800,395,4,451,4263,542158484,1,0,0,428.7,7,830440.68,10,2,10,5,True
6465196,949,4,30,4558,542158484,1,0,0,429.17,8,830011.51,24,5,12,7,True
6636370,1043,4,451,9317,542158484,1,0,0,428.93,7,829582.58,11,5,12,7,True
7009891,989,1,25,1379,542158484,1,0,0,428.92,8,829153.66,22,1,20,8,True
7044709,1483,0,10,4558,542158484,1,0,0,429.15,0,829582.81,24,3,14,8,True
7148484,989,1,-1,4006,542158484,1,1,0,429.29,4,829582.81,22,2,11,10,True
7262971,1169,0,30,3839,542158484,1,0,0,428.94,8,829153.87,24,2,13,10,True
7485967,1068,2,25,9267,542158484,1,0,0,428.9,8,828724.97,18,6,20,11,True
7592009,428,0,20,2336,542158484,1,0,0,429.31,5,828295.66,18,2,11,12,True
7697852,27,0,20,8852,542158484,1,0,0,429.01,3,827866.65,11,2,19,12,True
7776036,977,4,30,4928,542158484,1,0,0,428.84,8,827437.81,22,4,9,1,True
7807010,53,0,20,7092,542158484,1,0,0,429.04,3,827008.77,20,0,2,2,True
7817613,1169,0,25,9285,542158484,1,0,0,428.88,8,826579.89,24,1,7,3,True
7870281,621,2,20,5138,542158484,1,0,0,428.9,3,826150.99,11,0,0,3,True
7956527,252,4,451,3776,542158484,1,0,0,429.14,7,825721.85,6,6,20,3,True
8017483,861,4,-1,3363,542158484,1,1,0,429.15,4,825721.85,24,4,18,3,True
8034811,558,0,20,4067,542158484,1,0,0,428.81,5,825293.04,17,5,20,4,True
8221349,977,4,25,2665,542158484,1,0,0,429.11,8,824863.93,22,0,22,4,True
8266467,395,4,30,9285,542158484,1,0,0,428.75,8,824435.18,10,0,7,5,True
8313167,1159,0,10,9932,542158484,1,0,0,428.79,6,824863.97,15,5,6,6,True
8796514,1233,0,10,5889,542158484,1,0,0,428.8,6,825292.77,18,2,0,7,False
8832331,1277,2,20,1923,542158484,1,0,0,428.77,5,824864.0,24,3,17,7,True
9715731,949,4,-1,4263,542158484,1,1,0,428.97,4,824864.0,24,1,20,8,True
9776753,1043,4,30,1923,542158484,1,0,0,428.85,8,824435.15,11,0,21,9,True
9789327,429,0,10,3776,542158484,1,0,0,429.16,0,824864.31,24,6,18,9,False
9828618,949,4,451,6220,542158484,1,0,0,428.72,7,824435.59,24,4,17,10,True
9843067,949,4,25,9317,542158484,1,0,0,428.8,8,824006.79,24,2,12,11,True
9884082,395,4,451,7092,542158484,1,0,0,428.93,7,823577.86,10,4,7,11,True
1592954,373,1,451,2485,833240327,0,0,0,235.0,7,998715.0,25,1,13,1,True
1705643,373,1,25,9194,833240327,0,0,0,235.01,8,998479.99,25,5,8,2,True
1825988,1120,4,451,5908,833240327,0,0,0,234.99,7,998245.0,24,6,11,3,True
2440099,804,0,451,7562,833240327,0,0,0,235.27,7,998009.73,11,6,2,4,True
2533428,1183,4,451,2023,833240327,0,0,0,235.09,7,997774.64,24,1,11,4,True
2874765,1159,0,10,2023,833240327,0,0,0,235.08,0,998009.72,15,3,12,4,True
3194560,1475,3,30,6479,833240327,0,0,0,234.92,8,997774.8,24,1,15,5,True
3198250,944,2,451,6714,833240327,0,0,0,235.2,7,997539.6,24,4,3,7,True
3205427,618,3,451,4575,833240327,0,0,0,234.81,7,997304.79,11,4,20,7,True
3245044,1475,3,451,8307,833240327,0,0,0,235.13,7,997069.66,24,3,14,8,True
3728446,373,1,25,5908,833240327,0,0,0,234.79,8,996834.87,25,0,22,8,True
3924155,1019,0,20,2583,833240327,0,0,0,235.13,5,996599.74,26,2,0,10,True
4326894,1183,4,-1,6714,833240327,0,1,0,234.98,4,996599.74,24,4,1,11,True
4907712,393,1,-1,8654,833240327,0,2,0,234.89,4,996599.74,10,2,18,11,True
4957486,804,0,451,3198,833240327,0,0,0,234.9,7,996364.84,11,3,8,11,True
4967018,944,2,30,5299,833240327,0,0,0,235.11,8,996129.73,24,0,18,11,True
5017886,1475,3,25,5299,833240327,0,0,0,235.11,8,995894.62,24,4,18,1,True
5256837,1120,4,25,6063,833240327,0,0,0,234.96,8,995659.66,24,5,19,1,True
5340187,774,2,20,6479,833240327,0,0,0,235.03,5,995424.63,14,6,22,1,False
5413863,1475,3,451,5908,833240327,0,0,0,234.98,7,995189.65,24,4,1,2,False
5478482,944,2,25,3198,833240327,0,0,0,235.09,8,994954.56,24,5,15,2,True
5482238,1120,4,30,2023,833240327,0,0,0,235.04,8,994719.52,24,6,0,2,True
5493804,1183,4,30,8654,833240327,0,0,0,234.94,8,994484.58,24,2,9,4,True
5659365,1475,3,30,8654,833240327,0,0,0,235.25,8,994249.33,24,1,5,4,True
5676487,1120,4,25,2400,833240327,0,0,0,234.89,8,994014.44,24,0,0,5,True
6277828,116,0,20,6063,833240327,0,0,0,235.2,5,993779.24,3,6,22,5,True
6344881,551,0,20,6714,833240327,0,0,0,235.18,5,993544.06,17,2,12,6,False
6350237,373,1,30,2620,833240327,0,0,0,235.04,8,993309.02,25,3,23,6,True
6361807,944,2,25,2620,833240327,0,0,0,234.82,8,993074.2,24,3,2,7,True
6581940,267,0,10,2400,833240327,0,0,0,234.84,6,993309.04,6,3,13,8,True
6775138,1183,4,30,4575,833240327,0,0,0,235.16,8,993073.88,24,0,0,8,True
6906562,550,0,10,2400,833240327,0,0,0,234.95,6,993308.83,17,0,16,9,True
6943340,649,0,25,2620,833240327,0,0,0,235.0,8,993073.83,24,2,18,11,True
6987904,785,0,10,5299,833240327,0,0,0,234.96,6,993308.79,14,1,2,11,True
7151785,649,0,20,2583,833240327,0,0,0,235.22,3,993073.57,24,0,3,12,True
7275488,260,0,10,2400,833240327,0,0,0,235.01,6,993308.58,6,6,14,1,True
7480306,1183,4,30,4575,833240327,0,0,0,235.18,8,993073.4,24,4,6,2,True
7609814,1183,4,25,9129,833240327,0,0,0,235.03,8,992838.37,24,4,20,3,True
7635893,1475,3,451,8654,833240327,0,0,0,235.2,7,992603.17,24,6,13,3,True
7917539,1061,2,20,6714,833240327,0,0,0,235.01,5,992368.16,11,4,0,3,True
8089237,1475,3,25,9129,833240327,0,0,0,234.99,8,992133.17,24,0,23,5,True
8218484,1120,4,451,3198,833240327,0,0,0,234.87,7,991898.3,24,5,7,5,True
8312455,1475,3,451,4575,833240327,0,0,0,234.86,7,991663.44,24,2,22,7,True
8680749,393,1,-1,6423,833240327,0,1,0,235.01,4,991663.44,10,6,6,8,True
8688318,649,0,25,2400,833240327,0,0,0,235.17,8,991428.27,24,4,18,8,True
8795214,618,3,25,2620,833240327,0,0,0,235.24,8,991193.03,11,2,3,9,True
8811344,1183,4,451,5908,833240327,0,0,0,234.84,7,990958.19,24,0,4,9,True
8946598,618,3,30,6714,833240327,0,0,0,235.2,8,990722.99,11,0,21,9,False
9011950,1382,0,20,8654,833240327,0,0,0,234.8,3,990488.19,16,3,0,10,False
9163801,27,0,20,7493,833240327,0,0,0,235.16,5,990253.03,11,2,7,11,True
9779848,373,1,451,8654,833240327,0,0,0,234.77,7,990018.26,25,3,2,11,True
9907129,914,2,20,6714,833240327,0,0,0,234.85,5,989783.41,18,2,22,11,True
1083708,584,0,10,2815,113952064,0,0,0,1122.92,0,443920.92,11,4,1,2,False
1240121,631,3,-1,6411,113952064,0,1,0,1123.12,4,443920.92,11,4,16,2,True
1390399,56,4,451,9810,113952064,0,0,0,1123.05,7,442797.87,20,6,7,2,True
1593636,1068,2,20,5509,113952064,0,0,0,1123.04,5,441674.83,18,0,5,3,True
2007404,1353,4,25,4492,113952064,0,0,0,1123.08,8,440551.75,24,4,20,4,True
2035054,1488,0,-1,4253,113952064,0,1,0,1123.03,4,440551.75,24,1,17,5,True
2088926,274,1,451,2513,113952064,0,0,0,1123.28,7,439428.47,24,3,1,5,False
2335591,117,1,30,5685,113952064,0,0,0,1122.71,8,438305.76,18,6,14,7,True
2337019,935,1,30,8095,113952064,0,0,0,1123.13,8,437182.63,24,4,2,8,True
2447791,1488,0,451,2815,113952064,0,0,0,1122.82,7,436059.81,24,4,23,9,True
2470678,1488,0,451,8048,113952064,0,0,0,1123.15,7,434936.66,24,5,8,10,True
2517067,56,4,451,4446,113952064,0,0,0,1122.72,7,433813.94,20,6,22,11,True
2536665,854,0,451,8579,113952064,0,0,0,1123.0,7,432690.94,24,6,17,12,False
2583082,631,3,25,8048,113952064,0,0,0,1123.06,8,431567.88,11,0,12,1,True
2723662,274,1,30,5685,113952064,0,0,0,1123.02,8,430444.86,24,6,11,2,True
2830889,274,1,-1,6411,113952064,0,1,0,1123.06,1,430444.86,24,3,7,2,True
2982377,274,1,451,8048,113952064,0,0,0,1123.07,7,429321.79,24,1,10,3,True
3006145,274,1,30,2473,113952064,0,0,0,1123.13,8,428198.66,24,2,9,4,True
3112343,631,3,-1,8650,113952064,0,1,0,1122.93,4,428198.66,11,1,9,4,True
3381066,631,3,451,9810,113952064,0,0,0,1123.0,7,427075.66,11,6,7,5,True
3414390,854,0,25,6411,113952064,0,0,0,1123.13,8,425952.53,24,1,17,5,True
3464434,1353,4,30,8339,113952064,0,0,0,1122.71,8,424829.82,24,0,14,5,True
3554365,56,4,30,2473,113952064,0,0,0,1122.78,8,423707.04,20,0,11,5,True
3582382,274,1,451,5040,113952064,0,0,0,1122.93,7,422584.11,24,3,5,6,True
3874923,76,0,20,4253,113952064,0,0,0,1122.93,3,421461.18,20,5,21,6,True
4506395,274,1,451,5509,113952064,0,0,0,1123.12,7,420338.06,24,0,23,7,True
4651058,935,1,451,8048,113952064,0,0,0,1123.2,7,419214.86,24,3,22,8,True
4804593,631,3,25,3588,113952064,0,0,0,1122.89,8,418091.97,11,4,23,8,True
4806117,369,1,10,2473,113952064,0,0,0,1123.15,0,419215.12,25,5,19,8,True
4837327,854,0,30,8048,113952064,0,0,0,1123.06,8,418092.06,24,4,0,9,True
4973823,56,4,451,8207,113952064,0,0,0,1122.91,7,416969.15,20,0,17,10,True
5087730,274,1,30,9810,113952064,0,0,0,1123.06,8,415846.09,24,0,8,10,True
5114395,184,0,10,8339,113952064,0,0,0,1123.15,6,416969.24,18,0,10,10,True
5622832,117,1,451,4446,113952064,0,0,0,1122.96,7,415846.28,18,2,16,10,True
5665378,631,3,30,3588,113952064,0,0,0,1123.04,8,414723.24,11,4,23,10,True
6031697,56,4,451,4492,113952064,0,0,0,1123.01,7,413600.23,20,6,14,1,True
6160442,935,1,-1,8339,113952064,0,1,0,1123.28,1,413600.23,24,3,21,1,True
6187736,56,4,451,6411,113952064,0,0,0,1123.28,7,412476.95,20,1,21,1,True
6425729,631,3,30,8048,113952064,0,0,0,1123.11,8,411353.84,11,5,5,2,True
6460563,1231,2,20,4446,113952064,0,0,0,1123.03,5,410230.81,18,1,17,3,True
6571154,1353,4,451,8650,113952064,0,0,0,1122.84,7,409107.97,24,3,17,3,True
6651503,168,0,20,9810,113952064,0,0,0,1123.28,3,407984.69,24,6,15,3,True
6939075,1488,0,30,8207,113952064,0,0,0,1123.14,8,406861.55,24,1,2,3,True
7083681,854,0,451,4446,113952064,0,0,0,1123.02,7,405738.53,24,1,8,4,True
7327203,1488,0,30,6411,113952064,0,0,0,1122.91,8,404615.62,24,5,6,4,True
7627877,205,0,20,3588,113952064,0,0,0,1123.21,5,403492.41,9,4,10,5,True
7723510,1353,4,451,2873,113952064,0,0,0,1123.02,7,402369.39,24,4,8,6,True
7742813,1353,4,25,8650,113952064,0,0,0,1123.04,8,401246.35,24,6,16,6,True
7827171,117,1,25,9810,113952064,0,0,0,1123.08,8,400123.27,18,0,5,7,True
7893080,854,0,-1,9810,113952064,0,1,0,1122.74,4,400123.27,24,4,16,7,True
7970092,148,1,10,5728,113952064,0,0,0,1122.93,0,401246.2,18,2,13,8,True
8117063,249,0,20,5728,113952064,0,0,0,1123.19,5,400123.01,6,4,8,8,True
8441886,56,4,-1,4253,113952064,0,1,0,1123.16,1,400123.01,20,6,6,8,True
8533416,935,1,30,2873,113952064,0,0,0,1122.87,8,399000.14,24,6,8,8,True
8614679,631,3,30,8048,113952064,0,0,0,1122.99,8,397877.15,11,2,8,8,True
8852446,1314,2,20,3588,113952064,0,0,0,1122.96,5,396754.19,5,3,22,9,True
8913544,56,4,30,5685,113952064,0,0,0,1123.18,8,395631.01,20,1,11,10,True
8977324,1488,0,451,8095,113952064,0,0,0,1123.11,7,394507.9,24,0,15,11,True
9935460,935,1,25,8579,113952064,0,0,0,1122.82,8,393385.08,24,2,16,11,True
1034276,1459,1,451,7255,767968568,0,0,0,910.17,7,73138.83,11,4,3,1,True
1381144,1459,1,25,4524,767968568,0,0,0,909.9,8,72228.93,11,0,17,1,True
1590396,216,4,25,4959,767968568,0,0,0,910.04,8,71318.89,9,1,9,2,False
1663932,1159,0,30,9222,767968568,0,0,0,909.89,8,70409.0,15,6,16,3,True
1839207,216,4,30,5105,767968568,0,0,0,910.23,8,69498.77,9,1,7,3,True
1881098,1459,1,451,9208,767968568,0,0,0,910.02,7,68588.75,11,3,0,3,False
1881658,859,2,30,2087,767968568,0,0,0,909.96,8,67678.79,24,4,8,4,True
1940913,1429,0,10,8567,767968568,0,0,0,910.05,0,68588.84,24,0,17,4,True
2253930,72,4,25,5105,767968568,0,0,0,910.07,8,67678.77,20,4,19,4,True
2333595,859,2,451,5012,767968568,0,0,0,910.01,7,66768.76,24,1,21,5,True
2456215,1014,1,10,3276,767968568,0,0,0,909.89,0,67678.65,26,0,5,6,True
2747687,72,4,25,9222,767968568,0,0,0,910.0,8,66768.65,20,1,3,6,True
2791253,1459,1,30,1360,767968568,0,0,0,909.91,8,65858.74,11,4,2,6,True
2856375,1041,0,20,2356,767968568,0,0,0,909.86,3,64948.88,11,2,21,7,True
2992185,859,2,451,5078,767968568,0,0,0,909.9,7,64038.98,24,1,15,7,True
3158102,216,4,-1,8327,767968568,0,1,0,910.31,1,64038.98,9,1,18,9,True
3330755,373,1,30,8567,767968568,0,0,0,910.07,8,63128.91,25,2,20,10,True
3637926,1159,0,30,6600,767968568,0,0,0,909.99,8,62218.92,15,0,21,10,True
3760707,1159,0,-1,9208,767968568,0,1,0,909.76,4,62218.92,15,5,23,11,True
3777991,72,4,451,5241,767968568,0,0,0,910.17,7,61308.75,20,1,1,11,True
3792685,72,4,451,9178,767968568,0,0,0,909.79,7,60398.96,20,2,1,11,True
3901606,1459,1,-1,4959,767968568,0,1,0,909.92,4,60398.96,11,0,3,12,True
4340943,72,4,25,2294,767968568,0,0,0,909.92,8,59489.04,20,1,18,12,False
4532208,1159,0,451,2087,767968568,0,0,0,909.91,7,58579.13,15,2,1,12,True
4733851,1459,1,451,5241,767968568,0,0,0,910.02,7,57669.11,11,3,10,2,True
4813158,889,0,20,7386,767968568,0,0,0,910.21,3,56758.9,27,1,3,3,True
5040502,687,0,10,8327,767968568,0,0,0,909.85,6,57668.75,24,4,5,3,True
5180752,208,0,20,5078,767968568,0,0,0,909.86,5,56758.89,9,5,0,3,True
5443908,216,4,25,4181,767968568,0,0,0,910.32,8,55848.57,9,0,18,6,True
5721505,72,4,25,7255,767968568,0,0,0,909.83,8,54938.74,20,2,15,8,True
5778373,373,1,-1,4524,767968568,0,1,0,910.24,1,54938.74,25,3,2,8,True
6396063,72,4,451,5078,767968568,0,0,0,910.23,7,54028.51,20,4,3,9,True
6469719,318,0,10,8327,767968568,0,0,0,910.17,6,54938.68,11,1,14,10,True
6527214,346,0,10,4524,767968568,0,0,0,909.91,6,55848.59,24,1,0,10,True
6581901,859,2,451,2087,767968568,0,0,0,910.04,7,54938.55,24,2,14,11,True
6706483,216,4,451,5078,767968568,0,0,0,910.16,7,54028.39,9,5,9,11,True
6784954,1206,0,20,9178,767968568,0,0,0,910.09,5,53118.3,24,2,5,11,True
6804699,553,1,451,4524,767968568,0,0,0,909.93,7,52208.37,17,6,7,12,True
6857566,1459,1,451,2087,767968568,0,0,0,910.12,7,51298.25,11,4,2,1,True
6870456,216,4,451,1360,767968568,0,0,0,910.37,7,50387.88,9,0,8,3,True
6873414,859,2,25,9777,767968568,0,0,0,910.12,8,49477.76,24,2,7,3,True
6992759,703,0,20,5078,767968568,0,0,0,909.99,5,48567.77,18,3,6,4,True
6994590,1164,0,10,8896,767968568,0,0,0,909.95,0,49477.72,24,1,20,4,True
7099408,373,1,25,3863,767968568,0,0,0,910.09,8,48567.63,25,5,19,6,True
7370664,373,1,451,9777,767968568,0,0,0,910.08,7,47657.55,25,1,15,7,True
7533058,373,1,25,4181,767968568,0,0,0,910.11,8,46747.44,25,2,8,7,True
7659116,72,4,451,3988,767968568,0,0,0,910.11,7,45837.33,20,6,3,8,True
8154303,72,4,451,9208,767968568,0,0,0,909.99,7,44927.34,20,6,8,8,True
8857327,599,0,20,1684,767968568,0,0,0,909.99,5,44017.35,24,6,9,8,True
9438523,1159,0,451,8567,767968568,0,0,0,909.97,7,43107.38,15,0,23,8,True
9753539,553,1,25,2356,767968568,0,0,0,910.01,8,42197.37,17,3,0,9,True
9813861,553,1,25,4959,767968568,0,0,0,909.76,8,41287.61,17,1,21,10,True
9822263,1102,2,20,3988,767968568,0,0,0,909.94,5,40377.67,0,6,19,11,True
9967330,373,1,25,1684,767968568,0,0,0,909.77,8,39467.9,25,6,7,11,True
1074552,266,2,25,5076,694568427,0,0,0,751.99,8,747345.01,6,2,21,1,True
1078116,328,0,10,1999,694568427,0,0,0,752.01,0,748097.02,11,4,20,1,False
1231579,820,1,10,6987,694568427,0,0,0,751.98,6,748849.0,18,5,19,1,True
1234894,1249,2,20,9185,694568427,0,0,0,752.1,3,748096.9,23,3,0,2,True
1357101,866,0,-1,9185,694568427,0,1,0,752.17,4,748096.9,24,5,12,3,True
1492324,787,0,451,2945,694568427,0,0,0,752.21,7,747344.69,14,6,18,5,True
1527729,819,2,25,1999,694568427,0,0,0,751.91,8,746592.78,18,6,13,6,True
2054023,1400,3,30,5438,694568427,0,0,0,751.88,8,745840.9,24,6,0,7,True
2187210,20,0,20,1999,694568427,0,0,0,752.21,3,745088.69,24,3,14,7,True
2227341,647,4,30,2945,694568427,0,0,0,752.29,8,744336.4,24,4,17,7,True
2606983,685,3,25,5265,694568427,0,0,0,752.03,8,743584.37,24,0,23,8,True
2732581,579,0,20,4349,694568427,0,0,0,751.94,5,742832.43,11,0,18,9,True
2862905,1400,3,451,1999,694568427,0,0,0,751.92,7,742080.51,24,0,19,9,True
2887188,647,4,451,6987,694568427,0,0,0,751.94,7,741328.57,24,0,16,12,True
3021454,1400,3,25,2401,694568427,0,0,0,752.02,8,740576.55,24,3,18,12,True
3028290,1400,3,451,1311,694568427,0,0,0,751.89,7,739824.66,24,6,16,12,True
3342141,979,0,20,3498,694568427,0,0,0,751.75,5,739072.91,22,5,15,12,True
3399128,819,2,451,5265,694568427,0,0,0,752.0,7,738320.91,18,5,0,1,True
3823159,819,2,451,4433,694568427,0,0,0,751.94,7,737568.97,18,5,22,2,True
3950186,647,4,30,5265,694568427,0,0,0,751.8,8,736817.17,24,4,8,2,True
4223287,754,4,25,2145,694568427,0,0,0,751.74,8,736065.43,24,5,0,2,True
4684570,1255,0,20,5265,694568427,0,0,0,751.99,3,735313.44,23,4,6,3,True
4705002,783,0,20,2945,694568427,0,0,0,752.05,5,734561.39,14,2,7,3,True
4741562,266,2,-1,2401,694568427,0,1,0,752.09,1,734561.39,6,3,19,3,True
4920956,204,0,20,4433,694568427,0,0,0,751.82,5,733809.57,9,4,2,4,True
4924785,685,3,-1,5265,694568427,0,1,0,752.02,1,733809.57,24,6,22,5,True
4946737,647,4,25,9443,694568427,0,0,0,751.99,8,733057.58,24,6,7,6,True
5037555,178,4,30,1017,694568427,0,0,0,752.1,8,732305.48,24,6,23,9,True
5126649,819,2,30,7004,694568427,0,0,0,751.76,8,731553.72,18,2,2,10,True
5153941,647,4,30,9185,694568427,0,0,0,752.34,8,730801.38,24,6,16,10,True
5269147,819,2,-1,1017,694568427,0,1,0,751.95,4,730801.38,18,5,19,11,True
5583315,866,0,30,9185,694568427,0,0,0,752.3,8,730049.08,24,4,7,11,True
5672902,819,2,451,5076,694568427,0,0,0,751.61,7,729297.47,18,3,0,12,True
5905774,266,2,30,3382,694568427,0,0,0,752.01,8,728545.46,6,6,3,12,True
6630139,819,2,25,5076,694568427,0,0,0,752.11,8,727793.35,18,4,6,1,True
6668205,787,0,30,9443,694568427,0,0,0,752.26,8,727041.09,14,5,16,1,True
6885993,531,0,20,2740,694568427,0,0,0,751.76,5,726289.33,18,5,12,3,True
6888791,819,2,451,4433,694568427,0,0,0,752.04,7,725537.29,18,1,12,3,True
7121485,729,0,10,8973,694568427,0,0,0,752.19,0,726289.48,11,5,5,3,True
7569686,178,4,25,3498,694568427,0,0,0,752.04,8,725537.44,24,0,16,4,True
7591372,996,0,20,5363,694568427,0,0,0,751.82,5,724785.62,26,0,0,6,True
7725545,787,0,451,5265,694568427,0,0,0,752.1,7,724033.52,14,1,2,6,True
7803684,1400,3,25,7004,694568427,0,0,0,752.06,8,723281.46,24,4,14,6,True
7966848,299,1,10,2401,694568427,0,0,0,751.96,6,724033.42,4,2,14,6,True
8108739,266,2,-1,4470,694568427,0,1,0,752.14,4,724033.42,6,2,2,8,True
8839885,312,0,20,1017,694568427,0,0,0,751.88,5,723281.54,4,3,21,8,True
9049213,1400,3,-1,3498,694568427,0,1,0,752.21,1,723281.54,24,4,21,9,True
9134356,787,0,451,8973,694568427,0,0,0,752.11,7,722529.43,14,6,3,9,False
9308506,819,2,451,1311,694568427,0,0,0,752.04,7,721777.39,18,2,1,9,True
9553314,819,2,451,1311,694568427,0,0,0,752.31,7,721025.08,18,4,2,11,True
9854900,178,4,30,3382,694568427,0,0,0,751.97,8,720273.11,24,4,18,11,True
9956831,1400,3,-1,7486,694568427,0,1,0,751.88,1,720273.11,24,0,7,11,True
1264533,799,2,451,4018,761889942,1,0,0,982.04,7,87714.96,11,5,9,1,True
1648099,520,4,-1,5211,761889942,1,1,0,981.58,4,87714.96,18,6,14,2,True
1759085,1312,0,451,6996,761889942,1,0,0,982.1,7,86732.86,5,3,15,2,True
1804410,318,0,-1,2650,761889942,1,1,0,981.93,4,86732.86,11,5,18,2,True
1868003,573,0,20,5079,761889942,1,0,0,981.97,3,85750.89,11,0,18,2,True
1981564,318,0,-1,1139,761889942,1,1,0,981.99,4,85750.89,11,4,15,4,True
2217690,318,0,451,5276,761889942,1,0,0,981.8,7,84769.09,11,5,12,4,True
2560334,799,2,451,5955,761889942,1,0,0,982.17,7,83786.92,11,0,18,5,True
3025694,799,2,451,3853,761889942,1,0,0,982.02,7,82804.9,11,1,14,6,True
3425273,1312,0,451,2650,761889942,1,0,0,981.65,7,81823.25,5,4,14,6,True
3460043,318,0,30,6050,761889942,1,0,0,982.09,8,80841.16,11,1,8,7,True
3540638,318,0,-1,5211,761889942,1,1,0,981.95,4,80841.16,11,1,20,8,True
3554407,318,0,451,6050,761889942,1,0,0,982.12,7,79859.04,11,6,12,9,True
3664140,1354,0,10,4450,761889942,1,0,0,981.75,6,80840.79,24,6,10,9,True
3675970,224,3,30,5079,761889942,1,0,0,982.15,8,79858.64,26,2,10,9,False
3723235,799,2,-1,5276,761889942,1,1,0,981.99,1,79858.64,11,4,21,9,True
3859352,1021,4,30,7161,761889942,1,0,0,981.99,8,78876.65,11,2,18,9,True
4431398,1021,4,451,5079,761889942,1,0,0,981.83,7,77894.82,11,3,6,9,True
4663957,318,0,25,6791,761889942,1,0,0,982.15,8,76912.67,11,6,2,11,True
4716776,918,2,20,3050,761889942,1,0,0,982.05,5,75930.62,18,5,15,11,True
4738590,1298,0,10,4018,761889942,1,0,0,982.19,6,76912.81,5,0,4,12,True
4834402,95,2,30,8498,761889942,1,0,0,982.06,8,75930.75,1,4,4,12,True
5000345,1307,0,10,4018,761889942,1,0,0,982.04,6,76912.79,5,6,9,1,True
5167183,695,2,20,5211,761889942,1,0,0,981.96,5,75930.83,24,6,23,1,True
5327927,1312,0,-1,5276,761889942,1,1,0,981.93,1,75930.83,5,3,9,1,True
5417767,520,4,451,1652,761889942,1,0,0,981.79,7,74949.04,18,1,1,3,True
5522092,1312,0,451,5276,761889942,1,0,0,982.01,7,73967.03,5,6,21,4,True
5598562,520,4,451,1652,761889942,1,0,0,981.96,7,72985.07,18,5,12,6,True
5720214,318,0,451,6050,761889942,1,0,0,981.9,7,72003.17,11,4,22,8,True
5738201,898,1,25,6050,761889942,1,0,0,982.11,8,71021.06,24,2,22,8,True
5964301,1312,0,451,5079,761889942,1,0,0,981.74,7,70039.32,5,1,0,9,True
5999384,520,4,30,3265,761889942,1,0,0,981.76,8,69057.56,18,5,0,9,True
6146871,228,0,20,3853,761889942,1,0,0,981.98,5,68075.58,26,6,0,9,True
6302792,394,0,20,1724,761889942,1,0,0,982.17,5,67093.41,10,6,1,9,True
6487441,95,2,451,2650,761889942,1,0,0,982.01,7,66111.4,1,4,5,10,True
6542139,520,4,25,6791,761889942,1,0,0,981.84,8,65129.56,18,6,7,10,True
6625867,799,2,25,8498,761889942,1,0,0,981.77,8,64147.79,11,4,17,10,True
6863553,312,0,20,6791,761889942,1,0,0,982.18,5,63165.61,4,3,14,11,True
7008322,34,1,10,8498,761889942,1,0,0,981.93,6,64147.54,11,2,13,11,True
7116654,95,2,451,1139,761889942,1,0,0,981.98,7,63165.56,1,5,19,12,True
7412906,520,4,30,4450,761889942,1,0,0,982.11,8,62183.45,18,2,3,1,True
7471100,520,4,451,5211,761889942,1,0,0,981.88,7,61201.57,18,2,2,2,True
7519959,520,4,30,8498,761889942,1,0,0,981.78,8,60219.79,18,0,3,2,True
7624128,480,0,10,2650,761889942,1,0,0,982.35,6,61202.14,5,1,0,2,True
7651720,1471,0,20,5276,761889942,1,0,0,981.91,5,60220.23,24,3,16,3,True
7892001,95,2,451,7161,761889942,1,0,0,982.03,7,59238.2,1,3,13,4,True
7909608,898,1,451,5955,761889942,1,0,0,982.13,7,58256.07,24,0,5,4,True
7971659,792,1,10,5079,761889942,1,0,0,982.02,6,59238.09,11,3,17,5,True
8076129,520,4,451,5079,761889942,1,0,0,981.87,7,58256.22,18,4,8,5,True
8246012,318,0,25,3853,761889942,1,0,0,982.02,8,57274.2,11,2,18,7,True
8432664,641,0,20,1652,761889942,1,0,0,981.9,5,56292.3,24,5,10,8,True
8717167,95,2,30,2650,761889942,1,0,0,982.55,8,55309.75,1,1,8,8,True
8760385,520,4,451,5211,761889942,1,0,0,982.0,7,54327.75,18,0,1,8,True
9090162,520,4,30,5276,761889942,1,0,0,982.22,8,53345.53,18,2,13,8,True
9645904,1345,2,20,3853,761889942,1,0,0,981.97,5,52363.56,24,3,21,9,True
9661059,318,0,-1,5276,761889942,1,1,0,981.92,4,52363.56,11,3,16,9,True
9749404,275,0,20,3265,761889942,1,0,0,981.79,5,51381.77,24,6,17,10,True
9772329,95,2,451,1139,761889942,1,0,0,981.95,7,50399.82,1,6,6,10,True
9781290,224,3,451,3853,761889942,1,0,0,981.81,7,49418.01,26,6,19,10,True
1141688,480,0,25,4959,248884997,1,0,0,1086.02,8,596431.98,5,3,13,2,True
1295870,279,2,451,3284,248884997,1,0,0,1086.11,7,595345.87,24,0,15,3,True
1574531,279,2,451,8771,248884997,1,0,0,1086.08,7,594259.79,24,5,10,3,False
1801776,1124,0,10,8733,248884997,1,0,0,1085.99,0,595345.78,24,0,22,3,True
1841634,255,2,451,8083,248884997,1,0,0,1085.96,7,594259.82,6,3,20,4,True
1904896,279,2,25,1134,248884997,1,0,0,1086.02,8,593173.8,24,2,5,4,True
1984665,390,4,451,1574,248884997,1,0,0,1085.63,7,592088.17,10,5,12,4,True
2140081,480,0,-1,6757,248884997,1,1,0,1085.73,1,592088.17,5,4,8,5,True
2192017,1406,0,10,4247,248884997,1,0,0,1086.17,6,593174.34,24,5,6,5,True
2504677,1262,0,20,3826,248884997,1,0,0,1086.32,5,592088.02,23,2,16,6,True
2598681,1203,4,451,8733,248884997,1,0,0,1086.18,7,591001.84,24,1,3,7,True
3358703,390,4,25,4959,248884997,1,0,0,1085.77,8,589916.07,10,4,11,8,True
3511812,844,1,25,8083,248884997,1,0,0,1086.03,8,588830.04,5,3,20,9,True
3689421,844,1,451,8851,248884997,1,0,0,1085.94,7,587744.1,5,1,14,9,True
3757123,844,1,451,8771,248884997,1,0,0,1086.06,7,586658.04,5,2,20,9,True
3849120,844,1,451,8083,248884997,1,0,0,1085.88,7,585572.16,5,6,15,10,True
4038603,132,2,20,4759,248884997,1,0,0,1086.07,5,584486.09,18,3,13,10,True
4101547,655,3,451,3826,248884997,1,0,0,1085.94,7,583400.15,18,1,22,10,True
4376917,279,2,451,8083,248884997,1,0,0,1086.02,7,582314.13,24,6,7,11,True
4514857,655,3,25,4759,248884997,1,0,0,1086.02,8,581228.11,18,0,7,11,True
4908354,1228,4,-1,8793,248884997,1,1,0,1086.1,4,581228.11,18,6,22,1,True
5076347,390,4,-1,6757,248884997,1,2,0,1086.04,4,581228.11,10,0,8,1,True
5193916,880,1,10,8733,248884997,1,0,0,1085.89,0,582314.0,27,5,2,2,True
5307363,698,4,25,6757,248884997,1,0,0,1085.68,8,581228.32,18,1,1,3,True
5388120,572,0,10,4759,248884997,1,0,0,1086.22,0,582314.54,11,6,3,3,True
5473458,698,4,451,6757,248884997,1,0,0,1085.79,7,581228.75,18,4,1,4,True
5660825,1226,2,20,8733,248884997,1,0,0,1086.03,3,580142.72,18,4,15,4,True
5697068,480,0,451,5955,248884997,1,0,0,1086.2,7,579056.52,5,4,23,4,True
5930613,279,2,451,4247,248884997,1,0,0,1086.0,7,577970.52,24,3,18,5,True
6119358,929,0,20,4247,248884997,1,0,0,1086.12,5,576884.4,18,1,21,7,True
6167813,1203,4,30,8793,248884997,1,0,0,1085.91,8,575798.49,24,6,22,7,True
6424333,655,3,30,6757,248884997,1,0,0,1085.71,8,574712.78,18,1,11,7,True
6485165,1228,4,30,2326,248884997,1,0,0,1086.12,8,573626.66,18,6,20,7,True
6512707,645,0,10,3284,248884997,1,0,0,1086.1,6,574712.76,24,4,21,7,True
6805163,1228,4,451,8340,248884997,1,0,0,1086.01,7,573626.75,18,0,9,7,True
7108946,1228,4,-1,2326,248884997,1,1,0,1085.89,1,573626.75,18,0,23,7,True
7220589,1352,1,10,6757,248884997,1,0,0,1085.77,0,574712.52,24,1,10,8,True
7336778,1203,4,-1,8771,248884997,1,1,0,1086.06,1,574712.52,24,2,7,9,False
7461322,844,1,451,2326,248884997,1,0,0,1085.88,7,573626.64,5,1,2,9,True
7559690,365,0,20,2326,248884997,1,0,0,1085.94,5,572540.7,25,6,21,10,False
7784379,573,0,10,1574,248884997,1,0,0,1086.13,6,573626.83,11,4,3,10,True
7867485,279,2,30,2326,248884997,1,0,0,1086.09,8,572540.74,24,0,5,11,True
8108308,255,2,451,3961,248884997,1,0,0,1086.24,7,571454.5,6,3,21,12,True
8273983,655,3,30,8851,248884997,1,0,0,1086.0,8,570368.5,18,6,18,12,True
8408733,698,4,451,4247,248884997,1,0,0,1085.81,7,569282.69,18,1,0,12,True
8543013,698,4,451,2326,248884997,1,0,0,1085.9,7,568196.79,18,1,3,2,True
8555507,1434,0,10,2326,248884997,1,0,0,1086.09,0,569282.88,24,1,20,2,True
8682416,655,3,451,8793,248884997,1,0,0,1085.56,7,568197.32,18,5,11,2,True
8689843,180,0,20,4759,248884997,1,0,0,1086.07,5,567111.25,18,4,10,5,True
8698033,573,0,10,1645,248884997,1,0,0,1086.16,6,568197.41,11,3,13,5,True
9221408,480,0,30,6757,248884997,1,0,0,1085.83,8,567111.58,5,5,3,5,True
9289669,1203,4,451,2326,248884997,1,0,0,1085.96,7,566025.62,24,1,19,8,True
9468162,467,0,10,8793,248884997,1,0,0,1085.96,6,567111.58,5,3,11,9,True
9499580,1277,2,20,8083,248884997,1,0,0,1085.97,5,566025.61,24,4,13,11,True
1044023,1360,4,-1,7678,237750619,0,1,0,1036.94,1,253160.0,24,5,5,1,True
1096643,999,4,451,1035,237750619,0,0,0,1037.04,7,252122.96,26,0,4,1,True
1494524,84,4,451,2719,237750619,0,0,0,1036.86,7,251086.1,1,2,15,1,True
1513808,1360,4,-1,2719,237750619,0,1,0,1036.91,1,251086.1,24,4,21,3,True
1899394,735,1,10,4765,237750619,0,0,0,1037.09,6,252123.19,11,0,12,3,True
2160652,443,2,20,6160,237750619,0,0,0,1036.96,5,251086.23,24,5,6,5,True
2279713,1092,1,451,5984,237750619,0,0,0,1037.06,7,250049.17,18,5,11,5,True
2483693,790,0,20,6397,237750619,0,0,0,1036.99,5,249012.18,11,4,14,5,True
2844511,1092,1,451,6954,237750619,0,0,0,1036.93,7,247975.25,18,2,6,6,True
2949012,897,0,20,3294,237750619,0,0,0,1037.15,5,246938.1,24,6,5,6,True
3121484,16,4,451,7678,237750619,0,0,0,1037.02,7,245901.08,24,0,3,7,True
3190250,220,0,20,1035,237750619,0,0,0,1037.0,5,244864.08,26,4,21,8,True
3210322,1092,1,25,6954,237750619,0,0,0,1036.84,8,243827.24,18,6,10,9,True
3237565,84,4,30,9056,237750619,0,0,0,1036.89,8,242790.35,1,5,19,9,True
3238080,1113,1,451,4157,237750619,0,0,0,1037.03,7,241753.32,0,1,18,9,True
3293831,16,4,451,6645,237750619,0,0,0,1036.86,7,240716.46,24,0,12,10,True
3334809,1360,4,30,5595,237750619,0,0,0,1037.2,8,239679.26,24,1,22,12,True
3396792,316,2,20,5595,237750619,0,0,0,1036.89,3,238642.37,4,5,8,2,True
3700822,16,4,30,1391,237750619,0,0,0,1036.91,8,237605.46,24,4,15,3,True
3737360,669,2,20,6160,237750619,0,0,0,1036.77,3,236568.69,18,4,10,3,True
3951112,1038,3,451,1035,237750619,0,0,0,1036.87,7,235531.82,11,2,1,3,True
4020026,967,1,10,5595,237750619,0,0,0,1037.16,0,236568.98,13,4,3,4,True
4068689,627,0,10,8701,237750619,0,0,0,1037.07,0,237606.05,11,5,10,4,True
4153830,663,4,451,7652,237750619,0,0,0,1037.19,7,236568.86,18,3,22,4,True
4471398,1360,4,451,3294,237750619,0,0,0,1036.86,7,235532.0,24,2,4,5,True
4657541,999,4,-1,7678,237750619,0,1,0,1037.27,1,235532.0,26,1,11,6,True
4733043,394,0,10,6160,237750619,0,0,0,1036.69,0,236568.69,10,3,15,6,True
4745862,1273,0,10,8337,237750619,0,0,0,1037.09,6,237605.78,24,5,16,7,True
4903687,1205,0,10,9674,237750619,0,0,0,1036.98,6,238642.76,24,3,11,7,True
5169040,300,0,20,6645,237750619,0,0,0,1036.69,5,237606.07,4,4,6,7,True
5221577,1113,1,451,9674,237750619,0,0,0,1037.05,7,236569.02,0,0,2,7,True
5699641,999,4,25,1035,237750619,0,0,0,1037.23,8,235531.79,26,5,10,7,True
5709951,1360,4,30,3294,237750619,0,0,0,1037.01,8,234494.78,24,4,12,8,True
5726589,663,4,25,8701,237750619,0,0,0,1036.89,8,233457.89,18,5,7,8,True
5793230,23,0,20,5618,237750619,0,0,0,1036.88,5,232421.01,11,5,11,9,True
6063365,1075,0,10,8701,237750619,0,0,0,1036.82,6,233457.83,18,1,8,10,True
6079690,1038,3,451,5595,237750619,0,0,0,1036.91,7,232420.92,11,1,4,10,True
6363085,189,4,25,2719,237750619,0,0,0,1036.81,8,231384.11,18,0,14,11,True
6527403,806,1,10,4157,237750619,0,0,0,1036.72,0,232420.83,11,1,2,11,True
6595570,1113,1,-1,4765,237750619,0,1,0,1036.9,1,232420.83,0,0,0,11,True
6646510,128,0,20,3644,237750619,0,0,0,1037.01,3,231383.82,18,6,13,11,True
6726446,999,4,25,2313,237750619,0,0,0,1037.18,8,230346.64,26,2,13,12,True
6953135,238,0,20,6645,237750619,0,0,0,1037.06,5,229309.58,26,4,17,1,True
7797794,1288,0,20,2719,237750619,0,0,0,1037.28,3,228272.3,24,2,9,1,True
7938889,16,4,451,6645,237750619,0,0,0,1036.89,7,227235.41,24,4,22,2,True
7946002,189,4,30,6160,237750619,0,0,0,1037.16,8,226198.25,18,1,17,3,True
8283063,999,4,30,2313,237750619,0,0,0,1037.02,8,225161.23,26,1,0,4,True
8347200,1092,1,25,6397,237750619,0,0,0,1036.85,8,224124.38,18,4,6,5,True
8506245,1159,0,10,6397,237750619,0,0,0,1037.05,6,225161.43,15,5,9,5,True
8511243,84,4,30,4157,237750619,0,0,0,1036.96,8,224124.47,1,6,2,5,True
8697517,427,2,20,6645,237750619,0,0,0,1037.15,5,223087.32,18,0,17,7,True
8716612,1113,1,451,4765,237750619,0,0,0,1037.01,7,222050.31,0,4,16,7,True
8772835,1409,1,10,5595,237750619,0,0,0,1037.27,6,223087.58,24,5,22,8,True
8785817,663,4,30,5984,237750619,0,0,0,1037.07,8,222050.51,18,3,18,9,True
9791830,1092,1,451,2486,237750619,0,0,0,1036.99,7,221013.52,18,5,20,10,True
9942435,1113,1,451,6397,237750619,0,0,0,1037.08,7,219976.44,0,1,12,11,True
1147098,1025,1,25,5833,404719393,0,0,0,486.96,8,401735.04,11,5,4,1,True
1442746,1082,3,-1,3056,404719393,0,1,0,487.01,1,401735.04,18,2,4,2,True
1820044,1477,2,451,9042,404719393,0,0,0,486.89,7,401248.15,24,5,15,2,True
1865490,1082,3,451,8148,404719393,0,0,0,487.17,7,400760.98,18,4,4,2,True
1990181,1477,2,30,8148,404719393,0,0,0,487.01,8,400273.97,24,1,7,3,True
2050504,1082,3,-1,5904,404719393,0,1,0,487.06,4,400273.97,18,3,22,3,True
2100652,1082,3,30,8156,404719393,0,0,0,487.07,8,399786.9,18,1,10,3,True
2115057,1477,2,-1,3056,404719393,0,1,0,486.84,1,399786.9,24,0,20,4,True
2127254,339,4,30,8148,404719393,0,0,0,486.94,8,399299.96,11,2,2,4,True
2320292,1070,4,-1,2259,404719393,0,1,0,487.04,1,399299.96,18,5,5,4,True
2543404,1025,1,30,5833,404719393,0,0,0,486.89,8,398813.07,11,3,1,6,True
2592179,339,4,451,9042,404719393,0,0,0,486.98,7,398326.09,11,1,13,7,True
2668175,1082,3,-1,2259,404719393,0,1,0,486.97,4,398326.09,18,3,20,7,True
2705592,1364,0,10,5904,404719393,0,0,0,486.95,6,398813.04,16,4,10,7,True
2816716,1025,1,30,2259,404719393,0,0,0,486.89,8,398326.15,11,5,12,8,True
2834671,1477,2,-1,3382,404719393,0,1,0,487.32,1,398326.15,24,1,3,8,True
3010113,1063,0,451,5904,404719393,0,0,0,486.81,7,397839.34,11,3,21,9,True
3409922,1201,0,10,3101,404719393,0,0,0,487.06,0,398326.4,24,6,21,10,True
3564437,907,0,20,2259,404719393,0,0,0,487.05,3,397839.35,2,0,0,11,True
3579255,1477,2,451,2929,404719393,0,0,0,486.76,7,397352.59,24,4,16,12,True
4292651,579,0,10,8156,404719393,0,0,0,486.92,0,397839.51,11,2,17,12,True
4394361,1082,3,-1,6009,404719393,0,1,0,486.93,1,397839.51,18,5,22,12,True
4411473,1304,0,30,9289,404719393,0,0,0,487.1,8,397352.41,5,4,5,1,True
4546862,339,4,30,3382,404719393,0,0,0,486.66,8,396865.75,11,0,18,2,True
4611953,1304,0,30,3382,404719393,0,0,0,487.08,8,396378.67,5,4,23,3,True
4702799,339,4,-1,8156,404719393,0,1,0,486.98,4,396378.67,11,2,13,3,True
4898466,1283,2,20,2259,404719393,0,0,0,487.11,5,395891.56,24,5,1,3,True
4961623,1477,2,30,3056,404719393,0,0,0,487.03,8,395404.53,24,2,15,4,True
5826637,1467,0,10,3056,404719393,0,0,0,486.93,6,395891.46,11,5,1,4,True
5845207,1468,1,10,3942,404719393,0,0,0,487.11,6,396378.57,11,0,5,4,True
5877164,1063,0,451,5833,404719393,0,0,0,486.92,7,395891.65,11,3,11,4,True
5971125,1082,3,-1,3382,404719393,0,1,0,486.89,4,395891.65,18,3,15,5,True
6470898,1483,0,10,9042,404719393,0,0,0,487.17,6,396378.82,24,3,7,5,True
6531019,1477,2,-1,8156,404719393,0,1,0,486.94,1,396378.82,24,3,20,6,True
6548641,799,2,20,8156,404719393,0,0,0,486.79,5,395892.03,11,0,15,6,True
6636965,375,4,25,5833,404719393,0,0,0,486.75,8,395405.28,25,2,18,7,True
6646333,1304,0,25,5450,404719393,0,0,0,486.9,8,394918.38,5,3,0,7,True
6726053,375,4,-1,3101,404719393,0,1,0,487.14,4,394918.38,25,3,13,8,True
6824482,1413,0,20,6009,404719393,0,0,0,486.82,5,394431.56,24,0,20,8,True
7231425,375,4,25,3382,404719393,0,0,0,487.22,8,393944.34,25,2,10,8,True
7705478,339,4,451,2954,404719393,0,0,0,487.21,7,393457.13,11,0,8,10,True
7762522,1243,2,20,3942,404719393,0,0,0,487.25,5,392969.88,18,2,14,10,True
7777212,96,0,10,8156,404719393,0,0,0,486.83,0,393456.71,1,1,8,11,True
8015934,375,4,451,2259,404719393,0,0,0,487.12,7,392969.59,25,6,19,1,True
8186217,564,0,20,6009,404719393,0,0,0,487.05,5,392482.54,17,6,9,2,True
8307172,375,4,25,5904,404719393,0,0,0,486.86,8,391995.68,25,1,4,4,True
8711537,1063,0,30,3101,404719393,0,0,0,487.21,8,391508.47,11,0,23,4,True
8902640,95,2,20,3101,404719393,0,0,0,487.11,5,391021.36,1,2,3,5,True
8965057,1477,2,451,8156,404719393,0,0,0,486.76,7,390534.6,24,0,8,5,True
9236660,95,2,20,3382,404719393,0,0,0,486.84,3,390047.76,1,4,2,6,True
9312305,1082,3,25,8156,404719393,0,0,0,486.66,8,389561.1,18,3,11,6,True
9386315,375,4,451,3980,404719393,0,0,0,486.76,7,389074.34,25,4,7,6,True
9576800,128,0,20,5450,404719393,0,0,0,486.73,5,388587.61,18,1,11,8,True
9739719,339,4,451,3980,404719393,0,0,0,487.12,7,388100.49,11,0,1,8,True
9878805,1477,2,25,8156,404719393,0,0,0,486.95,8,387613.54,24,1,13,8,True
9951786,375,4,25,3382,404719393,0,0,0,486.9,8,387126.64,25,3,3,11,True
1274910,1379,3,451,4177,403539486,0,0,0,233.91,7,324592.09,16,1,19,3,True
1428163,721,4,-1,8591,403539486,0,1,0,234.02,1,324592.09,11,6,0,4,True
1439975,1270,1,25,3446,403539486,0,0,0,233.84,8,324358.25,23,5,2,4,True
1471036,1379,3,-1,7664,403539486,0,1,0,233.75,4,324358.25,16,6,14,5,True
1492275,721,4,451,9778,403539486,0,0,0,234.0,7,324124.25,11,3,0,7,True
2289646,1283,2,25,3066,403539486,0,0,0,233.8,8,323890.45,24,3,17,9,True
2402508,721,4,30,3446,403539486,0,0,0,233.58,8,323656.87,11,6,7,10,True
2581648,1379,3,451,4177,403539486,0,0,0,233.95,7,323422.92,16,5,12,11,True
2756363,346,0,20,4935,403539486,0,0,0,233.83,3,323189.09,24,0,9,11,True
2806102,721,4,451,4177,403539486,0,0,0,234.06,7,322955.03,11,5,14,12,True
3049769,889,0,10,3324,403539486,0,0,0,234.13,0,323189.16,27,0,20,12,True
3484010,1283,2,451,3446,403539486,0,0,0,233.93,7,322955.23,24,3,11,12,True
3756081,721,4,451,2989,403539486,0,0,0,233.99,7,322721.24,11,1,9,1,True
4006059,1485,0,20,8591,403539486,0,0,0,233.91,3,322487.33,24,2,3,1,True
4240522,1036,1,-1,2060,403539486,0,1,0,234.12,4,322487.33,11,6,1,1,True
4435842,53,0,451,3324,403539486,0,0,0,234.03,7,322253.3,20,4,6,2,True
4531351,721,4,30,7894,403539486,0,0,0,234.28,8,322019.02,11,4,17,2,True
4699738,811,0,20,3446,403539486,0,0,0,233.93,5,321785.09,18,0,5,2,True
4857847,1379,3,-1,2989,403539486,0,1,0,233.96,4,321785.09,16,1,2,3,False
4931110,1270,1,-1,4699,403539486,0,2,0,233.78,4,321785.09,23,2,16,3,True
4997776,1270,1,451,7664,403539486,0,0,0,233.97,7,321551.12,23,0,12,3,True
5141509,1270,1,30,3066,403539486,0,0,0,234.05,8,321317.07,23,6,15,4,True
5271871,53,0,451,2989,403539486,0,0,0,233.91,7,321083.16,20,2,22,5,True
5428672,1379,3,30,2989,403539486,0,0,0,233.99,8,320849.17,16,0,16,6,True
5466851,1036,1,451,4699,403539486,0,0,0,234.03,7,320615.14,11,0,1,6,True
5670375,721,4,451,8219,403539486,0,0,0,233.9,7,320381.24,11,4,3,7,True
5891823,1422,1,10,7894,403539486,0,0,0,233.82,6,320615.06,24,4,23,7,True
6157843,302,1,10,2989,403539486,0,0,0,233.87,6,320848.93,4,1,11,8,True
6170002,1270,1,451,4935,403539486,0,0,0,234.31,7,320614.62,23,1,1,8,True
6321399,1463,2,20,2989,403539486,0,0,0,233.89,5,320380.73,11,0,18,8,True
6339152,267,0,10,8219,403539486,0,0,0,234.01,0,320614.74,6,0,23,8,True
6399239,721,4,451,4286,403539486,0,0,0,233.97,7,320380.77,11,3,0,9,True
6452601,721,4,30,4935,403539486,0,0,0,234.22,8,320146.55,11,0,2,9,True
6492983,1270,1,30,8219,403539486,0,0,0,233.89,8,319912.66,23,6,18,10,True
6846244,721,4,451,9778,403539486,0,0,0,233.95,7,319678.71,11,1,11,10,True
6848473,721,4,30,4177,403539486,0,0,0,234.16,8,319444.55,11,4,16,11,True
6858373,1270,1,-1,9778,403539486,0,1,0,234.08,4,319444.55,23,6,12,12,True
6881911,1036,1,30,2989,403539486,0,0,0,234.1,8,319210.45,11,6,16,12,True
7222738,721,4,-1,7894,403539486,0,1,0,233.91,4,319210.45,11,1,7,1,True
7272651,1379,3,30,2060,403539486,0,0,0,234.05,8,318976.4,16,4,13,2,True
7389861,1036,1,30,8591,403539486,0,0,0,234.14,8,318742.26,11,5,12,2,True
7414335,1036,1,25,9778,403539486,0,0,0,234.05,8,318508.21,11,6,1,3,True
7563252,1270,1,451,2060,403539486,0,0,0,234.19,7,318274.02,23,3,3,3,True
7813575,1379,3,451,8591,403539486,0,0,0,233.92,7,318040.1,16,6,12,4,True
8304703,679,0,20,6906,403539486,0,0,0,233.76,5,317806.34,24,1,17,5,True
8336902,1270,1,-1,9778,403539486,0,1,0,233.83,4,317806.34,23,6,12,5,True
8445289,1283,2,451,8219,403539486,0,0,0,234.2,7,317572.14,24,4,8,5,True
8446071,916,0,20,7894,403539486,0,0,0,234.06,3,317338.08,18,4,16,7,True
8611961,53,0,25,2989,403539486,0,0,0,234.14,8,317103.94,20,5,18,8,True
8668003,1272,0,20,8219,403539486,0,0,0,233.98,3,316869.96,24,5,6,9,True
8836002,1325,0,20,8591,403539486,0,0,0,233.96,5,316636.0,18,5,4,9,True
8925145,1446,1,10,2060,403539486,0,0,0,233.78,6,316869.78,24,6,14,10,True
9949235,1379,3,451,8591,403539486,0,0,0,234.09,7,316635.69,16,1,5,11,True
1066316,916,0,10,8718,235846750,0,0,0,1166.0,6,446983.0,18,4,21,1,True
1228966,376,0,-1,8983,235846750,0,1,0,1166.13,4,446983.0,25,4,8,1,True
1502471,914,2,30,3642,235846750,0,0,0,1166.11,8,445816.89,18,4,19,1,True
1987600,178,4,30,9857,235846750,0,0,0,1165.82,8,444651.07,24,1,7,3,True
2498409,1176,4,451,5081,235846750,0,0,0,1166.11,7,443484.96,24,5,9,3,True
2650483,178,4,451,3642,235846750,0,0,0,1165.99,7,442318.97,24,2,5,4,True
3222387,955,4,451,8577,235846750,0,0,0,1166.01,7,441152.96,13,6,13,4,True
3237773,1121,3,451,7545,235846750,0,0,0,1166.11,7,439986.85,24,2,7,5,True
3406402,914,2,30,9340,235846750,0,0,0,1166.03,8,438820.82,18,4,3,5,True
3537094,502,0,20,8718,235846750,0,0,0,1165.84,3,437654.98,12,4,3,5,True
3549654,948,4,25,5094,235846750,0,0,0,1165.73,8,436489.25,24,1,2,9,True
3570637,955,4,-1,9340,235846750,0,1,0,1165.97,1,436489.25,13,2,23,9,True
3611120,1436,0,10,3642,235846750,0,0,0,1166.01,6,437655.26,24,2,9,10,True
3649622,339,4,-1,7544,235846750,0,1,0,1165.91,4,437655.26,11,4,11,10,True
3814725,132,2,20,7544,235846750,0,0,0,1165.89,3,436489.37,18,5,2,10,True
3834748,314,0,20,9688,235846750,0,0,0,1165.94,5,435323.43,4,6,15,11,True
4424747,948,4,-1,6999,235846750,0,1,0,1165.81,4,435323.43,24,0,7,11,True
4603672,1121,3,451,9688,235846750,0,0,0,1165.94,7,434157.49,24,6,3,1,True
4937928,314,0,20,2643,235846750,0,0,0,1165.86,3,432991.63,4,5,10,1,True
5434874,178,4,25,9471,235846750,0,0,0,1165.97,8,431825.66,24,0,19,1,True
5576245,538,0,20,8627,235846750,0,0,0,1165.87,5,430659.79,18,1,12,1,True
5592951,1160,0,20,9688,235846750,0,0,0,1166.24,5,429493.55,15,0,15,1,True
5607237,1090,0,-1,8920,235846750,0,1,0,1165.93,4,429493.55,18,6,19,2,True
5870027,328,0,20,3066,235846750,0,0,0,1166.14,5,428327.41,11,4,11,3,True
5892193,537,0,20,9688,235846750,0,0,0,1166.09,3,427161.32,18,0,21,3,True
5974961,339,4,451,6057,235846750,0,0,0,1166.03,7,425995.29,11,4,16,4,True
6074131,1262,0,20,5081,235846750,0,0,0,1166.05,3,424829.24,23,2,8,5,True
6253000,312,0,10,6387,235846750,0,0,0,1166.05,6,425995.29,4,5,13,5,True
6528276,955,4,451,5542,235846750,0,0,0,1165.79,7,424829.5,13,4,23,7,True
6543039,376,0,25,9857,235846750,0,0,0,1166.07,8,423663.43,25,4,9,7,True
6927526,339,4,-1,7545,235846750,0,1,0,1165.99,4,423663.43,11,3,11,8,True
7045238,703,0,20,3642,235846750,0,0,0,1165.62,3,422497.81,18,6,3,8,True
7136117,1121,3,-1,5081,235846750,0,1,0,1166.08,4,422497.81,24,6,13,8,True
7147927,1121,3,30,5081,235846750,0,0,0,1165.94,8,421331.87,24,0,16,8,True
7313710,339,4,30,6387,235846750,0,0,0,1165.93,8,420165.94,11,6,13,11,True
7744442,1315,0,10,7544,235846750,0,0,0,1165.94,6,421331.88,5,3,2,12,True
7906110,249,0,10,3642,235846750,0,0,0,1165.99,0,422497.87,6,5,10,1,True
8009849,1090,0,-1,8983,235846750,0,1,0,1166.41,1,422497.87,18,0,0,3,True
8070422,914,2,451,8718,235846750,0,0,0,1165.93,7,421331.94,18,5,19,3,True
8114036,178,4,30,8920,235846750,0,0,0,1166.08,8,420165.86,24,0,3,3,True
8165398,1137,1,10,9340,235846750,0,0,0,1166.1,6,421331.96,24,3,18,4,True
8178645,1262,0,20,8920,235846750,0,0,0,1165.92,5,420166.04,23,5,22,4,True
8199140,376,0,451,8627,235846750,0,0,0,1165.98,7,419000.06,25,1,6,6,True
8233615,948,4,25,9340,235846750,0,0,0,1165.98,8,417834.08,24,2,11,7,True
8331802,1090,0,25,8627,235846750,0,0,0,1165.95,8,416668.13,18,1,4,7,True
8629635,1090,0,25,8718,235846750,0,0,0,1165.81,8,415502.32,18,5,15,8,True
8675913,529,2,20,8920,235846750,0,0,0,1165.93,5,414336.39,18,1,19,8,True
8756545,1090,0,30,9857,235846750,0,0,0,1166.01,8,413170.38,18,4,18,8,True
8953473,1155,0,20,8718,235846750,0,0,0,1166.06,3,412004.32,15,1,10,8,True
9175690,1121,3,-1,9471,235846750,0,1,0,1166.25,4,412004.32,24,6,4,9,True
9282330,955,4,451,8577,235846750,0,0,0,1166.16,7,410838.16,13,2,16,10,True
9399325,1262,0,20,5081,235846750,0,0,0,1166.05,3,409672.11,23,1,16,10,False
9639113,916,0,20,9471,235846750,0,0,0,1166.0,3,408506.11,18,6,6,11,True
9887281,1121,3,-1,8983,235846750,0,1,0,1166.21,1,408506.11,24,0,0,11,True
9964080,1206,0,20,4981,235846750,0,0,0,1165.77,3,407340.34,24,0,0,11,True
1030258,1250,1,25,4765,448954950,0,0,0,1084.95,8,956401.05,23,0,19,1,True
1251721,385,1,-1,7875,448954950,0,1,0,1084.96,1,956401.05,25,0,7,3,True
1526763,423,3,30,5938,448954950,0,0,0,1085.36,8,955315.69,18,0,3,3,True
2367389,1250,1,451,9581,448954950,0,0,0,1084.88,7,954230.81,23,6,2,5,True
2409667,1312,0,20,7243,448954950,0,0,0,1085.07,5,953145.74,5,6,14,6,True
2581330,1022,4,-1,9581,448954950,0,1,0,1085.01,4,953145.74,11,1,15,8,True
3480850,1406,0,20,4800,448954950,0,0,0,1084.9,5,952060.84,24,1,17,9,True
3583055,423,3,25,7992,448954950,0,0,0,1084.86,8,950975.98,18,2,13,9,True
3891456,358,4,-1,7875,448954950,0,1,0,1085.05,1,950975.98,24,4,15,11,True
4051038,1022,4,451,1476,448954950,0,0,0,1085.11,7,949890.87,11,5,19,12,True
4309343,1250,1,30,8458,448954950,0,0,0,1085.27,8,948805.6,23,3,3,1,True
4441685,1410,1,10,4765,448954950,0,0,0,1084.99,6,949890.59,24,3,4,3,True
4479691,294,3,451,4765,448954950,0,0,0,1085.01,7,948805.58,4,2,20,4,True
4496715,423,3,451,4012,448954950,0,0,0,1085.12,7,947720.46,18,3,22,4,True
4496899,385,1,451,9581,448954950,0,0,0,1084.95,7,946635.51,25,2,5,5,True
4612804,309,0,10,8926,448954950,0,0,0,1084.82,6,947720.33,4,5,7,7,True
4727936,712,0,10,4765,448954950,0,0,0,1084.94,6,948805.27,18,4,8,7,True
4771310,887,2,20,8049,448954950,0,0,0,1085.16,5,947720.11,27,5,11,7,True
4775948,423,3,25,8049,448954950,0,0,0,1085.14,8,946634.97,18,2,5,10,True
4932646,739,1,10,1476,448954950,0,0,0,1085.01,6,947719.98,24,1,15,11,True
5026639,385,1,451,1476,448954950,0,0,0,1085.13,7,946634.85,25,0,17,2,True
5181133,385,1,451,5140,448954950,0,0,0,1085.02,7,945549.83,25,5,12,2,True
5204973,1336,2,20,9214,448954950,0,0,0,1085.13,5,944464.7,18,2,14,2,True
5218890,385,1,-1,9214,448954950,0,1,0,1084.7,4,944464.7,25,6,13,4,True
5726864,1250,1,-1,9214,448954950,0,2,0,1084.81,1,944464.7,23,3,22,5,False
5868178,294,3,-1,9214,448954950,0,3,1,1084.98,1,0.0,4,1,12,6,False
1651332,694,2,20,4840,171444948,1,0,0,223.92,3,358480.08,24,1,6,1,True
1657141,537,0,25,3709,171444948,1,0,0,224.11,8,358255.97,18,5,14,2,True
1850232,49,3,-1,3029,171444948,1,1,0,223.99,4,358255.97,20,6,9,2,True
1979511,204,0,20,2686,171444948,1,0,0,224.05,5,358031.92,9,6,15,2,True
2042969,130,0,30,5720,171444948,1,0,0,224.07,8,357807.85,18,4,22,2,True
2417781,130,0,25,4840,171444948,1,0,0,224.29,8,357583.56,18,4,15,3,True
2418876,65,3,25,3363,171444948,1,0,0,223.92,8,357359.64,20,0,7,3,True
2601021,130,0,451,4840,171444948,1,0,0,224.06,7,357135.58,18,4,6,3,True
2774981,612,4,25,4245,171444948,1,0,0,224.3,8,356911.28,11,2,9,3,True
3325359,130,0,-1,2767,171444948,1,1,0,224.08,4,356911.28,18,2,14,6,True
3418374,537,0,30,2686,171444948,1,0,0,224.08,8,356687.2,18,1,18,6,True
3558527,1119,0,10,3709,171444948,1,0,0,224.15,6,356911.35,24,2,23,7,True
3668761,502,0,20,5720,171444948,1,0,0,223.95,3,356687.4,12,0,18,8,True
3703698,49,3,30,9705,171444948,1,0,0,224.11,8,356463.29,20,4,12,8,True
3730711,65,3,30,5810,171444948,1,0,0,223.96,8,356239.33,20,2,3,8,True
3748485,1408,1,10,3029,171444948,1,0,0,224.05,6,356463.38,24,5,15,9,True
4294395,612,4,25,9705,171444948,1,0,0,223.91,8,356239.47,11,4,13,9,True
4337518,130,0,30,3363,171444948,1,0,0,223.92,8,356015.55,18,0,17,10,True
4357115,736,1,30,5511,171444948,1,0,0,224.19,8,355791.36,11,3,3,11,True
4390819,65,3,451,3709,171444948,1,0,0,223.91,7,355567.45,20,3,7,12,True
4446292,736,1,451,5511,171444948,1,0,0,223.84,7,355343.61,11,5,21,3,True
4495768,49,3,-1,3648,171444948,1,1,0,224.08,4,355343.61,20,6,6,3,True
4823711,49,3,25,1642,171444948,1,0,0,223.72,8,355119.89,20,2,15,4,True
4846962,96,0,20,5511,171444948,1,0,0,224.23,3,354895.66,1,3,21,4,True
5010434,1127,0,20,3648,171444948,1,0,0,224.01,5,354671.65,24,5,5,5,True
5357542,736,1,25,3363,171444948,1,0,0,223.83,8,354447.82,11,0,20,5,True
5390844,398,0,10,4245,171444948,1,0,0,224.07,6,354671.89,10,1,16,5,True
5532346,234,0,10,6428,171444948,1,0,0,223.95,0,354895.84,26,0,4,6,True
5751611,130,0,25,2686,171444948,1,0,0,224.0,8,354671.84,18,0,23,6,True
5762680,736,1,25,8690,171444948,1,0,0,224.1,8,354447.74,11,0,2,6,True
6022720,49,3,-1,3709,171444948,1,1,0,223.9,1,354447.74,20,6,19,7,True
6446128,652,0,10,5734,171444948,1,0,0,223.95,6,354671.69,24,2,8,7,True
6481040,736,1,451,3029,171444948,1,0,0,223.79,7,354447.9,11,0,12,8,True
6707680,537,0,25,7907,171444948,1,0,0,223.87,8,354224.03,18,4,2,8,True
6779776,537,0,25,6428,171444948,1,0,0,223.82,8,354000.21,18,4,22,8,True
6844429,1297,0,20,8690,171444948,1,0,0,224.13,5,353776.08,5,2,22,9,True
6983232,49,3,451,7907,171444948,1,0,0,224.08,7,353552.0,20,5,8,9,True
7255660,612,4,-1,9705,171444948,1,1,0,224.06,4,353552.0,11,1,6,10,True
7283591,465,0,20,5720,171444948,1,0,0,224.18,5,353327.82,13,2,23,10,True
7319579,736,1,451,5720,171444948,1,0,0,223.8,7,353104.02,11,3,15,11,True
7387325,537,0,451,5720,171444948,1,0,0,224.17,7,352879.85,18,1,22,11,True
7565682,649,0,10,3709,171444948,1,0,0,224.15,6,353104.0,24,1,9,12,True
7803729,612,4,-1,5720,171444948,1,1,0,224.01,4,353104.0,11,3,14,1,True
7810026,49,3,451,2649,171444948,1,0,0,223.8,7,352880.2,20,1,4,2,True
7997423,736,1,-1,6583,171444948,1,1,0,224.13,4,352880.2,11,6,11,3,True
8156728,49,3,451,7907,171444948,1,0,0,224.14,7,352656.06,20,6,15,3,True
8324899,287,0,10,3648,171444948,1,0,0,224.0,6,352880.06,24,3,11,3,True
8648749,681,2,20,5511,171444948,1,0,0,224.11,3,352655.95,24,3,0,5,True
8675967,130,0,451,6583,171444948,1,0,0,223.86,7,352432.09,18,4,12,5,True
8689244,65,3,451,4245,171444948,1,0,0,224.12,7,352207.97,20,2,4,5,True
8795961,588,0,20,3648,171444948,1,0,0,224.09,5,351983.88,24,0,10,6,True
8871391,834,0,20,7907,171444948,1,0,0,224.08,5,351759.8,5,4,16,7,True
8898772,130,0,25,5810,171444948,1,0,0,224.01,8,351535.79,18,6,5,8,True
9146626,736,1,30,3274,171444948,1,0,0,224.14,8,351311.65,11,0,17,9,True
9217885,612,4,25,7907,171444948,1,0,0,224.46,8,351087.19,11,4,0,10,True
9584170,65,3,30,6428,171444948,1,0,0,223.71,8,350863.48,20,3,14,10,True
9871823,130,0,25,3648,171444948,1,0,0,223.83,8,350639.65,18,5,19,11,True
9970865,537,0,451,5511,171444948,1,0,0,224.1,7,350415.55,18,3,15,11,True
1054314,1361,2,25,7347,344425794,1,0,0,1035.0,8,881433.0,16,5,7,1,True
1118657,613,4,451,5876,344425794,1,0,0,1035.0,7,880398.0,11,0,10,1,True
1707266,817,4,451,4649,344425794,1,0,0,1034.86,7,879363.14,18,5,11,1,True
1857785,747,1,-1,3359,344425794,1,1,0,1035.03,4,879363.14,24,2,0,1,True
1933642,1089,0,30,1059,344425794,1,0,0,1035.09,8,878328.05,18,2,16,3,True
2087740,108,2,20,6826,344425794,1,0,0,1034.91,3,877293.14,3,0,9,3,True
2138899,568,1,10,8732,344425794,1,0,0,1035.06,6,878328.2,11,1,1,4,True
2289969,148,1,30,4649,344425794,1,0,0,1035.02,8,877293.18,18,5,15,4,True
2603432,1010,0,10,3565,344425794,1,0,0,1034.9,0,878328.08,26,1,18,4,True
2784037,747,1,25,1916,344425794,1,0,0,1034.89,8,877293.19,24,4,4,4,True
3054039,1255,0,10,8732,344425794,1,0,0,1034.84,0,878328.03,23,6,17,7,True
3055508,841,1,10,3028,344425794,1,0,0,1035.03,6,879363.06,5,1,20,8,True
3064267,626,2,25,7347,344425794,1,0,0,1034.93,8,878328.13,11,5,0,8,True
3143215,148,1,451,5008,344425794,1,0,0,1034.75,7,877293.38,18,1,22,9,True
3390273,148,1,-1,6460,344425794,1,1,0,1034.86,1,877293.38,18,2,9,9,False
3409733,817,4,-1,3028,344425794,1,2,0,1035.22,1,877293.38,18,0,1,9,True
3464476,1361,2,451,1997,344425794,1,0,0,1034.77,7,876258.61,16,6,18,10,False
3732178,1303,0,20,4228,344425794,1,0,0,1034.87,5,875223.74,5,3,7,10,True
3786789,1089,0,25,9656,344425794,1,0,0,1034.99,8,874188.75,18,6,20,10,True
3789109,747,1,30,5876,344425794,1,0,0,1034.78,8,873153.97,24,4,12,11,True
4086640,626,2,451,5720,344425794,1,0,0,1035.0,7,872118.97,11,5,5,1,True
4109551,747,1,30,4649,344425794,1,0,0,1034.95,8,871084.02,24,6,13,2,True
4154756,817,4,451,5876,344425794,1,0,0,1034.69,7,870049.33,18,3,5,3,True
4258145,1233,0,20,6826,344425794,1,0,0,1035.22,3,869014.11,18,5,12,4,True
4382489,148,1,25,1059,344425794,1,0,0,1035.23,8,867978.88,18,2,10,4,True
4542252,626,2,30,5876,344425794,1,0,0,1034.98,8,866943.9,11,0,13,4,True
4926420,817,4,-1,7701,344425794,1,1,0,1034.83,4,866943.9,18,0,4,6,True
5200621,1361,2,30,2369,344425794,1,0,0,1035.0,8,865908.9,16,3,1,6,True
5528021,626,2,451,1916,344425794,1,0,0,1035.07,7,864873.83,11,4,23,6,True
5562216,1399,0,20,7347,344425794,1,0,0,1034.98,3,863838.85,24,5,10,7,True
5823191,613,4,451,1512,344425794,1,0,0,1035.01,7,862803.84,11,6,15,7,True
5980401,1361,2,30,6826,344425794,1,0,0,1035.23,8,861768.61,16,3,11,7,True
6747947,817,4,25,1059,344425794,1,0,0,1034.89,8,860733.72,18,5,10,8,True
6829474,613,4,25,6826,344425794,1,0,0,1034.93,8,859698.79,11,1,22,8,True
6933728,613,4,25,4649,344425794,1,0,0,1035.02,8,858663.77,11,3,2,8,True
7009645,747,1,25,7701,344425794,1,0,0,1035.21,8,857628.56,24,2,23,10,True
7218935,817,4,451,2369,344425794,1,0,0,1035.14,7,856593.42,18,2,11,12,True
7278056,747,1,451,8087,344425794,1,0,0,1035.06,7,855558.36,24,6,5,12,True
7465416,626,2,30,4228,344425794,1,0,0,1034.88,8,854523.48,11,4,12,1,True
7480225,613,4,451,3359,344425794,1,0,0,1034.99,7,853488.49,11,0,23,1,True
7623469,1361,2,30,8087,344425794,1,0,0,1034.78,8,852453.71,16,1,15,1,True
7676737,626,2,25,6703,344425794,1,0,0,1034.9,8,851418.81,11,1,7,4,True
8100897,613,4,25,8732,344425794,1,0,0,1035.01,8,850383.8,11,0,5,6,True
8221467,1361,2,30,6826,344425794,1,0,0,1034.93,8,849348.87,16,2,12,6,True
8233712,626,2,30,3359,344425794,1,0,0,1034.77,8,848314.1,11,6,9,7,True
8308276,96,0,10,6703,344425794,1,0,0,1034.99,6,849349.09,1,1,1,7,True
8311483,817,4,30,4228,344425794,1,0,0,1035.28,8,848313.81,18,3,23,8,True
8363240,1319,1,10,4063,344425794,1,0,0,1035.1,6,849348.91,18,0,13,8,True
8443217,882,0,10,9571,344425794,1,0,0,1035.06,6,850383.97,27,4,19,9,True
8462005,613,4,25,4649,344425794,1,0,0,1035.04,8,849348.93,11,3,21,9,True
8554698,1089,0,451,2369,344425794,1,0,0,1035.01,7,848313.92,18,1,10,9,True
8755061,1361,2,-1,5008,344425794,1,1,0,1034.97,4,848313.92,16,5,16,9,True
8997242,1319,1,10,1916,344425794,1,0,0,1035.05,0,849348.97,18,5,23,10,True
9061529,108,2,20,5720,344425794,1,0,0,1034.81,5,848314.16,3,0,6,10,True
9533065,626,2,30,3565,344425794,1,0,0,1034.96,8,847279.2,11,2,13,10,True
9750723,613,4,451,3028,344425794,1,0,0,1035.12,7,846244.08,11,2,16,10,True
9980981,1089,0,-1,5720,344425794,1,1,0,1034.82,4,846244.08,18,0,15,11,True
1630899,698,4,25,8250,577162787,1,0,0,485.24,8,691871.76,18,6,4,1,True
2193656,648,3,25,3826,577162787,1,0,0,485.14,8,691386.62,24,3,15,3,True
2497760,648,3,30,3826,577162787,1,0,0,485.1,8,690901.52,24,1,22,3,True
2519252,12,4,30,2482,577162787,1,0,0,485.26,8,690416.26,24,0,22,4,True
2691681,648,3,25,2421,577162787,1,0,0,484.89,8,689931.37,24,2,11,6,True
2726166,235,4,30,3652,577162787,1,0,0,485.27,8,689446.1,26,2,15,7,True
2829739,1115,1,10,3652,577162787,1,0,0,484.96,6,689931.06,0,5,9,8,True
3051845,698,4,25,6779,577162787,1,0,0,485.14,8,689445.92,18,2,4,8,True
3201827,648,3,451,1587,577162787,1,0,0,485.15,7,688960.77,24,1,6,9,True
3248322,1421,0,30,6779,577162787,1,0,0,484.99,8,688475.78,24,1,7,10,True
3288043,816,0,20,2482,577162787,1,0,0,484.91,5,687990.87,18,5,17,10,True
3597680,895,0,20,5079,577162787,1,0,0,484.86,5,687506.01,24,2,20,11,True
3657833,1009,0,30,9058,577162787,1,0,0,484.95,8,687021.06,26,2,20,11,True
3825945,698,4,451,5407,577162787,1,0,0,485.01,7,686536.05,18,2,11,12,True
3975514,1009,0,-1,4867,577162787,1,1,0,484.95,1,686536.05,26,3,1,1,True
4460462,648,3,30,1587,577162787,1,0,0,485.12,8,686050.93,24,5,6,1,True
4733424,681,2,451,3652,577162787,1,0,0,484.93,7,685566.0,24,0,19,1,True
4964677,1356,2,20,7574,577162787,1,0,0,485.04,5,685080.96,24,3,11,2,True
5131438,235,4,451,1985,577162787,1,0,0,484.78,7,684596.18,26,1,2,2,True
5202417,681,2,-1,2482,577162787,1,1,0,485.3,4,684596.18,24,4,8,2,True
5353545,698,4,30,1454,577162787,1,0,0,484.98,8,684111.2,18,4,4,4,False
5413877,1421,0,451,1985,577162787,1,0,0,485.05,7,683626.15,24,0,3,5,False
5525060,294,3,25,9840,577162787,1,0,0,485.03,8,683141.12,4,6,19,6,True
5734900,12,4,30,4867,577162787,1,0,0,484.99,8,682656.13,24,2,3,7,True
5946394,1072,0,20,2638,577162787,1,0,0,484.92,3,682171.21,18,5,8,7,True
6013848,12,4,30,2638,577162787,1,0,0,484.99,8,681686.22,24,0,8,7,True
6018265,1445,2,20,1587,577162787,1,0,0,485.12,5,681201.1,24,0,14,7,True
6057893,681,2,30,8250,577162787,1,0,0,485.16,8,680715.94,24,4,15,10,True
6163901,1410,1,10,4646,577162787,1,0,0,485.05,6,681200.99,24,1,1,10,True
6183652,698,4,451,2482,577162787,1,0,0,484.77,7,680716.22,18,1,5,12,True
6296379,681,2,30,5407,577162787,1,0,0,484.95,8,680231.27,24,1,1,12,True
6702065,1009,0,-1,4867,577162787,1,1,0,485.01,4,680231.27,26,1,10,1,True
7026225,834,0,20,8250,577162787,1,0,0,485.0,5,679746.27,5,2,16,1,True
7339759,1029,0,10,1587,577162787,1,0,0,484.74,6,680231.01,11,0,9,2,True
7379400,698,4,451,6779,577162787,1,0,0,485.09,7,679745.92,18,6,20,3,True
7399930,841,1,10,2652,577162787,1,0,0,485.35,0,680231.27,5,0,10,4,False
7625575,149,2,20,7574,577162787,1,0,0,484.96,5,679746.31,18,0,14,5,True
8120109,12,4,451,5407,577162787,1,0,0,485.06,7,679261.25,24,3,6,5,True
8151969,235,4,30,8949,577162787,1,0,0,485.05,8,678776.2,26,4,13,5,True
8260394,254,0,10,9840,577162787,1,0,0,484.93,6,679261.13,6,3,21,5,False
8340156,294,3,25,1985,577162787,1,0,0,484.67,8,678776.46,4,6,20,6,True
8665995,128,0,10,2497,577162787,1,0,0,484.9,6,679261.36,18,0,15,8,True
8705542,1312,0,20,1454,577162787,1,0,0,485.01,5,678776.35,5,3,11,8,True
9131991,327,0,10,4867,577162787,1,0,0,485.24,6,679261.59,11,3,11,8,True
9348105,681,2,25,9840,577162787,1,0,0,484.93,8,678776.66,24,3,15,9,True
9479323,812,0,10,9840,577162787,1,0,0,485.05,6,679261.71,18,4,15,9,True
9480727,573,0,20,9058,577162787,1,0,0,485.0,3,678776.71,11,5,8,10,True
9535016,570,2,20,5079,577162787,1,0,0,485.21,5,678291.5,11,1,3,10,True
9585481,648,3,30,8949,577162787,1,0,0,485.0,8,677806.5,24,5,20,10,True
9628571,294,3,451,9058,577162787,1,0,0,485.02,7,677321.48,4,6,5,10,True
9733057,698,4,25,2652,577162787,1,0,0,484.85,8,676836.63,18,0,2,10,True
9817446,12,4,30,9840,577162787,1,0,0,485.15,8,676351.48,24,3,23,11,True
9977689,1009,0,30,7574,577162787,1,0,0,485.14,8,675866.34,26,2,15,11,True
1120007,783,0,10,5887,186038039,0,0,0,881.99,6,296835.99,14,1,9,3,True
1206183,14,2,20,3320,186038039,0,0,0,881.96,5,295954.03,24,4,7,4,True
1293299,955,4,-1,5526,186038039,0,1,0,881.71,1,295954.03,13,2,11,4,True
1391370,1206,0,20,6460,186038039,0,0,0,881.85,3,295072.18,24,2,22,6,True
1405240,137,2,451,3411,186038039,0,0,0,881.95,7,294190.23,18,1,17,6,True
1518214,699,4,451,1765,186038039,0,0,0,881.72,7,293308.51,18,3,5,6,True
1633736,699,4,30,6460,186038039,0,0,0,882.13,8,292426.38,18,3,16,6,True
1689479,599,0,20,6940,186038039,0,0,0,881.93,5,291544.45,24,5,6,7,True
1785481,882,0,25,3411,186038039,0,0,0,881.94,8,290662.51,27,6,12,7,True
1988576,955,4,30,1229,186038039,0,0,0,882.1,8,289780.41,13,4,21,8,True
2021858,144,1,10,6337,186038039,0,0,0,882.07,6,290662.48,18,6,6,9,True
2551884,882,0,25,1862,186038039,0,0,0,881.87,8,289780.61,27,0,0,9,True
2655865,699,4,451,5887,186038039,0,0,0,881.92,7,288898.69,18,1,21,10,True
3180635,278,1,10,3320,186038039,0,0,0,882.27,6,289780.96,24,6,11,11,True
3276311,955,4,451,5083,186038039,0,0,0,882.04,7,288898.92,13,6,22,11,True
3337900,616,1,451,7452,186038039,0,0,0,882.11,7,288016.81,11,0,1,1,True
3810332,699,4,25,6940,186038039,0,0,0,882.1,8,287134.71,18,5,6,1,True
4112906,1349,3,-1,1229,186038039,0,1,0,881.92,4,287134.71,24,3,11,2,True
4590053,694,2,20,4939,186038039,0,0,0,882.15,5,286252.56,24,5,12,2,True
4635582,699,4,25,1765,186038039,0,0,0,882.08,8,285370.48,18,6,11,2,True
4662882,955,4,-1,1862,186038039,0,1,0,881.94,4,285370.48,13,4,2,3,True
4762035,1349,3,25,7452,186038039,0,0,0,881.68,8,284488.8,24,1,7,3,True
4875857,268,2,20,4881,186038039,0,0,0,881.94,5,283606.86,24,1,18,4,True
4945520,699,4,30,1765,186038039,0,0,0,882.02,8,282724.84,18,2,15,4,True
4980143,699,4,451,6460,186038039,0,0,0,882.07,7,281842.77,18,5,15,4,True
5047913,1349,3,451,5083,186038039,0,0,0,881.71,7,280961.06,24,4,8,5,True
5166629,23,0,20,2973,186038039,0,0,0,882.1,3,280078.96,11,1,20,5,True
5246698,950,0,10,5887,186038039,0,0,0,881.89,6,280960.85,24,4,2,6,True
5528695,1364,0,10,1862,186038039,0,0,0,882.08,6,281842.93,16,0,3,6,True
5581046,360,0,10,4881,186038039,0,0,0,882.09,0,282725.02,24,4,7,6,True
5761159,319,0,20,2973,186038039,0,0,0,881.92,5,281843.1,11,4,23,8,True
6034283,137,2,25,6337,186038039,0,0,0,882.05,8,280961.05,18,6,11,8,True
6711472,549,1,10,1229,186038039,0,0,0,881.9,6,281842.95,17,2,9,9,True
6720541,867,0,10,1547,186038039,0,0,0,882.19,0,282725.14,24,1,10,10,True
6726280,882,0,451,5526,186038039,0,0,0,881.9,7,281843.24,27,5,12,10,True
6813562,137,2,30,3688,186038039,0,0,0,881.78,8,280961.46,18,1,18,10,True
6996329,448,0,10,9065,186038039,0,0,0,881.96,6,281843.42,13,2,22,11,True
7039057,137,2,451,6337,186038039,0,0,0,882.14,7,280961.28,18,0,6,11,True
7447291,137,2,451,5083,186038039,0,0,0,882.03,7,280079.25,18,1,11,11,True
7490178,1349,3,30,1547,186038039,0,0,0,881.95,8,279197.3,24,2,8,11,True
7713877,781,1,10,9408,186038039,0,0,0,881.69,6,280078.99,14,0,12,12,True
7999120,699,4,-1,3688,186038039,0,1,0,882.35,1,280078.99,18,1,21,2,True
8124721,699,4,30,9408,186038039,0,0,0,882.07,8,279196.92,18,2,16,5,True
8317903,699,4,25,1765,186038039,0,0,0,882.05,8,278314.87,18,5,1,5,True
8389390,137,2,451,3320,186038039,0,0,0,882.11,7,277432.76,18,6,21,6,True
8642539,616,1,25,1011,186038039,0,0,0,881.94,8,276550.82,11,5,7,7,True
8788439,955,4,-1,4939,186038039,0,1,0,881.67,1,276550.82,13,1,2,7,True
8806185,699,4,-1,1765,186038039,0,2,0,881.97,1,276550.82,18,4,14,8,True
9070249,699,4,25,9408,186038039,0,0,0,882.01,8,275668.81,18,3,6,9,True
9556124,882,0,-1,6337,186038039,0,1,0,882.07,4,275668.81,27,3,19,9,True
9756344,955,4,451,4545,186038039,0,0,0,881.94,7,274786.87,13,6,13,10,True
9879846,1349,3,30,1862,186038039,0,0,0,881.92,8,273904.95,24,1,6,10,True
9891283,266,2,20,6337,186038039,0,0,0,881.88,3,273023.07,6,0,15,11,True
9967744,68,0,20,1229,186038039,0,0,0,882.2,5,272140.87,20,3,9,11,True
1007884,44,4,451,3469,970190581,0,0,0,848.9,7,241329.1,24,2,17,2,True
1135011,299,1,10,3469,970190581,0,0,0,849.0,6,242178.1,4,0,23,2,True
1137451,634,1,25,4051,970190581,0,0,0,849.04,8,241329.06,24,3,20,2,True
1305465,1311,2,20,5323,970190581,0,0,0,849.22,3,240479.84,5,3,8,3,True
1312977,1195,1,10,4911,970190581,0,0,0,848.95,6,241328.79,24,1,7,3,True
1578296,268,2,25,5323,970190581,0,0,0,848.86,8,240479.93,24,4,6,3,True
1992787,149,2,20,4051,970190581,0,0,0,849.03,3,239630.9,18,3,4,3,True
2098711,111,3,-1,4217,970190581,0,1,0,849.24,4,239630.9,3,6,16,5,True
2123835,1217,0,20,4911,970190581,0,0,0,849.1,5,238781.8,24,1,7,7,True
2299877,268,2,451,3635,970190581,0,0,0,848.82,7,237932.98,24,1,7,7,True
2689625,44,4,-1,3469,970190581,0,1,0,848.99,4,237932.98,24,2,16,8,True
2763939,1277,2,20,1344,970190581,0,0,0,849.16,3,237083.82,24,5,10,8,True
2766461,44,4,-1,8727,970190581,0,1,0,848.85,4,237083.82,24,5,23,9,True
2920380,111,3,25,4190,970190581,0,0,0,849.15,8,236234.67,3,3,1,9,True
3078672,268,2,451,4051,970190581,0,0,0,849.2,7,235385.47,24,2,7,11,True
3087122,634,1,451,7420,970190581,0,0,0,848.87,7,234536.6,24,3,0,11,True
3126928,268,2,30,1010,970190581,0,0,0,848.94,8,233687.66,24,5,17,1,True
3182645,1459,1,30,5323,970190581,0,0,0,848.7,8,232838.96,11,2,1,3,True
3185518,634,1,451,3635,970190581,0,0,0,848.85,7,231990.11,24,1,15,3,True
3397288,971,4,25,3469,970190581,0,0,0,848.99,8,231141.12,13,5,1,4,True
3631876,1352,1,10,4051,970190581,0,0,0,849.03,6,231990.15,24,4,14,5,True
3919863,419,4,451,5323,970190581,0,0,0,848.91,7,231141.24,18,6,17,5,True
3958677,1429,0,20,4051,970190581,0,0,0,849.09,5,230292.15,24,0,12,6,True
4023485,971,4,-1,3469,970190581,0,1,0,848.96,1,230292.15,13,4,9,6,True
4403063,44,4,25,3635,970190581,0,0,0,849.13,8,229443.02,24,1,10,6,True
4840525,1459,1,451,3469,970190581,0,0,0,848.99,7,228594.03,11,6,17,7,True
4908870,1380,0,20,5323,970190581,0,0,0,848.9,3,227745.13,16,6,1,8,True
5225421,634,1,25,3335,970190581,0,0,0,848.8,8,226896.33,24,1,9,10,True
5407737,634,1,451,3469,970190581,0,0,0,849.19,7,226047.14,24,4,20,10,True
5442094,634,1,-1,3469,970190581,0,1,0,849.31,4,226047.14,24,0,9,10,True
5506615,111,3,25,8270,970190581,0,0,0,848.97,8,225198.17,3,3,9,11,True
5546386,268,2,25,4051,970190581,0,0,0,848.81,8,224349.36,24,5,5,11,True
5665251,498,0,10,4051,970190581,0,0,0,848.93,6,225198.29,12,5,18,11,True
6133345,376,0,10,4793,970190581,0,0,0,848.91,6,226047.2,25,0,20,12,True
6396643,1459,1,25,3635,970190581,0,0,0,848.85,8,225198.35,11,2,0,12,True
6537898,677,0,20,4793,970190581,0,0,0,848.72,5,224349.63,24,0,20,12,True
6587937,1250,1,10,7420,970190581,0,0,0,848.98,6,225198.61,23,0,4,2,True
6650675,419,4,25,4217,970190581,0,0,0,849.16,8,224349.45,18,5,5,2,True
6680210,111,3,30,8270,970190581,0,0,0,848.83,8,223500.62,3,0,7,2,True
7010809,1459,1,451,4911,970190581,0,0,0,848.86,7,222651.76,11,3,3,2,True
7245811,419,4,30,3335,970190581,0,0,0,848.92,8,221802.84,18,6,21,2,True
7480740,44,4,451,4051,970190581,0,0,0,848.92,7,220953.92,24,1,23,3,True
7586381,634,1,-1,5603,970190581,0,1,0,848.9,4,220953.92,24,2,5,4,True
7951594,44,4,30,7466,970190581,0,0,0,849.06,8,220104.86,24,1,0,4,True
8236495,373,1,10,7420,970190581,0,0,0,848.94,6,220953.8,25,4,7,4,True
8380278,634,1,-1,4051,970190581,0,1,0,849.13,1,220953.8,24,0,3,5,True
8404163,971,4,25,7466,970190581,0,0,0,849.01,8,220104.79,13,0,20,6,True
8672005,419,4,25,5603,970190581,0,0,0,849.03,8,219255.76,18,6,6,7,True
8924327,503,0,20,4190,970190581,0,0,0,848.88,5,218406.88,12,5,11,9,True
8927921,804,0,10,1344,970190581,0,0,0,848.95,0,219255.83,11,6,10,11,True
9636338,111,3,30,4911,970190581,0,0,0,849.12,8,218406.71,3,4,2,11,True
1566687,1164,0,30,7125,156494933,1,0,0,129.99,8,83029.01,24,4,11,1,True
2022289,480,0,20,8303,156494933,1,0,0,129.81,5,82899.2,5,4,14,1,False
2206124,1352,1,10,8303,156494933,1,0,0,129.92,0,83029.12,24,4,9,2,True
2515256,164,4,451,8251,156494933,1,0,0,130.02,7,82899.1,24,1,12,2,True
2615342,263,3,30,7871,156494933,1,0,0,129.91,8,82769.19,6,0,11,3,False
3208759,164,4,25,4856,156494933,1,0,0,130.03,8,82639.16,24,0,18,3,True
3231467,164,4,451,5272,156494933,1,0,0,129.85,7,82509.31,24,6,17,5,True
3656641,164,4,451,5573,156494933,1,0,0,130.05,7,82379.26,24,0,1,7,True
3769477,664,2,25,5272,156494933,1,0,0,129.68,8,82249.58,18,5,0,8,True
3918312,263,3,451,7733,156494933,1,0,0,129.92,7,82119.66,6,4,12,9,True
4229260,726,0,451,9403,156494933,1,0,0,129.96,7,81989.7,11,4,11,10,True
4387395,263,3,30,7186,156494933,1,0,0,130.34,8,81859.36,6,3,3,10,True
4479240,1495,3,451,2849,156494933,1,0,0,130.14,7,81729.22,24,4,23,11,True
4636723,263,3,30,1732,156494933,1,0,0,129.96,8,81599.26,6,1,14,11,True
4680439,1012,0,25,7740,156494933,1,0,0,130.24,8,81469.02,26,3,4,12,True
4734557,1495,3,451,8731,156494933,1,0,0,130.06,7,81338.96,24,6,17,12,True
4823054,1012,0,-1,7186,156494933,1,1,0,130.07,4,81338.96,26,2,0,1,True
4882099,1495,3,30,7125,156494933,1,0,0,130.02,8,81208.94,24,3,4,1,True
4930541,164,4,25,8251,156494933,1,0,0,129.96,8,81078.98,24,5,8,1,True
5101252,263,3,30,7871,156494933,1,0,0,130.08,8,80948.9,6,1,8,4,True
5501899,1164,0,30,3814,156494933,1,0,0,129.78,8,80819.12,24,6,19,4,True
5641536,1166,2,20,5272,156494933,1,0,0,129.99,3,80689.13,24,3,0,5,True
5662399,263,3,30,8303,156494933,1,0,0,129.91,8,80559.22,6,6,4,5,True
6338847,164,4,30,4713,156494933,1,0,0,129.82,8,80429.4,24,6,0,6,True
6343616,726,0,30,5573,156494933,1,0,0,129.97,8,80299.43,11,1,21,6,True
6352805,59,0,20,7403,156494933,1,0,0,130.05,5,80169.38,20,0,12,6,True
6520308,263,3,30,8731,156494933,1,0,0,130.12,8,80039.26,6,3,11,8,True
6702547,520,4,451,4856,156494933,1,0,0,130.17,7,79909.09,18,3,8,8,True
6713850,1092,1,10,5272,156494933,1,0,0,130.21,6,80039.3,18,4,7,8,True
6936244,1012,0,25,4168,156494933,1,0,0,130.02,8,79909.28,26,6,2,9,True
7101583,64,0,20,7463,156494933,1,0,0,129.97,3,79779.31,20,2,7,9,True
7124966,1262,0,20,9423,156494933,1,0,0,130.06,5,79649.25,23,5,16,9,True
7306219,1495,3,451,8251,156494933,1,0,0,130.12,7,79519.13,24,5,15,11,True
7409777,1116,0,10,7733,156494933,1,0,0,129.79,6,79648.92,24,1,0,11,True
7480940,164,4,30,7733,156494933,1,0,0,129.98,8,79518.94,24,3,10,12,True
7572572,353,1,10,7733,156494933,1,0,0,129.84,6,79648.78,24,4,8,12,True
7722683,664,2,30,7186,156494933,1,0,0,129.83,8,79518.95,18,6,16,12,True
7727044,664,2,30,4357,156494933,1,0,0,129.93,8,79389.02,18,1,21,1,True
7812984,263,3,451,6521,156494933,1,0,0,130.09,7,79258.93,6,3,14,1,True
7856797,520,4,451,3814,156494933,1,0,0,130.09,7,79128.84,18,1,17,1,True
7928545,164,4,25,5272,156494933,1,0,0,129.82,8,78999.02,24,5,6,2,True
7943611,664,2,25,1732,156494933,1,0,0,130.19,8,78868.83,18,2,10,4,True
8051574,1012,0,25,8251,156494933,1,0,0,129.94,8,78738.89,26,1,14,5,True
8077583,164,4,451,5272,156494933,1,0,0,129.83,7,78609.06,24,5,7,5,True
8449393,664,2,451,8090,156494933,1,0,0,130.11,7,78478.95,18,4,21,6,True
8623044,664,2,451,4713,156494933,1,0,0,130.13,7,78348.82,18,0,23,7,True
8745598,726,0,-1,2849,156494933,1,1,0,130.12,4,78348.82,11,0,16,7,True
9202444,726,0,25,5272,156494933,1,0,0,130.19,8,78218.63,11,1,1,7,True
9472870,664,2,30,6521,156494933,1,0,0,130.02,8,78088.61,18,5,19,8,True
9537107,726,0,-1,7463,156494933,1,1,0,130.02,4,78088.61,11,6,7,8,True
9576924,445,0,10,7403,156494933,1,0,0,130.02,6,78218.63,13,6,16,10,True
9621330,594,0,20,8251,156494933,1,0,0,130.32,5,78088.31,24,6,9,11,True
9974950,1164,0,451,1732,156494933,1,0,0,130.18,7,77958.13,24,6,12,11,True
1761704,1037,0,451,9338,283776205,1,0,0,425.05,7,293903.95,11,2,9,1,True
1791963,1217,0,10,9161,283776205,1,0,0,424.87,0,294328.82,24,0,23,1,True
1943892,1037,0,30,8787,283776205,1,0,0,425.04,8,293903.78,11,2,0,3,True
2137053,1037,0,25,9338,283776205,1,0,0,425.06,8,293478.72,11,6,2,4,True
2167601,865,0,10,8248,283776205,1,0,0,424.61,0,293903.33,24,6,22,4,True
2297785,783,0,20,9338,283776205,1,0,0,425.01,5,293478.32,14,5,4,6,True
2311553,626,2,30,8787,283776205,1,0,0,424.92,8,293053.4,11,6,19,6,True
2313874,626,2,30,9161,283776205,1,0,0,424.97,8,292628.43,11,6,16,6,True
2332313,961,4,30,6233,283776205,1,0,0,424.94,8,292203.49,13,1,11,7,True
2499410,626,2,30,5594,283776205,1,0,0,424.96,8,291778.53,11,0,12,7,True
2672908,1352,1,10,9246,283776205,1,0,0,424.9,0,292203.43,24,6,19,9,True
2777566,68,0,30,8787,283776205,1,0,0,425.15,8,291778.28,20,2,1,9,True
2834182,588,0,30,6233,283776205,1,0,0,425.11,8,291353.17,24,0,13,10,True
3027813,1037,0,30,9526,283776205,1,0,0,425.2,8,290927.97,11,3,16,10,True
3161939,468,3,451,8787,283776205,1,0,0,424.78,7,290503.19,5,6,8,11,True
3223801,468,3,451,7451,283776205,1,0,0,425.34,7,290077.85,5,6,15,12,True
3249037,1406,0,10,5175,283776205,1,0,0,425.09,6,290502.94,24,4,15,2,True
3301124,626,2,25,8503,283776205,1,0,0,425.16,8,290077.78,11,1,3,2,True
3413497,355,1,-1,8787,283776205,1,1,0,425.23,4,290077.78,24,4,20,3,True
3685014,90,4,30,5594,283776205,1,0,0,425.04,8,289652.74,1,5,22,3,True
3784140,444,2,20,5594,283776205,1,0,0,424.9,3,289227.84,24,6,15,3,True
3820064,588,0,451,3485,283776205,1,0,0,424.96,7,288802.88,24,0,16,4,False
3871838,468,3,451,8131,283776205,1,0,0,424.94,7,288377.94,5,2,20,4,True
3987253,90,4,30,9246,283776205,1,0,0,425.03,8,287952.91,1,5,13,5,True
4502401,588,0,451,5175,283776205,1,0,0,424.95,7,287527.96,24,0,11,5,True
4722234,564,0,10,5594,283776205,1,0,0,424.81,0,287952.77,17,3,8,6,True
4963335,929,0,20,5584,283776205,1,0,0,425.13,5,287527.64,18,0,17,6,True
5296918,219,0,20,8787,283776205,1,0,0,425.13,5,287102.51,9,6,19,8,True
5387610,818,1,10,8503,283776205,1,0,0,425.22,6,287527.73,18,3,7,8,True
5555842,467,0,20,8443,283776205,1,0,0,425.02,5,287102.71,5,5,1,10,True
5607242,1132,0,20,9246,283776205,1,0,0,425.26,5,286677.45,24,4,21,11,True
5838773,1075,0,20,8787,283776205,1,0,0,425.14,3,286252.31,18,1,10,1,True
5864570,68,0,25,6233,283776205,1,0,0,425.11,8,285827.2,20,5,13,2,True
6036556,90,4,451,9526,283776205,1,0,0,425.02,7,285402.18,1,5,6,2,True
6229495,961,4,30,8787,283776205,1,0,0,425.02,8,284977.16,13,2,7,3,True
6337747,355,1,30,3485,283776205,1,0,0,425.04,8,284552.12,24,5,1,5,True
6498523,626,2,25,8443,283776205,1,0,0,425.0,8,284127.12,11,4,0,5,True
6644934,961,4,451,5594,283776205,1,0,0,425.03,7,283702.09,13,1,4,6,True
6736992,859,2,20,5594,283776205,1,0,0,425.26,5,283276.83,24,2,3,7,True
6772788,355,1,451,8787,283776205,1,0,0,424.78,7,282852.05,24,6,5,7,True
7190483,90,4,30,8787,283776205,1,0,0,424.79,8,282427.26,1,3,16,7,True
7758017,68,0,451,8443,283776205,1,0,0,424.77,7,282002.49,20,0,0,8,True
8342704,355,1,25,9338,283776205,1,0,0,424.93,8,281577.56,24,0,23,8,True
8386714,961,4,451,9338,283776205,1,0,0,425.17,7,281152.39,13,0,23,8,True
8992128,355,1,30,8787,283776205,1,0,0,425.08,8,280727.31,24,3,18,10,True
9063363,850,1,10,8503,283776205,1,0,0,424.9,0,281152.21,5,3,12,11,True
9103048,274,1,10,8503,283776205,1,0,0,425.11,0,281577.32,24,3,16,11,True
9446310,355,1,-1,8248,283776205,1,1,0,424.96,4,281577.32,24,4,23,11,True
9542510,90,4,-1,5584,283776205,1,2,0,425.11,4,281577.32,1,2,4,11,True
9866856,626,2,30,5594,283776205,1,0,0,424.86,8,281152.46,11,3,1,11,True
1218744,309,0,20,4978,857719255,0,0,0,615.15,5,268837.85,4,1,16,1,True
1275647,362,0,451,9899,857719255,0,0,0,615.18,7,268222.67,24,3,23,4,True
1697634,29,0,20,5162,857719255,0,0,0,615.02,3,267607.65,11,0,12,5,True
2085125,211,0,20,4695,857719255,0,0,0,615.02,5,266992.63,9,3,11,5,True
2409603,64,0,20,2732,857719255,0,0,0,615.0,5,266377.63,20,4,15,6,True
2419066,1159,0,20,3560,857719255,0,0,0,614.94,5,265762.69,15,4,10,7,True
2529611,1304,0,10,6799,857719255,0,0,0,614.81,6,266377.5,5,5,14,7,True
2667686,1358,4,25,7151,857719255,0,0,0,614.96,8,265762.54,24,6,8,11,True
2740082,362,0,30,9105,857719255,0,0,0,614.92,8,265147.62,24,5,19,1,True
2909850,626,2,20,2732,857719255,0,0,0,614.91,3,264532.71,11,4,9,3,True
2972732,1162,2,25,9105,857719255,0,0,0,615.09,8,263917.62,24,4,1,3,True
3027397,362,0,25,6191,857719255,0,0,0,614.85,8,263302.77,24,4,18,4,True
3080258,857,1,10,6691,857719255,0,0,0,615.15,6,263917.92,24,0,13,7,True
3281741,1162,2,451,7151,857719255,0,0,0,615.02,7,263302.9,24,5,3,8,True
3288479,1162,2,30,6191,857719255,0,0,0,615.07,8,262687.83,24,5,17,9,True
3435810,1358,4,-1,5931,857719255,0,1,0,615.04,4,262687.83,24,0,8,9,True
3527854,1399,0,10,8489,857719255,0,0,0,615.17,6,263303.0,24,4,4,10,True
3662387,1276,4,25,4695,857719255,0,0,0,614.82,8,262688.18,24,2,19,10,True
4108631,1276,4,25,3560,857719255,0,0,0,615.19,8,262072.99,24,2,3,12,True
4111497,1358,4,451,4678,857719255,0,0,0,615.08,7,261457.91,24,6,13,2,True
4184426,1276,4,-1,3144,857719255,0,1,0,614.92,4,261457.91,24,0,1,5,True
4258552,1065,0,-1,4482,857719255,0,2,0,615.04,4,261457.91,11,2,6,5,True
4328850,362,0,-1,6799,857719255,0,3,1,614.93,1,0.0,24,5,15,8,True
1007497,1243,2,20,1190,138367808,0,0,0,1116.81,3,784532.19,18,5,3,1,True
1110051,1119,0,10,3763,138367808,0,0,0,1117.25,0,785649.44,24,3,18,1,False
1179252,602,4,25,2705,138367808,0,0,0,1117.05,8,784532.39,24,2,10,1,True
1233629,1390,0,10,2705,138367808,0,0,0,1116.87,0,785649.26,24,1,0,2,True
1875926,602,4,25,1208,138367808,0,0,0,1117.11,8,784532.15,24,6,10,2,True
2040106,1364,0,451,8324,138367808,0,0,0,1117.0,7,783415.15,16,0,18,3,True
2055985,1364,0,451,6572,138367808,0,0,0,1116.8,7,782298.35,16,2,23,3,True
2489965,1364,0,30,8403,138367808,0,0,0,1116.86,8,781181.49,16,1,21,4,True
2499129,1364,0,451,2297,138367808,0,0,0,1116.92,7,780064.57,16,6,19,5,True
2538079,961,4,25,3291,138367808,0,0,0,1117.04,8,778947.53,13,5,0,5,True
2580459,961,4,451,2911,138367808,0,0,0,1116.96,7,777830.57,13,3,19,7,True
2630353,961,4,30,2911,138367808,0,0,0,1117.01,8,776713.56,13,4,8,7,True
2731337,644,0,10,1190,138367808,0,0,0,1117.22,6,777830.78,24,2,5,8,True
2928065,1092,1,30,2705,138367808,0,0,0,1116.89,8,776713.89,18,1,11,8,True
3110328,1092,1,451,3763,138367808,0,0,0,1116.99,7,775596.9,18,1,16,8,True
3420261,1092,1,25,8403,138367808,0,0,0,1117.01,8,774479.89,18,6,6,9,True
3473879,1463,2,20,2911,138367808,0,0,0,1117.07,5,773362.82,11,0,11,11,True
3628824,1092,1,25,1190,138367808,0,0,0,1116.98,8,772245.84,18,2,11,11,True
3691989,602,4,30,2705,138367808,0,0,0,1116.57,8,771129.27,24,3,2,12,True
3819504,1364,0,451,8403,138367808,0,0,0,1117.0,7,770012.27,16,5,9,12,True
3960732,1364,0,451,1756,138367808,0,0,0,1116.99,7,768895.28,16,0,6,12,True
4142027,1092,1,451,9067,138367808,0,0,0,1117.11,7,767778.17,18,4,6,12,True
4176609,806,1,10,3108,138367808,0,0,0,1117.29,0,768895.46,11,4,18,1,True
4226231,573,0,10,5669,138367808,0,0,0,1117.0,0,770012.46,11,5,16,1,True
4307521,1092,1,25,2705,138367808,0,0,0,1116.86,8,768895.6,18,0,8,2,True
4436697,728,1,10,8613,138367808,0,0,0,1117.26,6,770012.86,11,4,17,3,True
4658531,41,2,20,8403,138367808,0,0,0,1117.01,5,768895.85,11,0,7,4,True
4971952,1092,1,451,2297,138367808,0,0,0,1117.01,7,767778.84,18,2,15,5,True
4988853,602,4,451,9067,138367808,0,0,0,1117.02,7,766661.82,24,0,21,5,True
5550002,1364,0,30,1208,138367808,0,0,0,1116.85,8,765544.97,16,2,6,5,True
5853996,1364,0,30,6438,138367808,0,0,0,1116.89,8,764428.08,16,1,4,7,True
5932098,1312,0,10,6438,138367808,0,0,0,1116.99,6,765545.07,5,3,19,7,True
6532482,299,1,10,3046,138367808,0,0,0,1116.73,0,766661.8,4,1,20,8,True
6736697,1364,0,30,2480,138367808,0,0,0,1117.16,8,765544.64,16,5,21,8,True
6741070,160,0,451,9067,138367808,0,0,0,1116.97,7,764427.67,24,5,6,8,True
6851242,160,0,25,3027,138367808,0,0,0,1117.07,8,763310.6,24,2,6,10,True
7301069,961,4,30,8403,138367808,0,0,0,1116.93,8,762193.67,13,5,2,10,True
7535270,1179,0,20,1438,138367808,0,0,0,1117.13,5,761076.54,24,0,17,11,True
7544615,961,4,451,6572,138367808,0,0,0,1116.95,7,759959.59,13,1,21,12,True
7563962,961,4,30,2911,138367808,0,0,0,1116.88,8,758842.71,13,6,3,1,True
7604448,602,4,30,3027,138367808,0,0,0,1116.85,8,757725.86,24,6,13,2,True
8051801,180,0,20,3865,138367808,0,0,0,1116.96,3,756608.9,18,6,18,2,True
8085828,854,0,10,8324,138367808,0,0,0,1116.78,0,757725.68,24,3,16,3,True
8114934,602,4,451,2705,138367808,0,0,0,1117.0,7,756608.68,24,2,2,3,True
8235445,961,4,30,6572,138367808,0,0,0,1117.05,8,755491.63,13,3,22,3,True
8339184,1364,0,451,6307,138367808,0,0,0,1116.93,7,754374.7,16,5,0,3,True
8368769,160,0,10,3865,138367808,0,0,0,1117.04,6,755491.74,24,5,0,3,True
8524466,602,4,25,8324,138367808,0,0,0,1116.72,8,754375.02,24,3,14,4,True
8559886,160,0,30,3865,138367808,0,0,0,1116.75,8,753258.27,24,0,7,5,True
8708296,1364,0,30,2911,138367808,0,0,0,1117.08,8,752141.19,16,0,19,6,True
8748412,1243,2,20,6438,138367808,0,0,0,1117.21,5,751023.98,18,4,21,7,True
8758014,160,0,25,2911,138367808,0,0,0,1117.03,8,749906.95,24,5,2,9,True
9118296,1364,0,30,3865,138367808,0,0,0,1117.11,8,748789.84,16,6,13,9,True
9257854,1421,0,10,1748,138367808,0,0,0,1117.0,6,749906.84,24,5,7,10,True
9476435,1364,0,451,8403,138367808,0,0,0,1117.06,7,748789.78,16,3,16,10,True
9789163,1364,0,30,1438,138367808,0,0,0,1116.79,8,747672.99,16,6,11,10,True
9847197,602,4,-1,8324,138367808,0,1,0,1117.03,4,747672.99,24,6,12,10,True
9992752,1364,0,451,3865,138367808,0,0,0,1117.07,7,746555.92,16,4,13,11,True
1064144,1166,2,20,6502,457130353,0,0,0,570.24,3,590267.76,24,5,1,1,True
1117283,261,3,451,6502,457130353,0,0,0,570.15,7,589697.61,6,2,19,2,True
1280735,28,1,10,8743,457130353,0,0,0,569.68,0,590267.29,11,1,3,4,True
1371159,458,3,451,6502,457130353,0,0,0,570.06,7,589697.23,13,1,22,4,False
1486608,1285,1,451,1541,457130353,0,0,0,570.1,7,589127.13,24,0,0,4,True
1523625,1285,1,451,8002,457130353,0,0,0,569.83,7,588557.3,24,2,9,4,True
1554636,1111,0,10,4181,457130353,0,0,0,569.63,0,589126.93,0,6,7,5,True
1700209,51,0,451,8382,457130353,0,0,0,569.85,7,588557.08,20,3,0,6,True
2216420,610,0,10,1197,457130353,0,0,0,570.13,0,589127.21,11,1,8,8,True
2238417,145,0,10,4181,457130353,0,0,0,570.09,0,589697.3,18,5,8,8,True
2302138,261,3,-1,1993,457130353,0,1,0,570.09,4,589697.3,6,3,2,8,True
2374978,41,2,451,8382,457130353,0,0,0,569.95,7,589127.35,11,1,10,8,True
2399675,203,0,10,9626,457130353,0,0,0,569.98,0,589697.33,9,1,21,9,True
2669673,1359,2,30,8804,457130353,0,0,0,569.98,8,589127.35,24,3,23,9,True
2767875,637,4,-1,1197,457130353,0,1,0,569.97,1,589127.35,24,2,10,9,True
2982827,637,4,451,9626,457130353,0,0,0,569.82,7,588557.53,24,6,0,10,True
3350135,1359,2,30,8382,457130353,0,0,0,569.97,8,587987.56,24,5,13,12,True
3475191,29,0,20,7913,457130353,0,0,0,570.25,3,587417.31,11,2,12,1,True
3527173,41,2,-1,7913,457130353,0,1,0,570.0,4,587417.31,11,4,9,1,True
3529094,637,4,25,6502,457130353,0,0,0,570.08,8,586847.23,24,3,17,3,True
3846864,1359,2,451,6502,457130353,0,0,0,569.98,7,586277.25,24,4,19,3,False
4045450,41,2,-1,1111,457130353,0,1,0,570.18,4,586277.25,11,4,7,3,False
4299113,637,4,25,7385,457130353,0,0,0,569.9,8,585707.35,24,6,1,3,True
4334371,147,0,10,1197,457130353,0,0,0,570.02,6,586277.37,18,3,3,3,True
4447211,41,2,451,8382,457130353,0,0,0,570.04,7,585707.33,11,1,22,3,False
4906338,458,3,-1,7913,457130353,0,1,0,569.86,4,585707.33,13,3,22,4,True
5170092,1359,2,-1,8382,457130353,0,2,0,569.99,1,585707.33,24,4,14,4,True
5216379,1388,1,10,1072,457130353,0,0,0,569.79,0,586277.12,24,1,17,5,True
5378279,458,3,451,8002,457130353,0,0,0,569.91,7,585707.21,13,3,1,6,True
5504621,254,0,20,1072,457130353,0,0,0,570.13,5,585137.08,6,5,6,6,True
5812288,458,3,451,4927,457130353,0,0,0,570.13,7,584566.95,13,0,7,7,True
5826265,261,3,30,4927,457130353,0,0,0,569.94,8,583997.01,6,3,22,8,True
5858057,41,2,451,7007,457130353,0,0,0,570.16,7,583426.85,11,2,9,9,True
5876324,480,0,20,4181,457130353,0,0,0,570.0,3,582856.85,5,5,18,11,True
6134859,348,0,20,4271,457130353,0,0,0,570.3,5,582286.55,24,2,15,11,True
6498768,931,0,20,1273,457130353,0,0,0,569.84,5,581716.71,24,5,21,12,True
6534157,261,3,25,7913,457130353,0,0,0,569.88,8,581146.83,6,4,18,1,False
6706720,1285,1,451,7385,457130353,0,0,0,569.88,7,580576.95,24,5,6,2,True
6893471,1359,2,25,8035,457130353,0,0,0,569.9,8,580007.05,24,3,23,2,True
7088437,1285,1,25,4927,457130353,0,0,0,570.2,8,579436.85,24,3,9,4,True
7306377,1359,2,30,1541,457130353,0,0,0,570.06,8,578866.79,24,4,7,4,True
7491122,1314,2,20,1111,457130353,0,0,0,569.76,3,578297.03,5,5,17,5,True
7762682,458,3,25,1993,457130353,0,0,0,570.26,8,577726.77,13,2,3,5,False
7789384,1359,2,451,8035,457130353,0,0,0,569.88,7,577156.89,24,3,11,5,True
7833465,1285,1,30,1541,457130353,0,0,0,569.95,8,576586.94,24,3,5,6,True
7947013,303,0,20,8235,457130353,0,0,0,569.97,5,576016.97,4,3,20,6,True
8187351,637,4,30,8804,457130353,0,0,0,570.05,8,575446.92,24,4,12,6,True
8631336,1359,2,-1,7385,457130353,0,1,0,570.14,4,575446.92,24,3,16,7,True
8986615,1359,2,451,8035,457130353,0,0,0,570.13,7,574876.79,24,4,22,7,True
9329552,261,3,451,8035,457130353,0,0,0,569.92,7,574306.87,6,1,17,7,True
9412241,1285,1,25,8002,457130353,0,0,0,570.03,8,573736.84,24,6,3,8,True
9474631,627,0,20,4181,457130353,0,0,0,569.99,3,573166.85,11,0,10,8,True
9607843,1359,2,451,1273,457130353,0,0,0,569.97,7,572596.88,24,1,12,8,True
9677516,261,3,451,5444,457130353,0,0,0,570.2,7,572026.68,6,3,1,9,True
9957440,637,4,451,4271,457130353,0,0,0,570.06,7,571456.62,24,3,12,10,True
1104927,254,0,-1,6291,960497101,0,1,0,857.84,4,480574.0,6,1,21,1,True
1201836,44,4,-1,5649,960497101,0,2,0,857.98,1,480574.0,24,0,10,1,True
1365728,44,4,25,1311,960497101,0,0,0,858.01,8,479715.99,24,2,5,2,True
1609880,77,4,451,6291,960497101,0,0,0,858.0,7,478857.99,1,3,1,2,True
1709894,1345,2,20,5498,960497101,0,0,0,858.18,5,477999.81,24,0,9,2,True
1876872,1387,1,10,6031,960497101,0,0,0,858.11,0,478857.92,24,5,16,4,True
1920721,862,4,25,4877,960497101,0,0,0,857.72,8,478000.2,24,1,5,8,False
2074184,1125,1,10,1311,960497101,0,0,0,858.2,6,478858.4,24,4,4,9,True
2293102,128,0,20,4734,960497101,0,0,0,858.0,3,478000.4,18,1,22,9,True
2295609,118,2,20,7506,960497101,0,0,0,857.79,5,477142.61,18,4,20,10,True
2607169,1090,0,25,3051,960497101,0,0,0,857.95,8,476284.66,18,3,12,10,True
2944933,1041,0,25,7237,960497101,0,0,0,857.67,8,475426.99,11,1,16,11,True
3892658,1090,0,-1,5649,960497101,0,1,0,858.06,1,475426.99,18,2,8,12,True
3970531,1041,0,30,4158,960497101,0,0,0,858.19,8,474568.8,11,5,5,12,True
4042099,862,4,25,3099,960497101,0,0,0,857.75,8,473711.05,24,5,11,1,True
4320875,867,0,451,7237,960497101,0,0,0,858.09,7,472852.96,24,1,5,2,True
4535278,889,0,10,8412,960497101,0,0,0,858.19,6,473711.15,27,2,17,3,True
4685177,862,4,451,2803,960497101,0,0,0,858.19,7,472852.96,24,0,15,3,True
4751686,867,0,30,4734,960497101,0,0,0,857.85,8,471995.11,24,2,23,5,True
4864124,862,4,25,3051,960497101,0,0,0,857.94,8,471137.17,24,0,7,5,True
4882810,962,0,20,4680,960497101,0,0,0,857.86,5,470279.31,13,2,15,5,True
5520914,816,0,10,4158,960497101,0,0,0,858.05,6,471137.36,18,4,18,6,True
5906286,44,4,-1,7658,960497101,0,1,0,858.01,4,471137.36,24,6,18,6,True
5925105,1424,4,30,4978,960497101,0,0,0,858.19,8,470279.17,24,2,7,7,True
6078577,862,4,30,4680,960497101,0,0,0,857.84,8,469421.33,24,2,11,7,True
6515380,1123,2,20,1872,960497101,0,0,0,858.17,5,468563.16,24,1,11,9,True
6655987,695,2,20,4025,960497101,0,0,0,858.06,5,467705.1,24,4,16,9,True
6709185,254,0,-1,2664,960497101,0,1,0,858.3,4,467705.1,6,5,22,10,True
6743817,1424,4,451,4235,960497101,0,0,0,858.1,7,466847.0,24,4,14,11,True
6990090,588,0,10,5649,960497101,0,0,0,857.9,0,467704.9,24,0,10,11,True
7011279,254,0,25,8412,960497101,0,0,0,857.71,8,466847.19,6,4,8,1,True
7084559,862,4,451,9129,960497101,0,0,0,857.99,7,465989.2,24,4,7,2,True
7092909,51,0,20,2803,960497101,0,0,0,857.61,5,465131.59,20,4,2,2,True
7201973,44,4,30,7237,960497101,0,0,0,858.04,8,464273.55,24,2,19,3,True
7765025,862,4,-1,6291,960497101,0,1,0,858.42,4,464273.55,24,1,6,3,False
7825495,862,4,-1,5372,960497101,0,2,0,857.88,4,464273.55,24,5,19,4,True
8513220,1090,0,451,5649,960497101,0,0,0,858.02,7,463415.53,18,6,20,4,True
8717449,77,4,-1,2803,960497101,0,1,0,857.82,4,463415.53,1,0,18,5,True
8771447,1124,0,20,7506,960497101,0,0,0,858.19,3,462557.34,24,1,11,5,True
8849195,867,0,451,4734,960497101,0,0,0,857.95,7,461699.39,24,2,16,6,True
9044636,254,0,451,9129,960497101,0,0,0,858.06,7,460841.33,6,5,18,6,True
9233653,713,0,20,3051,960497101,0,0,0,858.18,5,459983.15,18,5,21,6,True
9282032,862,4,25,2849,960497101,0,0,0,858.01,8,459125.14,24,5,10,6,True
9398012,862,4,-1,4025,960497101,0,1,0,857.91,1,459125.14,24,3,15,7,True
9447107,867,0,30,5372,960497101,0,0,0,858.13,8,458267.01,24,5,3,7,True
9449191,867,0,451,5372,960497101,0,0,0,858.1,7,457408.91,24,0,17,9,True
9552625,180,0,20,2803,960497101,0,0,0,858.21,5,456550.7,18,2,21,9,True
9643024,77,4,30,4734,960497101,0,0,0,858.14,8,455692.56,1,3,6,10,True
9652655,867,0,451,5372,960497101,0,0,0,857.89,7,454834.67,24,3,5,11,True
9659197,1435,2,20,6031,960497101,0,0,0,858.14,3,453976.53,24,4,3,11,True
9953708,867,0,25,4235,960497101,0,0,0,858.11,8,453118.42,24,6,7,11,False
1193849,1164,0,20,6373,676546369,1,0,0,308.0,3,865591.0,24,1,6,1,True
1396343,931,0,20,4223,676546369,1,0,0,307.97,3,865283.03,24,1,4,1,True
1506551,584,0,10,4943,676546369,1,0,0,307.81,6,865590.84,11,4,15,1,True
1575262,1413,0,451,6863,676546369,1,0,0,307.9,7,865282.94,24,3,9,2,True
1722924,1413,0,451,2127,676546369,1,0,0,307.82,7,864975.12,24,5,16,2,True
1842837,486,4,25,3325,676546369,1,0,0,307.99,8,864667.13,5,6,0,3,True
2103832,734,0,10,4943,676546369,1,0,0,308.34,6,864975.47,11,6,7,3,True
2278598,1413,0,-1,1113,676546369,1,1,0,308.31,1,864975.47,24,4,16,4,True
2290253,1463,2,20,6863,676546369,1,0,0,307.87,5,864667.6,11,4,15,4,True
2309825,187,4,30,6373,676546369,1,0,0,307.67,8,864359.93,18,4,2,4,True
2387305,77,4,-1,4940,676546369,1,1,0,308.0,4,864359.93,1,5,7,4,True
2414342,480,0,10,8989,676546369,1,0,0,307.99,0,864667.92,5,6,19,6,True
2499199,844,1,10,9380,676546369,1,0,0,308.06,0,864975.98,5,4,5,6,True
2582477,394,0,20,8175,676546369,1,0,0,308.08,5,864667.9,10,4,20,6,True
2741729,486,4,30,9380,676546369,1,0,0,308.03,8,864359.87,5,1,6,7,True
2859197,1390,0,10,1982,676546369,1,0,0,308.36,6,864668.23,24,2,10,8,True
2906458,204,0,10,4758,676546369,1,0,0,307.9,6,864976.13,9,1,14,8,True
2942209,420,4,30,8234,676546369,1,0,0,308.03,8,864668.1,18,1,17,9,True
3170247,642,0,10,4223,676546369,1,0,0,308.06,6,864976.16,24,1,13,10,True
3244999,1284,2,451,4223,676546369,1,0,0,308.1,7,864668.06,24,0,21,10,True
3646920,77,4,451,1484,676546369,1,0,0,307.96,7,864360.1,1,2,21,11,True
3876442,187,4,451,4758,676546369,1,0,0,307.98,7,864052.12,18,3,20,1,True
3910063,1075,0,10,8175,676546369,1,0,0,308.25,6,864360.37,18,2,15,3,True
3992550,867,0,10,6373,676546369,1,0,0,308.03,6,864668.4,24,2,4,3,True
4027596,420,4,25,3163,676546369,1,0,0,307.92,8,864360.48,18,3,14,3,True
4854932,420,4,30,1484,676546369,1,0,0,308.03,8,864052.45,18,4,20,3,True
4895741,549,1,10,9380,676546369,1,0,0,308.09,6,864360.54,17,1,0,3,True
5074665,218,0,-1,8175,676546369,1,1,0,307.93,1,864360.54,9,3,17,4,True
5193690,1284,2,30,3163,676546369,1,0,0,307.92,8,864052.62,24,0,5,4,True
5378292,187,4,25,9645,676546369,1,0,0,307.81,8,863744.81,18,0,9,4,True
5420800,486,4,451,3325,676546369,1,0,0,308.11,7,863436.7,5,5,14,6,True
5520967,486,4,25,5113,676546369,1,0,0,307.72,8,863128.98,5,2,11,6,True
5765221,420,4,30,4223,676546369,1,0,0,308.17,8,862820.81,18,6,9,7,True
5844060,1284,2,30,9380,676546369,1,0,0,308.08,8,862512.73,24,0,6,8,True
5970087,187,4,-1,8989,676546369,1,1,0,308.02,1,862512.73,18,2,20,8,True
5990320,486,4,25,8175,676546369,1,0,0,308.24,8,862204.49,5,3,1,10,True
6169368,1284,2,-1,2127,676546369,1,1,0,307.92,4,862204.49,24,1,11,11,True
6684997,420,4,30,3506,676546369,1,0,0,308.19,8,861896.3,18,2,8,11,True
6765444,77,4,451,2137,676546369,1,0,0,307.97,7,861588.33,1,3,12,11,True
6827043,77,4,30,9645,676546369,1,0,0,308.1,8,861280.23,1,4,12,12,True
6937961,572,0,10,4037,676546369,1,0,0,307.98,0,861588.21,11,2,1,2,True
7481823,1413,0,451,8175,676546369,1,0,0,307.99,7,861280.22,24,4,3,3,True
7644932,1284,2,25,6863,676546369,1,0,0,308.13,8,860972.09,24,3,3,4,True
7957070,1413,0,30,2127,676546369,1,0,0,308.24,8,860663.85,24,4,13,4,True
8193761,1238,0,20,4758,676546369,1,0,0,307.89,5,860355.96,18,4,5,4,True
8507568,1284,2,451,3325,676546369,1,0,0,308.08,7,860047.88,24,1,21,5,True
9012026,866,0,20,5113,676546369,1,0,0,308.37,5,859739.51,24,2,6,7,True
9080950,1413,0,451,2127,676546369,1,0,0,307.83,7,859431.68,24,2,7,7,True
9266063,1413,0,-1,1484,676546369,1,1,0,308.21,4,859431.68,24,6,13,9,True
9605362,1284,2,451,6863,676546369,1,0,0,307.93,7,859123.75,24,1,12,9,True
9689460,420,4,-1,8989,676546369,1,1,0,308.12,1,859123.75,18,4,6,9,True
9941431,1284,2,30,3506,676546369,1,0,0,308.01,8,858815.74,24,2,11,10,True
1105095,1315,0,20,4415,869103866,0,0,0,953.02,5,434889.98,5,0,17,1,True
1356672,603,0,20,9393,869103866,0,0,0,953.13,5,433936.85,24,0,1,1,True
1532375,953,4,25,7257,869103866,0,0,0,953.18,8,432983.67,13,1,3,2,True
1805426,462,4,30,9244,869103866,0,0,0,952.75,8,432030.92,13,3,19,3,True
2044346,929,0,25,6117,869103866,0,0,0,953.11,8,431077.81,18,3,20,3,True
2373109,903,3,451,3811,869103866,0,0,0,953.26,7,430124.55,2,1,20,3,True
2992219,524,1,10,4410,869103866,0,0,0,953.01,6,431077.56,18,4,8,3,False
3054650,274,1,10,6675,869103866,0,0,0,952.96,6,432030.52,24,3,1,3,True
3177609,835,4,25,5848,869103866,0,0,0,952.71,8,431077.81,5,0,21,4,True
3321096,255,2,20,2181,869103866,0,0,0,953.39,3,430124.42,6,3,8,5,True
3337447,903,3,451,6822,869103866,0,0,0,953.03,7,429171.39,2,0,2,6,True
3404742,359,2,451,8984,869103866,0,0,0,953.05,7,428218.34,24,6,19,6,True
3500617,993,0,20,6848,869103866,0,0,0,953.0,5,427265.34,22,1,1,6,True
3886696,1075,0,451,9393,869103866,0,0,0,952.98,7,426312.36,18,6,19,7,False
3889658,462,4,30,9443,869103866,0,0,0,952.86,8,425359.5,13,5,18,9,True
4105964,841,1,10,8000,869103866,0,0,0,953.15,6,426312.65,5,5,2,10,True
4161836,42,2,30,6675,869103866,0,0,0,953.11,8,425359.54,24,6,0,10,True
4372527,1075,0,451,6608,869103866,0,0,0,952.79,7,424406.75,18,6,0,11,True
4461727,835,4,30,5129,869103866,0,0,0,953.05,8,423453.7,5,6,14,12,True
4624190,917,0,10,6043,869103866,0,0,0,952.93,6,424406.63,18,1,21,1,True
4733820,34,1,10,4415,869103866,0,0,0,952.93,6,425359.56,11,5,2,2,True
5218722,903,3,-1,6608,869103866,0,1,0,953.2,4,425359.56,2,6,12,3,True
5251033,42,2,451,6608,869103866,0,0,0,952.81,7,424406.75,24,4,14,3,True
5381674,462,4,451,8984,869103866,0,0,0,953.12,7,423453.63,13,1,1,3,True
5414730,279,2,20,8984,869103866,0,0,0,953.03,5,422500.6,24,0,14,3,True
5470265,42,2,451,2462,869103866,0,0,0,953.08,7,421547.52,24,2,11,4,True
5751691,462,4,25,6608,869103866,0,0,0,953.24,8,420594.28,13,6,0,5,True
5915722,34,1,25,9217,869103866,0,0,0,953.08,8,419641.2,11,4,11,7,True
6031957,1075,0,451,6848,869103866,0,0,0,952.94,7,418688.26,18,5,0,8,True
6441191,286,1,10,9171,869103866,0,0,0,953.28,6,419641.54,24,6,8,9,True
6749579,1000,0,20,6822,869103866,0,0,0,953.14,5,418688.4,26,1,20,9,True
6769144,462,4,451,8000,869103866,0,0,0,952.65,7,417735.75,13,1,13,9,True
6914522,594,0,20,6043,869103866,0,0,0,952.93,5,416782.82,24,3,22,9,True
7050920,42,2,30,2181,869103866,0,0,0,952.88,8,415829.94,24,0,23,10,True
7135962,34,1,451,4415,869103866,0,0,0,952.8,7,414877.14,11,3,7,11,True
8309283,462,4,-1,2462,869103866,0,1,0,952.99,4,414877.14,13,1,19,11,True
8341025,929,0,25,9217,869103866,0,0,0,952.9,8,413924.24,18,3,20,12,True
8524883,835,4,25,5129,869103866,0,0,0,953.36,8,412970.88,5,3,8,12,True
8792649,835,4,25,9443,869103866,0,0,0,952.97,8,412017.91,5,1,22,12,True
8819007,108,2,20,6117,869103866,0,0,0,953.08,5,411064.83,3,4,13,12,False
8836949,1075,0,-1,2181,869103866,0,1,0,953.25,4,411064.83,18,6,17,1,False
8899660,835,4,451,6608,869103866,0,0,0,953.0,7,410111.83,5,2,9,4,True
9219607,359,2,451,9443,869103866,0,0,0,953.22,7,409158.61,24,0,21,4,True
9264128,929,0,25,1757,869103866,0,0,0,953.15,8,408205.46,18,3,7,5,True
9358741,1262,0,10,8793,869103866,0,0,0,952.99,6,409158.45,23,0,1,6,True
9487139,1075,0,30,9393,869103866,0,0,0,952.77,8,408205.68,18,4,9,8,True
9494675,953,4,30,5848,869103866,0,0,0,952.93,8,407252.75,13,0,13,8,True
9597544,929,0,451,6822,869103866,0,0,0,952.8,7,406299.95,18,6,12,9,True
9846528,953,4,30,6608,869103866,0,0,0,952.94,8,405347.01,13,1,23,9,True
9887844,1179,0,10,6117,869103866,0,0,0,953.36,0,406300.37,24,3,10,9,True
1107852,366,0,20,9027,967641916,1,0,0,181.14,5,350184.86,25,1,13,1,True
1158210,589,1,25,8069,967641916,1,0,0,181.19,8,350003.67,24,0,0,1,True
1487130,736,1,30,8579,967641916,1,0,0,180.84,8,349822.83,11,1,8,3,True
1576693,469,4,451,8579,967641916,1,0,0,181.12,7,349641.71,5,4,5,3,True
1589584,1170,0,20,8579,967641916,1,0,0,180.73,5,349460.98,24,0,14,4,True
1664732,469,4,451,1913,967641916,1,0,0,181.06,7,349279.92,5,4,1,5,True
1680829,469,4,30,7219,967641916,1,0,0,180.92,8,349099.0,5,5,2,7,True
1726422,589,1,451,1745,967641916,1,0,0,180.93,7,348918.07,24,3,19,8,True
1865268,279,2,30,3857,967641916,1,0,0,180.94,8,348737.13,24,1,7,9,True
2115105,944,2,451,6422,967641916,1,0,0,180.84,7,348556.29,24,3,17,10,True
2204424,279,2,451,4013,967641916,1,0,0,181.06,7,348375.23,24,0,8,11,True
2375609,1411,0,20,3881,967641916,1,0,0,180.98,3,348194.25,24,4,11,12,False
2446123,736,1,30,8027,967641916,1,0,0,180.98,8,348013.27,11,4,16,12,True
2474978,736,1,30,3881,967641916,1,0,0,180.93,8,347832.34,11,0,12,12,True
2570273,469,4,30,6811,967641916,1,0,0,180.89,8,347651.45,5,1,7,12,True
2581146,123,0,10,8027,967641916,1,0,0,181.1,6,347832.55,18,4,2,2,True
2582544,735,1,451,8579,967641916,1,0,0,180.98,7,347651.57,11,0,9,2,True
2791406,279,2,451,4013,967641916,1,0,0,181.22,7,347470.35,24,4,3,2,True
3247318,589,1,-1,4013,967641916,1,1,0,181.29,4,347470.35,24,1,8,2,True
3255598,736,1,451,8690,967641916,1,0,0,181.08,7,347289.27,11,3,22,3,True
3300359,589,1,30,5151,967641916,1,0,0,181.01,8,347108.26,24,3,1,3,True
3389272,279,2,25,6196,967641916,1,0,0,181.12,8,346927.14,24,0,2,4,True
3710107,736,1,451,8271,967641916,1,0,0,181.05,7,346746.09,11,6,19,4,True
3803202,589,1,-1,8027,967641916,1,1,0,181.02,4,346746.09,24,5,8,4,True
4056793,511,1,10,3881,967641916,1,0,0,180.97,0,346927.06,12,0,15,5,True
4142122,279,2,30,6811,967641916,1,0,0,181.01,8,346746.05,24,0,2,5,True
4144081,944,2,451,5151,967641916,1,0,0,180.68,7,346565.37,24,0,14,5,True
4394388,944,2,30,1745,967641916,1,0,0,181.05,8,346384.32,24,1,16,5,True
4730559,589,1,-1,9027,967641916,1,1,0,180.96,4,346384.32,24,1,4,5,True
5322383,944,2,30,5151,967641916,1,0,0,181.06,8,346203.26,24,5,14,6,True
5453240,937,0,10,6811,967641916,1,0,0,180.9,6,346384.16,24,4,6,6,True
5508972,535,0,10,6422,967641916,1,0,0,181.06,0,346565.22,18,0,6,7,True
5839363,279,2,30,7560,967641916,1,0,0,181.03,8,346384.19,24,3,21,7,True
6130380,279,2,25,1745,967641916,1,0,0,181.01,8,346203.18,24,1,19,8,True
6278988,589,1,451,8690,967641916,1,0,0,181.06,7,346022.12,24,6,11,8,True
6645264,279,2,451,1745,967641916,1,0,0,181.02,7,345841.1,24,1,9,9,True
6797373,469,4,451,7219,967641916,1,0,0,180.86,7,345660.24,5,1,18,9,True
6800781,944,2,451,6196,967641916,1,0,0,180.81,7,345479.43,24,3,12,10,True
6867247,736,1,-1,7219,967641916,1,1,0,181.23,1,345479.43,11,2,4,11,True
6938770,736,1,451,7560,967641916,1,0,0,180.87,7,345298.56,11,5,3,12,True
7124695,589,1,25,7560,967641916,1,0,0,180.96,8,345117.6,24,6,3,12,True
7318773,279,2,25,8690,967641916,1,0,0,180.79,8,344936.81,24,3,9,1,True
7650875,944,2,-1,4013,967641916,1,1,0,180.85,4,344936.81,24,0,14,2,True
7935366,279,2,30,8579,967641916,1,0,0,180.97,8,344755.84,24,6,4,2,True
7953516,736,1,25,8579,967641916,1,0,0,181.05,8,344574.79,11,5,11,3,True
8237835,398,0,10,7560,967641916,1,0,0,181.14,6,344755.93,10,2,12,4,True
8505949,735,1,25,9027,967641916,1,0,0,180.9,8,344575.03,11,3,15,5,True
8905037,735,1,25,7560,967641916,1,0,0,181.0,8,344394.03,11,3,15,5,True
9197371,279,2,451,1913,967641916,1,0,0,180.73,7,344213.3,24,3,11,5,False
9290805,736,1,451,8690,967641916,1,0,0,180.94,7,344032.36,11,5,22,7,True
9351572,512,0,20,8690,967641916,1,0,0,180.98,5,343851.38,12,5,21,7,True
9427583,944,2,30,1919,967641916,1,0,0,181.28,8,343670.1,24,2,10,9,True
9548408,944,2,-1,7560,967641916,1,1,0,181.03,4,343670.1,24,3,22,10,True
9621755,757,0,20,1745,967641916,1,0,0,180.81,3,343489.29,24,5,3,10,True
9656930,735,1,451,5151,967641916,1,0,0,181.12,7,343308.17,11,3,20,11,True
9678938,944,2,30,9027,967641916,1,0,0,180.59,8,343127.58,24,4,9,11,True
9873324,736,1,451,8027,967641916,1,0,0,180.62,7,342946.96,11,5,10,11,True
1001807,1324,4,-1,9439,256837934,1,1,0,1183.96,1,950384.0,18,2,18,1,True
1515113,189,4,451,1495,256837934,1,0,0,1184.04,7,949199.96,18,5,21,1,True
1754598,1468,1,25,8190,256837934,1,0,0,1184.0,8,948015.96,11,3,9,1,True
1886966,1468,1,25,8726,256837934,1,0,0,1184.24,8,946831.72,11,3,11,3,True
1928047,708,2,20,8806,256837934,1,0,0,1184.12,5,945647.6,18,0,8,3,True
1981562,1468,1,-1,1910,256837934,1,1,0,1184.13,4,945647.6,11,5,1,4,True
2404822,1216,4,30,7543,256837934,1,0,0,1184.05,8,944463.55,24,3,7,7,True
2433121,790,0,20,5886,256837934,1,0,0,1183.81,5,943279.74,11,6,8,7,True
2542658,463,1,451,6652,256837934,1,0,0,1184.05,7,942095.69,13,0,15,7,True
2786857,189,4,451,2997,256837934,1,0,0,1184.11,7,940911.58,18,1,16,7,True
2797478,1110,0,10,7749,256837934,1,0,0,1184.09,6,942095.67,0,2,15,7,True
2873615,669,2,20,7676,256837934,1,0,0,1184.1,3,940911.57,18,0,16,9,True
2881813,1376,3,451,4112,256837934,1,0,0,1184.11,7,939727.46,16,6,15,10,True
2965668,1216,4,451,8190,256837934,1,0,0,1183.85,7,938543.61,24,2,4,10,False
2969929,189,4,30,4342,256837934,1,0,0,1184.14,8,937359.47,18,2,17,11,False
3104237,1128,2,20,9494,256837934,1,0,0,1183.81,5,936175.66,24,3,13,12,True
3409674,1376,3,-1,6652,256837934,1,1,0,1184.03,4,936175.66,16,4,10,12,True
3535199,367,1,10,8806,256837934,1,0,0,1184.16,6,937359.82,25,5,20,12,False
4052407,1284,2,20,8190,256837934,1,0,0,1184.05,5,936175.77,24,1,16,12,True
4167871,463,1,451,5129,256837934,1,0,0,1183.9,7,934991.87,13,5,12,12,True
4198375,1066,4,451,8806,256837934,1,0,0,1184.26,7,933807.61,11,2,8,1,True
4277553,1376,3,25,1495,256837934,1,0,0,1183.7,8,932623.91,16,6,3,1,True
4568203,189,4,451,3451,256837934,1,0,0,1183.96,7,931439.95,18,4,2,1,True
4892532,297,0,10,4112,256837934,1,0,0,1184.31,6,932624.26,4,5,1,1,True
5012247,1170,0,20,7676,256837934,1,0,0,1184.02,5,931440.24,24,2,1,1,True
5082073,1216,4,25,7543,256837934,1,0,0,1184.22,8,930256.02,24,5,10,2,True
5159861,189,4,451,1171,256837934,1,0,0,1183.96,7,929072.06,18,2,6,2,True
5284227,1159,0,10,6818,256837934,1,0,0,1183.9,6,930255.96,15,1,19,3,False
5444653,463,1,451,8190,256837934,1,0,0,1183.91,7,929072.05,13,3,6,3,True
5656788,1376,3,25,3451,256837934,1,0,0,1183.9,8,927888.15,16,0,23,4,True
5692866,1066,4,-1,2408,256837934,1,1,0,1184.05,4,927888.15,11,2,0,5,True
5724544,463,1,451,4342,256837934,1,0,0,1184.02,7,926704.13,13,1,22,6,True
5731504,27,0,20,4808,256837934,1,0,0,1183.96,3,925520.17,11,4,20,7,True
5823991,1376,3,25,5705,256837934,1,0,0,1183.95,8,924336.22,16,5,20,7,True
6120502,1324,4,30,6015,256837934,1,0,0,1183.64,8,923152.58,18,0,12,7,True
6383322,1468,1,451,5886,256837934,1,0,0,1183.97,7,921968.61,11,0,1,8,True
6474653,189,4,30,7596,256837934,1,0,0,1184.11,8,920784.5,18,3,13,8,True
6538923,916,0,10,2997,256837934,1,0,0,1184.01,6,921968.51,18,2,10,8,True
6612107,1066,4,451,9494,256837934,1,0,0,1183.9,7,920784.61,11,5,1,8,True
6627330,463,1,25,6652,256837934,1,0,0,1184.03,8,919600.58,13,0,9,9,True
6638610,800,0,10,2408,256837934,1,0,0,1184.13,0,920784.71,11,3,15,10,True
6786594,1468,1,451,4112,256837934,1,0,0,1184.08,7,919600.63,11,0,11,11,True
6828588,1376,3,-1,8190,256837934,1,1,0,1183.94,1,919600.63,16,6,10,11,True
7448352,1288,0,10,3672,256837934,1,0,0,1184.06,0,920784.69,24,2,23,11,True
7598639,635,2,20,1910,256837934,1,0,0,1184.18,3,919600.51,24,4,2,12,True
7723234,278,1,10,8190,256837934,1,0,0,1184.04,6,920784.55,24,3,22,12,True
8700089,1307,0,20,1495,256837934,1,0,0,1184.03,3,919600.52,5,0,15,1,True
8728266,1089,0,20,7749,256837934,1,0,0,1183.69,5,918416.83,18,0,19,2,True
9187978,189,4,451,6652,256837934,1,0,0,1184.06,7,917232.77,18,1,9,5,True
9199233,1324,4,-1,7676,256837934,1,1,0,1183.92,1,917232.77,18,0,13,6,True
9321998,1312,0,10,3227,256837934,1,0,0,1183.87,6,918416.64,5,0,10,6,True
9543349,189,4,30,9102,256837934,1,0,0,1183.78,8,917232.86,18,6,10,6,True
9797979,189,4,451,3069,256837934,1,0,0,1184.05,7,916048.81,18,1,12,7,True
9830425,1066,4,451,8806,256837934,1,0,0,1183.67,7,914865.14,11,3,21,8,True
9832633,1324,4,30,2408,256837934,1,0,0,1184.3,8,913680.84,18,3,17,8,True
9897885,312,0,20,1042,256837934,1,0,0,1184.18,5,912496.66,4,5,18,9,True
9911249,463,1,30,4112,256837934,1,0,0,1184.25,8,911312.41,13,5,19,10,True
9953569,1066,4,-1,1171,256837934,1,1,0,1184.03,4,911312.41,11,0,16,11,True
1039589,468,3,30,8007,932558963,0,0,0,824.87,8,741553.13,5,4,13,1,True
1117540,802,2,20,7836,932558963,0,0,0,824.97,5,740728.16,11,6,2,2,True
2385126,806,1,10,4232,932558963,0,0,0,825.22,0,741553.38,11,4,2,3,True
2648355,679,0,20,2176,932558963,0,0,0,824.84,5,740728.54,24,1,21,4,True
2782710,1233,0,451,8516,932558963,0,0,0,824.77,7,739903.77,18,5,14,4,True
2958761,134,4,-1,1245,932558963,0,1,0,824.95,1,739903.77,18,1,1,7,True
3283219,276,0,30,4831,932558963,0,0,0,824.71,8,739079.06,24,5,8,8,True
3299711,199,0,10,5545,932558963,0,0,0,824.94,0,739904.0,18,6,19,9,True
3824977,468,3,451,4972,932558963,0,0,0,825.37,7,739078.63,5,4,13,9,True
4186005,529,2,451,3146,932558963,0,0,0,825.17,7,738253.46,18,4,14,10,True
4409285,594,0,-1,9665,932558963,0,1,0,825.06,1,738253.46,24,2,21,11,True
4513262,240,4,451,4232,932558963,0,0,0,824.92,7,737428.54,26,0,23,11,True
4536918,168,0,20,4972,932558963,0,0,0,824.92,3,736603.62,24,3,21,12,True
4654563,594,0,30,4831,932558963,0,0,0,824.98,8,735778.64,24,1,5,12,True
4775519,1233,0,-1,3975,932558963,0,1,0,825.11,4,735778.64,18,1,8,12,True
4799545,594,0,451,5145,932558963,0,0,0,825.23,7,734953.41,24,4,2,1,True
4932386,134,4,451,2176,932558963,0,0,0,825.3,7,734128.11,18,1,21,1,True
4938023,134,4,30,1104,932558963,0,0,0,824.76,8,733303.35,18,6,10,2,True
4952119,134,4,451,5145,932558963,0,0,0,825.13,7,732478.22,18,3,12,2,True
5057144,579,0,10,1473,932558963,0,0,0,825.05,6,733303.27,11,0,4,3,True
5165528,459,1,10,2176,932558963,0,0,0,825.13,0,734128.4,13,5,22,4,True
5244829,134,4,25,4232,932558963,0,0,0,824.85,8,733303.55,18,1,6,4,False
5312167,1186,2,20,7836,932558963,0,0,0,824.96,3,732478.59,24,3,1,5,True
5380499,594,0,25,1104,932558963,0,0,0,824.93,8,731653.66,24,5,12,6,True
5709871,468,3,30,3146,932558963,0,0,0,824.94,8,730828.72,5,2,7,6,True
5946061,826,1,10,4831,932558963,0,0,0,824.75,6,731653.47,18,0,22,7,True
6019687,468,3,451,9665,932558963,0,0,0,824.82,7,730828.65,5,2,10,8,True
6067558,1233,0,451,5145,932558963,0,0,0,825.01,7,730003.64,18,5,6,9,True
6122876,1233,0,-1,7064,932558963,0,1,0,824.82,4,730003.64,18,0,19,10,True
6316522,1390,0,20,8516,932558963,0,0,0,824.99,3,729178.65,24,4,4,10,False
6341452,1146,2,20,3243,932558963,0,0,0,825.3,3,728353.35,15,4,21,11,True
6346486,276,0,30,4232,932558963,0,0,0,825.17,8,727528.18,24,2,23,11,True
6462294,673,0,30,1473,932558963,0,0,0,825.13,8,726703.05,18,3,21,12,True
6540147,673,0,451,1104,932558963,0,0,0,825.28,7,725877.77,18,2,11,12,True
7471266,276,0,-1,3146,932558963,0,1,0,824.9,4,725877.77,24,5,16,1,True
7575005,276,0,-1,3146,932558963,0,2,0,824.77,4,725877.77,24,5,13,1,True
8151671,673,0,30,4972,932558963,0,0,0,824.84,8,725052.93,18,6,3,2,True
8432415,276,0,-1,7064,932558963,0,1,0,824.97,4,725052.93,24,3,4,2,True
8441056,341,0,20,9665,932558963,0,0,0,824.88,3,724228.05,24,0,23,2,True
8443823,1278,0,20,4972,932558963,0,0,0,825.08,3,723402.97,24,3,6,3,True
8587488,594,0,30,5545,932558963,0,0,0,825.05,8,722577.92,24,2,14,4,True
8822805,134,4,451,1245,932558963,0,0,0,824.86,7,721753.06,18,3,2,4,True
8915346,335,4,30,5545,932558963,0,0,0,825.09,8,720927.97,11,2,12,6,True
8954617,240,4,25,2176,932558963,0,0,0,824.94,8,720103.03,26,6,22,6,True
9073988,1233,0,30,1506,932558963,0,0,0,825.0,8,719278.03,18,2,3,7,False
9499377,134,4,451,8516,932558963,0,0,0,824.86,7,718453.17,18,3,21,7,True
9550728,240,4,30,5545,932558963,0,0,0,824.71,8,717628.46,26,3,19,8,True
9554873,1233,0,25,4232,932558963,0,0,0,825.06,8,716803.4,18,3,2,9,True
9712079,1408,1,10,1104,932558963,0,0,0,824.86,6,717628.26,24,6,11,9,True
9715553,529,2,451,3243,932558963,0,0,0,824.82,7,716803.44,18,2,2,10,True
9796085,673,0,451,7945,932558963,0,0,0,824.75,7,715978.69,18,3,18,10,True
9802145,1233,0,451,1621,932558963,0,0,0,825.03,7,715153.66,18,3,12,11,True
9811663,468,3,451,7064,932558963,0,0,0,824.92,7,714328.74,5,1,2,11,True
1069854,1250,1,451,8767,327350261,1,0,0,1136.94,7,741940.06,23,2,1,1,True
1085059,361,4,25,1601,327350261,1,0,0,1136.58,8,740803.48,24,2,9,2,True
1195302,1110,0,20,7997,327350261,1,0,0,1137.0,3,739666.48,0,6,21,2,True
1536851,30,4,30,6862,327350261,1,0,0,1136.66,8,738529.82,11,5,10,3,True
1622022,557,1,30,8767,327350261,1,0,0,1137.0,8,737392.82,17,2,16,4,True
1666960,180,0,20,6942,327350261,1,0,0,1137.11,5,736255.71,18,6,6,5,True
1755786,361,4,25,6862,327350261,1,0,0,1137.19,8,735118.52,24,5,6,6,True
1812742,557,1,451,7442,327350261,1,0,0,1136.89,7,733981.63,17,1,13,7,True
1830260,30,4,451,7442,327350261,1,0,0,1137.21,7,732844.42,11,6,1,8,True
1913671,557,1,451,2555,327350261,1,0,0,1137.09,7,731707.33,17,4,1,9,True
1957671,557,1,-1,6942,327350261,1,1,0,1137.13,4,731707.33,17,2,0,9,True
2044647,185,1,25,2555,327350261,1,0,0,1137.01,8,730570.32,18,5,20,10,True
2088953,185,1,25,6398,327350261,1,0,0,1136.93,8,729433.39,18,5,21,10,True
2319218,1404,2,20,2754,327350261,1,0,0,1136.94,5,728296.45,24,1,6,10,True
2604058,185,1,30,4005,327350261,1,0,0,1136.86,8,727159.59,18,1,14,12,True
2632484,361,4,30,5327,327350261,1,0,0,1136.97,8,726022.62,24,0,22,12,True
2825267,361,4,-1,7524,327350261,1,1,0,1137.17,4,726022.62,24,3,1,12,True
2862488,361,4,451,5327,327350261,1,0,0,1137.18,7,724885.44,24,6,21,1,True
2885890,557,1,-1,6862,327350261,1,1,0,1136.96,4,724885.44,17,5,23,2,True
2972378,30,4,30,1601,327350261,1,0,0,1136.87,8,723748.57,11,0,6,3,True
3129618,557,1,25,6398,327350261,1,0,0,1136.98,8,722611.59,17,3,9,3,True
3199750,361,4,451,1676,327350261,1,0,0,1137.12,7,721474.47,24,5,21,4,True
3457676,525,0,20,6942,327350261,1,0,0,1137.38,5,720337.09,18,6,20,4,True
3651298,30,4,25,3348,327350261,1,0,0,1136.8,8,719200.29,11,4,6,4,True
3803926,361,4,-1,5619,327350261,1,1,0,1136.57,4,719200.29,24,2,16,4,True
4258006,557,1,451,7997,327350261,1,0,0,1136.74,7,718063.55,17,3,0,5,False
4844936,361,4,451,5619,327350261,1,0,0,1136.82,7,716926.73,24,0,12,7,True
4963026,361,4,30,1601,327350261,1,0,0,1136.86,8,715789.87,24,2,15,8,True
5474908,30,4,451,6744,327350261,1,0,0,1137.04,7,714652.83,11,0,3,9,False
5553169,1382,0,20,7997,327350261,1,0,0,1136.97,5,713515.86,16,2,17,10,True
5566002,1052,0,10,3348,327350261,1,0,0,1137.1,0,714652.96,11,6,3,10,False
6274139,1072,0,20,5619,327350261,1,0,0,1137.15,5,713515.81,18,6,23,10,True
6472172,732,0,10,1601,327350261,1,0,0,1137.18,0,714652.99,11,3,19,11,True
6503608,1278,0,20,1601,327350261,1,0,0,1136.84,3,713516.15,24,0,18,12,True
6703623,30,4,30,8767,327350261,1,0,0,1137.23,8,712378.92,11,5,14,12,True
6705752,234,0,20,3348,327350261,1,0,0,1137.01,5,711241.91,26,3,22,1,True
6766562,1250,1,30,7587,327350261,1,0,0,1136.81,8,710105.1,23,4,2,1,True
6894069,1250,1,30,8767,327350261,1,0,0,1137.0,8,708968.1,23,5,15,2,True
6908685,185,1,30,6398,327350261,1,0,0,1137.12,8,707830.98,18,6,7,2,True
7219708,1090,0,10,6398,327350261,1,0,0,1136.96,6,708967.94,18,5,17,3,True
7321885,361,4,25,5327,327350261,1,0,0,1137.01,8,707830.93,24,5,22,3,True
7328916,30,4,30,7524,327350261,1,0,0,1136.86,8,706694.07,11,0,10,3,True
7445904,557,1,25,5327,327350261,1,0,0,1137.11,8,705556.96,17,0,7,3,True
7521139,1035,0,10,1676,327350261,1,0,0,1137.2,6,706694.16,11,2,8,5,True
7774710,185,1,25,6942,327350261,1,0,0,1137.0,8,705557.16,18,4,20,5,True
7848319,253,2,20,7587,327350261,1,0,0,1136.94,5,704420.22,6,1,3,6,True
8168414,220,0,10,6862,327350261,1,0,0,1136.92,0,705557.14,26,1,21,6,True
8436952,361,4,-1,2555,327350261,1,1,0,1136.92,1,705557.14,24,2,23,8,True
8448249,341,0,20,5619,327350261,1,0,0,1137.23,5,704419.91,24,1,22,8,True
8522805,1250,1,30,6744,327350261,1,0,0,1136.91,8,703283.0,23,1,1,9,True
8660594,1461,0,10,8767,327350261,1,0,0,1137.22,6,704420.22,11,1,10,9,True
9047794,30,4,451,1676,327350261,1,0,0,1136.85,7,703283.37,11,1,11,9,True
9185641,185,1,30,5327,327350261,1,0,0,1137.04,8,702146.33,18,3,8,10,True
9283218,95,2,20,2555,327350261,1,0,0,1137.03,3,701009.3,1,4,9,11,True
9436211,30,4,25,7524,327350261,1,0,0,1137.11,8,699872.19,11,4,14,11,True
9710902,185,1,451,8404,327350261,1,0,0,1137.33,7,698734.86,18,1,13,11,True
1218638,724,3,-1,2700,821753751,1,1,0,107.08,4,753560.0,11,5,22,3,True
1229546,348,0,-1,6438,821753751,1,2,0,106.96,4,753560.0,24,6,8,3,True
1406855,937,0,20,2685,821753751,1,0,0,107.14,3,753452.86,24,0,23,3,True
1409189,1366,4,25,6575,821753751,1,0,0,106.73,8,753346.13,16,5,9,3,True
1496673,1425,0,25,1543,821753751,1,0,0,107.0,8,753239.13,24,0,11,4,True
1814552,1425,0,-1,7497,821753751,1,1,0,107.04,4,753239.13,24,0,21,4,True
2379841,348,0,25,5892,821753751,1,0,0,106.93,8,753132.2,24,6,1,5,True
2964508,348,0,451,9683,821753751,1,0,0,107.05,7,753025.15,24,6,5,5,True
3198092,1425,0,451,9683,821753751,1,0,0,107.01,7,752918.14,24,4,5,6,True
3205972,551,0,10,8716,821753751,1,0,0,107.3,6,753025.44,17,2,19,6,True
3415092,1339,2,-1,2456,821753751,1,1,0,106.91,1,753025.44,18,2,3,7,True
3576575,724,3,451,2680,821753751,1,0,0,106.94,7,752918.5,11,6,0,7,True
3636537,1366,4,25,7497,821753751,1,0,0,107.23,8,752811.27,16,4,14,7,True
3809890,1339,2,451,4633,821753751,1,0,0,106.89,7,752704.38,18,5,22,8,True
4066216,1425,0,30,5719,821753751,1,0,0,107.01,8,752597.37,24,3,23,1,True
4170130,1425,0,30,7947,821753751,1,0,0,106.94,8,752490.43,24,4,10,2,True
4313987,678,4,30,3340,821753751,1,0,0,106.76,8,752383.67,24,0,0,2,True
5078379,1366,4,451,7310,821753751,1,0,0,107.18,7,752276.49,16,2,19,2,True
5194273,385,1,10,4633,821753751,1,0,0,107.28,6,752383.77,25,5,8,2,True
5226827,348,0,25,2685,821753751,1,0,0,107.08,8,752276.69,24,5,20,3,True
5494767,1339,2,451,7497,821753751,1,0,0,107.05,7,752169.64,18,2,13,4,True
5531064,611,0,20,2680,821753751,1,0,0,107.03,5,752062.61,11,2,17,5,True
5606524,851,1,10,2685,821753751,1,0,0,107.03,6,752169.64,5,0,5,6,True
5661740,1461,0,10,4633,821753751,1,0,0,107.05,6,752276.69,11,5,21,6,True
5996644,724,3,30,7947,821753751,1,0,0,107.06,8,752169.63,11,5,8,8,True
6023093,1116,0,20,7947,821753751,1,0,0,106.88,5,752062.75,24,3,4,8,True
6198835,393,1,10,3340,821753751,1,0,0,106.86,6,752169.61,10,6,4,8,True
6205736,1366,4,30,2456,821753751,1,0,0,106.68,8,752062.93,16,2,10,9,True
6295210,678,4,30,9544,821753751,1,0,0,106.88,8,751956.05,24,6,23,9,True
6561635,807,0,20,8627,821753751,1,0,0,107.0,3,751849.05,11,6,18,10,True
6724890,348,0,-1,2700,821753751,1,1,0,106.9,4,751849.05,24,4,1,10,True
6756726,724,3,30,3400,821753751,1,0,0,106.78,8,751742.27,11,0,6,10,True
6948873,678,4,-1,7947,821753751,1,1,0,106.99,4,751742.27,24,6,7,10,True
7000943,724,3,25,3340,821753751,1,0,0,107.07,8,751635.2,11,5,8,11,True
7105052,724,3,451,6846,821753751,1,0,0,107.08,7,751528.12,11,0,10,11,True
7117700,406,1,10,1369,821753751,1,0,0,107.13,0,751635.25,10,3,20,12,True
7315793,1155,0,20,6575,821753751,1,0,0,106.96,5,751528.29,15,4,7,2,True
7523024,1366,4,30,9683,821753751,1,0,0,106.91,8,751421.38,16,1,13,2,False
7531974,1339,2,-1,6835,821753751,1,1,0,106.83,1,751421.38,18,1,11,2,True
7646161,678,4,451,8210,821753751,1,0,0,107.0,7,751314.38,24,1,5,3,True
7667574,724,3,30,6575,821753751,1,0,0,106.73,8,751207.65,11,6,21,3,True
7966533,463,1,10,9544,821753751,1,0,0,107.21,6,751314.86,13,0,14,4,True
8097348,678,4,451,2700,821753751,1,0,0,106.97,7,751207.89,24,1,10,5,True
8131549,348,0,30,5719,821753751,1,0,0,107.15,8,751100.74,24,3,2,6,True
8272225,652,0,20,2680,821753751,1,0,0,107.3,5,750993.44,24,6,14,6,True
8440996,457,0,10,4809,821753751,1,0,0,107.01,6,751100.45,13,3,11,6,True
8556294,1366,4,451,9544,821753751,1,0,0,106.95,7,750993.5,16,6,16,7,True
8990646,1425,0,25,1933,821753751,1,0,0,107.13,8,750886.37,24,4,11,7,True
9487735,1339,2,451,7497,821753751,1,0,0,107.05,7,750779.32,18,6,1,7,True
9520748,1425,0,30,4102,821753751,1,0,0,107.11,8,750672.21,24,3,14,8,True
9568252,1366,4,25,5892,821753751,1,0,0,107.06,8,750565.15,16,5,21,9,True
9595062,577,0,10,4633,821753751,1,0,0,106.61,6,750671.76,11,2,17,10,True
9709290,889,0,20,6846,821753751,1,0,0,107.15,5,750564.61,27,1,19,10,True
9854846,1339,2,30,6575,821753751,1,0,0,106.99,8,750457.62,18,0,7,11,True
9938971,724,3,30,4809,821753751,1,0,0,107.02,8,750350.6,11,4,5,11,True
1047081,975,4,25,8147,356278256,0,0,0,1086.99,8,604094.01,22,4,0,1,True
1178374,975,4,30,7236,356278256,0,0,0,1087.17,8,603006.84,22,3,6,2,True
1182912,469,4,30,5619,356278256,0,0,0,1087.01,8,601919.83,5,4,18,4,True
1316628,129,0,10,7236,356278256,0,0,0,1087.02,6,603006.85,18,0,1,4,True
1488534,975,4,451,4149,356278256,0,0,0,1087.09,7,601919.76,22,0,18,4,True
1922507,469,4,25,5619,356278256,0,0,0,1086.94,8,600832.82,5,1,19,4,True
2561785,276,0,25,8147,356278256,0,0,0,1087.17,8,599745.65,24,6,14,5,True
2618713,975,4,451,3464,356278256,0,0,0,1087.0,7,598658.65,22,0,22,5,True
2704766,276,0,30,7124,356278256,0,0,0,1087.04,8,597571.61,24,0,21,5,True
2873327,1318,0,451,4149,356278256,0,0,0,1086.77,7,596484.84,18,2,16,7,True
2902284,469,4,25,8147,356278256,0,0,0,1086.99,8,595397.85,5,3,21,7,True
3029765,276,0,451,4149,356278256,0,0,0,1087.15,7,594310.7,24,5,12,7,True
3062463,276,0,451,7124,356278256,0,0,0,1086.9,7,593223.8,24,0,2,8,True
3132259,687,0,20,2930,356278256,0,0,0,1087.21,3,592136.59,24,1,11,11,True
3486757,715,0,20,2930,356278256,0,0,0,1087.09,5,591049.5,18,6,22,11,True
3550841,1318,0,-1,7124,356278256,0,1,0,1087.15,4,591049.5,18,3,21,12,True
3583617,134,4,30,5234,356278256,0,0,0,1086.97,8,589962.53,18,5,17,1,True
3936140,712,0,20,2930,356278256,0,0,0,1087.07,5,588875.46,18,1,11,1,True
4087104,980,1,25,4200,356278256,0,0,0,1086.87,8,587788.59,22,4,10,2,True
4190410,276,0,451,4200,356278256,0,0,0,1087.08,7,586701.51,24,0,6,2,True
4629314,469,4,451,5619,356278256,0,0,0,1087.11,7,585614.4,5,4,6,4,True
4917484,592,4,451,6897,356278256,0,0,0,1086.87,7,584527.53,24,6,9,4,True
4992471,533,2,20,7907,356278256,0,0,0,1086.92,5,583440.61,18,5,1,5,True
5062137,134,4,25,7907,356278256,0,0,0,1086.62,8,582353.99,18,3,2,6,True
5243555,975,4,25,4200,356278256,0,0,0,1087.23,8,581266.76,22,6,17,6,True
5869223,276,0,30,9905,356278256,0,0,0,1086.86,8,580179.9,24,6,1,8,True
5921334,276,0,30,7236,356278256,0,0,0,1086.98,8,579092.92,24,0,16,8,True
6020246,1318,0,451,7907,356278256,0,0,0,1087.08,7,578005.84,18,4,18,8,True
6204328,469,4,30,3464,356278256,0,0,0,1086.79,8,576919.05,5,0,1,8,True
6444624,535,0,10,7236,356278256,0,0,0,1086.87,6,578005.92,18,1,2,9,True
6469976,1318,0,-1,4149,356278256,0,1,0,1086.83,1,578005.92,18,1,19,9,True
6808795,560,2,20,8147,356278256,0,0,0,1086.75,5,576919.17,17,3,4,10,True
6904933,199,0,451,3668,356278256,0,0,0,1087.02,7,575832.15,18,4,9,10,True
7055324,134,4,451,7124,356278256,0,0,0,1086.81,7,574745.34,18,2,11,11,True
7108975,312,0,10,5619,356278256,0,0,0,1086.82,6,575832.16,4,3,20,11,True
7331861,592,4,451,6897,356278256,0,0,0,1086.9,7,574745.26,24,5,8,1,True
7447441,469,4,30,5619,356278256,0,0,0,1086.76,8,573658.5,5,0,16,2,True
7478626,980,1,451,7075,356278256,0,0,0,1087.16,7,572571.34,22,0,19,2,True
7730063,199,0,451,7124,356278256,0,0,0,1087.11,7,571484.23,18,6,23,3,True
7855891,1318,0,-1,4200,356278256,0,1,0,1087.32,1,571484.23,18,5,16,3,True
8436001,980,1,451,5619,356278256,0,0,0,1087.04,7,570397.19,22,1,3,3,True
8782736,134,4,30,3464,356278256,0,0,0,1086.92,8,569310.27,18,2,3,4,True
8822201,980,1,25,5234,356278256,0,0,0,1086.86,8,568223.41,22,6,23,5,True
8957229,975,4,451,7075,356278256,0,0,0,1086.91,7,567136.5,22,0,6,5,True
9035098,134,4,451,7907,356278256,0,0,0,1086.74,7,566049.76,18,6,15,6,True
9047279,199,0,451,2845,356278256,0,0,0,1086.88,7,564962.88,18,2,8,6,True
9064819,134,4,451,3668,356278256,0,0,0,1086.87,7,563876.01,18,0,18,7,True
9131168,1318,0,30,8147,356278256,0,0,0,1086.85,8,562789.16,18,1,1,7,True
9396379,134,4,451,4149,356278256,0,0,0,1087.09,7,561702.07,18,3,5,8,True
9562767,276,0,30,5234,356278256,0,0,0,1086.96,8,560615.11,24,1,11,8,True
9636640,1318,0,30,7075,356278256,0,0,0,1086.88,8,559528.23,18,4,10,9,True
9678434,199,0,451,9905,356278256,0,0,0,1087.14,7,558441.09,18,3,4,9,True
9899480,592,4,-1,5234,356278256,0,1,0,1087.14,4,558441.09,24,5,0,9,True
9965873,276,0,30,7907,356278256,0,0,0,1086.82,8,557354.27,24,5,12,10,True
1054506,962,0,10,1870,989476871,0,0,0,1126.2,0,979931.2,13,2,20,1,True
1102755,1036,1,10,3143,989476871,0,0,0,1126.06,6,981057.26,11,1,6,3,True
1266897,989,1,-1,7539,989476871,0,1,0,1126.21,4,981057.26,22,1,10,3,True
1452244,1192,2,30,2769,989476871,0,0,0,1125.99,8,979931.27,24,5,17,5,True
1463055,1094,0,20,5057,989476871,0,0,0,1125.86,5,978805.41,0,0,13,6,True
1826143,1192,2,30,3143,989476871,0,0,0,1125.68,8,977679.73,24,0,5,6,True
1878020,989,1,451,3143,989476871,0,0,0,1125.75,7,976553.98,22,0,7,6,True
1986630,1288,0,10,8609,989476871,0,0,0,1125.87,6,977679.85,24,2,21,7,True
2251716,147,0,30,3659,989476871,0,0,0,1125.99,8,976553.86,18,5,19,7,True
2297687,1201,0,30,8609,989476871,0,0,0,1125.95,8,975427.91,24,3,12,8,True
2320879,1201,0,30,1870,989476871,0,0,0,1126.11,8,974301.8,24,4,1,9,True
2433953,989,1,25,9899,989476871,0,0,0,1125.87,8,973175.93,22,2,12,9,True
2595946,1450,4,25,8282,989476871,0,0,0,1126.3,8,972049.63,11,4,20,11,True
2706785,490,4,30,3659,989476871,0,0,0,1125.82,8,970923.81,12,1,17,12,True
2940365,220,0,20,9899,989476871,0,0,0,1126.0,5,969797.81,26,4,10,1,True
3411034,1201,0,451,9792,989476871,0,0,0,1126.02,7,968671.79,24,0,12,1,True
3451508,1450,4,451,3659,989476871,0,0,0,1126.06,7,967545.73,11,6,3,1,True
3992773,1127,0,10,2769,989476871,0,0,0,1125.87,0,968671.6,24,4,20,2,True
4198747,989,1,30,7680,989476871,0,0,0,1126.16,8,967545.44,22,5,17,2,True
4271709,744,4,451,3143,989476871,0,0,0,1126.04,7,966419.4,24,3,6,3,True
4550601,147,0,-1,8282,989476871,0,1,0,1126.09,4,966419.4,18,4,3,3,True
4553301,490,4,451,7539,989476871,0,0,0,1126.14,7,965293.26,12,4,23,3,True
4688899,147,0,25,4332,989476871,0,0,0,1126.11,8,964167.15,18,5,2,4,True
5173159,218,0,20,3748,989476871,0,0,0,1126.01,5,963041.14,9,2,1,4,True
5204387,1406,0,30,3143,989476871,0,0,0,1125.95,8,961915.19,24,5,3,4,False
5252594,917,0,20,8282,989476871,0,0,0,1125.74,5,960789.45,18,0,18,4,True
5285244,744,4,451,3143,989476871,0,0,0,1125.97,7,959663.48,24,2,20,5,True
5625570,1192,2,25,4969,989476871,0,0,0,1126.04,8,958537.44,24,3,8,6,True
5689663,266,2,20,2769,989476871,0,0,0,1126.02,5,957411.42,6,0,5,6,True
5842427,550,0,10,3659,989476871,0,0,0,1126.17,0,958537.59,17,2,3,6,True
5869536,1201,0,451,4969,989476871,0,0,0,1125.93,7,957411.66,24,2,23,6,True
5887959,1450,4,451,9792,989476871,0,0,0,1125.98,7,956285.68,11,1,21,7,True
5980439,866,0,10,9235,989476871,0,0,0,1125.82,0,957411.5,24,5,18,8,False
6107620,1052,0,10,8282,989476871,0,0,0,1125.95,6,958537.45,11,0,18,8,True
6250209,1192,2,451,4332,989476871,0,0,0,1126.17,7,957411.28,24,1,18,8,True
6602758,1201,0,30,6529,989476871,0,0,0,1125.74,8,956285.54,24,0,10,10,True
6693759,490,4,25,7539,989476871,0,0,0,1125.86,8,955159.68,12,5,9,10,True
7358965,1019,0,10,1870,989476871,0,0,0,1125.82,6,956285.5,26,1,9,10,True
7467529,744,4,30,3143,989476871,0,0,0,1126.1,8,955159.4,24,0,13,1,True
7560737,147,0,-1,4332,989476871,0,1,0,1125.93,4,955159.4,18,1,6,2,True
8015499,1201,0,25,4969,989476871,0,0,0,1125.86,8,954033.54,24,2,15,2,True
8249276,1450,4,25,2769,989476871,0,0,0,1125.63,8,952907.91,11,2,19,2,True
8577957,560,2,20,8282,989476871,0,0,0,1126.22,5,951781.69,17,1,3,2,False
8582474,147,0,30,9899,989476871,0,0,0,1126.05,8,950655.64,18,2,11,4,True
8906952,1450,4,451,5057,989476871,0,0,0,1126.25,7,949529.39,11,4,1,5,True
9017240,183,1,10,8609,989476871,0,0,0,1126.13,6,950655.52,18,6,13,5,True
9061941,1406,0,451,1606,989476871,0,0,0,1125.94,7,949529.58,24,4,17,6,True
9148901,812,0,10,9235,989476871,0,0,0,1126.0,6,950655.58,18,1,13,6,True
9288691,1201,0,-1,1870,989476871,0,1,0,1125.94,4,950655.58,24,2,6,8,True
9499655,989,1,30,3143,989476871,0,0,0,1126.25,8,949529.33,22,4,13,9,True
9635700,1406,0,451,2651,989476871,0,0,0,1126.16,7,948403.17,24,5,20,9,True
1072986,1363,0,10,6186,322513262,1,0,0,581.99,6,425045.99,16,4,18,1,True
1114826,433,4,451,9333,322513262,1,0,0,581.82,7,424464.17,24,2,3,2,True
1182860,145,0,10,2979,322513262,1,0,0,581.77,6,425045.94,18,5,19,2,True
1191352,1196,4,451,6390,322513262,1,0,0,582.14,7,424463.8,24,0,2,3,True
1273185,1455,2,451,1907,322513262,1,0,0,582.14,7,423881.66,11,6,21,4,True
1370635,1307,0,10,2979,322513262,1,0,0,582.33,6,424463.99,5,1,10,5,True
1542993,194,1,10,3379,322513262,1,0,0,581.91,6,425045.9,18,5,17,7,True
1927941,885,3,30,9584,322513262,1,0,0,581.79,8,424464.11,24,6,0,10,True
2652809,116,0,20,4012,322513262,1,0,0,582.18,3,423881.93,3,0,9,10,True
2746860,885,3,-1,6152,322513262,1,1,0,581.89,4,423881.93,24,2,19,10,True
3440424,197,4,30,6390,322513262,1,0,0,581.97,8,423299.96,18,3,19,2,True
3465544,987,4,451,1907,322513262,1,0,0,582.05,7,422717.91,22,5,5,2,True
3938658,577,0,10,9113,322513262,1,0,0,581.72,0,423299.63,11,6,7,4,True
4108413,1043,4,-1,3240,322513262,1,1,0,582.06,4,423299.63,11,6,12,4,True
4269704,1284,2,25,9584,322513262,1,0,0,582.05,8,422717.58,24,3,3,6,True
4636836,1196,4,451,4668,322513262,1,0,0,581.98,7,422135.6,24,3,20,7,True
4885950,197,4,30,3364,322513262,1,0,0,581.71,8,421553.89,18,5,18,9,True
5193594,1196,4,25,5891,322513262,1,0,0,581.78,8,420972.11,24,3,13,9,True
5307165,1162,2,20,5891,322513262,1,0,0,582.01,5,420390.1,24,2,15,9,True
5429297,281,1,10,9333,322513262,1,0,0,581.94,6,420972.04,24,6,5,10,True
5616594,1196,4,-1,4668,322513262,1,1,0,581.76,1,420972.04,24,0,18,11,True
5742219,1196,4,25,9584,322513262,1,0,0,581.91,8,420390.13,24,6,11,12,True
5753473,885,3,25,4668,322513262,1,0,0,581.83,8,419808.3,24,1,8,12,True
5936191,433,4,451,9584,322513262,1,0,0,581.97,7,419226.33,24,1,11,1,True
5983601,1043,4,451,6390,322513262,1,0,0,582.05,7,418644.28,11,5,5,3,True
6070405,1043,4,451,9333,322513262,1,0,0,581.94,7,418062.34,11,4,17,7,True
6123727,885,3,451,4370,322513262,1,0,0,582.11,7,417480.23,24,0,20,8,True
6135449,1088,4,451,5891,322513262,1,0,0,582.0,7,416898.23,18,4,2,8,True
6358430,433,4,-1,3240,322513262,1,1,0,581.93,4,416898.23,24,0,4,9,True
6408303,433,4,-1,1670,322513262,1,2,0,582.05,4,416898.23,24,0,9,9,True
6489217,987,4,-1,9231,322513262,1,3,1,582.39,4,416898.23,22,5,16,10,True
1075295,146,4,-1,3815,466594225,0,1,0,183.98,4,567579.0,18,1,9,1,True
1170641,346,0,20,2989,466594225,0,0,0,184.32,5,567394.68,24,2,0,1,True
1199516,76,0,10,9208,466594225,0,0,0,183.88,0,567578.56,20,6,1,2,True
1443691,146,4,451,9208,466594225,0,0,0,184.05,7,567394.51,18,3,2,3,True
1468315,596,3,451,4945,466594225,0,0,0,183.89,7,567210.62,24,1,10,3,True
1550713,1421,0,10,9706,466594225,0,0,0,184.04,6,567394.66,24,5,1,4,True
1629788,596,3,25,3620,466594225,0,0,0,183.91,8,567210.75,24,2,13,4,True
1678365,146,4,25,7837,466594225,0,0,0,184.02,8,567026.73,18,1,14,5,True
1806701,146,4,-1,9957,466594225,0,1,0,183.77,4,567026.73,18,5,9,6,False
2069308,596,3,451,9957,466594225,0,0,0,184.31,7,566842.42,24,2,16,6,True
2081110,53,0,25,1398,466594225,0,0,0,183.97,8,566658.45,20,4,14,6,True
2459723,995,1,10,1398,466594225,0,0,0,183.87,6,566842.32,22,6,15,6,True
2650003,146,4,25,7339,466594225,0,0,0,183.76,8,566658.56,18,3,0,7,True
2899449,53,0,451,8957,466594225,0,0,0,184.09,7,566474.47,20,3,11,7,True
3101579,53,0,451,9957,466594225,0,0,0,184.15,7,566290.32,20,5,17,9,True
3166680,869,2,451,9915,466594225,0,0,0,183.78,7,566106.54,24,4,4,11,True
3401299,53,0,451,7439,466594225,0,0,0,184.01,7,565922.53,20,3,22,12,True
3485810,334,0,20,7439,466594225,0,0,0,183.84,5,565738.69,11,2,17,12,True
3881236,644,0,451,1398,466594225,0,0,0,184.0,7,565554.69,24,5,18,1,True
4194430,146,4,25,9706,466594225,0,0,0,184.03,8,565370.66,18,3,4,1,True
4199280,148,1,10,3145,466594225,0,0,0,183.94,6,565554.6,18,5,9,3,True
4348560,1186,2,20,3620,466594225,0,0,0,184.04,3,565370.56,24,6,5,4,True
4766265,53,0,-1,5221,466594225,0,1,0,184.11,1,565370.56,20,5,15,4,True
4956744,146,4,30,5416,466594225,0,0,0,184.07,8,565186.49,18,4,15,4,True
5075684,630,0,20,9957,466594225,0,0,0,183.88,5,565002.61,11,5,15,5,True
5206802,1210,0,10,9915,466594225,0,0,0,184.27,6,565186.88,24,2,2,5,True
5449060,146,4,25,5574,466594225,0,0,0,184.27,8,565002.61,18,2,19,5,True
5470723,596,3,451,7837,466594225,0,0,0,184.03,7,564818.58,24,6,14,5,True
5646965,146,4,451,3815,466594225,0,0,0,184.31,7,564634.27,18,2,16,6,True
5654325,146,4,30,9915,466594225,0,0,0,183.73,8,564450.54,18,3,12,6,True
5707120,1072,0,10,1398,466594225,0,0,0,184.04,0,564634.58,18,5,4,7,True
6297004,869,2,-1,3301,466594225,0,1,0,184.06,4,564634.58,24,6,0,7,True
6562310,53,0,25,5416,466594225,0,0,0,183.86,8,564450.72,20,5,2,9,True
6564780,869,2,451,2220,466594225,0,0,0,184.32,7,564266.4,24,1,12,9,True
6628851,1093,0,20,5574,466594225,0,0,0,184.02,3,564082.38,18,0,3,10,True
6750640,35,2,20,5221,466594225,0,0,0,184.0,3,563898.38,11,2,0,10,True
6786590,869,2,451,6060,466594225,0,0,0,183.89,7,563714.49,24,0,2,10,True
6839570,869,2,451,7339,466594225,0,0,0,184.14,7,563530.35,24,4,20,11,True
6994367,312,0,20,2989,466594225,0,0,0,184.15,3,563346.2,4,6,13,12,True
7149458,644,0,30,8957,466594225,0,0,0,183.83,8,563162.37,24,6,22,12,False
7317001,644,0,451,7837,466594225,0,0,0,183.73,7,562978.64,24,5,11,1,True
7485946,20,0,20,2220,466594225,0,0,0,184.2,5,562794.44,24,0,18,1,True
7576156,596,3,30,8957,466594225,0,0,0,184.11,8,562610.33,24,1,18,1,True
7944642,146,4,451,9798,466594225,0,0,0,184.13,7,562426.2,18,5,9,2,True
7954240,53,0,25,5105,466594225,0,0,0,183.95,8,562242.25,20,3,17,2,True
8535154,146,4,25,7837,466594225,0,0,0,184.07,8,562058.18,18,2,7,3,True
8590842,146,4,451,9957,466594225,0,0,0,183.94,7,561874.24,18,6,17,4,True
8939898,939,0,20,7855,466594225,0,0,0,184.09,5,561690.15,24,2,13,5,True
9037502,146,4,30,9798,466594225,0,0,0,184.15,8,561506.0,18,5,8,5,True
9060661,644,0,30,1706,466594225,0,0,0,183.78,8,561322.22,24,4,22,5,True
9231520,53,0,451,1398,466594225,0,0,0,184.05,7,561138.17,20,5,17,6,True
9283929,1483,0,20,5416,466594225,0,0,0,183.75,5,560954.42,24,6,16,6,True
9293371,146,4,-1,9706,466594225,0,1,0,184.21,1,560954.42,18,5,8,8,True
9517308,1451,1,10,2220,466594225,0,0,0,184.2,6,561138.62,11,5,16,9,True
9529882,596,3,25,7339,466594225,0,0,0,184.03,8,560954.59,24,0,2,9,True
9746083,1255,0,10,8957,466594225,0,0,0,183.61,6,561138.2,23,2,6,10,True
9752549,53,0,451,5039,466594225,0,0,0,183.99,7,560954.21,20,5,0,11,True
9973110,1354,0,10,3815,466594225,0,0,0,184.3,6,561138.51,24,6,4,11,False
1156863,215,0,20,8991,171969202,0,0,0,693.05,3,924272.95,9,1,20,1,True
1549180,199,0,25,7912,171969202,0,0,0,692.84,8,923580.11,18,4,6,2,True
1780486,670,0,30,3140,171969202,0,0,0,693.03,8,922887.08,18,4,14,3,True
2190416,199,0,-1,3655,171969202,0,1,0,693.07,1,922887.08,18,3,21,3,True
2353804,464,1,25,4042,171969202,0,0,0,692.82,8,922194.26,13,4,5,3,True
2381300,1047,3,30,2453,171969202,0,0,0,693.12,8,921501.14,11,5,22,4,True
2386190,1047,3,25,7379,171969202,0,0,0,692.93,8,920808.21,11,0,21,4,True
2419817,1127,0,20,8458,171969202,0,0,0,693.14,3,920115.07,24,5,2,6,True
2533708,199,0,25,6754,171969202,0,0,0,693.07,8,919422.0,18,0,23,6,True
2808548,168,0,20,6754,171969202,0,0,0,692.88,5,918729.12,24,0,6,7,True
3068186,670,0,451,1985,171969202,0,0,0,693.08,7,918036.04,18,0,19,7,True
3099642,1162,2,20,3481,171969202,0,0,0,693.35,3,917342.69,24,2,20,7,True
3285947,726,0,10,2453,171969202,0,0,0,693.05,6,918035.74,11,2,20,9,True
3486045,670,0,451,7912,171969202,0,0,0,693.06,7,917342.68,18,1,12,9,True
3649659,199,0,30,9543,171969202,0,0,0,692.87,8,916649.81,18,1,8,10,True
3788310,1325,0,10,6144,171969202,0,0,0,693.04,0,917342.85,18,1,9,11,True
3964162,1363,0,10,3481,171969202,0,0,0,693.08,6,918035.93,16,2,8,12,True
4032499,1047,3,451,6754,171969202,0,0,0,693.2,7,917342.73,11,6,13,12,True
4303263,1047,3,451,6400,171969202,0,0,0,692.94,7,916649.79,11,0,21,12,True
4391877,1322,2,451,1274,171969202,0,0,0,693.0,7,915956.79,18,6,17,12,True
4695211,464,1,30,6144,171969202,0,0,0,692.88,8,915263.91,13,2,18,12,True
4850456,130,0,20,9543,171969202,0,0,0,693.21,3,914570.7,18,5,20,1,True
4893060,1322,2,25,3481,171969202,0,0,0,693.0,8,913877.7,18,5,2,1,True
5140495,464,1,451,1274,171969202,0,0,0,693.25,7,913184.45,13,4,0,2,True
5290648,1322,2,451,9543,171969202,0,0,0,693.12,7,912491.33,18,1,6,2,True
5320189,199,0,30,2453,171969202,0,0,0,693.06,8,911798.27,18,3,23,2,True
5418046,1090,0,10,4042,171969202,0,0,0,692.88,0,912491.15,18,1,12,2,True
5510624,670,0,-1,3140,171969202,0,1,0,692.95,4,912491.15,18,2,12,3,True
5566744,1047,3,25,7249,171969202,0,0,0,692.8,8,911798.35,11,0,4,4,True
5618877,1322,2,-1,3655,171969202,0,1,0,692.94,4,911798.35,18,4,22,5,True
5762110,1488,0,10,9526,171969202,0,0,0,692.85,6,912491.2,24,3,15,5,False
5917800,145,0,10,1985,171969202,0,0,0,693.09,6,913184.29,18,3,17,5,True
6011852,199,0,30,6754,171969202,0,0,0,693.05,8,912491.24,18,5,19,5,True
6366367,713,0,10,2453,171969202,0,0,0,692.7,6,913183.94,18,2,4,11,True
6874764,464,1,25,6144,171969202,0,0,0,693.17,8,912490.77,13,5,9,11,True
6938235,1047,3,451,2453,171969202,0,0,0,692.91,7,911797.86,11,5,20,1,True
7072384,464,1,25,8458,171969202,0,0,0,693.04,8,911104.82,13,2,13,1,True
7251065,670,0,451,9543,171969202,0,0,0,692.99,7,910411.83,18,6,8,2,True
7255613,464,1,30,1985,171969202,0,0,0,693.23,8,909718.6,13,5,13,4,True
7581971,670,0,25,8458,171969202,0,0,0,692.99,8,909025.61,18,0,17,4,True
7840643,916,0,20,1274,171969202,0,0,0,692.75,5,908332.86,18,5,17,5,True
8034691,900,1,10,3140,171969202,0,0,0,693.45,6,909026.31,24,5,7,5,True
8230712,1047,3,451,6754,171969202,0,0,0,692.74,7,908333.57,11,1,19,6,True
8231117,1025,1,10,7249,171969202,0,0,0,693.02,0,909026.59,11,3,13,7,True
8472912,464,1,25,8991,171969202,0,0,0,692.75,8,908333.84,13,2,5,7,True
8693865,303,0,10,7379,171969202,0,0,0,693.0,6,909026.84,4,5,4,8,True
9314228,199,0,-1,4529,171969202,0,1,0,693.06,4,909026.84,18,6,15,8,False
9315134,1047,3,451,3655,171969202,0,0,0,692.75,7,908334.09,11,0,8,10,True
9525297,1047,3,451,6144,171969202,0,0,0,692.97,7,907641.12,11,1,20,10,True
9579869,703,0,20,3655,171969202,0,0,0,693.02,3,906948.1,18,3,5,11,True
1165622,892,4,30,9194,566813666,0,0,0,745.87,8,733137.13,24,3,23,1,True
1273564,806,1,10,1273,566813666,0,0,0,746.03,0,733883.16,11,5,19,1,True
1428360,414,4,25,2235,566813666,0,0,0,746.19,8,733136.97,18,1,17,3,True
1456570,1382,0,451,4745,566813666,0,0,0,746.12,7,732390.85,16,3,13,3,True
1699005,892,4,30,9675,566813666,0,0,0,746.19,8,731644.66,24,3,13,3,True
1744809,892,4,451,9728,566813666,0,0,0,746.16,7,730898.5,24,2,5,3,True
1772907,819,2,20,7123,566813666,0,0,0,746.11,5,730152.39,18,2,11,3,True
1906405,892,4,-1,7123,566813666,0,1,0,746.06,1,730152.39,24,5,16,4,True
1960454,414,4,451,4745,566813666,0,0,0,746.17,7,729406.22,18,4,18,4,True
2175405,1382,0,451,7123,566813666,0,0,0,745.95,7,728660.27,16,6,22,4,True
2391106,414,4,451,4054,566813666,0,0,0,745.84,7,727914.43,18,4,18,6,True
2559135,913,0,30,7481,566813666,0,0,0,746.08,8,727168.35,18,3,10,9,True
2840783,767,0,10,2235,566813666,0,0,0,745.93,6,727914.28,14,6,8,9,True
3162469,1310,4,451,9194,566813666,0,0,0,746.09,7,727168.19,5,1,14,9,True
3219132,913,0,25,1365,566813666,0,0,0,746.14,8,726422.05,18,5,1,9,True
3339001,1310,4,25,1273,566813666,0,0,0,746.22,8,725675.83,5,0,14,10,True
3965335,1310,4,25,2357,566813666,0,0,0,745.64,8,724930.19,5,2,22,10,True
4168004,913,0,451,8624,566813666,0,0,0,746.02,7,724184.17,18,5,21,10,True
4365238,892,4,451,6826,566813666,0,0,0,745.84,7,723438.33,24,2,4,10,True
4404867,348,0,20,2235,566813666,0,0,0,746.02,5,722692.31,24,2,0,11,True
4410955,1421,0,10,7123,566813666,0,0,0,746.06,0,723438.37,24,1,10,12,True
4760869,892,4,451,4745,566813666,0,0,0,746.02,7,722692.35,24,4,18,12,True
4835597,329,1,10,6826,566813666,0,0,0,746.19,6,723438.54,11,3,4,1,True
5186392,414,4,451,6826,566813666,0,0,0,745.86,7,722692.68,18,1,10,2,True
5237513,913,0,451,6826,566813666,0,0,0,746.07,7,721946.61,18,1,11,2,True
5263410,1260,0,20,7123,566813666,0,0,0,745.96,3,721200.65,23,5,10,3,True
5296823,414,4,30,2235,566813666,0,0,0,746.16,8,720454.49,18,3,10,3,True
5901622,378,0,10,1273,566813666,0,0,0,746.18,6,721200.67,25,1,11,3,True
6013227,584,0,10,2511,566813666,0,0,0,746.39,0,721947.06,11,1,14,4,True
6459798,913,0,451,7607,566813666,0,0,0,745.83,7,721201.23,18,3,6,4,True
6506027,892,4,451,9194,566813666,0,0,0,746.19,7,720455.04,24,5,13,5,True
6514040,275,0,20,2235,566813666,0,0,0,745.96,5,719709.08,24,5,23,7,True
6785689,913,0,25,2511,566813666,0,0,0,745.95,8,718963.13,18,3,19,8,True
6810299,1134,1,10,7607,566813666,0,0,0,746.26,0,719709.39,24,6,11,8,True
6831780,892,4,-1,7481,566813666,0,1,0,745.84,4,719709.39,24,3,9,8,True
7037698,913,0,451,2357,566813666,0,0,0,745.92,7,718963.47,18,6,16,9,True
7111219,414,4,30,1365,566813666,0,0,0,746.04,8,718217.43,18,0,7,9,True
7188232,892,4,-1,4054,566813666,0,1,0,745.96,4,718217.43,24,4,19,10,True
7297471,549,1,10,6826,566813666,0,0,0,745.94,0,718963.37,17,5,2,10,True
7844056,913,0,-1,9194,566813666,0,1,0,746.33,1,718963.37,18,6,6,10,True
7844668,913,0,30,4745,566813666,0,0,0,745.95,8,718217.42,18,6,19,11,True
7933876,346,0,10,2357,566813666,0,0,0,745.96,6,718963.38,24,5,14,12,True
8000389,341,0,20,1273,566813666,0,0,0,745.81,5,718217.57,24,2,21,1,True
8270811,1382,0,-1,2235,566813666,0,1,0,746.03,4,718217.57,16,6,22,2,True
8371142,630,0,10,9675,566813666,0,0,0,746.45,0,718964.02,11,1,20,3,True
8405591,1212,0,10,9728,566813666,0,0,0,746.02,6,719710.04,24,3,11,4,True
8422875,1382,0,25,4054,566813666,0,0,0,745.98,8,718964.06,16,4,11,4,True
8628802,23,0,20,9728,566813666,0,0,0,746.08,5,718217.98,11,1,4,5,True
8652819,603,0,20,2357,566813666,0,0,0,745.87,5,717472.11,24,5,22,6,True
8840913,1310,4,451,9675,566813666,0,0,0,746.04,7,716726.07,5,5,3,6,True
8859714,892,4,30,6826,566813666,0,0,0,745.96,8,715980.11,24,6,22,6,True
8900872,913,0,451,1273,566813666,0,0,0,745.79,7,715234.32,18,4,2,7,True
9048294,27,0,10,1273,566813666,0,0,0,745.88,0,715980.2,11,4,22,7,True
9329473,892,4,451,1365,566813666,0,0,0,746.22,7,715233.98,24,5,0,10,False
9448363,892,4,30,7607,566813666,0,0,0,746.0,8,714487.98,24,6,2,10,True
9605165,1310,4,30,2511,566813666,0,0,0,745.9,8,713742.08,5,5,23,10,True
9631923,1382,0,-1,8624,566813666,0,1,0,746.1,4,713742.08,16,6,13,11,True
1278835,1278,0,20,9096,684239232,1,0,0,1094.08,5,542416.92,24,1,21,2,False
1309757,1151,4,30,9096,684239232,1,0,0,1094.32,8,541322.6,15,5,3,3,True
1708241,998,0,451,4731,684239232,1,0,0,1094.08,7,540228.52,26,4,16,4,True
1802550,1195,1,10,6892,684239232,1,0,0,1093.86,0,541322.38,24,0,21,4,True
1829964,1350,4,451,3019,684239232,1,0,0,1094.46,7,540227.92,24,1,0,4,True
1897727,998,0,451,6892,684239232,1,0,0,1094.01,7,539133.91,26,3,8,5,True
2255895,1043,4,451,7728,684239232,1,0,0,1093.99,7,538039.92,11,6,3,6,True
2296761,445,0,10,5662,684239232,1,0,0,1094.33,6,539134.25,13,5,13,7,True
2453283,1079,4,451,2699,684239232,1,0,0,1094.04,7,538040.21,18,1,14,7,True
2500916,1093,0,20,1985,684239232,1,0,0,1094.41,3,536945.8,18,1,13,9,True
2564420,630,0,451,1985,684239232,1,0,0,1093.7,7,535852.1,11,4,11,10,True
2661072,630,0,30,2699,684239232,1,0,0,1094.16,8,534757.94,11,0,20,11,True
2722175,1043,4,451,1881,684239232,1,0,0,1094.33,7,533663.61,11,2,18,12,True
2782976,1043,4,-1,7661,684239232,1,1,0,1094.11,4,533663.61,11,5,7,12,True
2940740,1350,4,451,9471,684239232,1,0,0,1093.85,7,532569.76,24,5,14,1,True
2953750,282,2,20,3818,684239232,1,0,0,1093.86,3,531475.9,24,0,22,1,True
2968397,1151,4,451,6075,684239232,1,0,0,1094.05,7,530381.85,15,6,6,1,True
3047262,998,0,451,2556,684239232,1,0,0,1094.15,7,529287.7,26,2,9,2,True
3071175,1347,4,451,3310,684239232,1,0,0,1094.27,7,528193.43,24,4,11,3,True
3079178,1079,4,25,3841,684239232,1,0,0,1093.75,8,527099.68,18,0,7,3,True
3361442,1347,4,30,6892,684239232,1,0,0,1093.89,8,526005.79,24,6,16,4,True
3369129,1347,4,451,1985,684239232,1,0,0,1093.89,7,524911.9,24,5,8,4,True
3467607,1079,4,25,2699,684239232,1,0,0,1094.18,8,523817.72,18,3,20,6,True
3527418,998,0,25,6892,684239232,1,0,0,1094.08,8,522723.64,26,0,4,6,True
3696376,1043,4,25,9868,684239232,1,0,0,1094.16,8,521629.48,11,0,21,6,True
3850904,1169,0,20,2556,684239232,1,0,0,1094.08,5,520535.4,24,6,9,7,True
3922323,630,0,30,7178,684239232,1,0,0,1093.85,8,519441.55,11,2,10,7,True
3963515,1019,0,20,2556,684239232,1,0,0,1093.9,5,518347.65,26,1,2,8,True
4185812,630,0,451,4247,684239232,1,0,0,1093.94,7,517253.71,11,6,8,9,True
4320213,1079,4,-1,4540,684239232,1,1,0,1093.67,4,517253.71,18,2,17,9,True
4337333,286,1,10,4247,684239232,1,0,0,1094.21,6,518347.92,24,1,6,11,True
4379348,318,0,10,5136,684239232,1,0,0,1093.8,0,519441.72,11,4,17,11,True
5118661,824,2,20,6892,684239232,1,0,0,1094.02,3,518347.7,18,1,12,11,True
5581746,1079,4,451,4694,684239232,1,0,0,1093.86,7,517253.84,18,6,15,11,True
5631219,1079,4,451,4086,684239232,1,0,0,1094.16,7,516159.68,18,2,1,12,True
5703238,714,2,20,2327,684239232,1,0,0,1093.82,3,515065.86,18,4,2,12,True
5871336,1043,4,30,4086,684239232,1,0,0,1093.83,8,513972.03,11,2,19,1,True
6308403,1151,4,30,6093,684239232,1,0,0,1093.94,8,512878.09,15,3,13,1,True
6587374,1043,4,451,1881,684239232,1,0,0,1093.85,7,511784.24,11,4,23,2,True
6709215,858,1,10,3310,684239232,1,0,0,1093.79,6,512878.03,24,0,3,2,True
6888641,630,0,30,4694,684239232,1,0,0,1094.04,8,511783.99,11,4,15,3,True
7052505,1079,4,30,7728,684239232,1,0,0,1093.91,8,510690.08,18,0,17,4,True
7072921,531,0,10,3818,684239232,1,0,0,1093.98,6,511784.06,18,3,9,4,True
7100444,998,0,451,7728,684239232,1,0,0,1093.97,7,510690.09,26,4,3,5,True
7121756,1350,4,25,9868,684239232,1,0,0,1093.94,8,509596.15,24,6,21,5,True
7286901,628,0,30,3818,684239232,1,0,0,1093.88,8,508502.27,11,4,5,5,True
7431614,448,0,10,5662,684239232,1,0,0,1093.92,0,509596.19,13,2,13,5,True
7867158,1347,4,451,1881,684239232,1,0,0,1094.01,7,508502.18,24,2,11,6,True
8414440,1043,4,25,9868,684239232,1,0,0,1093.71,8,507408.47,11,1,17,7,True
8595677,628,0,30,8911,684239232,1,0,0,1093.96,8,506314.51,11,3,20,7,True
8881357,1413,0,10,4086,684239232,1,0,0,1094.19,6,507408.7,24,2,23,7,True
8898046,630,0,25,1881,684239232,1,0,0,1094.21,8,506314.49,11,1,9,8,True
8994354,998,0,25,3818,684239232,1,0,0,1093.94,8,505220.55,26,3,10,8,True
9125875,628,0,451,4731,684239232,1,0,0,1094.14,7,504126.41,11,2,8,9,True
9434026,630,0,-1,7728,684239232,1,1,0,1094.02,4,504126.41,11,0,10,10,True
9689011,1350,4,30,9525,684239232,1,0,0,1093.96,8,503032.45,24,2,2,10,True
9783953,630,0,25,4731,684239232,1,0,0,1094.15,8,501938.3,11,2,11,11,True
1033515,114,0,30,8386,776377571,1,0,0,500.87,8,256833.13,3,4,22,5,True
1052304,588,0,20,4371,776377571,1,0,0,500.93,5,256332.2,24,1,13,7,True
1513685,1467,0,30,8877,776377571,1,0,0,501.33,8,255830.87,11,5,14,8,True
1768481,822,4,30,4798,776377571,1,0,0,500.91,8,255329.96,18,4,18,8,True
1901510,1233,0,-1,3533,776377571,1,1,0,500.97,4,255329.96,18,4,15,9,True
2061703,976,4,30,3736,776377571,1,0,0,500.95,8,254829.01,22,6,4,10,True
2069646,114,0,-1,9466,776377571,1,1,0,501.07,1,254829.01,3,6,18,11,True
2521769,1467,0,451,6093,776377571,1,0,0,501.04,7,254327.97,11,6,0,11,True
2523452,114,0,30,7933,776377571,1,0,0,500.92,8,253827.05,3,4,8,12,True
3118975,114,0,25,4904,776377571,1,0,0,500.86,8,253326.19,3,1,3,12,True
3200485,424,1,10,5803,776377571,1,0,0,500.96,6,253827.15,18,3,18,1,True
3290857,1034,1,451,1713,776377571,1,0,0,500.85,7,253326.3,11,3,23,1,True
3319632,1034,1,451,1883,776377571,1,0,0,501.01,7,252825.29,11,3,9,2,True
3611277,1467,0,451,1385,776377571,1,0,0,500.93,7,252324.36,11,4,21,2,True
3629258,950,0,10,7933,776377571,1,0,0,500.98,6,252825.34,24,0,21,4,True
3668660,1034,1,451,7664,776377571,1,0,0,501.03,7,252324.31,11,4,5,4,True
3798491,1467,0,25,1762,776377571,1,0,0,500.91,8,251823.4,11,4,16,4,True
4136066,1233,0,25,1432,776377571,1,0,0,501.24,8,251322.16,18,6,1,4,True
4158642,1132,0,25,6598,776377571,1,0,0,501.1,8,250821.06,24,2,11,5,True
4219466,822,4,-1,3533,776377571,1,1,0,500.99,1,250821.06,18,5,0,6,True
4341247,822,4,25,4957,776377571,1,0,0,500.93,8,250320.13,18,4,15,6,True
4521875,114,0,-1,8386,776377571,1,1,0,501.26,4,250320.13,3,2,13,7,True
4647716,1233,0,451,1385,776377571,1,0,0,501.02,7,249819.11,18,1,2,8,True
4749823,471,0,20,7933,776377571,1,0,0,500.75,5,249318.36,5,5,6,9,True
5053634,976,4,30,8794,776377571,1,0,0,501.0,8,248817.36,22,3,11,10,True
5677041,1034,1,25,1762,776377571,1,0,0,501.16,8,248316.2,11,5,0,10,True
6030561,1125,1,10,4957,776377571,1,0,0,500.96,6,248817.16,24,6,8,12,True
6063112,1467,0,25,7664,776377571,1,0,0,501.01,8,248316.15,11,1,3,12,True
6276081,114,0,-1,5803,776377571,1,1,0,500.98,4,248316.15,3,3,22,1,True
6589024,976,4,451,3736,776377571,1,0,0,501.0,7,247815.15,22,3,14,2,True
6712033,976,4,-1,1432,776377571,1,1,0,501.09,4,247815.15,22,4,18,2,True
6885055,1467,0,25,6285,776377571,1,0,0,501.04,8,247314.11,11,5,22,4,True
6951428,114,0,451,6093,776377571,1,0,0,501.03,7,246813.08,3,0,18,4,True
7033861,1233,0,-1,9466,776377571,1,1,0,500.96,1,246813.08,18,2,8,5,True
7045403,114,0,30,3149,776377571,1,0,0,501.1,8,246311.98,3,6,13,5,True
7071206,114,0,-1,1432,776377571,1,1,0,500.97,4,246311.98,3,0,6,5,True
7131532,976,4,25,1713,776377571,1,0,0,501.05,8,245810.93,22,0,14,6,True
7410960,1233,0,451,4957,776377571,1,0,0,501.16,7,245309.77,18,4,16,6,True
7832650,1119,0,10,1432,776377571,1,0,0,501.03,0,245810.8,24,0,6,6,True
7939991,641,0,10,4957,776377571,1,0,0,501.01,6,246311.81,24,5,13,7,True
8071828,938,4,25,6598,776377571,1,0,0,500.8,8,245811.01,24,3,2,7,True
8331113,303,0,20,7933,776377571,1,0,0,500.61,5,245310.4,4,0,16,8,True
8353787,1233,0,25,9710,776377571,1,0,0,501.04,8,244809.36,18,2,19,8,True
8628893,1159,0,20,9710,776377571,1,0,0,501.03,5,244308.33,15,3,1,8,True
8702759,1233,0,-1,9048,776377571,1,1,0,500.84,1,244308.33,18,6,8,9,True
8718684,1034,1,451,9938,776377571,1,0,0,501.18,7,243807.15,11,0,5,9,True
9057082,822,4,451,9710,776377571,1,0,0,500.99,7,243306.16,18,4,15,10,True
9434538,976,4,25,9710,776377571,1,0,0,500.74,8,242805.42,22,1,2,11,True
9767882,1467,0,-1,4904,776377571,1,1,0,500.74,4,242805.42,11,2,3,11,True
9935451,1132,0,25,4798,776377571,1,0,0,501.06,8,242304.36,24,0,16,11,True
1096786,652,0,451,6991,106476302,1,0,0,931.13,7,413721.87,24,4,16,1,True
1170295,652,0,30,8732,106476302,1,0,0,931.04,8,412790.83,24,5,19,2,True
1475074,1284,2,451,6096,106476302,1,0,0,931.16,7,411859.67,24,4,18,2,True
1531918,1313,4,25,8758,106476302,1,0,0,931.14,8,410928.53,5,3,12,3,True
1665211,824,2,20,8758,106476302,1,0,0,931.11,3,409997.42,18,1,3,3,True
2243182,732,0,-1,5497,106476302,1,1,0,931.01,4,409997.42,11,4,10,3,True
2416704,831,1,10,8732,106476302,1,0,0,931.19,6,410928.61,5,3,19,4,True
2423949,1284,2,-1,6876,106476302,1,1,0,931.15,1,410928.61,24,4,18,5,False
2605103,524,1,10,8758,106476302,1,0,0,930.98,6,411859.59,18,6,14,7,True
2615153,1284,2,451,7253,106476302,1,0,0,931.2,7,410928.39,24,3,21,7,True
2624450,1284,2,25,8142,106476302,1,0,0,930.97,8,409997.42,24,0,8,8,False
2747741,1023,2,20,6876,106476302,1,0,0,931.0,5,409066.42,11,2,1,10,True
2766017,1321,0,20,6118,106476302,1,0,0,930.73,5,408135.69,18,0,13,10,True
2933479,670,0,20,4014,106476302,1,0,0,931.11,5,407204.58,18,2,22,11,True
2942001,859,2,25,7058,106476302,1,0,0,930.94,8,406273.64,24,4,3,11,False
3281949,1284,2,451,9270,106476302,1,0,0,931.26,7,405342.38,24,0,1,12,True
3714962,204,0,20,1160,106476302,1,0,0,931.2,5,404411.18,9,2,3,1,True
4224642,859,2,30,6118,106476302,1,0,0,930.94,8,403480.24,24,2,11,2,True
4231286,859,2,30,9920,106476302,1,0,0,930.89,8,402549.35,24,6,8,2,True
4372613,1284,2,25,9747,106476302,1,0,0,931.04,8,401618.31,24,4,23,3,True
4472944,652,0,451,1600,106476302,1,0,0,931.04,7,400687.27,24,2,14,3,True
4499531,652,0,-1,8142,106476302,1,1,0,930.8,1,400687.27,24,0,14,4,True
4632097,945,1,10,6348,106476302,1,0,0,931.1,0,401618.37,24,4,22,5,True
4748417,1238,0,20,6118,106476302,1,0,0,931.05,3,400687.32,18,6,8,5,True
4961474,816,0,10,2245,106476302,1,0,0,930.92,6,401618.24,18,0,11,5,True
5051913,732,0,-1,7451,106476302,1,1,0,931.19,1,401618.24,11,4,18,6,True
5064377,752,0,451,1600,106476302,1,0,0,930.87,7,400687.37,24,2,21,8,True
5246259,752,0,30,6001,106476302,1,0,0,931.08,8,399756.29,24,5,1,8,True
5316037,1278,0,20,7475,106476302,1,0,0,931.11,5,398825.18,24,3,0,9,True
5577440,652,0,30,5497,106476302,1,0,0,931.0,8,397894.18,24,4,7,9,True
5715596,652,0,451,6991,106476302,1,0,0,930.73,7,396963.45,24,4,12,9,True
5855291,652,0,25,9270,106476302,1,0,0,930.91,8,396032.54,24,3,13,10,True
6050823,752,0,25,6991,106476302,1,0,0,931.15,8,395101.39,24,0,6,10,True
6179584,1227,0,20,4476,106476302,1,0,0,930.95,5,394170.44,18,5,13,11,True
6196697,752,0,25,6096,106476302,1,0,0,931.03,8,393239.41,24,0,11,12,True
6385102,1313,4,30,4014,106476302,1,0,0,931.09,8,392308.32,5,1,17,12,True
6506619,732,0,30,6096,106476302,1,0,0,931.27,8,391377.05,11,3,1,1,True
6563473,752,0,451,6118,106476302,1,0,0,931.17,7,390445.88,24,4,6,3,True
6583785,1284,2,-1,8300,106476302,1,1,0,931.1,4,390445.88,24,4,11,3,True
6592306,1313,4,451,5497,106476302,1,0,0,931.12,7,389514.76,5,6,17,3,True
7482281,1009,0,20,8300,106476302,1,0,0,931.22,3,388583.54,26,6,21,4,True
7569071,752,0,-1,7253,106476302,1,1,0,931.0,1,388583.54,24,0,6,4,True
7584509,757,0,20,8142,106476302,1,0,0,930.97,5,387652.57,24,4,14,5,True
7671055,732,0,25,6118,106476302,1,0,0,930.93,8,386721.64,11,6,0,5,True
7781794,1284,2,451,1248,106476302,1,0,0,930.97,7,385790.67,24,3,6,5,True
8204185,752,0,-1,4014,106476302,1,1,0,931.16,1,385790.67,24,4,23,6,True
8863454,1313,4,451,7058,106476302,1,0,0,930.91,7,384859.76,5,1,6,6,True
9011950,1284,2,30,7058,106476302,1,0,0,931.02,8,383928.74,24,1,11,7,True
9016831,1284,2,25,6118,106476302,1,0,0,930.97,8,382997.77,24,0,0,7,True
9287515,732,0,-1,9270,106476302,1,1,0,930.85,4,382997.77,11,3,19,8,True
9394695,732,0,25,4476,106476302,1,0,0,930.86,8,382066.91,11,2,9,9,True
9571891,752,0,451,1248,106476302,1,0,0,931.12,7,381135.79,24,5,19,10,True
9729604,732,0,451,8300,106476302,1,0,0,930.9,7,380204.89,11,2,11,11,True
9901630,1284,2,30,1160,106476302,1,0,0,930.82,8,379274.07,24,0,23,11,True
1508984,641,0,20,8341,412877762,0,0,0,810.37,5,222253.63,24,4,22,1,True
1611095,802,2,20,1811,412877762,0,0,0,810.13,3,221443.5,11,4,1,2,True
1644062,327,0,10,3836,412877762,0,0,0,810.2,0,222253.7,11,5,23,3,True
2156849,255,2,451,9069,412877762,0,0,0,810.18,7,221443.52,6,2,18,4,True
2374722,1390,0,-1,2196,412877762,0,1,0,810.13,4,221443.52,24,4,17,4,True
2411470,887,2,451,9394,412877762,0,0,0,809.8,7,220633.72,27,5,19,6,True
2533818,588,0,451,5416,412877762,0,0,0,809.77,7,219823.95,24,3,22,6,True
2852534,220,0,10,5976,412877762,0,0,0,810.25,6,220634.2,26,4,7,7,True
3124067,424,1,10,9394,412877762,0,0,0,810.11,0,221444.31,18,4,13,7,True
3447207,630,0,20,5976,412877762,0,0,0,810.03,5,220634.28,11,2,9,7,True
3574884,993,0,25,6864,412877762,0,0,0,810.05,8,219824.23,22,2,18,8,True
3689350,257,1,10,5636,412877762,0,0,0,810.18,0,220634.41,6,4,15,8,True
3706368,887,2,30,8014,412877762,0,0,0,809.95,8,219824.46,27,2,16,10,True
3887363,887,2,30,9069,412877762,0,0,0,809.96,8,219014.5,27,5,13,10,True
4134231,247,4,451,9468,412877762,0,0,0,809.93,7,218204.57,6,1,9,11,True
4224473,275,0,10,6864,412877762,0,0,0,809.89,6,219014.46,24,5,2,12,True
4324079,887,2,25,5847,412877762,0,0,0,809.98,8,218204.48,27,0,20,1,True
4395443,951,0,10,8341,412877762,0,0,0,810.06,0,219014.54,24,5,10,1,True
4435024,446,1,10,2196,412877762,0,0,0,810.03,6,219824.57,13,0,11,6,True
4444756,247,4,25,1352,412877762,0,0,0,810.02,8,219014.55,6,6,1,6,True
4566594,1288,0,451,9468,412877762,0,0,0,809.72,7,218204.83,24,4,6,6,True
4633139,129,0,10,5976,412877762,0,0,0,810.07,0,219014.9,18,0,3,7,True
4708970,424,1,10,1811,412877762,0,0,0,809.98,6,219824.88,18,3,11,7,True
4889771,249,0,20,5976,412877762,0,0,0,809.98,5,219014.9,6,4,6,7,True
4929323,1288,0,25,4953,412877762,0,0,0,809.86,8,218205.04,24,0,18,7,True
5842150,85,2,451,2112,412877762,0,0,0,809.79,7,217395.25,1,3,16,8,True
6005045,85,2,451,1219,412877762,0,0,0,810.09,7,216585.16,1,4,4,8,True
6339972,85,2,25,9069,412877762,0,0,0,809.8,8,215775.36,1,0,7,8,True
6354205,1132,0,10,2196,412877762,0,0,0,809.71,0,216585.07,24,3,16,8,True
6643654,1390,0,30,9468,412877762,0,0,0,809.97,8,215775.1,24,6,0,9,True
6724423,1406,0,10,1811,412877762,0,0,0,810.24,6,216585.34,24,0,19,9,True
6741314,993,0,25,8014,412877762,0,0,0,809.88,8,215775.46,22,1,22,10,True
6875397,588,0,-1,2196,412877762,0,1,0,809.78,1,215775.46,24,6,1,11,False
7030856,255,2,-1,9069,412877762,0,2,0,809.93,4,215775.46,6,0,21,2,True
7304097,168,0,10,9468,412877762,0,0,0,809.96,6,216585.42,24,2,15,4,True
7440326,260,0,10,8341,412877762,0,0,0,810.12,6,217395.54,6,6,4,4,True
7473973,428,0,20,1570,412877762,0,0,0,809.87,5,216585.67,18,5,1,5,False
7609866,471,0,20,2196,412877762,0,0,0,809.7,5,215775.97,5,6,14,5,True
7831828,588,0,-1,2112,412877762,0,1,0,810.12,4,215775.97,24,0,4,5,True
7842003,993,0,-1,7558,412877762,0,2,0,810.04,1,215775.97,22,0,23,5,True
7877920,887,2,25,3836,412877762,0,0,0,809.86,8,214966.11,27,3,21,5,True
8024427,255,2,30,5416,412877762,0,0,0,810.06,8,214156.05,6,2,1,7,True
8259436,560,2,20,1352,412877762,0,0,0,809.98,5,213346.07,17,5,0,7,True
8335474,292,1,10,7558,412877762,0,0,0,810.07,6,214156.14,4,0,13,8,True
9028454,887,2,451,5416,412877762,0,0,0,810.09,7,213346.05,27,2,15,8,True
9055008,378,0,10,5636,412877762,0,0,0,809.87,6,214155.92,25,6,12,9,True
9192816,887,2,25,9069,412877762,0,0,0,809.91,8,213346.01,27,0,10,9,True
9425198,887,2,30,4953,412877762,0,0,0,810.07,8,212535.94,27,3,14,9,True
9557681,887,2,451,1570,412877762,0,0,0,809.9,7,211726.04,27,0,3,9,True
9627795,1390,0,451,5976,412877762,0,0,0,810.08,7,210915.96,24,2,2,10,True
9810523,1027,0,10,8014,412877762,0,0,0,809.88,0,211725.84,11,5,8,10,True
9907562,316,2,20,3836,412877762,0,0,0,809.9,3,210915.94,4,6,12,10,True
9915563,588,0,451,4953,412877762,0,0,0,810.12,7,210105.82,24,2,12,10,True
1066914,645,0,30,6124,402009816,1,0,0,632.03,8,135123.97,24,5,6,1,True
1265716,1439,4,451,6098,402009816,1,0,0,631.77,7,134492.2,24,6,22,1,True
1577314,962,0,451,5545,402009816,1,0,0,632.01,7,133860.19,13,3,23,1,True
1681421,642,0,20,3506,402009816,1,0,0,632.34,3,133227.85,24,3,15,2,True
1717589,962,0,25,5545,402009816,1,0,0,632.01,8,132595.84,13,3,4,3,True
1790774,1439,4,25,3007,402009816,1,0,0,632.08,8,131963.76,24,0,7,3,True
1808587,523,2,20,8663,402009816,1,0,0,631.82,3,131331.94,18,2,21,4,True
1858117,1439,4,-1,9126,402009816,1,1,0,632.15,4,131331.94,24,5,15,4,True
1862530,645,0,-1,7439,402009816,1,2,0,632.0,4,131331.94,24,1,17,5,True
1902942,1318,0,20,8663,402009816,1,0,0,632.06,5,130699.88,18,1,4,7,True
2449647,645,0,30,9743,402009816,1,0,0,632.04,8,130067.84,24,0,3,8,True
2568160,123,0,10,9301,402009816,1,0,0,632.12,0,130699.96,18,5,14,9,True
2681012,962,0,451,6098,402009816,1,0,0,632.02,7,130067.94,13,4,17,11,True
3009907,962,0,-1,9321,402009816,1,1,0,632.19,4,130067.94,13,4,10,12,True
3023950,562,1,10,2519,402009816,1,0,0,632.05,6,130699.99,17,1,19,12,True
3142276,645,0,30,6903,402009816,1,0,0,632.09,8,130067.9,24,4,16,12,True
3423173,497,0,451,6903,402009816,1,0,0,631.91,7,129435.99,12,3,11,12,True
3734360,645,0,30,6098,402009816,1,0,0,631.96,8,128804.03,24,1,2,2,True
3834087,497,0,451,5545,402009816,1,0,0,631.99,7,128172.04,12,2,17,3,True
3937873,714,2,20,5810,402009816,1,0,0,632.03,3,127540.01,18,5,14,4,True
4269575,1035,0,10,9743,402009816,1,0,0,631.95,6,128171.96,11,0,1,4,True
5012335,962,0,30,8343,402009816,1,0,0,632.09,8,127539.87,13,6,23,4,True
5054888,962,0,451,3704,402009816,1,0,0,632.09,7,126907.78,13,5,17,4,True
5143607,759,0,10,8663,402009816,1,0,0,632.16,6,127539.94,24,0,11,5,True
5562643,645,0,451,8663,402009816,1,0,0,631.97,7,126907.97,24,0,5,5,True
5579560,1439,4,25,9743,402009816,1,0,0,631.9,8,126276.07,24,0,11,6,True
5856014,1017,2,20,9126,402009816,1,0,0,631.91,3,125644.16,26,3,1,6,True
5951415,645,0,451,3506,402009816,1,0,0,631.89,7,125012.27,24,6,23,7,True
6075236,398,0,20,6903,402009816,1,0,0,631.87,5,124380.4,10,4,16,8,True
6217407,645,0,30,8343,402009816,1,0,0,632.05,8,123748.35,24,6,0,8,True
6251866,497,0,30,3704,402009816,1,0,0,631.79,8,123116.56,12,4,11,12,True
6489599,108,2,30,5810,402009816,1,0,0,631.78,8,122484.78,3,3,12,1,True
6797831,1439,4,451,4361,402009816,1,0,0,631.99,7,121852.79,24,6,3,1,True
7156573,497,0,451,5887,402009816,1,0,0,632.0,7,121220.79,12,6,4,1,True
7271084,610,0,10,5887,402009816,1,0,0,631.97,6,121852.76,11,2,2,1,True
7367383,796,2,20,9301,402009816,1,0,0,632.02,3,121220.74,11,5,18,3,True
7691201,1439,4,25,2519,402009816,1,0,0,631.91,8,120588.83,24,0,14,3,True
7980330,108,2,25,5525,402009816,1,0,0,632.05,8,119956.78,3,6,10,5,True
8050898,1069,1,10,6549,402009816,1,0,0,631.99,6,120588.77,18,3,23,5,True
8107009,305,1,-1,6124,402009816,1,1,0,631.74,4,120588.77,4,5,19,6,True
8230139,287,0,20,3006,402009816,1,0,0,632.0,5,119956.77,24,6,15,7,True
8260274,305,1,451,3007,402009816,1,0,0,632.15,7,119324.62,4,0,11,7,True
8475017,962,0,25,5470,402009816,1,0,0,632.07,8,118692.55,13,5,17,9,True
8642820,811,0,10,8663,402009816,1,0,0,631.97,0,119324.52,18,1,23,9,True
8819462,962,0,30,3007,402009816,1,0,0,632.08,8,118692.44,13,6,1,9,True
8895496,1010,0,20,3506,402009816,1,0,0,632.21,3,118060.23,26,3,16,10,True
8912977,996,0,10,3006,402009816,1,0,0,631.98,6,118692.21,26,6,20,10,True
9155238,645,0,451,9301,402009816,1,0,0,631.94,7,118060.27,24,3,17,10,True
9166154,108,2,30,8540,402009816,1,0,0,631.77,8,117428.5,3,2,20,11,True
9722632,108,2,25,6124,402009816,1,0,0,632.01,8,116796.49,3,1,15,11,True
9923347,1439,4,30,6124,402009816,1,0,0,632.17,8,116164.32,24,4,12,11,True
1265808,1339,2,20,2127,921537863,0,0,0,361.02,5,725997.98,18,0,4,1,True
1373190,281,1,10,4372,921537863,0,0,0,360.94,0,726358.92,24,5,3,2,True
1446799,496,1,451,8979,921537863,0,0,0,360.85,7,725998.07,12,1,12,3,True
1754168,696,2,451,3365,921537863,0,0,0,360.97,7,725637.1,24,1,20,5,True
1869135,496,1,25,5436,921537863,0,0,0,360.84,8,725276.26,12,2,13,10,True
1916282,1325,0,10,1684,921537863,0,0,0,360.74,6,725637.0,18,5,0,10,True
2267441,496,1,-1,5436,921537863,0,1,0,361.17,1,725637.0,12,5,22,12,True
2334564,696,2,30,2127,921537863,0,0,0,361.06,8,725275.94,24,0,3,1,True
2388516,824,2,20,4120,921537863,0,0,0,360.95,5,724914.99,18,5,17,1,True
2513514,1303,0,20,1113,921537863,0,0,0,360.91,5,724554.08,5,0,0,3,True
2520781,496,1,30,1988,921537863,0,0,0,360.91,8,724193.17,12,0,1,5,True
3246006,1492,4,25,4699,921537863,0,0,0,360.87,8,723832.3,24,3,19,6,True
3356040,1413,0,20,4854,921537863,0,0,0,361.01,5,723471.29,24,4,14,6,True
3537119,1321,0,10,2127,921537863,0,0,0,360.74,6,723832.03,18,4,10,7,True
3587237,1485,0,10,7139,921537863,0,0,0,360.81,6,724192.84,24,4,19,7,True
3719429,688,0,10,2436,921537863,0,0,0,360.91,6,724553.75,24,1,8,8,True
4184632,734,0,451,7139,921537863,0,0,0,361.15,7,724192.6,11,2,3,9,True
4196655,696,2,-1,9665,921537863,0,1,0,361.14,1,724192.6,24,3,12,9,True
4500639,398,0,10,1684,921537863,0,0,0,361.03,0,724553.63,10,2,18,9,True
4685594,201,1,30,9324,921537863,0,0,0,361.35,8,724192.28,9,0,8,10,True
4761822,734,0,-1,2964,921537863,0,1,0,360.94,4,724192.28,11,4,7,11,True
4851086,1363,0,20,1190,921537863,0,0,0,361.22,3,723831.06,16,6,17,12,True
5000205,496,1,30,7766,921537863,0,0,0,361.17,8,723469.89,12,1,15,1,True
5021719,201,1,451,1988,921537863,0,0,0,361.22,7,723108.67,9,4,4,2,True
5294047,530,0,30,8931,921537863,0,0,0,361.02,8,722747.65,18,4,22,2,True
5965971,871,0,10,5787,921537863,0,0,0,360.87,0,723108.52,24,2,2,4,True
5978349,696,2,451,4854,921537863,0,0,0,361.18,7,722747.34,24,6,23,4,True
6100530,1231,2,20,9665,921537863,0,0,0,360.96,5,722386.38,18,4,6,5,True
6270535,1086,0,10,1688,921537863,0,0,0,360.85,6,722747.23,18,1,15,5,True
6405645,538,0,10,7766,921537863,0,0,0,360.76,6,723107.99,18,1,10,7,True
6554503,563,4,25,4854,921537863,0,0,0,360.96,8,722747.03,17,3,6,8,True
6570012,1017,2,20,2127,921537863,0,0,0,360.71,5,722386.32,26,4,4,8,True
6677692,696,2,30,1988,921537863,0,0,0,361.11,8,722025.21,24,3,2,9,True
6680110,249,0,10,7766,921537863,0,0,0,360.84,6,722386.05,6,5,0,9,True
6717104,496,1,-1,7766,921537863,0,1,0,360.96,1,722386.05,12,5,20,9,True
6795381,530,0,-1,5436,921537863,0,2,0,360.96,1,722386.05,18,5,1,10,True
6845972,1492,4,-1,1113,921537863,0,3,1,360.83,1,0.0,24,1,21,11,False
1161152,1449,0,10,3873,755433519,0,0,0,607.96,6,810943.96,11,2,15,3,True
1408451,754,4,451,7898,755433519,0,0,0,608.27,7,810335.69,24,0,21,3,True
1469000,1277,2,20,9803,755433519,0,0,0,608.01,3,809727.68,24,2,0,5,True
1525505,1364,0,20,9803,755433519,0,0,0,608.07,5,809119.61,16,5,9,5,True
1591347,754,4,30,6969,755433519,0,0,0,608.01,8,808511.6,24,5,11,6,True
1673942,429,0,451,9889,755433519,0,0,0,607.77,7,807903.83,24,4,5,6,True
1760115,990,0,20,7416,755433519,0,0,0,608.14,3,807295.69,22,1,1,6,True
1765974,988,3,451,8517,755433519,0,0,0,608.13,7,806687.56,22,0,2,7,True
2505455,818,1,-1,8336,755433519,0,1,0,608.36,4,806687.56,18,1,18,7,True
2549433,592,4,451,6969,755433519,0,0,0,608.17,7,806079.39,24,1,21,7,True
2706856,429,0,30,6969,755433519,0,0,0,607.98,8,805471.41,24,0,1,7,False
2820438,429,0,451,6969,755433519,0,0,0,608.17,7,804863.24,24,2,9,7,True
2999610,854,0,10,2916,755433519,0,0,0,607.96,0,805471.2,24,1,19,8,True
3043533,569,4,30,1899,755433519,0,0,0,608.11,8,804863.09,11,2,22,8,True
3150165,754,4,30,5079,755433519,0,0,0,607.95,8,804255.14,24,1,2,8,True
3150243,569,4,25,7898,755433519,0,0,0,608.23,8,803646.91,11,2,11,10,True
3395096,1388,1,10,9889,755433519,0,0,0,608.16,6,804255.07,24,1,11,11,True
3423322,988,3,30,3809,755433519,0,0,0,608.02,8,803647.05,22,1,2,12,True
3609788,346,0,20,7416,755433519,0,0,0,608.04,5,803039.01,24,3,1,12,True
3869306,825,2,20,3809,755433519,0,0,0,608.15,3,802430.86,18,6,21,1,True
3983321,385,1,10,5079,755433519,0,0,0,608.22,6,803039.08,25,5,4,3,True
3984918,569,4,451,3809,755433519,0,0,0,607.59,7,802431.49,11,3,21,3,True
4448151,628,0,10,3873,755433519,0,0,0,607.94,6,803039.43,11,1,14,4,True
4471189,1069,1,10,3809,755433519,0,0,0,607.96,0,803647.39,18,0,22,4,False
4483420,537,0,10,1899,755433519,0,0,0,607.94,6,804255.33,18,2,22,6,True
5146053,471,0,10,8517,755433519,0,0,0,608.02,6,804863.35,5,3,0,6,True
5409680,569,4,451,8544,755433519,0,0,0,607.94,7,804255.41,11,1,10,6,True
5455830,448,0,20,7898,755433519,0,0,0,608.22,5,803647.19,13,1,8,7,True
5675505,887,2,20,1962,755433519,0,0,0,607.93,3,803039.26,27,1,8,7,True
5796754,592,4,451,8336,755433519,0,0,0,608.3,7,802430.96,24,2,8,7,True
5860861,754,4,-1,8336,755433519,0,1,0,608.13,1,802430.96,24,4,6,8,True
5892342,867,0,20,6969,755433519,0,0,0,607.87,5,801823.09,24,0,23,8,True
6081016,1426,1,10,3873,755433519,0,0,0,607.85,6,802430.94,24,3,2,8,True
6408490,818,1,30,8364,755433519,0,0,0,607.86,8,801823.08,18,2,16,8,True
6518781,988,3,451,8517,755433519,0,0,0,608.03,7,801215.05,22,5,9,9,True
6692641,569,4,451,9889,755433519,0,0,0,608.24,7,800606.81,11,1,20,9,True
6914701,818,1,451,9889,755433519,0,0,0,608.31,7,799998.5,18,5,22,9,True
7168960,988,3,25,2916,755433519,0,0,0,608.18,8,799390.32,22,6,12,10,True
7179721,804,0,20,9584,755433519,0,0,0,608.15,3,798782.17,11,6,22,10,True
7185263,457,0,20,8336,755433519,0,0,0,607.64,5,798174.53,13,6,11,11,True
7248203,569,4,451,7416,755433519,0,0,0,608.15,7,797566.38,11,1,19,12,True
7295864,569,4,451,3873,755433519,0,0,0,608.11,7,796958.27,11,0,3,1,True
7351970,754,4,451,9803,755433519,0,0,0,607.82,7,796350.45,24,0,18,1,True
7424249,429,0,25,7898,755433519,0,0,0,607.9,8,795742.55,24,2,19,1,True
7566154,569,4,-1,9889,755433519,0,1,0,607.96,4,795742.55,11,0,17,2,True
7850353,1382,0,20,3873,755433519,0,0,0,607.95,5,795134.6,16,1,16,2,True
7936008,696,2,20,6969,755433519,0,0,0,608.19,5,794526.41,24,3,0,2,True
8005877,818,1,451,1899,755433519,0,0,0,607.98,7,793918.43,18,0,5,3,True
8009570,1009,0,10,2916,755433519,0,0,0,608.15,6,794526.58,26,6,7,3,True
8089700,569,4,-1,8364,755433519,0,1,0,608.02,4,794526.58,11,2,7,4,True
8402265,569,4,30,5196,755433519,0,0,0,608.2,8,793918.38,11,4,7,5,True
8405096,592,4,25,7416,755433519,0,0,0,607.97,8,793310.41,24,0,10,6,True
8980131,592,4,25,9803,755433519,0,0,0,607.97,8,792702.44,24,6,6,7,True
9011645,818,1,25,9803,755433519,0,0,0,607.97,8,792094.47,18,4,15,8,True
9056292,645,0,10,1899,755433519,0,0,0,607.94,6,792702.41,24,5,6,8,False
9284713,580,0,10,9584,755433519,0,0,0,607.67,6,793310.08,11,6,22,8,True
9494180,689,0,10,8544,755433519,0,0,0,608.13,6,793918.21,24,1,5,9,True
9627528,569,4,-1,8336,755433519,0,1,0,608.22,4,793918.21,11,4,6,9,True
9632590,754,4,25,8544,755433519,0,0,0,607.92,8,793310.29,24,6,13,10,False
1062175,539,4,25,4932,710989031,0,0,0,428.96,8,395529.04,18,2,4,1,True
1126128,539,4,30,3709,710989031,0,0,0,428.98,8,395100.06,18,2,2,2,True
1180133,791,3,451,4932,710989031,0,0,0,428.97,7,394671.09,11,2,15,4,True
1336481,993,0,30,2909,710989031,0,0,0,428.93,8,394242.16,22,1,14,5,True
1387004,883,0,10,2370,710989031,0,0,0,429.12,6,394671.28,24,4,14,7,True
1617172,467,0,20,2909,710989031,0,0,0,429.25,5,394242.03,5,6,19,7,True
1672998,993,0,451,3709,710989031,0,0,0,428.93,7,393813.1,22,5,6,7,True
2038282,779,4,451,8523,710989031,0,0,0,428.94,7,393384.16,14,1,13,7,True
2085115,1089,0,10,3709,710989031,0,0,0,428.78,6,393812.94,18,3,20,9,True
2429161,185,1,10,4932,710989031,0,0,0,428.94,0,394241.88,18,5,23,10,True
2677078,993,0,451,4932,710989031,0,0,0,428.73,7,393813.15,22,2,10,11,True
3152501,1363,0,30,4743,710989031,0,0,0,428.89,8,393384.26,16,3,4,11,True
3319537,951,0,10,6064,710989031,0,0,0,429.1,0,393813.36,24,6,17,12,True
3358244,539,4,30,8523,710989031,0,0,0,429.04,8,393384.32,18,2,1,1,True
3767090,208,0,30,3418,710989031,0,0,0,428.87,8,392955.45,9,4,10,2,True
3812101,1186,2,20,7731,710989031,0,0,0,429.07,5,392526.38,24,4,12,2,True
4088045,791,3,25,2909,710989031,0,0,0,429.06,8,392097.32,11,1,6,2,True
4490260,866,0,10,2426,710989031,0,0,0,428.95,6,392526.27,24,1,3,3,True
4513032,182,1,10,4132,710989031,0,0,0,429.12,6,392955.39,18,4,5,3,True
4523228,114,0,20,4743,710989031,0,0,0,429.0,3,392526.39,3,5,13,3,True
4748163,199,0,20,6064,710989031,0,0,0,428.83,5,392097.56,18,2,22,3,True
4766466,208,0,-1,4132,710989031,0,1,0,429.25,1,392097.56,9,0,10,4,True
5004054,779,4,-1,2909,710989031,0,2,0,429.2,4,392097.56,14,0,15,4,True
5238368,993,0,451,4743,710989031,0,0,0,428.88,7,391668.68,22,4,15,4,True
5332846,208,0,25,1778,710989031,0,0,0,429.04,8,391239.64,9,1,22,5,True
5459086,1363,0,25,8523,710989031,0,0,0,428.97,8,390810.67,16,3,7,5,True
5750660,1363,0,451,2426,710989031,0,0,0,429.24,7,390381.43,16,2,13,6,True
5794468,1363,0,451,2426,710989031,0,0,0,428.98,7,389952.45,16,5,18,6,True
5873074,208,0,20,8377,710989031,0,0,0,428.95,3,389523.5,9,3,13,6,True
5939187,996,0,10,5411,710989031,0,0,0,429.18,6,389952.68,26,2,10,6,True
5956988,895,0,20,3709,710989031,0,0,0,428.92,5,389523.76,24,4,0,7,True
6160327,314,0,10,7731,710989031,0,0,0,428.85,6,389952.61,4,1,4,8,True
6418540,539,4,25,7030,710989031,0,0,0,429.03,8,389523.58,18,6,7,9,True
6578146,791,3,-1,3418,710989031,0,1,0,428.93,4,389523.58,11,3,8,9,True
6652480,791,3,-1,3418,710989031,0,2,0,429.2,1,389523.58,11,1,6,10,True
6731753,23,0,20,3709,710989031,0,0,0,428.87,3,389094.71,11,1,0,10,True
6792060,539,4,30,6064,710989031,0,0,0,429.02,8,388665.69,18,3,22,11,True
6955017,791,3,30,4932,710989031,0,0,0,429.16,8,388236.53,11,1,3,11,True
7318818,952,0,10,7030,710989031,0,0,0,428.99,6,388665.52,13,5,20,11,True
7514089,993,0,451,8377,710989031,0,0,0,429.18,7,388236.34,22,0,13,11,True
7515373,993,0,451,6486,710989031,0,0,0,429.06,7,387807.28,22,6,10,12,True
7650783,791,3,-1,1778,710989031,0,1,0,429.15,1,387807.28,11,4,13,12,True
7753757,539,4,25,2426,710989031,0,0,0,429.25,8,387378.03,18,2,0,1,True
8182144,539,4,451,8523,710989031,0,0,0,429.27,7,386948.76,18,3,0,1,True
8222822,800,0,20,3418,710989031,0,0,0,428.78,3,386519.98,11,2,15,2,True
8239970,539,4,451,1778,710989031,0,0,0,429.07,7,386090.91,18,6,2,3,True
8302688,208,0,30,4132,710989031,0,0,0,429.03,8,385661.88,9,4,21,4,True
8398039,1404,2,20,1778,710989031,0,0,0,428.77,5,385233.11,24,4,8,4,True
8486797,791,3,451,7731,710989031,0,0,0,429.01,7,384804.1,11,0,20,6,True
8644396,1363,0,451,2370,710989031,0,0,0,429.11,7,384374.99,16,3,12,6,True
8860331,779,4,-1,2426,710989031,0,1,0,429.04,1,384374.99,14,6,16,6,True
9070473,539,4,-1,8377,710989031,0,2,0,429.11,1,384374.99,18,2,22,7,True
9175963,180,0,20,4932,710989031,0,0,0,429.03,5,383945.96,18,6,23,8,True
9480371,1390,0,20,6486,710989031,0,0,0,429.09,3,383516.87,24,3,5,9,False
9899409,208,0,30,2370,710989031,0,0,0,429.13,8,383087.74,9,4,9,11,True
1032373,1218,4,451,1975,431046314,0,0,0,286.91,7,280743.09,24,5,5,1,False
1405314,673,0,10,1615,431046314,0,0,0,286.78,0,281029.87,18,6,3,1,True
1451507,834,0,451,1260,431046314,0,0,0,287.24,7,280742.63,5,2,10,1,True
1571416,358,4,30,1414,431046314,0,0,0,287.15,8,280455.48,24,1,0,1,True
1572906,895,0,20,9380,431046314,0,0,0,287.08,5,280168.4,24,2,9,1,False
2093700,1074,4,451,1953,431046314,0,0,0,287.02,7,279881.38,18,3,11,1,True
2420859,1238,0,20,5309,431046314,0,0,0,287.1,5,279594.28,18,0,15,1,False
3049900,1000,0,10,8675,431046314,0,0,0,286.99,6,279881.27,26,3,14,2,True
3297092,260,0,20,8304,431046314,0,0,0,286.94,5,279594.33,6,2,11,2,True
3374811,1074,4,25,4898,431046314,0,0,0,287.02,8,279307.31,18,4,9,2,True
3489488,482,1,10,8304,431046314,0,0,0,287.12,0,279594.43,5,1,12,3,True
3651909,767,0,451,7817,431046314,0,0,0,286.99,7,279307.44,14,6,11,4,True
3692403,358,4,25,7147,431046314,0,0,0,286.98,8,279020.46,24,0,12,5,True
3711985,406,1,10,4577,431046314,0,0,0,287.07,0,279307.53,10,3,5,5,True
3717158,1179,0,20,9380,431046314,0,0,0,286.86,5,279020.67,24,0,5,5,True
4020027,1074,4,451,8420,431046314,0,0,0,286.82,7,278733.85,18,6,7,7,True
4440007,834,0,451,7759,431046314,0,0,0,287.04,7,278446.81,5,5,0,9,True
4485272,1140,0,10,1132,431046314,0,0,0,287.13,6,278733.94,15,4,23,9,True
4552606,358,4,451,8157,431046314,0,0,0,286.99,7,278446.95,24,6,2,9,True
4758780,834,0,30,1365,431046314,0,0,0,287.08,8,278159.87,5,6,15,9,False
4859816,1218,4,25,4470,431046314,0,0,0,287.38,8,277872.49,24,2,0,11,True
4895896,774,2,20,7740,431046314,0,0,0,287.16,5,277585.33,14,0,5,11,True
4897781,1218,4,451,7621,431046314,0,0,0,286.94,7,277298.39,24,3,1,12,True
4990779,834,0,25,8675,431046314,0,0,0,287.37,8,277011.02,5,1,13,1,True
5027454,834,0,25,7147,431046314,0,0,0,286.92,8,276724.1,5,0,18,3,True
5458344,626,2,20,4903,431046314,0,0,0,286.9,5,276437.2,11,0,9,3,True
5571875,1218,4,-1,1414,431046314,0,1,0,286.91,4,276437.2,24,0,21,4,True
5691735,358,4,451,8420,431046314,0,0,0,287.18,7,276150.02,24,1,2,4,True
5693542,358,4,25,8529,431046314,0,0,0,287.03,8,275862.99,24,5,8,5,True
5881827,358,4,451,7759,431046314,0,0,0,287.08,7,275575.91,24,4,21,6,True
5975237,834,0,25,5309,431046314,0,0,0,287.06,8,275288.85,5,2,16,6,True
6409289,834,0,-1,7991,431046314,0,1,0,286.83,1,275288.85,5,3,17,6,True
6435118,132,2,20,1260,431046314,0,0,0,286.88,5,275001.97,18,0,6,7,True
6464204,358,4,451,8975,431046314,0,0,0,287.04,7,274714.93,24,4,17,8,True
6654995,358,4,25,7621,431046314,0,0,0,286.91,8,274428.02,24,3,14,8,True
7103920,1074,4,30,1953,431046314,0,0,0,286.93,8,274141.09,18,5,16,9,True
7346108,1124,0,10,7817,431046314,0,0,0,287.15,6,274428.24,24,4,20,9,True
7607063,358,4,451,1975,431046314,0,0,0,286.9,7,274141.34,24,6,1,9,True
7651511,223,2,20,4898,431046314,0,0,0,286.88,3,273854.46,26,2,17,10,True
7687967,834,0,451,1132,431046314,0,0,0,286.96,7,273567.5,5,5,6,10,True
7802791,834,0,-1,1414,431046314,0,1,0,286.9,1,273567.5,5,6,23,11,True
7806677,376,0,20,2341,431046314,0,0,0,287.16,5,273280.34,25,0,3,11,True
7863356,767,0,-1,4898,431046314,0,1,0,286.98,1,273280.34,14,0,8,11,True
8218956,1074,4,25,5309,431046314,0,0,0,287.11,8,272993.23,18,4,15,12,True
8347922,767,0,30,7817,431046314,0,0,0,286.88,8,272706.35,14,4,20,12,True
8388889,767,0,451,8529,431046314,0,0,0,287.03,7,272419.32,14,5,19,12,True
8473623,616,1,10,4903,431046314,0,0,0,286.93,6,272706.25,11,2,15,1,True
8563780,358,4,30,7778,431046314,0,0,0,287.04,8,272419.21,24,3,10,1,True
8601977,1218,4,451,1132,431046314,0,0,0,286.97,7,272132.24,24,6,19,2,True
8608735,1164,0,10,1975,431046314,0,0,0,287.24,0,272419.48,24,2,18,3,True
8735805,834,0,25,9516,431046314,0,0,0,287.04,8,272132.44,5,1,8,5,True
8850071,234,0,20,7147,431046314,0,0,0,286.78,3,271845.66,26,2,15,5,True
8890008,1074,4,25,4903,431046314,0,0,0,287.15,8,271558.51,18,1,11,6,True
8950781,767,0,451,9380,431046314,0,0,0,287.1,7,271271.41,14,5,16,7,True
8958092,1218,4,451,9380,431046314,0,0,0,287.2,7,270984.21,24,4,15,8,True
9037283,834,0,-1,9516,431046314,0,1,0,286.69,1,270984.21,5,5,17,9,True
9359870,358,4,25,7817,431046314,0,0,0,286.78,8,270697.43,24,6,8,9,True
9389886,328,0,10,8975,431046314,0,0,0,287.08,6,270984.51,11,6,7,11,True
1168175,844,1,-1,5116,531019743,1,1,0,309.88,4,130491.0,5,0,13,1,True
1208875,1271,0,20,4898,531019743,1,0,0,309.93,5,130181.07,23,1,19,2,True
1587240,844,1,30,4898,531019743,1,0,0,310.04,8,129871.03,5,3,16,3,False
1806750,1212,0,25,8297,531019743,1,0,0,310.0,8,129561.03,24,6,13,6,True
1831092,137,2,25,9319,531019743,1,0,0,309.99,8,129251.04,18,4,12,6,True
1846092,137,2,30,1070,531019743,1,0,0,309.91,8,128941.13,18,5,19,7,True
1886010,137,2,30,1341,531019743,1,0,0,310.06,8,128631.07,18,5,17,8,True
1934710,735,1,25,9319,531019743,1,0,0,309.94,8,128321.13,11,1,6,10,True
2562315,211,0,30,4898,531019743,1,0,0,310.16,8,128010.97,9,4,5,10,True
2789503,1212,0,-1,5471,531019743,1,1,0,309.8,1,128010.97,24,3,12,1,True
2860387,137,2,451,1070,531019743,1,0,0,310.15,7,127700.82,18,3,3,1,True
2902481,844,1,451,8343,531019743,1,0,0,309.93,7,127390.89,5,0,5,3,True
3208569,735,1,-1,7599,531019743,1,1,0,309.86,4,127390.89,11,3,9,3,True
3291374,531,0,451,8343,531019743,1,0,0,309.83,7,127081.06,18,4,10,3,True
3547663,844,1,451,6107,531019743,1,0,0,309.73,7,126771.33,5,2,23,3,True
3886255,211,0,30,6478,531019743,1,0,0,310.14,8,126461.19,9,5,16,4,True
4367121,844,1,30,4465,531019743,1,0,0,309.97,8,126151.22,5,0,10,4,True
4407818,137,2,-1,5471,531019743,1,1,0,309.86,1,126151.22,18,1,13,4,True
4473526,211,0,451,8343,531019743,1,0,0,310.15,7,125841.07,9,3,16,5,True
4782988,1212,0,451,4465,531019743,1,0,0,309.98,7,125531.09,24,3,5,6,True
4873320,531,0,30,8804,531019743,1,0,0,310.21,8,125220.88,18,0,6,8,True
5657059,1212,0,30,8626,531019743,1,0,0,310.13,8,124910.75,24,0,18,8,True
5956973,211,0,30,1070,531019743,1,0,0,309.89,8,124600.86,9,5,7,9,True
6026303,531,0,25,9319,531019743,1,0,0,309.94,8,124290.92,18,4,12,9,True
6393574,137,2,451,8636,531019743,1,0,0,309.71,7,123981.21,18,4,10,9,True
6578632,299,1,10,8804,531019743,1,0,0,310.08,6,124291.29,4,2,11,9,True
6600630,844,1,25,8602,531019743,1,0,0,310.2,8,123981.09,5,3,16,9,True
6947744,1238,0,10,8297,531019743,1,0,0,309.89,6,124290.98,18,5,21,11,True
7393666,1387,1,10,4095,531019743,1,0,0,310.09,6,124601.07,24,0,4,11,True
7412898,1000,0,10,4898,531019743,1,0,0,309.86,6,124910.93,26,4,4,11,True
7572506,531,0,451,6478,531019743,1,0,0,309.95,7,124600.98,18,3,22,11,True
7648012,677,0,20,4095,531019743,1,0,0,310.07,3,124290.91,24,1,7,11,True
7749402,844,1,-1,4095,531019743,1,1,0,309.98,1,124290.91,5,6,5,12,True
7789808,457,0,10,8297,531019743,1,0,0,310.22,6,124601.13,13,5,18,1,True
7964873,1210,0,10,5471,531019743,1,0,0,310.02,0,124911.15,24,4,8,1,True
8094450,300,0,10,3215,531019743,1,0,0,310.18,0,125221.33,4,3,7,1,True
8213564,137,2,451,5471,531019743,1,0,0,309.72,7,124911.61,18,6,17,1,True
8318886,211,0,451,4465,531019743,1,0,0,310.06,7,124601.55,9,2,5,2,False
8381080,1434,0,20,4898,531019743,1,0,0,310.0,5,124291.55,24,1,13,2,False
8500942,211,0,451,8636,531019743,1,0,0,310.11,7,123981.44,9,1,9,3,True
8579925,531,0,451,8343,531019743,1,0,0,309.73,7,123671.71,18,4,18,3,True
8734984,1246,0,20,3215,531019743,1,0,0,310.06,3,123361.65,23,3,12,4,True
8898340,735,1,451,8297,531019743,1,0,0,310.03,7,123051.62,11,1,10,5,True
8923993,1123,2,20,1070,531019743,1,0,0,310.0,5,122741.62,24,1,17,5,True
8964134,137,2,-1,4898,531019743,1,1,0,309.95,1,122741.62,18,6,7,6,True
8969311,350,0,10,9521,531019743,1,0,0,310.17,0,123051.79,24,4,11,7,True
9021975,205,0,10,6478,531019743,1,0,0,309.81,6,123361.6,9,2,8,8,True
9538274,137,2,25,8297,531019743,1,0,0,310.03,8,123051.57,18,0,1,8,True
9565085,844,1,25,7599,531019743,1,0,0,309.91,8,122741.66,5,4,13,9,True
9600989,844,1,-1,6107,531019743,1,1,0,310.01,1,122741.66,5,1,23,10,True
9779637,211,0,-1,6478,531019743,1,2,0,310.03,1,122741.66,9,2,10,10,False
9982545,160,0,10,6107,531019743,1,0,0,309.98,6,123051.64,24,6,20,11,True
1042769,1369,3,451,1389,420262424,1,0,0,954.25,7,744166.75,16,5,10,1,True
1212413,131,4,451,4318,420262424,1,0,0,953.83,7,743212.92,18,6,10,1,True
1359817,1063,0,30,8458,420262424,1,0,0,954.39,8,742258.53,11,6,16,1,True
1474825,131,4,25,1993,420262424,1,0,0,954.08,8,741304.45,18,1,8,4,True
1534142,1369,3,30,5291,420262424,1,0,0,953.73,8,740350.72,16,4,19,4,True
1984690,318,0,20,8028,420262424,1,0,0,954.21,3,739396.51,11,3,22,6,True
2435775,131,4,-1,1389,420262424,1,1,0,953.96,4,739396.51,18,3,4,7,True
2457936,887,2,451,1190,420262424,1,0,0,954.06,7,738442.45,27,3,13,8,True
2484513,548,2,20,5977,420262424,1,0,0,953.93,3,737488.52,17,1,14,8,True
2563252,1428,1,-1,8458,420262424,1,1,0,954.09,4,737488.52,24,0,23,8,True
2581771,1369,3,451,4229,420262424,1,0,0,953.95,7,736534.57,16,0,1,8,True
3218360,131,4,451,1389,420262424,1,0,0,954.13,7,735580.44,18,2,0,9,True
3746743,131,4,451,5999,420262424,1,0,0,954.05,7,734626.39,18,3,1,10,True
4021270,1369,3,25,7295,420262424,1,0,0,953.95,8,733672.44,16,4,20,11,True
4137285,1063,0,451,8458,420262424,1,0,0,953.72,7,732718.72,11,4,17,11,True
4339255,1035,0,10,4229,420262424,1,0,0,953.91,0,733672.63,11,3,10,12,True
4502862,1369,3,30,6203,420262424,1,0,0,953.84,8,732718.79,16,5,17,2,True
4552949,131,4,451,3047,420262424,1,0,0,954.15,7,731764.64,18,1,20,2,True
4636524,1428,1,25,5999,420262424,1,0,0,953.96,8,730810.68,24,6,7,2,True
4780360,887,2,25,3047,420262424,1,0,0,954.05,8,729856.63,27,4,10,2,True
4900611,1428,1,451,4229,420262424,1,0,0,953.9,7,728902.73,24,1,13,4,True
4950993,1238,0,10,4229,420262424,1,0,0,953.89,6,729856.62,18,4,13,4,True
5237727,1428,1,451,4185,420262424,1,0,0,953.7,7,728902.92,24,5,9,5,True
5317903,1369,3,451,1484,420262424,1,0,0,954.0,7,727948.92,16,2,17,5,True
5346902,1063,0,451,6805,420262424,1,0,0,953.74,7,726995.18,11,4,7,5,True
5538967,131,4,451,6537,420262424,1,0,0,954.13,7,726041.05,18,0,17,6,True
5676373,887,2,-1,6203,420262424,1,1,0,953.85,4,726041.05,27,1,16,7,True
5742799,327,0,20,3047,420262424,1,0,0,954.01,3,725087.04,11,3,21,8,True
5788229,681,2,20,8458,420262424,1,0,0,953.84,5,724133.2,24,4,9,9,True
5959323,1428,1,25,7953,420262424,1,0,0,953.66,8,723179.54,24,5,17,9,True
5974195,1164,0,10,1484,420262424,1,0,0,954.21,6,724133.75,24,3,6,10,True
6015808,131,4,451,5291,420262424,1,0,0,954.26,7,723179.49,18,4,13,10,True
6235167,131,4,-1,1190,420262424,1,1,0,953.82,1,723179.49,18,4,15,11,True
6277944,1063,0,30,1491,420262424,1,0,0,954.15,8,722225.34,11,5,2,11,True
6630968,1369,3,451,4318,420262424,1,0,0,953.87,7,721271.47,16,2,15,11,True
6778216,131,4,-1,1484,420262424,1,1,0,954.09,4,721271.47,18,3,0,11,True
6863699,1238,0,20,4318,420262424,1,0,0,954.22,5,720317.25,18,1,21,11,True
6978306,1369,3,25,9459,420262424,1,0,0,954.15,8,719363.1,16,0,8,12,True
7165760,348,0,20,5977,420262424,1,0,0,953.7,3,718409.4,24,6,12,12,True
7340909,1369,3,-1,6805,420262424,1,1,0,953.56,4,718409.4,16,4,22,1,True
7562191,887,2,451,6805,420262424,1,0,0,953.95,7,717455.45,27,6,5,2,True
7595817,887,2,25,5999,420262424,1,0,0,953.9,8,716501.55,27,2,6,2,True
7708006,1063,0,25,7953,420262424,1,0,0,953.92,8,715547.63,11,2,12,3,False
7734977,131,4,451,4229,420262424,1,0,0,953.88,7,714593.75,18,3,10,3,True
7822882,131,4,451,8458,420262424,1,0,0,953.88,7,713639.87,18,6,7,3,True
8094421,234,0,10,7493,420262424,1,0,0,953.92,0,714593.79,26,2,6,4,False
8294767,887,2,451,5977,420262424,1,0,0,954.11,7,713639.68,27,1,17,5,True
8521332,1063,0,30,1190,420262424,1,0,0,953.93,8,712685.75,11,1,12,5,True
8809852,1369,3,-1,2778,420262424,1,1,0,953.88,4,712685.75,16,4,22,5,True
8945568,1063,0,30,8028,420262424,1,0,0,953.88,8,711731.87,11,1,1,7,True
8956381,1428,1,451,4318,420262424,1,0,0,953.83,7,710778.04,24,0,0,7,True
9001924,1369,3,451,6203,420262424,1,0,0,954.25,7,709823.79,16,3,19,8,True
9088151,1063,0,-1,8458,420262424,1,1,0,954.03,4,709823.79,11,4,16,10,True
9273221,1428,1,30,2778,420262424,1,0,0,953.98,8,708869.81,24,0,10,10,True
9417963,1428,1,30,7493,420262424,1,0,0,953.86,8,707915.95,24,3,18,10,True
9950244,1063,0,-1,8458,420262424,1,1,0,954.08,4,707915.95,11,5,6,11,True
9982817,131,4,451,4185,420262424,1,0,0,954.03,7,706961.92,18,6,0,11,True
1084559,111,3,30,9806,179210465,0,0,0,620.96,8,248300.04,3,1,14,1,True
1200959,193,1,451,6072,179210465,0,0,0,621.18,7,247678.86,18,6,19,1,True
1220019,111,3,30,7722,179210465,0,0,0,620.96,8,247057.9,3,0,15,1,True
1262601,734,0,25,1522,179210465,0,0,0,621.04,8,246436.86,11,0,15,2,True
1305208,610,0,20,6072,179210465,0,0,0,620.95,3,245815.91,11,4,12,3,True
1553682,811,0,30,7722,179210465,0,0,0,620.94,8,245194.97,18,2,22,3,True
1928629,734,0,-1,4099,179210465,0,1,0,621.19,4,245194.97,11,4,12,5,True
2094415,201,1,10,4099,179210465,0,0,0,620.96,6,245815.93,9,4,19,6,True
2180462,811,0,-1,6929,179210465,0,1,0,620.86,1,245815.93,18,5,4,6,True
2588944,193,1,-1,5580,179210465,0,2,0,621.16,1,245815.93,18,1,10,6,True
2744759,574,2,20,6865,179210465,0,0,0,620.9,3,245195.03,11,1,2,7,True
3046797,931,0,30,4206,179210465,0,0,0,621.09,8,244573.94,24,6,20,7,False
3431655,549,1,10,7722,179210465,0,0,0,620.94,6,245194.88,17,4,3,9,True
3553050,781,1,10,9789,179210465,0,0,0,621.02,6,245815.9,14,3,2,9,True
3729411,616,1,10,1725,179210465,0,0,0,620.87,6,246436.77,11,4,14,9,True
3754675,1113,1,25,4449,179210465,0,0,0,621.29,8,245815.48,0,6,11,10,False
4131805,193,1,25,9124,179210465,0,0,0,620.92,8,245194.56,18,0,5,11,True
4406875,1113,1,-1,5409,179210465,0,1,0,621.36,4,245194.56,0,2,6,11,True
4442603,1318,0,10,7349,179210465,0,0,0,621.24,6,245815.8,18,4,19,12,True
4701625,931,0,-1,9806,179210465,0,1,0,620.88,1,245815.8,24,5,13,12,True
5055861,734,0,25,4450,179210465,0,0,0,621.34,8,245194.46,11,6,4,12,True
5332007,1113,1,25,4099,179210465,0,0,0,621.0,8,244573.46,0,0,17,1,True
5400883,1461,0,10,7077,179210465,0,0,0,620.82,6,245194.28,11,5,7,1,True
5426734,588,0,20,4304,179210465,0,0,0,621.17,5,244573.11,24,0,9,2,True
5427025,208,0,20,4314,179210465,0,0,0,620.99,5,243952.12,9,2,14,3,True
5566065,931,0,25,6865,179210465,0,0,0,621.13,8,243330.99,24,2,3,3,True
5900849,1252,4,451,6733,179210465,0,0,0,621.05,7,242709.94,23,1,0,5,True
6136481,734,0,30,9736,179210465,0,0,0,621.07,8,242088.87,11,2,17,5,True
6171002,34,1,10,9736,179210465,0,0,0,620.87,6,242709.74,11,3,22,5,True
6328590,193,1,451,7077,179210465,0,0,0,621.26,7,242088.48,18,6,11,5,True
6337592,1252,4,30,5580,179210465,0,0,0,620.95,8,241467.53,23,2,11,6,True
6982283,909,2,20,4099,179210465,0,0,0,621.3,3,240846.23,18,4,2,6,True
7033452,879,1,10,7349,179210465,0,0,0,621.01,6,241467.24,27,1,0,6,True
7341079,1380,0,20,6733,179210465,0,0,0,621.15,5,240846.09,16,3,6,7,True
7523798,811,0,25,7931,179210465,0,0,0,621.0,8,240225.09,18,2,19,8,True
7657235,1252,4,451,9124,179210465,0,0,0,620.93,7,239604.16,23,4,9,8,True
7796633,551,0,10,7349,179210465,0,0,0,621.05,6,240225.21,17,0,5,8,True
8061815,76,0,20,9806,179210465,0,0,0,620.98,5,239604.23,20,5,18,9,False
8119214,806,1,10,4449,179210465,0,0,0,620.84,6,240225.07,11,5,21,9,True
8184429,761,2,20,9124,179210465,0,0,0,620.86,5,239604.21,24,1,13,9,True
8222873,1113,1,25,1725,179210465,0,0,0,620.89,8,238983.32,0,4,17,10,True
8305083,952,0,20,9789,179210465,0,0,0,621.06,3,238362.26,13,2,1,1,True
8395135,1252,4,25,1310,179210465,0,0,0,621.14,8,237741.12,23,6,5,1,True
8409862,1323,4,25,5580,179210465,0,0,0,621.21,8,237119.91,18,2,17,1,True
8464300,1076,1,10,5409,179210465,0,0,0,621.02,6,237740.93,18,4,9,2,True
8785855,1406,0,10,6089,179210465,0,0,0,621.18,0,238362.11,24,5,22,2,True
8990913,1390,0,20,9539,179210465,0,0,0,620.94,5,237741.17,24,3,15,2,True
9111946,811,0,30,6072,179210465,0,0,0,620.95,8,237120.22,18,5,9,3,True
9174676,337,1,10,5580,179210465,0,0,0,621.15,6,237741.37,11,1,15,4,True
9289090,1113,1,-1,4206,179210465,0,1,0,620.98,1,237741.37,0,4,9,5,True
9309481,677,0,20,6733,179210465,0,0,0,620.8,3,237120.57,24,3,21,5,True
9338242,811,0,25,1310,179210465,0,0,0,620.91,8,236499.66,18,5,23,6,True
9499910,111,3,-1,7278,179210465,0,1,0,621.08,4,236499.66,3,0,4,6,True
9808626,304,0,10,6865,179210465,0,0,0,620.72,6,237120.38,4,4,4,9,True
9904244,931,0,451,9539,179210465,0,0,0,620.86,7,236499.52,24,3,10,10,True
1254563,1017,2,30,7200,741885619,1,0,0,1041.82,8,739486.18,26,6,20,1,True
1554544,180,0,-1,4555,741885619,1,1,0,1042.22,1,739486.18,18,2,7,3,True
1591964,1304,0,10,8816,741885619,1,0,0,1042.04,6,740528.22,5,0,14,3,True
1732611,180,0,30,9182,741885619,1,0,0,1042.18,8,739486.04,18,2,6,3,True
1780203,63,3,451,8816,741885619,1,0,0,1042.02,7,738444.02,20,6,16,3,True
1841080,63,3,451,1725,741885619,1,0,0,1042.13,7,737401.89,20,1,9,4,True
1846824,703,0,20,3622,741885619,1,0,0,1042.1,3,736359.79,18,3,1,4,True
1951642,1017,2,25,2512,741885619,1,0,0,1042.1,8,735317.69,26,5,18,4,True
2106011,733,3,25,4932,741885619,1,0,0,1041.97,8,734275.72,11,3,6,6,True
2176966,225,3,25,8767,741885619,1,0,0,1041.83,8,733233.89,26,4,20,6,True
2203979,180,0,-1,6543,741885619,1,1,0,1042.19,4,733233.89,18,0,20,6,True
2219296,180,0,451,7650,741885619,1,0,0,1041.9,7,732191.99,18,2,6,8,True
2413358,867,0,20,8760,741885619,1,0,0,1042.02,3,731149.97,24,5,11,9,True
2503081,225,3,25,8767,741885619,1,0,0,1042.11,8,730107.86,26,2,15,9,True
2505661,180,0,-1,6543,741885619,1,1,0,1042.04,4,730107.86,18,6,5,10,True
2581046,180,0,451,2700,741885619,1,0,0,1042.19,7,729065.67,18,0,20,10,True
2711181,1017,2,451,7003,741885619,1,0,0,1042.09,7,728023.58,26,2,13,10,True
2728510,225,3,-1,6486,741885619,1,1,0,1042.03,4,728023.58,26,1,20,10,True
2735778,1017,2,30,8281,741885619,1,0,0,1041.92,8,726981.66,26,5,16,10,True
2764756,733,3,25,1700,741885619,1,0,0,1041.85,8,725939.81,11,1,23,11,True
3355106,180,0,30,6621,741885619,1,0,0,1041.85,8,724897.96,18,2,19,12,True
3531973,180,0,30,1470,741885619,1,0,0,1041.95,8,723856.01,18,0,4,12,True
3540137,282,2,20,9242,741885619,1,0,0,1042.02,5,722813.99,24,2,15,12,True
3594711,342,0,20,9489,741885619,1,0,0,1042.22,5,721771.77,24,0,8,1,True
3757404,733,3,30,4555,741885619,1,0,0,1041.99,8,720729.78,11,6,4,1,True
3895675,1206,0,20,1335,741885619,1,0,0,1042.12,5,719687.66,24,0,10,1,True
3910912,180,0,-1,6543,741885619,1,1,0,1042.23,4,719687.66,18,5,17,4,True
4020526,1436,0,10,8693,741885619,1,0,0,1042.09,6,720729.75,24,5,15,4,True
4064473,180,0,-1,6593,741885619,1,1,0,1042.12,1,720729.75,18,5,7,5,True
4081903,225,3,-1,4932,741885619,1,2,0,1041.93,1,720729.75,26,5,21,6,True
4247761,1089,0,10,7003,741885619,1,0,0,1042.33,0,721772.08,18,1,5,6,True
4261474,733,3,25,1700,741885619,1,0,0,1041.99,8,720730.09,11,1,11,6,True
4341919,225,3,30,3622,741885619,1,0,0,1041.83,8,719688.26,26,5,8,6,True
4503997,225,3,30,1725,741885619,1,0,0,1042.06,8,718646.2,26,3,6,7,True
5386307,733,3,-1,7711,741885619,1,1,0,1041.83,1,718646.2,11,6,3,7,True
5534791,180,0,451,9182,741885619,1,0,0,1041.86,7,717604.34,18,6,18,9,True
5699417,1164,0,10,6621,741885619,1,0,0,1042.38,6,718646.72,24,3,8,10,True
6074566,180,0,-1,8281,741885619,1,1,0,1041.93,4,718646.72,18,1,15,10,True
6099996,1063,0,20,1470,741885619,1,0,0,1042.22,3,717604.5,11,4,3,12,True
6210628,1017,2,30,8291,741885619,1,0,0,1041.95,8,716562.55,26,2,3,1,True
6297444,748,1,-1,6486,741885619,1,1,0,1041.93,1,716562.55,24,4,8,1,False
6306164,733,3,30,7003,741885619,1,0,0,1041.88,8,715520.67,11,1,12,4,False
6480871,937,0,10,2505,741885619,1,0,0,1041.95,0,716562.62,24,2,7,4,True
6681343,225,3,451,7003,741885619,1,0,0,1041.99,7,715520.63,26,2,10,4,True
6898491,1017,2,-1,3372,741885619,1,1,0,1041.99,4,715520.63,26,3,22,4,True
7039016,180,0,25,1470,741885619,1,0,0,1041.39,8,714479.24,18,1,12,4,True
7857293,748,1,30,6543,741885619,1,0,0,1041.99,8,713437.25,24,1,17,5,True
7872194,733,3,30,8816,741885619,1,0,0,1041.91,8,712395.34,11,4,23,5,True
8554388,748,1,25,3622,741885619,1,0,0,1042.17,8,711353.17,24,4,1,5,True
8560105,180,0,25,7650,741885619,1,0,0,1041.98,8,710311.19,18,4,23,5,True
8607862,471,0,20,9242,741885619,1,0,0,1042.27,5,709268.92,5,5,9,8,True
8977938,59,0,20,5626,741885619,1,0,0,1041.86,5,708227.06,20,2,3,8,True
9031623,63,3,451,9242,741885619,1,0,0,1042.24,7,707184.82,20,6,21,8,True
9177927,1429,0,10,1700,741885619,1,0,0,1042.06,6,708226.88,24,6,14,9,True
9333830,950,0,20,3372,741885619,1,0,0,1042.11,5,707184.77,24,2,2,9,True
9548183,1017,2,-1,9182,741885619,1,1,0,1042.18,4,707184.77,26,0,13,10,True
9853800,403,0,10,9242,741885619,1,0,0,1042.05,0,708226.82,10,2,17,10,True
9978428,63,3,451,8693,741885619,1,0,0,1042.09,7,707184.73,20,6,9,10,True
1033452,551,0,10,9758,340716316,0,0,0,1127.83,6,670483.83,17,3,22,1,True
1057149,130,0,451,3318,340716316,0,0,0,1128.01,7,669355.82,18,3,12,3,True
1570244,1214,4,30,4662,340716316,0,0,0,1128.15,8,668227.67,24,5,7,4,True
1698191,522,0,10,5774,340716316,0,0,0,1127.84,6,669355.51,18,1,21,6,True
1943751,452,4,451,2276,340716316,0,0,0,1128.18,7,668227.33,13,5,10,7,True
2212641,452,4,451,1824,340716316,0,0,0,1128.0,7,667099.33,13,5,17,8,True
2346732,966,4,451,8526,340716316,0,0,0,1127.93,7,665971.4,13,6,6,8,True
2496302,130,0,451,6082,340716316,0,0,0,1127.95,7,664843.45,18,1,2,8,True
2514593,1214,4,451,5695,340716316,0,0,0,1127.85,7,663715.6,24,1,14,8,True
2595221,452,4,25,1051,340716316,0,0,0,1127.63,8,662587.97,13,4,13,8,True
2789392,907,0,20,1051,340716316,0,0,0,1128.04,5,661459.93,2,2,22,8,True
2789692,1181,2,20,4593,340716316,0,0,0,1128.07,5,660331.86,24,3,2,9,True
2839467,885,3,451,9758,340716316,0,0,0,1127.98,7,659203.88,24,2,6,9,True
2990468,802,2,20,7759,340716316,0,0,0,1128.16,5,658075.72,11,3,1,9,True
3381813,130,0,25,7335,340716316,0,0,0,1127.88,8,656947.84,18,3,14,9,True
3599052,554,4,30,3348,340716316,0,0,0,1128.12,8,655819.72,17,6,20,10,True
3762505,554,4,30,4084,340716316,0,0,0,1128.02,8,654691.7,17,6,5,10,True
3792533,51,0,20,2539,340716316,0,0,0,1128.18,3,653563.52,20,0,14,10,True
4023283,554,4,25,3318,340716316,0,0,0,1128.08,8,652435.44,17,4,8,10,True
4073760,917,0,10,2631,340716316,0,0,0,1127.8,0,653563.24,18,2,7,11,True
4084300,1214,4,451,1087,340716316,0,0,0,1128.08,7,652435.16,24,1,5,1,True
4125646,885,3,-1,9381,340716316,0,1,0,1128.03,4,652435.16,24,6,22,2,True
4395565,1105,2,20,1051,340716316,0,0,0,1128.02,3,651307.14,0,4,19,2,True
4446357,1214,4,25,7759,340716316,0,0,0,1127.81,8,650179.33,24,0,1,7,True
4610769,966,4,451,6082,340716316,0,0,0,1127.86,7,649051.47,13,3,2,7,True
4675432,554,4,451,2261,340716316,0,0,0,1128.11,7,647923.36,17,4,21,7,True
4853128,1214,4,451,4487,340716316,0,0,0,1127.83,7,646795.53,24,6,9,7,True
5060482,359,2,20,8526,340716316,0,0,0,1128.02,3,645667.51,24,4,12,8,True
5181218,554,4,25,9882,340716316,0,0,0,1127.92,8,644539.59,17,6,9,8,True
5313112,452,4,-1,3318,340716316,0,1,0,1128.08,4,644539.59,13,5,22,8,True
5435954,554,4,451,2261,340716316,0,0,0,1128.34,7,643411.25,17,2,13,9,True
5683029,1214,4,451,4487,340716316,0,0,0,1128.01,7,642283.24,24,3,19,9,True
5890234,130,0,-1,2631,340716316,0,1,0,1127.85,1,642283.24,18,5,13,9,True
6082911,554,4,30,5774,340716316,0,0,0,1127.98,8,641155.26,17,6,15,11,True
6380810,712,0,10,1393,340716316,0,0,0,1127.86,6,642283.12,18,5,18,11,True
6604807,452,4,451,5391,340716316,0,0,0,1128.11,7,641155.01,13,6,23,11,True
6882202,300,0,10,7759,340716316,0,0,0,1128.03,0,642283.04,4,3,23,11,True
7539522,834,0,10,3318,340716316,0,0,0,1128.03,6,643411.07,5,6,0,12,True
7635419,1214,4,-1,3348,340716316,0,1,0,1127.88,4,643411.07,24,0,14,12,False
7728108,554,4,30,9932,340716316,0,0,0,1128.04,8,642283.03,17,1,9,12,True
7793556,966,4,451,4487,340716316,0,0,0,1127.75,7,641155.28,13,1,19,12,True
8002397,966,4,451,3318,340716316,0,0,0,1128.14,7,640027.14,13,3,20,1,True
8178817,404,1,10,4487,340716316,0,0,0,1127.64,0,641154.78,10,3,8,1,True
8237546,239,1,10,4325,340716316,0,0,0,1127.96,0,642282.74,26,0,14,2,True
8275976,1214,4,25,4735,340716316,0,0,0,1128.12,8,641154.62,24,5,21,2,True
8468524,130,0,30,3318,340716316,0,0,0,1127.87,8,640026.75,18,4,9,2,True
8514942,1214,4,451,4084,340716316,0,0,0,1127.99,7,638898.76,24,4,10,3,True
8545520,1288,0,10,4662,340716316,0,0,0,1127.92,0,640026.68,24,6,2,3,True
8902845,713,0,10,1061,340716316,0,0,0,1127.72,6,641154.4,18,2,0,5,True
9029563,554,4,25,1824,340716316,0,0,0,1128.12,8,640026.28,17,6,5,5,True
9358030,130,0,30,4325,340716316,0,0,0,1127.73,8,638898.55,18,3,13,6,True
9677458,1399,0,20,1061,340716316,0,0,0,1128.12,3,637770.43,24,4,1,6,True
9690004,966,4,451,4735,340716316,0,0,0,1127.89,7,636642.54,13,3,18,8,True
9725124,1214,4,25,2631,340716316,0,0,0,1128.13,8,635514.41,24,2,20,10,True
9749237,130,0,451,9932,340716316,0,0,0,1128.26,7,634386.15,18,5,0,10,True
9832941,885,3,25,2276,340716316,0,0,0,1128.07,8,633258.08,24,2,20,11,True
1125804,365,0,30,7143,770678867,1,0,0,974.97,8,847695.03,25,4,14,1,True
1302128,466,4,25,9477,770678867,1,0,0,975.13,8,846719.9,13,6,9,1,True
1608260,652,0,20,6677,770678867,1,0,0,975.0,3,845744.9,24,0,21,2,True
1656851,989,1,10,7143,770678867,1,0,0,974.81,6,846719.71,22,4,12,2,True
1666832,365,0,30,3169,770678867,1,0,0,974.73,8,845744.98,25,4,22,3,True
1705136,205,0,10,6176,770678867,1,0,0,974.65,0,846719.63,9,2,9,3,True
1748994,326,4,30,7835,770678867,1,0,0,974.93,8,845744.7,11,2,5,5,True
1981262,365,0,-1,5085,770678867,1,1,0,975.13,1,845744.7,25,3,14,5,True
1991095,533,2,-1,7143,770678867,1,2,0,975.07,4,845744.7,18,1,13,6,True
2094064,747,1,10,5416,770678867,1,0,0,975.07,6,846719.77,24,0,1,7,True
2140437,466,4,25,6600,770678867,1,0,0,975.1,8,845744.67,13,2,2,8,True
2500321,632,4,-1,5085,770678867,1,1,0,975.02,4,845744.67,11,5,21,8,True
2737454,632,4,25,6176,770678867,1,0,0,974.92,8,844769.75,11,4,7,8,True
2821874,1009,0,20,7143,770678867,1,0,0,974.95,5,843794.8,26,6,7,8,True
2992762,702,4,30,5416,770678867,1,0,0,975.02,8,842819.78,18,4,14,8,True
3224206,466,4,25,5416,770678867,1,0,0,974.82,8,841844.96,13,0,5,8,True
3333788,249,0,20,9864,770678867,1,0,0,974.99,3,840869.97,6,3,9,9,True
4301333,326,4,451,9477,770678867,1,0,0,975.25,7,839894.72,11,4,22,9,True
4398829,1075,0,451,7116,770678867,1,0,0,975.02,7,838919.7,18,5,13,10,True
4504295,632,4,30,6600,770678867,1,0,0,975.02,8,837944.68,11,5,7,10,True
4621147,1041,0,20,5085,770678867,1,0,0,975.05,5,836969.63,11,1,2,11,True
4803595,1391,2,20,7143,770678867,1,0,0,975.02,5,835994.61,24,4,17,12,True
4829968,632,4,451,8119,770678867,1,0,0,974.87,7,835019.74,11,4,18,12,True
4921442,1382,0,20,8460,770678867,1,0,0,975.37,3,834044.37,16,0,13,1,True
4921517,25,3,25,7835,770678867,1,0,0,975.21,8,833069.16,11,0,4,1,True
5050164,702,4,30,8460,770678867,1,0,0,975.1,8,832094.06,18,0,4,1,True
5434126,702,4,25,8699,770678867,1,0,0,975.19,8,831118.87,18,1,10,2,True
5859233,533,2,25,6677,770678867,1,0,0,975.05,8,830143.82,18,4,4,2,True
5963724,326,4,25,8119,770678867,1,0,0,974.92,8,829168.9,11,5,1,2,True
5964747,1075,0,451,5416,770678867,1,0,0,975.04,7,828193.86,18,5,9,3,True
5979806,292,1,10,6600,770678867,1,0,0,974.98,0,829168.84,4,0,15,3,True
6023402,365,0,451,5085,770678867,1,0,0,975.07,7,828193.77,25,2,0,3,True
6026338,466,4,30,8699,770678867,1,0,0,975.0,8,827218.77,13,6,3,4,True
6039945,522,0,20,7116,770678867,1,0,0,974.86,5,826243.91,18,6,21,5,True
6077477,365,0,25,9477,770678867,1,0,0,974.82,8,825269.09,25,4,19,5,True
6106291,326,4,30,9477,770678867,1,0,0,974.9,8,824294.19,11,2,11,5,True
6108068,1075,0,451,9477,770678867,1,0,0,975.03,7,823319.16,18,1,2,6,True
6181156,1075,0,451,3349,770678867,1,0,0,974.7,7,822344.46,18,4,7,6,True
6266413,25,3,451,3349,770678867,1,0,0,975.28,7,821369.18,11,3,15,8,True
6272104,1303,0,10,7835,770678867,1,0,0,975.22,6,822344.4,5,2,7,9,True
6311989,1075,0,451,8699,770678867,1,0,0,974.78,7,821369.62,18,4,7,10,True
6667347,533,2,30,5416,770678867,1,0,0,975.03,8,820394.59,18,1,17,1,True
6885438,466,4,25,5085,770678867,1,0,0,974.98,8,819419.61,13,2,4,1,True
7033749,466,4,25,9864,770678867,1,0,0,974.94,8,818444.67,13,6,3,2,True
7496379,607,2,20,8460,770678867,1,0,0,974.87,5,817469.8,24,1,9,2,True
7618432,702,4,25,7835,770678867,1,0,0,974.86,8,816494.94,18,2,2,2,True
8215848,25,3,25,3169,770678867,1,0,0,974.96,8,815519.98,11,6,17,3,True
8249722,1156,1,10,9477,770678867,1,0,0,975.06,6,816495.04,15,2,6,7,True
8286266,533,2,451,7835,770678867,1,0,0,974.92,7,815520.12,18,4,17,8,True
8304281,1101,2,20,6600,770678867,1,0,0,974.97,5,814545.15,0,5,15,8,True
8355985,1111,0,20,5416,770678867,1,0,0,975.12,5,813570.03,0,3,5,10,True
8798528,326,4,-1,9864,770678867,1,1,0,974.89,4,813570.03,11,4,21,10,True
9230201,96,0,20,5085,770678867,1,0,0,974.88,3,812595.15,1,5,12,10,True
9363171,632,4,30,3349,770678867,1,0,0,975.23,8,811619.92,11,6,9,10,True
9442581,304,0,10,8699,770678867,1,0,0,975.04,6,812594.96,4,1,22,10,True
9973151,632,4,30,7835,770678867,1,0,0,975.08,8,811619.88,11,3,22,10,True
1266774,420,4,451,9229,599163838,1,0,0,1064.86,7,447049.14,18,5,10,2,True
1292473,1416,4,451,1308,599163838,1,0,0,1064.94,7,445984.2,24,1,2,3,True
1410795,1493,4,451,7120,599163838,1,0,0,1064.78,7,444919.42,24,4,19,4,True
1537330,114,0,10,7497,599163838,1,0,0,1064.91,6,445984.33,3,5,9,4,True
1603701,1247,0,451,2982,599163838,1,0,0,1065.02,7,444919.31,23,5,15,4,True
1643242,1272,0,451,7295,599163838,1,0,0,1064.8,7,443854.51,24,2,20,4,True
1724533,1247,0,30,5607,599163838,1,0,0,1065.03,8,442789.48,23,2,6,5,True
1871693,63,3,30,7295,599163838,1,0,0,1064.96,8,441724.52,20,2,22,7,True
1951513,914,2,451,5607,599163838,1,0,0,1065.07,7,440659.45,18,3,22,7,True
2204596,63,3,451,1280,599163838,1,0,0,1065.09,7,439594.36,20,1,10,8,True
2211607,1272,0,30,7497,599163838,1,0,0,1065.14,8,438529.22,24,0,2,9,True
2290592,1272,0,30,8916,599163838,1,0,0,1065.14,8,437464.08,24,5,1,11,True
2538306,538,0,-1,1308,599163838,1,1,0,1065.23,4,437464.08,18,4,6,1,True
2613332,420,4,451,7300,599163838,1,0,0,1065.13,7,436398.95,18,6,3,1,True
2647053,1312,0,10,2982,599163838,1,0,0,1065.03,6,437463.98,5,1,17,2,True
2757476,945,1,10,7300,599163838,1,0,0,1065.05,6,438529.03,24,1,4,2,True
2979724,1247,0,451,6941,599163838,1,0,0,1065.34,7,437463.69,23,3,13,3,False
3031515,665,2,20,8916,599163838,1,0,0,1065.04,5,436398.65,18,4,0,3,True
3093812,1416,4,30,1137,599163838,1,0,0,1064.82,8,435333.83,24,6,18,3,True
3136202,346,0,20,5394,599163838,1,0,0,1064.8,5,434269.03,24,3,11,3,True
3415055,420,4,-1,8923,599163838,1,1,0,1065.06,4,434269.03,18,5,4,3,True
3619186,1272,0,451,6941,599163838,1,0,0,1065.27,7,433203.76,24,1,17,5,True
3854466,1493,4,451,6043,599163838,1,0,0,1064.96,7,432138.8,24,2,14,5,True
3915732,538,0,30,1137,599163838,1,0,0,1064.84,8,431073.96,18,2,3,5,True
4370763,1416,4,30,1317,599163838,1,0,0,1065.09,8,430008.87,24,2,13,6,True
4558987,1416,4,451,7497,599163838,1,0,0,1065.19,7,428943.68,24,3,18,6,True
4565588,914,2,30,9229,599163838,1,0,0,1064.84,8,427878.84,18,5,20,6,True
4825958,145,0,10,5536,599163838,1,0,0,1065.06,6,428943.9,18,0,5,6,True
5184406,1416,4,451,8916,599163838,1,0,0,1064.9,7,427879.0,24,6,20,6,True
5228616,406,1,10,6442,599163838,1,0,0,1065.0,0,428944.0,10,2,11,7,True
5268990,63,3,30,2982,599163838,1,0,0,1065.06,8,427878.94,20,5,17,7,True
5358410,1416,4,451,6033,599163838,1,0,0,1065.01,7,426813.93,24,4,6,7,True
5660505,1205,0,10,1280,599163838,1,0,0,1064.91,0,427878.84,24,2,3,8,True
5737301,914,2,25,8923,599163838,1,0,0,1064.76,8,426814.08,18,4,20,8,True
5785435,1493,4,-1,7295,599163838,1,1,0,1065.13,1,426814.08,24,2,23,9,True
5810608,1493,4,25,6043,599163838,1,0,0,1064.9,8,425749.18,24,6,16,10,False
5876504,531,0,10,9229,599163838,1,0,0,1064.97,6,426814.15,18,4,4,10,True
5983084,1105,2,20,9229,599163838,1,0,0,1065.01,3,425749.14,0,1,1,10,True
6062783,1272,0,451,7120,599163838,1,0,0,1065.12,7,424684.02,24,5,18,11,True
6380947,1493,4,451,6033,599163838,1,0,0,1064.63,7,423619.39,24,1,3,11,True
6859881,1272,0,451,8923,599163838,1,0,0,1065.05,7,422554.34,24,2,10,11,True
6867662,538,0,451,6442,599163838,1,0,0,1065.14,7,421489.2,18,1,2,12,True
6906712,420,4,-1,6442,599163838,1,1,0,1065.13,4,421489.2,18,5,7,1,True
7158645,1192,2,20,6941,599163838,1,0,0,1064.88,5,420424.32,24,5,0,1,True
7197594,538,0,-1,7300,599163838,1,1,0,1064.92,4,420424.32,18,6,16,1,True
7222508,160,0,20,8923,599163838,1,0,0,1064.87,3,419359.45,24,1,0,1,True
7460067,309,0,20,5394,599163838,1,0,0,1064.96,3,418294.49,4,6,10,2,True
7714584,538,0,25,1280,599163838,1,0,0,1064.87,8,417229.62,18,1,2,3,True
8085203,1272,0,30,6033,599163838,1,0,0,1064.86,8,416164.76,24,3,4,3,True
8141719,1272,0,30,5607,599163838,1,0,0,1065.04,8,415099.72,24,1,15,5,True
8298187,538,0,25,5536,599163838,1,0,0,1064.93,8,414034.79,18,1,23,7,True
8331622,1493,4,451,1317,599163838,1,0,0,1065.15,7,412969.64,24,6,0,8,True
8637507,420,4,-1,2982,599163838,1,1,0,1065.07,1,412969.64,18,5,3,8,True
8768932,1493,4,25,5607,599163838,1,0,0,1064.67,8,411904.97,24,3,5,8,True
8842952,574,2,20,3115,599163838,1,0,0,1064.85,5,410840.12,11,2,1,9,False
9028302,1416,4,25,1308,599163838,1,0,0,1065.02,8,409775.1,24,3,20,9,True
9218337,568,1,10,5536,599163838,1,0,0,1065.12,0,410840.22,11,6,3,9,True
9333855,1421,0,20,8923,599163838,1,0,0,1064.83,5,409775.39,24,6,20,11,True
1357499,240,4,451,6433,377896811,0,0,0,761.01,7,501189.99,26,0,1,2,True
1547255,713,0,10,8746,377896811,0,0,0,761.03,6,501951.02,18,3,17,3,True
1601522,240,4,-1,6222,377896811,0,1,0,761.05,4,501951.02,26,6,10,3,True
1606503,448,0,20,1282,377896811,0,0,0,760.69,3,501190.33,13,1,8,3,True
1783918,240,4,-1,7992,377896811,0,1,0,761.02,4,501190.33,26,5,18,4,True
2220846,1325,0,10,3665,377896811,0,0,0,760.83,6,501951.16,18,6,19,5,True
2291881,319,0,10,7992,377896811,0,0,0,761.1,6,502712.26,11,0,23,5,True
2882028,385,1,10,7326,377896811,0,0,0,760.89,6,503473.15,25,2,2,5,True
3043140,64,0,20,5528,377896811,0,0,0,761.02,5,502712.13,20,4,17,5,True
3044073,1014,1,10,9562,377896811,0,0,0,761.14,6,503473.27,26,5,4,7,True
3068917,240,4,25,1282,377896811,0,0,0,761.0,8,502712.27,26,6,3,8,True
3519362,982,4,451,2902,377896811,0,0,0,760.84,7,501951.43,22,1,19,8,True
3585429,982,4,25,9516,377896811,0,0,0,760.92,8,501190.51,22,6,10,9,True
3684544,769,3,25,7482,377896811,0,0,0,760.91,8,500429.6,14,5,8,9,True
3869692,982,4,25,2285,377896811,0,0,0,761.07,8,499668.53,22,6,13,10,True
3953498,769,3,-1,9516,377896811,0,1,0,761.1,4,499668.53,14,5,12,12,True
4498511,769,3,25,3947,377896811,0,0,0,760.95,8,498907.58,14,6,10,12,True
4533337,1270,1,451,7544,377896811,0,0,0,760.84,7,498146.74,23,3,14,12,True
4743235,950,0,20,2008,377896811,0,0,0,761.04,5,497385.7,24,0,4,1,True
4846785,1270,1,451,3947,377896811,0,0,0,760.68,7,496625.02,23,3,19,2,True
4850459,734,0,20,1533,377896811,0,0,0,761.23,3,495863.79,11,1,21,3,True
4881793,982,4,25,3947,377896811,0,0,0,760.81,8,495102.98,22,2,8,4,True
5019508,769,3,25,6222,377896811,0,0,0,761.08,8,494341.9,14,5,5,6,True
5559109,1270,1,-1,2902,377896811,0,1,0,761.01,4,494341.9,23,0,10,8,True
5610266,769,3,30,4441,377896811,0,0,0,760.96,8,493580.94,14,1,5,8,True
5733715,240,4,451,1282,377896811,0,0,0,760.96,7,492819.98,26,2,2,9,True
5742100,1270,1,25,7482,377896811,0,0,0,760.9,8,492059.08,23,2,18,9,True
5771891,240,4,451,1282,377896811,0,0,0,760.99,7,491298.09,26,2,17,9,True
6451328,240,4,451,7482,377896811,0,0,0,761.01,7,490537.08,26,6,10,9,True
6581670,982,4,451,4441,377896811,0,0,0,761.01,7,489776.07,22,6,17,11,True
6630179,1412,2,25,6150,377896811,0,0,0,760.96,8,489015.11,24,0,11,12,True
6702042,1412,2,-1,3636,377896811,0,1,0,760.61,1,489015.11,24,0,16,12,True
6761151,240,4,25,7326,377896811,0,0,0,761.02,8,488254.09,26,2,17,12,True
7024473,240,4,-1,5528,377896811,0,1,0,761.21,4,488254.09,26,5,3,1,True
7128342,584,0,20,1533,377896811,0,0,0,760.76,5,487493.33,11,4,1,1,True
7216786,982,4,451,1533,377896811,0,0,0,761.02,7,486732.31,22,5,12,2,True
7305440,769,3,30,2902,377896811,0,0,0,760.86,8,485971.45,14,3,0,2,True
7311006,982,4,30,6078,377896811,0,0,0,761.09,8,485210.36,22,3,5,2,True
7678544,266,2,20,2176,377896811,0,0,0,760.8,5,484449.56,6,3,21,3,True
7731676,982,4,25,6078,377896811,0,0,0,761.3,8,483688.26,22,6,15,3,True
7743142,1412,2,30,7482,377896811,0,0,0,760.83,8,482927.43,24,2,14,4,True
7767300,1412,2,-1,1533,377896811,0,1,0,761.26,1,482927.43,24,1,20,4,True
7889137,240,4,451,3947,377896811,0,0,0,761.05,7,482166.38,26,1,10,4,True
8075243,1412,2,-1,3947,377896811,0,1,0,761.05,4,482166.38,24,4,5,5,True
8768206,679,0,10,2848,377896811,0,0,0,760.73,6,482927.11,24,4,12,6,True
8784272,769,3,451,3636,377896811,0,0,0,761.24,7,482165.87,14,5,22,7,True
8893234,240,4,25,6222,377896811,0,0,0,761.02,8,481404.85,26,4,21,8,True
8978052,982,4,451,5528,377896811,0,0,0,761.3,7,480643.55,22,0,17,8,True
9057690,1412,2,25,9562,377896811,0,0,0,761.03,8,479882.52,24,6,15,9,True
9196532,769,3,30,3947,377896811,0,0,0,760.96,8,479121.56,14,2,9,9,True
9651414,769,3,30,2176,377896811,0,0,0,761.02,8,478360.54,14,0,15,10,True
9848255,982,4,451,1533,377896811,0,0,0,760.9,7,477599.64,22,0,6,10,True
9888141,1060,1,10,2285,377896811,0,0,0,761.11,6,478360.75,11,1,15,11,True
1410540,319,0,10,8511,918362177,0,0,0,500.92,6,407972.92,11,3,2,2,True
1551703,1119,0,451,3440,918362177,0,0,0,501.19,7,407471.73,24,5,23,3,True
1736515,1320,3,30,7720,918362177,0,0,0,501.25,8,406970.48,18,1,1,4,True
1750366,464,1,10,5746,918362177,0,0,0,501.24,6,407471.72,13,5,16,4,True
1753868,132,2,451,7720,918362177,0,0,0,500.75,7,406970.97,18,4,4,5,True
1844225,1320,3,451,6182,918362177,0,0,0,501.0,7,406469.97,18,4,0,5,True
1907550,132,2,451,8511,918362177,0,0,0,501.01,7,405968.96,18,0,6,5,True
2109883,995,1,10,8511,918362177,0,0,0,500.87,0,406469.83,22,4,15,5,True
2124966,366,0,20,3559,918362177,0,0,0,500.59,5,405969.24,25,3,17,6,True
2310306,1183,4,25,8355,918362177,0,0,0,500.83,8,405468.41,24,2,9,6,True
3267757,1320,3,451,1668,918362177,0,0,0,501.18,7,404967.23,18,6,22,7,True
3335341,98,0,10,5817,918362177,0,0,0,500.72,6,405467.95,3,3,0,7,True
3336384,618,3,451,7720,918362177,0,0,0,501.22,7,404966.73,11,3,22,11,True
3688717,160,0,451,2891,918362177,0,0,0,500.78,7,404465.95,24,0,11,11,True
3805105,618,3,30,2098,918362177,0,0,0,501.17,8,403964.78,11,4,12,12,True
3850229,1119,0,30,6182,918362177,0,0,0,500.96,8,403463.82,24,1,0,12,True
3933334,254,0,20,9110,918362177,0,0,0,500.78,5,402963.04,6,4,4,12,True
4202686,1114,1,10,2098,918362177,0,0,0,501.15,6,403464.19,0,1,15,1,True
4286981,1183,4,451,2098,918362177,0,0,0,501.08,7,402963.11,24,6,19,2,True
4562124,1164,0,20,8355,918362177,0,0,0,500.97,3,402462.14,24,3,21,2,True
5340921,1183,4,451,8355,918362177,0,0,0,501.16,7,401960.98,24,1,3,3,True
5497009,1119,0,30,7720,918362177,0,0,0,501.29,8,401459.69,24,2,16,3,True
5525481,1186,2,20,7720,918362177,0,0,0,501.12,5,400958.57,24,6,15,4,True
5535024,160,0,30,7173,918362177,0,0,0,501.05,8,400457.52,24,3,11,6,True
5984327,130,0,10,2098,918362177,0,0,0,500.67,6,400958.19,18,0,23,8,False
6138185,1320,3,-1,7720,918362177,0,1,0,501.32,4,400958.19,18,0,1,9,False
6353774,1012,0,10,6182,918362177,0,0,0,500.77,6,401458.96,26,6,10,9,True
6536814,588,0,10,6182,918362177,0,0,0,500.87,0,401959.83,24,3,5,10,True
6965110,1112,1,451,8355,918362177,0,0,0,501.13,7,401458.7,0,2,22,11,True
7184103,1119,0,-1,9550,918362177,0,1,0,500.96,1,401458.7,24,3,21,11,True
7266955,160,0,30,8221,918362177,0,0,0,501.06,8,400957.64,24,6,20,12,True
7413283,1150,0,10,3440,918362177,0,0,0,501.21,6,401458.85,15,3,7,12,True
7878928,1320,3,-1,9550,918362177,0,1,0,500.97,4,401458.85,18,5,6,12,True
8078514,1183,4,451,2891,918362177,0,0,0,501.05,7,400957.8,24,6,10,1,True
8203303,1119,0,30,1914,918362177,0,0,0,500.87,8,400456.93,24,6,13,2,True
8323918,1119,0,-1,1668,918362177,0,1,0,501.31,4,400456.93,24,1,10,2,True
8334075,132,2,451,8511,918362177,0,0,0,501.09,7,399955.84,18,6,15,2,True
8533344,160,0,25,3559,918362177,0,0,0,500.84,8,399455.0,24,5,7,3,True
8557789,618,3,25,9550,918362177,0,0,0,500.71,8,398954.29,11,3,6,4,True
8586507,222,2,20,8221,918362177,0,0,0,500.93,5,398453.36,26,6,22,5,True
8606506,1314,2,20,3440,918362177,0,0,0,501.29,3,397952.07,5,2,0,5,True
8878732,1119,0,451,3440,918362177,0,0,0,501.17,7,397450.9,24,2,0,6,True
9110175,160,0,451,9110,918362177,0,0,0,501.08,7,396949.82,24,2,23,6,True
9231135,618,3,451,7173,918362177,0,0,0,501.23,7,396448.59,11,5,8,6,True
9266661,522,0,10,5746,918362177,0,0,0,501.16,6,396949.75,18,1,10,7,True
9361695,175,3,451,3440,918362177,0,0,0,500.77,7,396448.98,24,2,5,8,False
9480316,1320,3,25,9550,918362177,0,0,0,501.18,8,395947.8,18,4,23,9,False
9826600,160,0,451,3440,918362177,0,0,0,500.93,7,395446.87,24,4,20,10,True
9924451,1320,3,-1,2891,918362177,0,1,0,501.15,4,395446.87,18,5,15,10,True
9970149,160,0,451,3559,918362177,0,0,0,500.92,7,394945.95,24,3,19,11,True
9990591,160,0,-1,8221,918362177,0,1,0,501.18,4,394945.95,24,5,1,11,True
1834516,535,0,20,7058,749599882,1,0,0,658.89,3,72124.11,18,6,23,1,True
1996238,115,2,451,7956,749599882,1,0,0,659.18,7,71464.93,3,0,4,1,True
2044941,1325,0,10,9101,749599882,1,0,0,659.35,0,72124.28,18,4,16,1,True
2174635,693,4,30,8161,749599882,1,0,0,659.08,8,71465.2,24,3,16,1,True
2366698,1233,0,10,4663,749599882,1,0,0,659.15,0,72124.35,18,5,5,2,True
2450091,318,0,-1,9588,749599882,1,1,0,658.95,4,72124.35,11,6,11,2,False
2493968,376,0,25,7975,749599882,1,0,0,659.0,8,71465.35,25,1,19,3,True
2662239,298,4,-1,4663,749599882,1,1,0,659.01,1,71465.35,4,4,20,4,True
2674913,115,2,30,7845,749599882,1,0,0,659.29,8,70806.06,3,3,4,6,True
2907434,376,0,25,7020,749599882,1,0,0,658.95,8,70147.11,25,3,4,6,True
3088456,1424,4,25,1646,749599882,1,0,0,659.22,8,69487.89,24,4,6,7,True
3697462,767,0,20,4663,749599882,1,0,0,658.95,5,68828.94,14,2,6,8,True
3881082,115,2,-1,2020,749599882,1,1,0,659.03,4,68828.94,3,2,18,8,True
4206147,747,1,451,5421,749599882,1,0,0,658.95,7,68169.99,24,5,16,9,True
4294898,504,4,30,7817,749599882,1,0,0,659.02,8,67510.97,12,2,14,9,True
4433093,747,1,30,2000,749599882,1,0,0,658.71,8,66852.26,24,2,10,12,True
4615773,1424,4,30,3570,749599882,1,0,0,658.92,8,66193.34,24,0,18,12,True
4908971,747,1,30,1933,749599882,1,0,0,659.0,8,65534.34,24,6,9,1,True
5014718,298,4,30,7845,749599882,1,0,0,659.14,8,64875.2,4,2,14,1,True
5069035,476,1,451,3570,749599882,1,0,0,659.08,7,64216.12,5,6,1,1,True
5219014,747,1,30,1933,749599882,1,0,0,659.18,8,63556.94,24,3,16,2,True
5264255,376,0,30,8161,749599882,1,0,0,658.81,8,62898.13,25,3,17,2,True
5298414,476,1,451,6738,749599882,1,0,0,658.93,7,62239.2,5,3,14,2,True
5533898,504,4,451,1933,749599882,1,0,0,658.88,7,61580.32,12,3,4,3,True
5551327,1065,0,10,4343,749599882,1,0,0,659.05,6,62239.37,11,0,22,3,True
5746116,318,0,25,7817,749599882,1,0,0,658.86,8,61580.51,11,0,4,4,True
5857567,693,4,-1,2020,749599882,1,1,0,659.09,4,61580.51,24,0,13,4,True
5878197,318,0,-1,1646,749599882,1,2,0,658.73,1,61580.51,11,6,17,6,True
6532109,1238,0,20,3570,749599882,1,0,0,658.9,5,60921.61,18,5,5,7,True
6545378,693,4,-1,7975,749599882,1,1,0,659.05,4,60921.61,24,3,22,7,True
6775805,115,2,-1,2020,749599882,1,2,0,659.03,4,60921.61,3,4,1,8,False
6967593,1206,0,10,9101,749599882,1,0,0,658.75,0,61580.36,24,1,3,10,True
7198353,476,1,25,4755,749599882,1,0,0,658.99,8,60921.37,5,1,12,11,True
7217117,715,0,20,8431,749599882,1,0,0,659.22,5,60262.15,18,0,19,1,True
7324958,298,4,451,6738,749599882,1,0,0,659.05,7,59603.1,4,5,22,1,True
7425376,148,1,10,3570,749599882,1,0,0,659.05,0,60262.15,18,3,17,1,False
7635832,198,0,10,1933,749599882,1,0,0,659.2,6,60921.35,18,5,13,2,True
7820559,1132,0,10,7817,749599882,1,0,0,658.71,0,61580.06,24,4,23,4,True
7899811,476,1,30,8431,749599882,1,0,0,658.94,8,60921.12,5,0,12,4,True
8127035,504,4,30,1933,749599882,1,0,0,658.98,8,60262.14,12,6,5,4,True
8198171,278,1,10,3423,749599882,1,0,0,659.01,6,60921.15,24,6,12,5,True
8343010,298,4,30,7956,749599882,1,0,0,659.01,8,60262.14,4,2,7,5,True
8854965,218,0,10,7058,749599882,1,0,0,658.93,0,60921.07,9,1,11,5,True
9020859,588,0,20,7845,749599882,1,0,0,658.76,5,60262.31,24,3,16,5,True
9249118,465,0,10,7817,749599882,1,0,0,659.06,6,60921.37,13,6,16,7,True
9297062,1015,0,20,4544,749599882,1,0,0,658.66,5,60262.71,26,4,8,7,True
9377536,649,0,20,2000,749599882,1,0,0,659.16,3,59603.55,24,1,20,7,True
9455456,376,0,451,7020,749599882,1,0,0,659.2,7,58944.35,25,2,23,7,True
9595784,249,0,10,2000,749599882,1,0,0,659.33,6,59603.68,6,6,8,9,True
9620810,208,0,10,2020,749599882,1,0,0,658.92,0,60262.6,9,2,2,9,True
9689900,115,2,30,4755,749599882,1,0,0,659.08,8,59603.52,3,6,18,10,True
9739678,800,0,10,3570,749599882,1,0,0,658.96,6,60262.48,11,1,14,10,True
1286222,282,2,20,6579,565761454,0,0,0,163.98,3,137258.02,24,0,20,1,True
1418185,1212,0,10,1338,565761454,0,0,0,163.95,6,137421.97,24,3,4,1,True
1663247,572,0,-1,2278,565761454,0,1,0,163.99,1,137421.97,11,3,19,2,True
1862305,847,3,451,3402,565761454,0,0,0,163.82,7,137258.15,5,4,17,3,True
1864673,650,3,25,6186,565761454,0,0,0,164.25,8,137093.9,24,5,10,3,True
1912965,1186,2,451,2096,565761454,0,0,0,164.11,7,136929.79,24,6,4,3,True
2176668,847,3,25,8367,565761454,0,0,0,164.2,8,136765.59,5,4,21,4,True
2342810,748,1,10,6965,565761454,0,0,0,164.12,0,136929.71,24,1,6,5,True
2398421,650,3,-1,7699,565761454,0,1,0,164.07,1,136929.71,24,6,2,6,True
2437669,847,3,451,2677,565761454,0,0,0,163.97,7,136765.74,5,1,2,6,True
2780417,96,0,10,2677,565761454,0,0,0,163.95,6,136929.69,1,2,8,6,True
2818599,818,1,10,6319,565761454,0,0,0,163.88,0,137093.57,18,6,6,7,False
2971911,650,3,451,2769,565761454,0,0,0,164.02,7,136929.55,24,2,7,7,True
3023969,847,3,-1,2768,565761454,0,1,0,164.06,4,136929.55,5,1,7,8,True
3093886,991,1,10,9736,565761454,0,0,0,163.85,6,137093.4,22,2,18,10,True
3106394,1062,3,-1,4107,565761454,0,1,0,163.99,4,137093.4,11,6,13,10,True
3279474,1062,3,451,6319,565761454,0,0,0,163.94,7,136929.46,11,5,8,11,True
3443399,847,3,25,1338,565761454,0,0,0,164.12,8,136765.34,5,2,17,11,True
3449892,1237,4,451,2769,565761454,0,0,0,164.1,7,136601.24,18,2,7,11,True
3563420,1237,4,451,2768,565761454,0,0,0,163.86,7,136437.38,18,2,10,12,True
3706343,1455,2,20,5773,565761454,0,0,0,163.82,5,136273.56,11,2,16,12,True
3802393,1186,2,30,2677,565761454,0,0,0,164.09,8,136109.47,24,5,17,1,True
3824531,1062,3,30,6186,565761454,0,0,0,164.22,8,135945.25,11,3,4,2,True
3881165,847,3,-1,9736,565761454,0,1,0,164.15,4,135945.25,5,3,16,2,True
3916142,572,0,451,3402,565761454,0,0,0,163.82,7,135781.43,11,2,2,2,True
4164304,939,0,20,2768,565761454,0,0,0,163.91,3,135617.52,24,1,6,3,True
4250709,1186,2,25,1338,565761454,0,0,0,163.98,8,135453.54,24,4,3,4,True
4462736,847,3,451,8367,565761454,0,0,0,164.14,7,135289.4,5,2,9,4,True
4749857,650,3,30,1338,565761454,0,0,0,164.06,8,135125.34,24,1,21,5,True
4794952,1186,2,25,9736,565761454,0,0,0,163.99,8,134961.35,24,1,8,5,True
5153325,1186,2,451,5635,565761454,0,0,0,164.24,7,134797.11,24,2,9,7,True
5489220,650,3,25,7699,565761454,0,0,0,163.82,8,134633.29,24,1,9,8,True
5841170,937,0,20,7412,565761454,0,0,0,164.13,3,134469.16,24,2,23,9,True
6131532,847,3,30,2769,565761454,0,0,0,163.93,8,134305.23,5,4,0,9,True
6227852,1062,3,25,7412,565761454,0,0,0,163.88,8,134141.35,11,0,8,10,True
6285090,1186,2,451,7662,565761454,0,0,0,163.9,7,133977.45,24,4,12,10,True
6534157,1062,3,30,2769,565761454,0,0,0,164.13,8,133813.32,11,2,20,11,True
6537762,1246,0,10,7662,565761454,0,0,0,164.04,0,133977.36,23,0,1,12,True
6692702,1186,2,-1,1986,565761454,0,1,0,163.86,4,133977.36,24,4,18,12,True
6775755,1186,2,451,9680,565761454,0,0,0,164.01,7,133813.35,24,5,18,12,True
7263927,59,0,10,3298,565761454,0,0,0,163.95,6,133977.3,20,0,2,12,True
7411389,723,1,10,6186,565761454,0,0,0,163.59,6,134140.89,11,5,22,12,True
7495007,847,3,451,6186,565761454,0,0,0,164.19,7,133976.7,5,0,21,1,False
7749261,1116,0,20,2769,565761454,0,0,0,163.97,3,133812.73,24,1,5,4,True
7758513,650,3,451,1555,565761454,0,0,0,164.02,7,133648.71,24,6,23,4,True
7993840,1186,2,451,3298,565761454,0,0,0,163.84,7,133484.87,24,2,5,4,True
8034172,1186,2,451,6319,565761454,0,0,0,163.75,7,133321.12,24,3,23,4,True
8122496,584,0,20,5773,565761454,0,0,0,163.89,3,133157.23,11,4,7,5,True
8171013,1062,3,25,6186,565761454,0,0,0,164.22,8,132993.01,11,4,0,6,True
8279500,299,1,10,6579,565761454,0,0,0,164.0,0,133157.01,4,0,22,6,False
8757791,1186,2,451,4585,565761454,0,0,0,164.05,7,132992.96,24,6,12,7,False
8795161,847,3,-1,8804,565761454,0,1,0,164.05,1,132992.96,5,3,9,8,True
9154180,1186,2,20,5707,565761454,0,0,0,163.87,5,132829.09,24,2,2,8,True
9192354,1237,4,30,9680,565761454,0,0,0,164.03,8,132665.06,18,5,10,8,True
9241159,715,0,10,8367,565761454,0,0,0,163.92,0,132828.98,18,5,12,10,True
9750263,785,0,20,7662,565761454,0,0,0,163.98,5,132665.0,14,4,10,11,False
9945420,1062,3,25,2165,565761454,0,0,0,164.06,8,132500.94,11,4,10,11,True
1058207,1367,4,25,5609,692935008,0,0,0,682.18,8,319535.82,16,4,22,2,True
1260486,1190,3,-1,2060,692935008,0,1,0,682.03,1,319535.82,24,4,8,3,True
1322069,1033,4,-1,5276,692935008,0,2,0,682.01,1,319535.82,11,0,9,3,True
1429733,976,4,30,6537,692935008,0,0,0,681.8,8,318854.02,22,6,5,3,True
1480880,1033,4,25,2060,692935008,0,0,0,681.9,8,318172.12,11,1,23,3,True
1616921,1033,4,30,5609,692935008,0,0,0,681.93,8,317490.19,11,3,1,3,True
1755966,1190,3,451,5988,692935008,0,0,0,682.31,7,316807.88,24,0,16,5,True
1948208,554,4,30,6537,692935008,0,0,0,682.04,8,316125.84,17,1,19,5,True
2005402,554,4,451,3638,692935008,0,0,0,681.82,7,315444.02,17,0,11,5,True
2141352,554,4,451,3638,692935008,0,0,0,681.85,7,314762.17,17,0,17,6,True
2775059,1190,3,-1,5988,692935008,0,1,0,682.06,4,314762.17,24,0,17,7,True
2825780,1463,2,20,8357,692935008,0,0,0,681.92,3,314080.25,11,3,4,7,True
2951335,114,0,20,8357,692935008,0,0,0,681.8,5,313398.45,3,2,6,9,True
3017995,1461,0,20,9232,692935008,0,0,0,682.22,5,312716.23,11,4,5,9,False
3132870,292,1,10,9232,692935008,0,0,0,681.62,0,313397.85,4,0,4,9,True
3176517,20,0,10,5215,692935008,0,0,0,682.26,0,314080.11,24,2,8,9,True
3202427,861,4,25,6537,692935008,0,0,0,681.8,8,313398.31,24,6,3,10,True
3476869,1413,0,20,6307,692935008,0,0,0,682.05,3,312716.26,24,5,7,10,True
3521543,796,2,20,8042,692935008,0,0,0,682.12,3,312034.14,11,4,12,12,True
3530830,1245,1,10,3638,692935008,0,0,0,681.49,0,312715.63,18,6,2,12,False
3605874,976,4,451,7214,692935008,0,0,0,681.96,7,312033.67,22,2,19,12,True
3762255,976,4,30,7719,692935008,0,0,0,681.7,8,311351.97,22,4,21,12,True
4058849,554,4,451,5276,692935008,0,0,0,681.88,7,310670.09,17,1,13,1,True
4158508,656,2,20,8042,692935008,0,0,0,681.97,5,309988.12,18,2,16,2,True
4535744,976,4,30,5988,692935008,0,0,0,681.94,8,309306.18,22,6,23,4,True
4605293,1144,2,-1,5988,692935008,0,1,0,682.06,1,309306.18,15,2,20,4,True
4815086,976,4,30,6307,692935008,0,0,0,682.12,8,308624.06,22,5,8,5,True
4820401,554,4,25,5609,692935008,0,0,0,681.91,8,307942.15,17,2,2,5,True
4822081,861,4,25,3894,692935008,0,0,0,681.91,8,307260.24,24,4,22,7,True
4891818,976,4,-1,5215,692935008,0,1,0,681.91,4,307260.24,22,1,16,8,True
4935332,14,2,20,7214,692935008,0,0,0,681.96,3,306578.28,24,2,19,8,True
5119700,554,4,30,6307,692935008,0,0,0,682.19,8,305896.09,17,3,2,8,True
5163851,1019,0,20,9232,692935008,0,0,0,682.16,3,305213.93,26,1,14,10,True
5395610,861,4,25,7476,692935008,0,0,0,681.96,8,304531.97,24,4,18,11,True
5408406,1190,3,25,7476,692935008,0,0,0,681.87,8,303850.1,24,2,15,11,True
5676945,861,4,25,5276,692935008,0,0,0,681.92,8,303168.18,24,6,20,12,True
5729724,627,0,20,8357,692935008,0,0,0,682.09,5,302486.09,11,0,16,12,True
5803100,1033,4,451,9232,692935008,0,0,0,682.09,7,301804.0,11,2,10,12,True
5876601,1190,3,451,5276,692935008,0,0,0,681.78,7,301122.22,24,1,14,1,False
5900495,76,0,10,1716,692935008,0,0,0,682.12,0,301804.34,20,4,20,2,True
5905062,605,0,20,5276,692935008,0,0,0,681.81,3,301122.53,24,4,23,2,True
5924444,979,0,20,8357,692935008,0,0,0,681.85,3,300440.68,22,5,23,4,True
6258624,1033,4,451,3073,692935008,0,0,0,681.97,7,299758.71,11,4,3,4,False
6405115,1144,2,25,7214,692935008,0,0,0,681.9,8,299076.81,15,1,22,7,False
6733892,726,0,20,3073,692935008,0,0,0,682.09,3,298394.72,11,4,21,7,True
7830779,1356,2,20,7476,692935008,0,0,0,681.87,5,297712.85,24,3,11,8,True
8027456,1190,3,451,6307,692935008,0,0,0,681.9,7,297030.95,24,2,19,8,True
8183527,531,0,20,5609,692935008,0,0,0,682.22,3,296348.73,18,4,12,9,True
8892839,734,0,10,9232,692935008,0,0,0,681.92,6,297030.65,11,5,11,9,True
9593756,861,4,-1,7719,692935008,0,1,0,681.98,1,297030.65,24,0,19,10,True
1497083,1124,0,451,1625,112657514,0,0,0,662.3,7,478706.7,24,3,15,3,True
1506106,823,4,451,9473,112657514,0,0,0,661.94,7,478044.76,18,1,10,4,False
1524532,937,0,20,2084,112657514,0,0,0,661.91,5,477382.85,24,2,14,4,True
1565971,1124,0,30,5318,112657514,0,0,0,661.85,8,476721.0,24,6,13,4,True
1949976,53,0,20,4176,112657514,0,0,0,661.95,3,476059.05,20,5,21,5,True
1965307,823,4,451,4935,112657514,0,0,0,661.99,7,475397.06,18,1,21,5,True
1989461,355,1,30,9473,112657514,0,0,0,662.0,8,474735.06,24,3,12,6,False
2089199,1124,0,30,5307,112657514,0,0,0,662.13,8,474072.93,24,3,22,6,True
2185108,823,4,451,8164,112657514,0,0,0,662.03,7,473410.9,18,4,8,6,True
2188894,111,3,451,9473,112657514,0,0,0,661.81,7,472749.09,3,2,0,6,False
2554594,1352,1,10,3767,112657514,0,0,0,661.81,6,473410.9,24,0,8,7,True
2677464,355,1,30,3247,112657514,0,0,0,661.8,8,472749.1,24,0,12,7,True
2874294,1305,2,451,6545,112657514,0,0,0,661.99,7,472087.11,5,1,2,7,True
2875428,219,0,10,2493,112657514,0,0,0,662.06,6,472749.17,9,4,17,7,True
2881236,155,1,30,1625,112657514,0,0,0,662.07,8,472087.1,18,0,19,8,True
3153156,111,3,451,5196,112657514,0,0,0,662.09,7,471425.01,3,6,10,8,True
3265130,404,1,10,4816,112657514,0,0,0,662.12,6,472087.13,10,3,3,9,True
3370734,860,1,10,6438,112657514,0,0,0,662.14,6,472749.27,24,5,6,9,True
3476118,823,4,30,2493,112657514,0,0,0,662.18,8,472087.09,18,6,18,11,True
3488023,1124,0,30,8164,112657514,0,0,0,662.09,8,471425.0,24,6,3,11,True
3505494,1305,2,451,6545,112657514,0,0,0,662.24,7,470762.76,5,1,7,11,True
3627801,551,0,20,3247,112657514,0,0,0,661.94,3,470100.82,17,4,20,11,True
3833611,465,0,-1,7153,112657514,0,1,0,662.2,4,470100.82,13,4,9,11,False
4153106,155,1,30,2084,112657514,0,0,0,661.91,8,469438.91,18,6,3,12,True
4231896,155,1,451,4816,112657514,0,0,0,662.14,7,468776.77,18,3,14,1,True
4458784,465,0,-1,5196,112657514,0,1,0,662.11,4,468776.77,13,3,12,2,True
4532786,823,4,30,4631,112657514,0,0,0,662.21,8,468114.56,18,1,1,2,True
4761337,1124,0,25,6545,112657514,0,0,0,661.88,8,467452.68,24,1,5,2,True
4889583,1305,2,25,8164,112657514,0,0,0,662.2,8,466790.48,5,1,18,3,True
5030860,465,0,451,4816,112657514,0,0,0,661.82,7,466128.66,13,4,11,3,True
5378660,1305,2,451,8164,112657514,0,0,0,661.86,7,465466.8,5,3,14,4,True
5443165,1009,0,10,8164,112657514,0,0,0,662.06,0,466128.86,26,5,21,4,True
5630198,823,4,-1,3767,112657514,0,1,0,662.07,4,466128.86,18,1,6,6,True
5634429,155,1,-1,5011,112657514,0,2,0,662.24,4,466128.86,18,2,7,6,False
5699825,511,1,10,4176,112657514,0,0,0,661.96,0,466790.82,12,4,10,6,True
5835518,823,4,451,2084,112657514,0,0,0,662.0,7,466128.82,18,5,21,6,True
6005872,465,0,451,4433,112657514,0,0,0,661.91,7,465466.91,13,3,1,8,True
6055253,445,0,20,4799,112657514,0,0,0,661.94,5,464804.97,13,4,4,9,True
6141289,355,1,-1,7685,112657514,0,1,0,662.15,1,464804.97,24,4,22,10,True
6263721,111,3,30,4176,112657514,0,0,0,662.04,8,464142.93,3,0,11,10,False
6295309,111,3,451,3078,112657514,0,0,0,662.16,7,463480.77,3,2,5,10,True
6296437,1052,0,20,7153,112657514,0,0,0,661.97,5,462818.8,11,0,8,10,True
6419117,355,1,451,4935,112657514,0,0,0,661.94,7,462156.86,24,2,20,12,True
6435310,1205,0,20,4799,112657514,0,0,0,662.12,5,461494.74,24,3,0,12,True
6577155,1305,2,25,4631,112657514,0,0,0,662.09,8,460832.65,5,3,15,1,True
6610794,522,0,10,3078,112657514,0,0,0,662.06,0,461494.71,18,5,22,2,True
6778436,1124,0,451,5318,112657514,0,0,0,661.93,7,460832.78,24,4,10,3,True
6890140,365,0,10,2385,112657514,0,0,0,662.23,6,461495.01,25,5,12,4,True
6902402,355,1,25,5318,112657514,0,0,0,662.07,8,460832.94,24,2,23,4,True
7113626,708,2,20,7685,112657514,0,0,0,661.71,5,460171.23,18,3,18,4,True
7566800,780,0,10,4631,112657514,0,0,0,662.04,6,460833.27,14,4,10,4,True
7877805,1305,2,451,5307,112657514,0,0,0,661.89,7,460171.38,5,2,3,5,True
8298567,1201,0,10,4935,112657514,0,0,0,661.77,6,460833.15,24,2,10,5,True
8337586,1124,0,30,7873,112657514,0,0,0,662.22,8,460170.93,24,5,15,7,False
8473370,1305,2,25,2084,112657514,0,0,0,662.12,8,459508.81,5,2,9,7,True
8826048,428,0,20,4031,112657514,0,0,0,661.98,5,458846.83,18,4,2,7,True
9041620,792,1,10,5424,112657514,0,0,0,662.1,6,459508.93,11,3,13,9,False
9423243,1113,1,10,2628,112657514,0,0,0,661.92,6,460170.85,0,0,14,9,False
9437191,1297,0,20,6545,112657514,0,0,0,661.83,5,459509.02,5,3,12,10,True
1275441,1238,0,25,3475,924583506,1,0,0,281.97,8,77483.03,18,5,8,2,True
1421261,94,3,451,9440,924583506,1,0,0,281.68,7,77201.35,1,6,18,2,True
1491568,94,3,451,2830,924583506,1,0,0,281.95,7,76919.4,1,5,16,3,True
1638517,297,0,20,4732,924583506,1,0,0,282.05,5,76637.35,4,3,9,3,False
1759496,94,3,-1,7754,924583506,1,1,0,281.8,1,76637.35,1,4,13,4,True
1794052,925,4,-1,3744,924583506,1,2,0,281.85,1,76637.35,18,6,17,4,False
1930187,531,0,25,1116,924583506,1,0,0,282.2,8,76355.15,18,0,20,4,True
2047257,677,0,451,1199,924583506,1,0,0,282.0,7,76073.15,24,1,19,4,True
2353046,409,4,451,3760,924583506,1,0,0,282.03,7,75791.12,10,3,8,5,False
2584784,1312,0,30,4732,924583506,1,0,0,282.08,8,75509.04,5,4,21,5,True
3116009,1459,1,10,8382,924583506,1,0,0,282.03,0,75791.07,11,2,6,6,True
3126954,94,3,25,7140,924583506,1,0,0,282.02,8,75509.05,1,2,6,7,True
3299073,1238,0,451,4732,924583506,1,0,0,282.25,7,75226.8,18,3,20,8,True
3302613,114,0,10,1144,924583506,1,0,0,281.87,6,75508.67,3,1,17,8,True
3885934,145,0,10,8721,924583506,1,0,0,281.98,6,75790.65,18,2,12,8,True
3931762,409,4,25,8541,924583506,1,0,0,281.89,8,75508.76,10,4,9,9,True
3989562,531,0,30,2830,924583506,1,0,0,282.09,8,75226.67,18,0,16,9,True
4033389,94,3,25,6338,924583506,1,0,0,281.97,8,74944.7,1,6,20,10,True
4441616,201,1,10,3475,924583506,1,0,0,282.13,0,75226.83,9,2,23,11,True
4483339,1320,3,451,3376,924583506,1,0,0,282.01,7,74944.82,18,6,16,12,True
4715086,1238,0,-1,5824,924583506,1,1,0,282.05,4,74944.82,18,6,13,12,True
4959670,94,3,451,3760,924583506,1,0,0,282.16,7,74662.66,1,1,13,12,True
5304491,925,4,451,9714,924583506,1,0,0,282.08,7,74380.58,18,1,13,1,True
5561570,1435,2,20,6026,924583506,1,0,0,282.16,5,74098.42,24,6,0,2,True
5585918,925,4,25,4045,924583506,1,0,0,281.99,8,73816.43,18,0,4,2,True
5705229,94,3,451,9714,924583506,1,0,0,281.99,7,73534.44,1,1,6,3,True
5735901,677,0,-1,2830,924583506,1,1,0,281.91,4,73534.44,24,2,15,4,True
5964099,1238,0,25,9417,924583506,1,0,0,282.15,8,73252.29,18,4,16,4,True
6215776,459,1,10,8433,924583506,1,0,0,281.87,0,73534.16,13,1,17,4,True
6476345,1201,0,10,4045,924583506,1,0,0,281.83,6,73815.99,24,5,3,5,True
6757733,677,0,-1,3490,924583506,1,1,0,282.04,4,73815.99,24,2,20,5,True
6972157,531,0,25,3490,924583506,1,0,0,282.15,8,73533.84,18,0,2,7,True
7113110,1312,0,30,6338,924583506,1,0,0,281.96,8,73251.88,5,2,2,8,True
7170857,1320,3,30,3490,924583506,1,0,0,282.13,8,72969.75,18,1,4,9,True
7277655,1312,0,25,1199,924583506,1,0,0,282.08,8,72687.67,5,0,21,9,True
7389339,531,0,30,7140,924583506,1,0,0,282.02,8,72405.65,18,3,0,11,True
7444141,783,0,20,9302,924583506,1,0,0,281.85,5,72123.8,14,3,20,11,True
7739396,409,4,451,1116,924583506,1,0,0,281.99,7,71841.81,10,1,21,11,True
7847074,677,0,30,1144,924583506,1,0,0,282.09,8,71559.72,24,1,8,12,True
7989178,1238,0,30,3744,924583506,1,0,0,281.8,8,71277.92,18,5,22,12,True
8353489,1312,0,30,3376,924583506,1,0,0,282.12,8,70995.8,5,0,11,12,True
8605525,677,0,451,9417,924583506,1,0,0,282.15,7,70713.65,24,5,6,2,True
8639217,577,0,20,3744,924583506,1,0,0,281.99,3,70431.66,11,4,7,3,True
8659572,925,4,25,4045,924583506,1,0,0,281.99,8,70149.67,18,2,4,3,False
8706345,409,4,451,4045,924583506,1,0,0,282.06,7,69867.61,10,2,0,4,False
8916691,1238,0,30,3475,924583506,1,0,0,281.91,8,69585.7,18,2,4,4,False
9049349,531,0,30,8834,924583506,1,0,0,281.96,8,69303.74,18,5,19,6,True
9156947,1320,3,30,3760,924583506,1,0,0,281.79,8,69021.95,18,1,2,7,True
9271478,677,0,25,9440,924583506,1,0,0,282.1,8,68739.85,24,2,4,7,True
9308398,409,4,30,3376,924583506,1,0,0,282.03,8,68457.82,10,4,6,8,True
9381778,1238,0,451,8721,924583506,1,0,0,282.0,7,68175.82,18,2,18,10,True
9488083,369,1,10,8382,924583506,1,0,0,281.97,6,68457.79,25,2,19,10,True
9620874,348,0,10,1144,924583506,1,0,0,282.17,6,68739.96,24,2,12,10,True
9770448,409,4,451,9302,924583506,1,0,0,281.98,7,68457.98,10,4,8,11,True
9911202,551,0,10,8541,924583506,1,0,0,282.11,6,68740.09,17,5,20,11,True
1067353,713,0,451,6037,272447412,1,0,0,1011.83,7,309424.17,18,2,4,1,True
1221465,219,0,10,9644,272447412,1,0,0,1012.02,0,310436.19,9,2,20,5,True
1438942,642,0,20,1487,272447412,1,0,0,1011.89,3,309424.3,24,6,4,5,True
1678993,129,0,-1,3634,272447412,1,1,0,1011.77,4,309424.3,18,5,8,5,True
1768633,1471,0,-1,3265,272447412,1,2,0,1011.98,1,309424.3,24,2,2,6,True
2564521,129,0,30,3404,272447412,1,0,0,1012.25,8,308412.05,18,1,0,7,False
2632395,892,4,451,6879,272447412,1,0,0,1011.95,7,307400.1,24,4,13,7,True
2997922,892,4,451,1623,272447412,1,0,0,1011.87,7,306388.23,24,1,18,8,True
3165710,225,3,25,2975,272447412,1,0,0,1011.82,8,305376.41,26,0,12,8,True
3320115,509,0,-1,1816,272447412,1,1,0,1011.89,4,305376.41,12,0,17,8,True
3386927,149,2,20,8792,272447412,1,0,0,1012.16,5,304364.25,18,3,18,8,True
3677186,273,4,30,8792,272447412,1,0,0,1012.26,8,303351.99,24,6,16,8,True
3838089,273,4,-1,6037,272447412,1,1,0,1012.16,4,303351.99,24,6,23,9,True
3913117,713,0,30,1788,272447412,1,0,0,1011.98,8,302340.01,18,0,1,9,True
3992775,892,4,25,1623,272447412,1,0,0,1011.9,8,301328.11,24,1,15,9,True
4016130,713,0,-1,6047,272447412,1,1,0,1012.22,1,301328.11,18,1,6,10,True
4501371,892,4,25,6879,272447412,1,0,0,1012.11,8,300316.0,24,6,17,10,True
4570205,1471,0,25,5488,272447412,1,0,0,1012.01,8,299303.99,24,2,22,10,True
4779179,225,3,-1,7978,272447412,1,1,0,1011.88,1,299303.99,26,6,4,10,True
4988466,1471,0,-1,6037,272447412,1,2,0,1012.12,1,299303.99,24,3,10,11,True
5058851,1471,0,451,6047,272447412,1,0,0,1011.92,7,298292.07,24,5,10,1,True
5072651,962,0,20,2457,272447412,1,0,0,1012.03,5,297280.04,13,2,8,1,True
5144718,1471,0,30,2457,272447412,1,0,0,1011.83,8,296268.21,24,0,13,1,True
5377418,713,0,-1,1788,272447412,1,1,0,1012.0,4,296268.21,18,5,13,2,True
5385372,225,3,451,6879,272447412,1,0,0,1011.92,7,295256.29,26,2,22,6,True
5393477,129,0,451,8792,272447412,1,0,0,1011.74,7,294244.55,18,2,21,6,True
5565878,509,0,-1,1788,272447412,1,1,0,1012.08,4,294244.55,12,0,18,7,True
5732779,378,0,10,7614,272447412,1,0,0,1011.93,6,295256.48,25,3,0,8,True
5775769,892,4,451,6047,272447412,1,0,0,1012.2,7,294244.28,24,2,10,10,True
5830997,129,0,-1,2534,272447412,1,1,0,1011.88,1,294244.28,18,5,20,11,True
6141164,897,0,20,4960,272447412,1,0,0,1011.86,5,293232.42,24,6,0,11,True
6404184,974,3,30,6293,272447412,1,0,0,1012.18,8,292220.24,22,6,20,12,True
6409923,1094,0,10,8792,272447412,1,0,0,1011.6,6,293231.84,0,6,12,12,True
6530215,974,3,-1,8792,272447412,1,1,0,1011.92,1,293231.84,22,4,7,12,True
6725966,298,4,25,1623,272447412,1,0,0,1012.08,8,292219.76,4,2,22,12,True
6936868,129,0,30,3200,272447412,1,0,0,1011.76,8,291208.0,18,3,23,12,True
6941162,974,3,30,1623,272447412,1,0,0,1012.12,8,290195.88,22,2,21,12,True
7499595,974,3,30,3634,272447412,1,0,0,1011.88,8,289184.0,22,2,1,1,True
7515349,274,1,10,3634,272447412,1,0,0,1011.93,0,290195.93,24,4,21,1,True
7555929,129,0,30,3634,272447412,1,0,0,1011.87,8,289184.06,18,2,15,3,True
7862520,1262,0,20,3634,272447412,1,0,0,1012.24,5,288171.82,23,2,13,3,True
7878687,225,3,-1,7614,272447412,1,1,0,1011.97,4,288171.82,26,1,0,4,True
7919467,1226,2,20,3200,272447412,1,0,0,1011.92,5,287159.9,18,4,11,4,True
7920416,1471,0,451,6047,272447412,1,0,0,1011.77,7,286148.13,24,5,18,4,True
7941508,1471,0,30,8792,272447412,1,0,0,1011.89,8,285136.24,24,2,12,5,True
8257391,548,2,20,3634,272447412,1,0,0,1011.85,5,284124.39,17,1,6,5,True
8276952,298,4,30,1623,272447412,1,0,0,1012.01,8,283112.38,4,6,23,5,True
8307391,273,4,451,6293,272447412,1,0,0,1011.77,7,282100.61,24,3,14,5,True
8395535,509,0,30,6293,272447412,1,0,0,1011.84,8,281088.77,12,5,9,6,True
8524341,225,3,-1,7978,272447412,1,1,0,1011.69,4,281088.77,26,0,23,6,True
8526432,129,0,30,3265,272447412,1,0,0,1012.08,8,280076.69,18,3,7,6,True
8546000,273,4,451,2975,272447412,1,0,0,1012.01,7,279064.68,24,4,17,6,True
8575877,225,3,30,1788,272447412,1,0,0,1012.01,8,278052.67,26,4,21,7,True
8635556,892,4,451,6293,272447412,1,0,0,1012.07,7,277040.6,24,2,17,7,True
8641549,298,4,30,3404,272447412,1,0,0,1012.12,8,276028.48,4,0,20,8,True
8933488,298,4,-1,5151,272447412,1,1,0,1011.64,1,276028.48,4,6,11,9,True
9655820,1235,1,10,5488,272447412,1,0,0,1011.98,6,277040.46,18,5,15,10,True
9884465,892,4,451,8792,272447412,1,0,0,1011.84,7,276028.62,24,5,16,11,True
1061978,194,1,-1,1815,968766396,1,1,0,770.73,1,507263.0,18,3,3,1,True
1063434,194,1,25,3915,968766396,1,0,0,771.0,8,506492.0,18,1,3,1,True
1320493,511,1,-1,1163,968766396,1,1,0,770.87,4,506492.0,12,2,5,3,True
1348801,677,0,10,3915,968766396,1,0,0,771.14,6,507263.14,24,0,3,4,True
1560070,1449,0,30,3634,968766396,1,0,0,771.08,8,506492.06,11,0,21,4,True
1846359,1449,0,-1,3236,968766396,1,1,0,771.05,1,506492.06,11,1,20,5,True
2086123,1065,0,451,9601,968766396,1,0,0,770.88,7,505721.18,11,6,15,6,True
2948888,1449,0,451,8449,968766396,1,0,0,770.68,7,504950.5,11,4,3,6,True
3028027,194,1,30,3634,968766396,1,0,0,771.3,8,504179.2,18,1,14,6,True
3116409,511,1,25,7322,968766396,1,0,0,770.84,8,503408.36,12,2,0,6,True
3183259,355,1,-1,2501,968766396,1,1,0,770.71,4,503408.36,24,4,23,7,True
3204117,511,1,451,7352,968766396,1,0,0,770.95,7,502637.41,12,3,21,8,True
3317341,194,1,25,3874,968766396,1,0,0,771.22,8,501866.19,18,5,16,9,True
3351146,211,0,20,6378,968766396,1,0,0,771.03,5,501095.16,9,1,4,9,True
3816455,1065,0,25,3692,968766396,1,0,0,770.97,8,500324.19,11,2,13,9,True
3837093,355,1,451,9817,968766396,1,0,0,770.91,7,499553.28,24,2,23,10,True
3844796,1449,0,25,9817,968766396,1,0,0,771.05,8,498782.23,11,0,23,10,True
3905980,895,0,20,3236,968766396,1,0,0,771.26,5,498010.97,24,0,17,10,True
4178164,511,1,451,2501,968766396,1,0,0,770.77,7,497240.2,12,1,17,11,True
4239306,1449,0,30,3634,968766396,1,0,0,771.03,8,496469.17,11,0,20,11,True
4449705,1356,2,20,3236,968766396,1,0,0,770.9,5,495698.27,24,2,14,12,True
4600131,392,4,30,7322,968766396,1,0,0,770.96,8,494927.31,10,0,20,2,True
4722698,194,1,-1,3874,968766396,1,1,0,771.16,4,494927.31,18,3,4,3,True
4917679,194,1,25,3915,968766396,1,0,0,770.82,8,494156.49,18,4,6,3,True
4963079,194,1,-1,2501,968766396,1,1,0,771.21,1,494156.49,18,5,1,3,True
5407090,607,2,20,7352,968766396,1,0,0,771.0,5,493385.49,24,4,10,4,True
5730056,1449,0,25,1163,968766396,1,0,0,771.01,8,492614.48,11,2,12,6,True
5760899,511,1,451,3874,968766396,1,0,0,770.71,7,491843.77,12,0,18,6,True
6017629,1449,0,-1,9601,968766396,1,1,0,771.08,4,491843.77,11,2,11,7,True
6041390,392,4,-1,7352,968766396,1,2,0,770.92,4,491843.77,10,4,13,7,True
6161126,194,1,30,9601,968766396,1,0,0,771.02,8,491072.75,18,4,23,8,True
6259897,392,4,451,3692,968766396,1,0,0,770.67,7,490302.08,10,1,8,8,True
6797425,1449,0,451,1815,968766396,1,0,0,771.04,7,489531.04,11,2,21,9,True
7211648,392,4,451,8449,968766396,1,0,0,771.13,7,488759.91,10,5,12,11,True
7215141,194,1,25,9817,968766396,1,0,0,771.03,8,487988.88,18,5,8,11,True
7236693,1065,0,451,3915,968766396,1,0,0,770.87,7,487218.01,11,1,22,12,True
7397335,1449,0,451,6378,968766396,1,0,0,771.09,7,486446.92,11,3,4,12,True
7649060,194,1,451,7322,968766396,1,0,0,770.92,7,485676.0,18,1,11,1,True
7708441,1065,0,25,6378,968766396,1,0,0,770.78,8,484905.22,11,5,7,3,True
7905130,392,4,451,8449,968766396,1,0,0,771.26,7,484133.96,10,6,16,3,True
8127004,511,1,25,9817,968766396,1,0,0,770.96,8,483363.0,12,4,23,5,True
8209598,355,1,451,9601,968766396,1,0,0,770.98,7,482592.02,24,0,7,5,True
8548011,511,1,25,3107,968766396,1,0,0,770.98,8,481821.04,12,4,19,5,True
8738029,445,0,20,3915,968766396,1,0,0,770.97,5,481050.07,13,5,6,7,True
8765505,918,2,20,3915,968766396,1,0,0,771.37,5,480278.7,18,0,9,7,True
8948817,511,1,451,1815,968766396,1,0,0,770.96,7,479507.74,12,1,15,7,True
9155177,1065,0,30,3236,968766396,1,0,0,770.98,8,478736.76,11,1,0,8,True
9219929,880,1,10,6378,968766396,1,0,0,770.74,6,479507.5,27,1,3,8,True
9296805,1065,0,451,3915,968766396,1,0,0,771.02,7,478736.48,11,5,0,8,True
9480996,1065,0,30,3692,968766396,1,0,0,771.05,8,477965.43,11,4,10,9,True
9520448,1297,0,10,1815,968766396,1,0,0,771.13,6,478736.56,5,3,2,10,True
9885479,194,1,451,3915,968766396,1,0,0,771.03,7,477965.53,18,3,2,10,True
9978959,1449,0,30,7322,968766396,1,0,0,771.05,8,477194.48,11,2,14,11,True
1457940,1307,0,10,8683,889367375,1,0,0,141.89,6,923459.89,5,1,12,1,True
1465794,961,4,451,1728,889367375,1,0,0,142.09,7,923317.8,13,4,9,1,True
1518707,765,4,25,9865,889367375,1,0,0,142.29,8,923175.51,14,4,13,1,True
1555867,765,4,451,5190,889367375,1,0,0,141.89,7,923033.62,14,1,21,2,True
1648602,1267,2,-1,6948,889367375,1,1,0,142.05,1,923033.62,23,5,1,5,True
1906455,1163,4,30,3951,889367375,1,0,0,141.93,8,922891.69,24,1,3,6,True
1919634,961,4,451,2164,889367375,1,0,0,141.81,7,922749.88,13,3,20,7,True
2033191,427,2,30,3360,889367375,1,0,0,142.04,8,922607.84,18,5,8,7,True
2290804,1267,2,30,8328,889367375,1,0,0,141.77,8,922466.07,23,3,11,7,True
2757555,1406,0,30,6948,889367375,1,0,0,141.88,8,922324.19,24,6,10,7,True
2772536,765,4,-1,2468,889367375,1,1,0,142.06,4,922324.19,14,3,14,8,True
2898472,1406,0,30,2164,889367375,1,0,0,141.99,8,922182.2,24,6,7,8,False
3182572,427,2,25,1671,889367375,1,0,0,141.87,8,922040.33,18,5,11,11,True
3283164,180,0,20,1026,889367375,1,0,0,142.03,5,921898.3,18,2,9,12,True
3550546,961,4,451,1026,889367375,1,0,0,141.77,7,921756.53,13,5,20,1,True
3695337,1406,0,25,8683,889367375,1,0,0,141.82,8,921614.71,24,5,5,1,False
3738622,796,2,20,3951,889367375,1,0,0,142.22,3,921472.49,11,1,17,1,True
3904315,1267,2,-1,1528,889367375,1,1,0,142.1,4,921472.49,23,2,14,2,True
3976730,1322,2,25,9479,889367375,1,0,0,142.11,8,921330.38,18,2,23,2,True
4660846,1322,2,-1,3360,889367375,1,1,0,141.9,4,921330.38,18,4,10,2,True
4691452,427,2,-1,7445,889367375,1,2,0,142.04,4,921330.38,18,2,18,3,True
4823383,765,4,30,6948,889367375,1,0,0,141.81,8,921188.57,14,3,3,4,True
4845716,765,4,451,2468,889367375,1,0,0,141.9,7,921046.67,14,0,8,5,True
4871663,96,0,10,1728,889367375,1,0,0,142.0,6,921188.67,1,3,4,6,True
5090650,1406,0,25,1528,889367375,1,0,0,142.04,8,921046.63,24,6,1,6,True
5152189,942,0,20,5190,889367375,1,0,0,141.92,5,920904.71,24,2,0,6,True
5287705,427,2,25,1728,889367375,1,0,0,142.05,8,920762.66,18,4,12,6,True
5351977,1163,4,-1,1671,889367375,1,1,0,141.97,4,920762.66,24,0,20,7,True
5636848,537,0,10,1026,889367375,1,0,0,142.1,6,920904.76,18,1,12,8,True
5672203,144,1,451,8328,889367375,1,0,0,142.0,7,920762.76,18,6,9,8,True
5728319,1267,2,25,8328,889367375,1,0,0,142.15,8,920620.61,23,3,0,9,True
5751754,797,3,25,7445,889367375,1,0,0,142.03,8,920478.58,11,1,1,9,True
5776043,961,4,25,5014,889367375,1,0,0,141.84,8,920336.74,13,3,3,10,True
5801259,1322,2,-1,8683,889367375,1,1,0,142.18,1,920336.74,18,4,6,10,True
5876258,260,0,10,1044,889367375,1,0,0,142.16,6,920478.9,6,4,2,10,True
6106345,950,0,10,8328,889367375,1,0,0,141.97,6,920620.87,24,4,13,12,True
6217688,1322,2,451,8328,889367375,1,0,0,142.22,7,920478.65,18,6,1,1,True
6321182,797,3,-1,8328,889367375,1,1,0,141.78,1,920478.65,11,1,10,1,True
7133631,1406,0,451,2468,889367375,1,0,0,142.24,7,920336.41,24,4,12,1,True
7175826,1406,0,20,1671,889367375,1,0,0,142.06,5,920194.35,24,4,20,1,True
7233739,1322,2,-1,1044,889367375,1,1,0,142.34,1,920194.35,18,5,16,2,True
7271032,1164,0,20,1026,889367375,1,0,0,141.93,3,920052.42,24,5,19,3,True
7379906,1406,0,30,1026,889367375,1,0,0,141.92,8,919910.5,24,1,23,3,True
7391562,1267,2,25,9865,889367375,1,0,0,142.2,8,919768.3,23,1,21,4,True
7425371,1436,0,10,8328,889367375,1,0,0,142.06,6,919910.36,24,0,14,4,True
7550225,1322,2,451,1528,889367375,1,0,0,141.92,7,919768.44,18,4,1,5,True
7908821,1322,2,30,1728,889367375,1,0,0,141.93,8,919626.51,18,1,13,5,True
8301863,1089,0,10,9865,889367375,1,0,0,141.77,6,919768.28,18,0,21,6,True
8390635,144,1,30,2359,889367375,1,0,0,142.11,8,919626.17,18,3,1,7,True
8925986,427,2,-1,1728,889367375,1,1,0,142.05,1,919626.17,18,0,2,7,True
9003268,961,4,-1,1044,889367375,1,2,0,142.05,1,919626.17,13,3,15,7,True
9069037,961,4,25,2468,889367375,1,0,0,141.95,8,919484.22,13,3,6,8,True
9129529,961,4,-1,2943,889367375,1,1,0,142.2,4,919484.22,13,1,18,9,True
9401433,603,0,20,1671,889367375,1,0,0,141.89,5,919342.33,24,3,2,9,True
9717547,961,4,-1,2468,889367375,1,1,0,142.09,4,919342.33,13,5,21,9,True
9754722,1163,4,451,1044,889367375,1,0,0,142.05,7,919200.28,24,4,5,9,True
9843740,1267,2,-1,2164,889367375,1,1,0,142.14,1,919200.28,23,6,22,9,True
9930159,1159,0,10,2359,889367375,1,0,0,142.04,6,919342.32,15,1,5,9,True
9999449,144,1,451,1528,889367375,1,0,0,141.83,7,919200.49,18,5,22,10,True
1057725,64,0,451,5772,776505800,1,0,0,457.19,7,379185.81,20,0,12,5,False
1115409,608,4,451,7146,776505800,1,0,0,457.01,7,378728.8,24,2,18,7,True
1119198,291,3,25,9276,776505800,1,0,0,457.11,8,378271.69,24,2,17,10,True
1350137,1429,0,-1,2204,776505800,1,1,0,457.07,4,378271.69,24,6,23,7,True
1380122,991,1,-1,1635,776505800,1,2,0,457.1,4,378271.69,22,3,18,8,True
1515217,64,0,-1,7785,776505800,1,3,1,457.01,4,378271.69,20,6,4,4,True
1098965,128,0,20,6172,958252617,0,0,0,1043.0,5,169373.0,18,6,16,3,True
1155556,490,4,30,3442,958252617,0,0,0,1043.04,8,168329.96,12,4,19,3,True
1330425,564,0,20,4471,958252617,0,0,0,1043.15,5,167286.81,17,0,12,3,True
1335560,832,3,25,9824,958252617,0,0,0,1042.92,8,166243.89,5,2,8,3,True
1341861,1249,2,20,1631,958252617,0,0,0,1043.09,5,165200.8,23,4,23,4,True
1416016,553,1,10,3442,958252617,0,0,0,1042.97,0,166243.77,17,2,18,5,True
1695199,955,4,30,6845,958252617,0,0,0,1042.93,8,165200.84,13,1,4,5,True
2069577,1224,4,25,4704,958252617,0,0,0,1043.02,8,164157.82,24,1,5,6,True
2453055,151,4,25,1813,958252617,0,0,0,1043.22,8,163114.6,18,0,1,7,True
2663579,832,3,25,4674,958252617,0,0,0,1042.74,8,162071.86,5,1,23,7,True
2764189,955,4,-1,4674,958252617,0,1,0,1042.91,4,162071.86,13,2,20,7,True
2938913,223,2,20,3510,958252617,0,0,0,1043.14,5,161028.72,26,3,19,8,True
2989079,490,4,451,3510,958252617,0,0,0,1042.94,7,159985.78,12,0,21,8,True
3027121,844,1,10,8017,958252617,0,0,0,1043.01,6,161028.79,5,0,7,10,True
3116753,151,4,451,7383,958252617,0,0,0,1043.4,7,159985.39,18,3,3,10,True
3506443,955,4,-1,3158,958252617,0,1,0,1043.03,4,159985.39,13,1,17,11,True
3563445,151,4,25,7549,958252617,0,0,0,1043.13,8,158942.26,18,3,6,12,True
3918540,792,1,451,9442,958252617,0,0,0,1042.95,7,157899.31,11,4,8,1,True
3971635,490,4,451,6845,958252617,0,0,0,1043.04,7,156856.27,12,6,19,1,True
3989318,1150,0,10,3189,958252617,0,0,0,1043.07,6,157899.34,15,3,2,1,True
4083665,955,4,451,1813,958252617,0,0,0,1042.99,7,156856.35,13,2,14,4,True
4092510,490,4,30,6845,958252617,0,0,0,1042.93,8,155813.42,12,1,0,5,True
4104057,490,4,30,4674,958252617,0,0,0,1042.97,8,154770.45,12,4,13,5,True
4149348,208,0,10,5416,958252617,0,0,0,1043.02,0,155813.47,9,2,1,5,True
4278420,1455,2,25,9918,958252617,0,0,0,1043.0,8,154770.47,11,1,9,6,False
4754548,1455,2,451,9442,958252617,0,0,0,1042.91,7,153727.56,11,3,19,6,True
4859471,792,1,451,9489,958252617,0,0,0,1042.76,7,152684.8,11,5,19,7,True
4920137,151,4,-1,3510,958252617,0,1,0,1042.84,1,152684.8,18,1,5,8,True
4938630,1455,2,25,7549,958252617,0,0,0,1043.06,8,151641.74,11,0,14,8,True
5002264,736,1,10,7383,958252617,0,0,0,1043.2,0,152684.94,11,1,15,9,True
5476953,955,4,25,1813,958252617,0,0,0,1042.91,8,151642.03,13,3,19,9,True
5532902,1009,0,20,4471,958252617,0,0,0,1043.14,5,150598.89,26,1,19,10,True
5586922,1110,0,10,9824,958252617,0,0,0,1042.86,6,151641.75,0,1,2,10,True
5926305,1224,4,-1,1813,958252617,0,1,0,1043.15,4,151641.75,24,4,17,11,True
6033834,792,1,451,4471,958252617,0,0,0,1043.16,7,150598.59,11,3,0,11,True
6159494,627,0,20,3189,958252617,0,0,0,1042.8,3,149555.79,11,0,9,11,False
6411343,832,3,25,1813,958252617,0,0,0,1042.91,8,148512.88,5,5,5,12,True
6733674,955,4,30,4471,958252617,0,0,0,1043.05,8,147469.83,13,0,10,1,True
6785973,151,4,25,8017,958252617,0,0,0,1043.03,8,146426.8,18,1,21,1,True
6793728,529,2,20,5416,958252617,0,0,0,1042.84,5,145383.96,18,3,20,2,True
6828996,1224,4,451,1813,958252617,0,0,0,1043.06,7,144340.9,24,3,0,2,True
6831600,490,4,25,6845,958252617,0,0,0,1042.84,8,143298.06,12,1,12,2,True
6915656,1224,4,451,4704,958252617,0,0,0,1042.9,7,142255.16,24,0,14,2,True
7264843,1224,4,30,1631,958252617,0,0,0,1043.18,8,141211.98,24,5,6,3,False
7517578,792,1,30,4674,958252617,0,0,0,1042.94,8,140169.04,11,6,20,3,True
7781251,850,1,10,9489,958252617,0,0,0,1042.82,6,141211.86,5,4,13,3,True
7891096,832,3,451,3158,958252617,0,0,0,1043.03,7,140168.83,5,4,18,4,True
7946936,792,1,451,1631,958252617,0,0,0,1042.96,7,139125.87,11,5,5,4,True
7979889,490,4,30,8017,958252617,0,0,0,1043.21,8,138082.66,12,5,6,4,True
8011918,445,0,20,4704,958252617,0,0,0,1042.96,3,137039.7,13,2,9,5,True
8152405,1224,4,30,6776,958252617,0,0,0,1042.85,8,135996.85,24,6,19,6,False
8165030,1455,2,25,9918,958252617,0,0,0,1042.81,8,134954.04,11,4,15,8,True
8333329,1224,4,-1,6776,958252617,0,1,0,1042.91,1,134954.04,24,2,5,9,True
8356189,151,4,25,9918,958252617,0,0,0,1043.2,8,133910.84,18,2,8,10,True
9367558,955,4,30,1813,958252617,0,0,0,1043.09,8,132867.75,13,2,21,10,True
9797805,151,4,25,6172,958252617,0,0,0,1043.1,8,131824.65,18,4,5,10,True
1001997,25,3,-1,1775,324080282,0,1,0,587.0,4,200438.0,11,1,1,1,True
1120663,1428,1,10,8408,324080282,0,0,0,587.14,0,201025.14,24,6,8,1,True
1240219,14,2,20,6731,324080282,0,0,0,587.08,5,200438.06,24,4,10,3,True
1461393,895,0,10,4874,324080282,0,0,0,586.85,6,201024.91,24,1,22,4,True
1502456,25,3,30,9574,324080282,0,0,0,586.75,8,200438.16,11,0,22,5,True
1522837,1123,2,25,8408,324080282,0,0,0,586.85,8,199851.31,24,4,1,7,True
1598290,640,4,30,8408,324080282,0,0,0,587.18,8,199264.13,24,5,3,9,True
1626679,25,3,30,4874,324080282,0,0,0,586.99,8,198677.14,11,6,10,9,True
1835381,411,2,451,2873,324080282,0,0,0,587.09,7,198090.05,18,0,13,10,True
1836056,531,0,10,9574,324080282,0,0,0,586.69,0,198676.74,18,3,0,10,True
2073986,640,4,451,6731,324080282,0,0,0,586.87,7,198089.87,24,2,5,10,True
2086085,1123,2,451,6731,324080282,0,0,0,587.22,7,197502.65,24,3,4,11,True
2170207,25,3,30,1251,324080282,0,0,0,587.05,8,196915.6,11,4,9,11,True
2219973,935,1,10,8408,324080282,0,0,0,587.01,6,197502.61,24,0,16,11,True
2467089,1123,2,30,4247,324080282,0,0,0,587.19,8,196915.42,24,1,5,11,True
2538164,1123,2,25,2873,324080282,0,0,0,586.9,8,196328.52,24,2,11,12,True
2575713,1164,0,20,6731,324080282,0,0,0,587.15,3,195741.37,24,2,1,1,True
2726382,76,0,25,1251,324080282,0,0,0,586.93,8,195154.44,20,4,19,2,True
2777257,522,0,20,2933,324080282,0,0,0,586.99,5,194567.45,18,1,5,2,True
2837185,1123,2,30,2946,324080282,0,0,0,587.0,8,193980.45,24,3,9,3,True
2862960,98,0,10,5623,324080282,0,0,0,586.69,0,194567.14,3,0,16,4,True
2969233,694,2,20,9558,324080282,0,0,0,586.93,5,193980.21,24,1,20,4,True
3137612,640,4,451,4259,324080282,0,0,0,587.11,7,193393.1,24,1,15,4,True
3400279,76,0,-1,6277,324080282,0,1,0,587.16,4,193393.1,20,0,8,5,True
3507429,23,0,20,2357,324080282,0,0,0,587.16,3,192805.94,11,2,6,5,True
3587699,76,0,451,1775,324080282,0,0,0,587.26,7,192218.68,20,3,22,6,True
3737930,411,2,451,8408,324080282,0,0,0,586.85,7,191631.83,18,6,12,6,True
4170280,367,1,10,2946,324080282,0,0,0,587.14,0,192218.97,25,0,10,6,True
4256428,398,0,20,6766,324080282,0,0,0,587.06,3,191631.91,10,2,5,7,True
4326159,411,2,25,1775,324080282,0,0,0,586.69,8,191045.22,18,3,7,7,False
4402306,882,0,20,4259,324080282,0,0,0,587.08,3,190458.14,27,0,4,8,True
5228788,25,3,25,4259,324080282,0,0,0,586.97,8,189871.17,11,2,7,8,True
5295481,25,3,451,5623,324080282,0,0,0,586.83,7,189284.34,11,6,20,9,True
5662082,76,0,25,2330,324080282,0,0,0,586.98,8,188697.36,20,5,16,10,True
5702214,570,2,20,9558,324080282,0,0,0,586.89,5,188110.47,11,0,13,12,True
5996540,1123,2,30,5526,324080282,0,0,0,586.79,8,187523.68,24,0,19,12,True
6061883,715,0,20,6731,324080282,0,0,0,587.13,5,186936.55,18,3,4,2,True
6090085,76,0,30,9558,324080282,0,0,0,587.09,8,186349.46,20,1,1,2,True
6749402,1119,0,10,6766,324080282,0,0,0,586.95,0,186936.41,24,3,19,2,True
7076381,76,0,451,8408,324080282,0,0,0,586.73,7,186349.68,20,6,0,2,True
7615741,76,0,-1,5526,324080282,0,1,0,587.31,1,186349.68,20,2,16,3,True
7620230,411,2,451,4259,324080282,0,0,0,587.01,7,185762.67,18,2,10,4,True
7784865,76,0,451,4247,324080282,0,0,0,587.08,7,185175.59,20,4,14,4,True
7792888,463,1,10,4874,324080282,0,0,0,587.1,6,185762.69,13,4,8,6,True
7981839,25,3,451,4259,324080282,0,0,0,587.08,7,185175.61,11,3,17,6,True
8008053,411,2,-1,6277,324080282,0,1,0,586.94,4,185175.61,18,1,16,7,True
8116320,640,4,25,5623,324080282,0,0,0,587.12,8,184588.49,24,6,2,7,True
8268790,411,2,-1,1251,324080282,0,1,0,586.95,4,184588.49,18,1,9,7,True
8649547,573,0,20,4259,324080282,0,0,0,586.77,5,184001.72,11,4,5,7,True
8794502,411,2,30,9558,324080282,0,0,0,587.23,8,183414.49,18,1,2,7,True
8919728,25,3,30,2933,324080282,0,0,0,586.84,8,182827.65,11,6,10,8,True
9267377,909,2,20,4247,324080282,0,0,0,587.07,3,182240.58,18,3,16,8,True
9394423,411,2,30,6766,324080282,0,0,0,586.96,8,181653.62,18,1,23,9,True
9649117,662,1,10,5807,324080282,0,0,0,586.87,6,182240.49,18,0,9,10,True
9960116,25,3,25,6731,324080282,0,0,0,587.0,8,181653.49,11,3,11,11,True
1023175,1353,4,30,3695,773274125,0,0,0,687.95,8,376739.05,24,5,17,1,True
1023518,1483,0,20,2506,773274125,0,0,0,688.21,5,376050.84,24,3,9,1,True
2223091,208,0,10,5287,773274125,0,0,0,687.94,0,376738.78,9,2,20,2,True
2375539,630,0,20,2424,773274125,0,0,0,688.21,5,376050.57,11,5,4,2,True
2447424,318,0,25,7129,773274125,0,0,0,688.02,8,375362.55,11,1,0,3,True
2673981,318,0,451,2424,773274125,0,0,0,687.98,7,374674.57,11,5,20,3,True
2848832,1425,0,20,2389,773274125,0,0,0,687.78,5,373986.79,24,4,21,4,True
2855152,357,4,25,9696,773274125,0,0,0,688.03,8,373298.76,24,6,8,5,False
2866925,357,4,451,4082,773274125,0,0,0,688.07,7,372610.69,24,5,8,5,True
2891689,357,4,25,6697,773274125,0,0,0,688.03,8,371922.66,24,0,10,5,True
3319060,287,0,451,9243,773274125,0,0,0,687.97,7,371234.69,24,3,13,6,True
3328332,1353,4,25,2348,773274125,0,0,0,687.9,8,370546.79,24,2,0,6,True
3542730,1383,4,25,9707,773274125,0,0,0,687.89,8,369858.9,16,3,5,7,True
3646928,226,4,30,5414,773274125,0,0,0,687.97,8,369170.93,26,5,7,7,False
3897282,357,4,451,2359,773274125,0,0,0,688.09,7,368482.84,24,0,19,8,True
4350158,287,0,25,5376,773274125,0,0,0,688.0,8,367794.84,24,1,9,8,True
4533475,357,4,30,9863,773274125,0,0,0,687.97,8,367106.87,24,6,0,10,True
4852962,365,0,-1,3865,773274125,0,1,0,687.8,4,367106.87,25,2,21,10,True
4946368,568,1,10,3381,773274125,0,0,0,688.07,6,367794.94,11,2,22,11,True
5118874,1383,4,25,5376,773274125,0,0,0,688.16,8,367106.78,16,5,22,11,True
5124557,857,1,10,3148,773274125,0,0,0,688.1,6,367794.88,24,0,16,11,True
5296094,365,0,30,2825,773274125,0,0,0,688.16,8,367106.72,25,6,13,11,True
5628634,238,0,10,2348,773274125,0,0,0,687.88,6,367794.6,26,2,3,2,True
5792798,1451,1,10,3466,773274125,0,0,0,688.11,0,368482.71,11,0,21,2,True
5930938,820,1,10,2825,773274125,0,0,0,688.22,0,369170.93,18,3,12,3,True
5965878,1383,4,25,6321,773274125,0,0,0,688.28,8,368482.65,16,1,5,4,True
6062851,318,0,451,2825,773274125,0,0,0,688.11,7,367794.54,11,6,3,6,True
6230846,199,0,10,5376,773274125,0,0,0,688.08,6,368482.62,18,2,19,6,True
6433654,357,4,451,3466,773274125,0,0,0,687.85,7,367794.77,24,6,20,7,True
6577062,226,4,25,9863,773274125,0,0,0,687.92,8,367106.85,26,3,20,9,True
6826838,1383,4,451,5909,773274125,0,0,0,688.0,7,366418.85,16,5,9,9,True
6828981,365,0,25,5287,773274125,0,0,0,687.87,8,365730.98,25,2,4,9,True
7084594,1353,4,30,2506,773274125,0,0,0,687.73,8,365043.25,24,1,18,9,True
7216060,365,0,30,5909,773274125,0,0,0,687.9,8,364355.35,25,2,0,10,True
7246359,116,0,10,2160,773274125,0,0,0,687.87,6,365043.22,3,6,23,10,True
7252955,365,0,25,9696,773274125,0,0,0,687.93,8,364355.29,25,5,21,11,True
7524179,1298,0,20,6697,773274125,0,0,0,688.04,3,363667.25,5,3,6,12,True
7536181,287,0,-1,2389,773274125,0,1,0,688.0,4,363667.25,24,0,16,1,True
7568871,365,0,30,2160,773274125,0,0,0,688.21,8,362979.04,25,2,23,1,True
7587323,365,0,-1,9697,773274125,0,1,0,688.16,1,362979.04,25,0,1,2,True
7914712,1383,4,25,6321,773274125,0,0,0,688.07,8,362290.97,16,2,6,2,True
7920884,64,0,10,9243,773274125,0,0,0,688.13,0,362979.1,20,4,12,2,True
8069827,287,0,30,9530,773274125,0,0,0,688.33,8,362290.77,24,0,3,2,True
8327039,226,4,451,7129,773274125,0,0,0,688.0,7,361602.77,26,1,15,3,True
8344924,1353,4,451,4082,773274125,0,0,0,687.95,7,360914.82,24,5,3,3,False
8540451,365,0,25,6321,773274125,0,0,0,688.07,8,360226.75,25,2,3,4,True
8678658,365,0,30,4082,773274125,0,0,0,688.13,8,359538.62,25,5,10,4,True
8823622,1353,4,30,9478,773274125,0,0,0,688.06,8,358850.56,24,2,4,5,True
8991605,357,4,451,9100,773274125,0,0,0,687.92,7,358162.64,24,1,14,7,True
9001491,226,4,-1,6697,773274125,0,1,0,688.02,4,358162.64,26,2,20,7,True
9411718,428,0,10,3381,773274125,0,0,0,688.09,0,358850.73,18,6,5,7,True
9571118,203,0,10,2465,773274125,0,0,0,688.16,6,359538.89,9,1,19,9,True
9772075,1485,0,10,3695,773274125,0,0,0,688.04,0,360226.93,24,4,4,10,True
9870598,365,0,25,9530,773274125,0,0,0,687.97,8,359538.96,25,6,3,10,True
9996825,844,1,10,3695,773274125,0,0,0,688.0,6,360226.96,5,2,11,11,True
1064709,305,1,-1,8868,347544546,1,1,0,1126.03,1,302194.0,4,0,13,2,True
1122686,305,1,451,8868,347544546,1,0,0,1126.07,7,301067.93,4,1,6,3,True
1172275,1076,1,10,2149,347544546,1,0,0,1126.11,0,302194.04,18,5,16,3,True
1519858,1021,4,-1,6435,347544546,1,1,0,1126.07,4,302194.04,11,2,19,4,True
1703078,765,4,451,6099,347544546,1,0,0,1126.12,7,301067.92,14,0,9,5,True
2249780,464,1,10,2149,347544546,1,0,0,1126.02,0,302193.94,13,2,6,5,True
2326144,305,1,25,3514,347544546,1,0,0,1126.21,8,301067.73,4,2,9,6,True
2384124,765,4,30,5440,347544546,1,0,0,1126.17,8,299941.56,14,5,6,7,True
2476725,1119,0,30,8868,347544546,1,0,0,1126.12,8,298815.44,24,3,14,8,True
2812407,399,2,25,1332,347544546,1,0,0,1125.93,8,297689.51,10,2,10,8,True
2888543,305,1,451,2173,347544546,1,0,0,1125.93,7,296563.58,4,6,23,10,True
3125731,1119,0,30,5440,347544546,1,0,0,1125.83,8,295437.75,24,3,11,11,True
3286689,305,1,-1,8674,347544546,1,1,0,1126.0,4,295437.75,4,3,17,11,True
3530513,502,0,10,5823,347544546,1,0,0,1125.88,6,296563.63,12,3,18,12,True
3623499,1021,4,451,9034,347544546,1,0,0,1125.9,7,295437.73,11,3,11,12,True
3737894,305,1,30,2204,347544546,1,0,0,1126.0,8,294311.73,4,1,5,1,True
3775004,234,0,20,6435,347544546,1,0,0,1126.07,5,293185.66,26,3,22,2,True
3963793,1144,2,25,6099,347544546,1,0,0,1126.08,8,292059.58,15,0,21,2,True
4344051,1021,4,451,8868,347544546,1,0,0,1125.94,7,290933.64,11,4,23,2,True
4359835,1119,0,30,2149,347544546,1,0,0,1126.16,8,289807.48,24,5,19,2,True
4394346,305,1,25,5440,347544546,1,0,0,1126.12,8,288681.36,4,0,16,2,True
4510940,147,0,20,1314,347544546,1,0,0,1126.18,3,287555.18,18,6,4,3,True
4657475,800,0,10,6099,347544546,1,0,0,1125.91,6,288681.09,11,5,14,4,True
4751088,1127,0,10,6099,347544546,1,0,0,1125.98,6,289807.07,24,5,21,4,True
4883044,1137,1,10,7221,347544546,1,0,0,1126.24,6,290933.31,24,4,1,4,False
5001982,571,4,-1,8868,347544546,1,1,0,1125.92,4,290933.31,11,0,3,4,True
5014282,1144,2,25,6099,347544546,1,0,0,1126.34,8,289806.97,15,3,23,5,True
5540240,438,1,30,1332,347544546,1,0,0,1125.96,8,288681.01,24,4,1,5,True
5656064,300,0,20,1332,347544546,1,0,0,1126.25,5,287554.76,4,2,8,6,True
5735436,186,4,-1,8674,347544546,1,1,0,1125.82,1,287554.76,18,6,1,7,True
5882426,399,2,451,2149,347544546,1,0,0,1126.13,7,286428.63,10,0,17,7,True
5900361,305,1,30,3514,347544546,1,0,0,1126.11,8,285302.52,4,3,21,9,True
6101199,341,0,10,3495,347544546,1,0,0,1126.07,6,286428.59,24,1,18,9,True
6361056,525,0,10,3514,347544546,1,0,0,1126.01,6,287554.6,18,2,22,11,True
6551481,1021,4,30,2204,347544546,1,0,0,1125.97,8,286428.63,11,6,15,11,False
6569158,399,2,-1,9034,347544546,1,1,0,1125.93,4,286428.63,10,1,19,11,True
6598740,765,4,30,6435,347544546,1,0,0,1126.0,8,285302.63,14,2,6,12,True
6881597,765,4,30,9690,347544546,1,0,0,1126.02,8,284176.61,14,2,3,2,True
7101619,1144,2,451,7221,347544546,1,0,0,1125.83,7,283050.78,15,1,17,2,True
7142096,305,1,451,5440,347544546,1,0,0,1126.2,7,281924.58,4,0,17,3,True
7739717,1144,2,451,2173,347544546,1,0,0,1126.12,7,280798.46,15,0,3,3,True
8069076,1455,2,20,2173,347544546,1,0,0,1126.28,3,279672.18,11,2,12,4,True
8687628,550,0,20,3514,347544546,1,0,0,1125.63,5,278546.55,17,4,18,5,True
8696115,1021,4,30,1332,347544546,1,0,0,1126.03,8,277420.52,11,1,5,5,True
8790672,399,2,30,5440,347544546,1,0,0,1125.81,8,276294.71,10,6,5,7,True
8811806,1128,2,20,3514,347544546,1,0,0,1125.92,3,275168.79,24,5,11,7,True
8835691,186,4,451,6099,347544546,1,0,0,1125.87,7,274042.92,18,0,15,7,True
9079820,438,1,25,2149,347544546,1,0,0,1126.01,8,272916.91,24,6,1,8,True
9114830,1119,0,451,1332,347544546,1,0,0,1125.84,7,271791.07,24,2,17,8,True
9286083,1119,0,-1,2149,347544546,1,1,0,1126.11,4,271791.07,24,3,16,8,False
9881677,399,2,25,5823,347544546,1,0,0,1125.86,8,270665.21,10,6,9,10,True
9952018,1119,0,-1,5440,347544546,1,1,0,1126.2,1,270665.21,24,5,0,11,True
1161878,747,1,25,2070,593799844,1,0,0,846.97,8,792760.03,24,2,19,1,True
1501545,135,2,20,4273,593799844,1,0,0,846.92,3,791913.11,18,5,2,1,True
1605996,1238,0,10,4273,593799844,1,0,0,846.86,6,792759.97,18,5,8,1,True
2206525,748,1,-1,9277,593799844,1,1,0,847.01,4,792759.97,24,0,18,4,True
2516461,1350,4,30,1651,593799844,1,0,0,847.11,8,791912.86,24,2,0,4,True
2568135,65,3,30,2529,593799844,1,0,0,846.6,8,791066.26,20,2,13,4,True
2786445,118,2,20,3214,593799844,1,0,0,847.04,5,790219.22,18,4,1,4,True
2928668,1350,4,451,6135,593799844,1,0,0,847.28,7,789371.94,24,0,16,5,True
3113980,748,1,451,4273,593799844,1,0,0,846.8,7,788525.14,24,4,19,6,False
3131205,65,3,-1,7709,593799844,1,1,0,847.13,1,788525.14,20,2,4,6,True
3297050,65,3,-1,1651,593799844,1,2,0,847.04,4,788525.14,20,4,8,6,True
3357663,480,0,30,7672,593799844,1,0,0,846.94,8,787678.2,5,1,0,7,True
3580446,1350,4,451,6135,593799844,1,0,0,847.02,7,786831.18,24,3,9,7,True
3653308,1065,0,451,9277,593799844,1,0,0,847.19,7,785983.99,11,4,23,7,True
3709546,65,3,451,5538,593799844,1,0,0,846.9,7,785137.09,20,6,23,8,True
3890187,480,0,451,9798,593799844,1,0,0,846.9,7,784290.19,5,0,6,8,True
4135618,748,1,25,9277,593799844,1,0,0,847.12,8,783443.07,24,3,1,10,True
4138737,1350,4,451,4821,593799844,1,0,0,846.96,7,782596.11,24,1,0,10,True
4377551,65,3,-1,8864,593799844,1,1,0,847.02,4,782596.11,20,1,19,10,True
4485638,480,0,451,3422,593799844,1,0,0,846.69,7,781749.42,5,5,1,10,True
4504425,1350,4,30,3214,593799844,1,0,0,847.13,8,780902.29,24,4,20,11,True
5041370,747,1,25,4273,593799844,1,0,0,847.23,8,780055.06,24,6,16,11,True
5052942,747,1,-1,8120,593799844,1,1,0,847.34,4,780055.06,24,4,3,11,True
5066559,65,3,-1,4821,593799844,1,2,0,847.15,4,780055.06,20,3,2,12,True
5080240,1065,0,25,3422,593799844,1,0,0,847.01,8,779208.05,11,2,5,1,True
5147177,787,0,20,5538,593799844,1,0,0,846.78,3,778361.27,14,2,21,1,True
5188572,747,1,25,5538,593799844,1,0,0,847.32,8,777513.95,24,4,11,2,True
5218554,1350,4,25,2070,593799844,1,0,0,847.04,8,776666.91,24,3,2,3,True
5320579,747,1,451,5538,593799844,1,0,0,847.28,7,775819.63,24,5,21,3,True
5946134,783,0,10,3422,593799844,1,0,0,846.99,0,776666.62,14,6,8,3,True
5968687,1350,4,30,3422,593799844,1,0,0,847.12,8,775819.5,24,4,1,3,True
6199626,123,0,20,3422,593799844,1,0,0,847.08,5,774972.42,18,4,15,3,True
6572252,747,1,451,2070,593799844,1,0,0,847.07,7,774125.35,24,5,0,4,True
6672633,320,1,10,2070,593799844,1,0,0,847.26,6,774972.61,11,4,18,4,True
6719881,480,0,25,3422,593799844,1,0,0,847.3,8,774125.31,5,3,20,6,True
6745109,1350,4,451,4071,593799844,1,0,0,846.74,7,773278.57,24,3,11,6,True
6786646,65,3,25,9798,593799844,1,0,0,846.8,8,772431.77,20,2,22,7,False
6865708,799,2,20,4713,593799844,1,0,0,846.96,3,771584.81,11,3,16,7,True
6905155,1303,0,10,5538,593799844,1,0,0,847.12,0,772431.93,5,4,3,7,True
7344226,1471,0,10,2529,593799844,1,0,0,846.86,6,773278.79,24,2,8,8,False
7408699,1350,4,451,8778,593799844,1,0,0,847.07,7,772431.72,24,6,8,8,True
7465612,1065,0,25,6135,593799844,1,0,0,846.86,8,771584.86,11,1,5,10,True
7788460,1413,0,10,1651,593799844,1,0,0,847.04,0,772431.9,24,1,3,11,True
8014538,951,0,20,4071,593799844,1,0,0,847.13,5,771584.77,24,2,23,11,True
8689720,1065,0,451,2529,593799844,1,0,0,847.04,7,770737.73,11,2,13,12,True
8845086,747,1,451,7672,593799844,1,0,0,847.07,7,769890.66,24,6,17,2,True
9012801,1065,0,451,4071,593799844,1,0,0,846.79,7,769043.87,11,1,3,3,True
9048362,1065,0,-1,8864,593799844,1,1,0,846.81,1,769043.87,11,4,0,4,True
9202896,65,3,25,4821,593799844,1,0,0,847.16,8,768196.71,20,0,9,5,True
9229154,53,0,10,6135,593799844,1,0,0,846.74,6,769043.45,20,2,16,5,True
9428025,65,3,-1,5538,593799844,1,1,0,846.85,4,769043.45,20,1,14,6,True
9476693,480,0,30,3422,593799844,1,0,0,847.07,8,768196.38,5,4,18,7,True
9516928,1350,4,30,2070,593799844,1,0,0,846.98,8,767349.4,24,3,20,9,True
9877259,579,0,20,2070,593799844,1,0,0,846.87,5,766502.53,11,6,1,9,True
9982083,1065,0,451,8864,593799844,1,0,0,847.1,7,765655.43,11,1,9,10,True
1195016,859,2,20,9156,247321389,1,0,0,844.92,5,842186.08,24,1,1,1,True
1605209,838,4,-1,3871,247321389,1,1,0,844.99,4,842186.08,5,1,20,1,True
1842865,1035,0,25,8821,247321389,1,0,0,844.93,8,841341.15,11,0,10,1,True
2079919,1121,3,451,1998,247321389,1,0,0,845.07,7,840496.08,24,2,18,2,True
2128493,940,1,10,9739,247321389,1,0,0,844.95,0,841341.03,24,6,19,2,True
2218915,838,4,25,8821,247321389,1,0,0,844.83,8,840496.2,5,1,2,2,True
2230972,316,2,30,6426,247321389,1,0,0,844.86,8,839651.34,4,3,18,3,True
2281077,838,4,25,5915,247321389,1,0,0,844.91,8,838806.43,5,6,2,3,True
2354352,1121,3,-1,6590,247321389,1,1,0,845.19,4,838806.43,24,5,18,4,True
2399311,838,4,-1,6426,247321389,1,2,0,845.07,4,838806.43,5,5,7,5,True
2583654,1401,1,10,6426,247321389,1,0,0,845.19,6,839651.62,24,4,4,5,True
2659240,698,4,25,9314,247321389,1,0,0,844.81,8,838806.81,18,4,13,6,True
2773314,1412,2,20,4641,247321389,1,0,0,845.06,5,837961.75,24,3,0,6,True
3070256,1145,4,30,5071,247321389,1,0,0,844.95,8,837116.8,15,1,8,8,True
3399006,838,4,25,9278,247321389,1,0,0,845.12,8,836271.68,5,6,21,9,True
3402716,398,0,10,6426,247321389,1,0,0,845.33,6,837117.01,10,1,17,10,True
3499270,1145,4,25,5418,247321389,1,0,0,844.99,8,836272.02,15,0,17,10,True
3773685,931,0,20,2415,247321389,1,0,0,845.26,5,835426.76,24,2,2,10,True
3902523,307,4,30,6866,247321389,1,0,0,844.76,8,834582.0,4,5,16,11,True
4334520,307,4,-1,9278,247321389,1,1,0,844.84,4,834582.0,4,6,6,11,True
4373325,1035,0,451,3871,247321389,1,0,0,844.83,7,833737.17,11,4,22,1,True
4405691,708,2,20,6426,247321389,1,0,0,844.87,5,832892.3,18,0,0,2,True
4439917,1035,0,30,6426,247321389,1,0,0,845.04,8,832047.26,11,3,10,3,True
4599161,1035,0,451,5460,247321389,1,0,0,845.2,7,831202.06,11,5,23,4,True
5047073,1145,4,451,2434,247321389,1,0,0,844.91,7,830357.15,15,2,4,4,True
5178127,1121,3,451,6866,247321389,1,0,0,845.16,7,829511.99,24,0,0,5,True
5304175,999,4,25,5071,247321389,1,0,0,845.22,8,828666.77,26,1,5,5,True
5448440,1278,0,20,5071,247321389,1,0,0,844.98,3,827821.79,24,5,19,6,True
5615247,1145,4,-1,6974,247321389,1,1,0,844.91,4,827821.79,15,1,10,7,True
5662028,1227,0,10,4641,247321389,1,0,0,844.76,6,828666.55,18,5,9,7,True
5821510,307,4,25,5460,247321389,1,0,0,845.23,8,827821.32,4,0,7,7,True
5903870,1121,3,30,6590,247321389,1,0,0,845.04,8,826976.28,24,3,3,8,True
5939969,47,1,10,6360,247321389,1,0,0,844.89,0,827821.17,24,1,2,8,True
6245476,1121,3,-1,5460,247321389,1,1,0,844.96,1,827821.17,24,5,16,9,True
6372389,626,2,20,9156,247321389,1,0,0,845.14,3,826976.03,11,2,21,10,True
6571717,937,0,20,5330,247321389,1,0,0,845.11,5,826130.92,24,5,12,10,True
6578392,999,4,30,9314,247321389,1,0,0,845.27,8,825285.65,26,4,3,10,True
7157217,1121,3,-1,2415,247321389,1,1,0,844.93,4,825285.65,24,6,8,10,True
7318972,1145,4,451,9739,247321389,1,0,0,845.02,7,824440.63,15,3,15,11,True
7357086,1035,0,451,3025,247321389,1,0,0,844.93,7,823595.7,11,6,17,12,True
7457630,838,4,451,6712,247321389,1,0,0,845.03,7,822750.67,5,2,20,12,True
7915008,316,2,25,9739,247321389,1,0,0,844.74,8,821905.93,4,5,6,12,True
8129558,457,0,20,9156,247321389,1,0,0,844.93,3,821061.0,13,2,20,1,True
8139084,316,2,25,8821,247321389,1,0,0,844.82,8,820216.18,4,4,1,1,True
8445364,999,4,30,5915,247321389,1,0,0,844.91,8,819371.27,26,3,22,3,True
8517526,1121,3,25,6360,247321389,1,0,0,845.16,8,818526.11,24,6,13,3,True
8723070,307,4,25,1586,247321389,1,0,0,844.9,8,817681.21,4,1,19,4,True
8773723,307,4,30,6712,247321389,1,0,0,845.03,8,816836.18,4,3,15,4,True
9059202,1145,4,30,3025,247321389,1,0,0,844.92,8,815991.26,15,0,1,4,True
9115830,1110,0,10,1998,247321389,1,0,0,844.88,6,816836.14,0,3,2,5,True
9302740,999,4,451,2481,247321389,1,0,0,845.05,7,815991.09,26,5,18,6,True
9343797,838,4,25,5330,247321389,1,0,0,845.01,8,815146.08,5,0,11,6,True
9357760,316,2,30,9739,247321389,1,0,0,844.88,8,814301.2,4,6,23,7,True
9430577,307,4,-1,5330,247321389,1,1,0,845.1,4,814301.2,4,3,19,7,True
9468386,1145,4,30,6590,247321389,1,0,0,845.24,8,813455.96,15,4,12,7,True
9740492,914,2,20,6360,247321389,1,0,0,844.93,5,812611.03,18,5,1,8,True
9849985,1121,3,30,5418,247321389,1,0,0,845.01,8,811766.02,24,6,3,8,True
1003674,1120,4,451,2902,177611200,1,0,0,886.78,7,311678.22,24,5,20,1,True
1800139,1488,0,451,7675,177611200,1,0,0,886.95,7,310791.27,24,5,10,1,True
1823029,857,1,10,6902,177611200,1,0,0,887.18,6,311678.45,24,0,11,2,True
1979071,159,2,25,1934,177611200,1,0,0,887.02,8,310791.43,24,6,7,3,True
2013458,159,2,30,3779,177611200,1,0,0,886.99,8,309904.44,24,6,23,3,True
2259734,950,0,10,9177,177611200,1,0,0,887.04,6,310791.48,24,0,23,3,True
2663211,1334,3,30,1293,177611200,1,0,0,887.19,8,309904.29,18,6,9,4,True
2831256,159,2,-1,3779,177611200,1,1,0,886.9,4,309904.29,24,3,14,4,True
3092767,302,1,-1,4112,177611200,1,2,0,887.1,1,309904.29,4,1,7,4,True
3608396,1488,0,25,4107,177611200,1,0,0,887.06,8,309017.23,24,0,21,8,True
3838821,159,2,451,3779,177611200,1,0,0,887.09,7,308130.14,24,2,8,10,True
3847650,729,0,10,4408,177611200,1,0,0,887.04,6,309017.18,11,2,2,10,True
3957910,1318,0,10,5328,177611200,1,0,0,886.8,6,309903.98,18,4,21,10,True
4034414,1120,4,451,9641,177611200,1,0,0,887.11,7,309016.87,24,0,11,10,True
4041106,1469,4,451,4049,177611200,1,0,0,886.87,7,308130.0,11,1,13,11,True
4253836,159,2,451,9641,177611200,1,0,0,887.08,7,307242.92,24,2,7,11,True
4333924,591,0,20,4674,177611200,1,0,0,886.94,5,306355.98,24,0,4,12,True
4338539,879,1,10,1934,177611200,1,0,0,887.05,6,307243.03,27,0,12,12,True
4339323,1334,3,451,9641,177611200,1,0,0,886.81,7,306356.22,18,4,23,12,True
4504986,1120,4,25,4049,177611200,1,0,0,886.86,8,305469.36,24,6,16,1,True
4832536,159,2,-1,9223,177611200,1,1,0,886.94,4,305469.36,24,0,6,1,True
5410435,159,2,-1,4107,177611200,1,2,0,887.2,1,305469.36,24,3,19,3,True
5636240,53,0,20,3363,177611200,1,0,0,886.95,3,304582.41,20,4,9,3,True
5659850,1120,4,25,3363,177611200,1,0,0,887.15,8,303695.26,24,3,6,4,True
5794813,1334,3,-1,1513,177611200,1,1,0,887.02,4,303695.26,18,1,19,4,True
6004340,220,0,10,1293,177611200,1,0,0,886.83,6,304582.09,26,5,17,4,True
6087837,1380,0,20,6140,177611200,1,0,0,887.18,5,303694.91,16,3,6,4,True
6558474,302,1,-1,6140,177611200,1,1,0,887.15,4,303694.91,4,1,19,5,True
6831008,159,2,451,9223,177611200,1,0,0,887.19,7,302807.72,24,5,18,6,True
6858783,1120,4,30,9387,177611200,1,0,0,886.92,8,301920.8,24,1,8,7,True
7075868,302,1,451,6334,177611200,1,0,0,887.1,7,301033.7,4,5,1,7,True
7209544,1334,3,25,3779,177611200,1,0,0,887.3,8,300146.4,18,0,0,7,True
7285720,1488,0,-1,9372,177611200,1,1,0,887.23,4,300146.4,24,3,17,8,True
7297221,1488,0,-1,1293,177611200,1,2,0,887.11,4,300146.4,24,5,18,9,True
7456578,129,0,10,5328,177611200,1,0,0,886.81,6,301033.21,18,5,20,10,True
7608816,159,2,-1,4049,177611200,1,1,0,886.99,4,301033.21,24,3,19,11,True
7750741,611,0,20,9764,177611200,1,0,0,886.86,3,300146.35,11,3,13,12,True
7779126,1449,0,10,2902,177611200,1,0,0,886.97,6,301033.32,11,6,11,1,True
7833231,1488,0,-1,2977,177611200,1,1,0,887.0,4,301033.32,24,2,7,1,True
7899213,1120,4,-1,4107,177611200,1,2,0,886.98,1,301033.32,24,3,7,2,True
8123181,1334,3,30,6902,177611200,1,0,0,887.11,8,300146.21,18,3,8,2,True
8195761,96,0,20,7569,177611200,1,0,0,887.1,5,299259.11,1,4,15,3,True
8331841,1120,4,25,4674,177611200,1,0,0,887.05,8,298372.06,24,5,9,4,True
8359761,1488,0,451,9685,177611200,1,0,0,886.96,7,297485.1,24,5,17,5,True
8520422,159,2,-1,8393,177611200,1,1,0,886.74,4,297485.1,24,0,14,5,True
8539942,457,0,-1,1293,177611200,1,2,0,886.76,4,297485.1,13,2,11,5,True
8583732,1488,0,25,6140,177611200,1,0,0,887.11,8,296597.99,24,4,21,5,True
8666667,53,0,20,4674,177611200,1,0,0,886.86,3,295711.13,20,0,23,6,True
8838853,457,0,25,2902,177611200,1,0,0,886.92,8,294824.21,13,4,23,6,True
8907722,1469,4,-1,4049,177611200,1,1,0,887.04,4,294824.21,11,3,1,7,True
8912102,1469,4,-1,9387,177611200,1,2,0,887.06,1,294824.21,11,6,12,7,True
9111015,979,0,10,9837,177611200,1,0,0,887.14,0,295711.35,22,3,21,7,True
9168713,1120,4,25,2902,177611200,1,0,0,886.81,8,294824.54,24,3,8,8,True
9363056,1166,2,20,9685,177611200,1,0,0,887.11,5,293937.43,24,0,9,10,True
9853524,1334,3,30,8393,177611200,1,0,0,886.87,8,293050.56,18,0,17,11,True
9982456,53,0,10,9538,177611200,1,0,0,887.06,6,293937.62,20,4,20,11,False
1084413,1336,2,-1,6277,147285147,0,1,0,873.01,4,499308.0,18,2,7,2,True
1481054,999,4,30,8279,147285147,0,0,0,873.16,8,498434.84,26,4,0,2,False
1985964,1463,2,30,1763,147285147,0,0,0,872.91,8,497561.93,11,0,1,2,True
2405310,999,4,30,1299,147285147,0,0,0,873.11,8,496688.82,26,2,23,4,True
2545339,653,1,10,4400,147285147,0,0,0,873.13,0,497561.95,24,2,4,6,True
2552467,999,4,30,4438,147285147,0,0,0,872.75,8,496689.2,26,2,14,6,True
2556231,1336,2,30,1299,147285147,0,0,0,872.96,8,495816.24,18,2,8,7,True
2654097,1455,2,20,7311,147285147,0,0,0,873.03,5,494943.21,11,3,12,8,True
2920073,960,3,25,5319,147285147,0,0,0,872.93,8,494070.28,13,2,1,9,True
2994185,282,2,20,3758,147285147,0,0,0,873.04,3,493197.24,24,6,0,12,True
3373860,300,0,20,6868,147285147,0,0,0,872.96,5,492324.28,4,1,16,1,True
3713961,1463,2,451,9388,147285147,0,0,0,873.09,7,491451.19,11,4,10,1,True
4104044,385,1,25,2024,147285147,0,0,0,873.07,8,490578.12,25,1,6,1,True
4123063,114,0,10,6651,147285147,0,0,0,873.11,6,491451.23,3,6,5,2,True
4273799,1160,0,20,4556,147285147,0,0,0,873.1,5,490578.13,15,4,15,3,True
4358863,385,1,-1,9388,147285147,0,1,0,872.89,4,490578.13,25,1,5,3,True
4449741,1336,2,25,2024,147285147,0,0,0,873.13,8,489705.0,18,6,10,4,True
5502584,1336,2,30,6598,147285147,0,0,0,873.08,8,488831.92,18,5,20,6,True
5781876,960,3,30,9388,147285147,0,0,0,872.95,8,487958.97,13,3,2,6,True
5890039,385,1,-1,8645,147285147,0,1,0,873.09,4,487958.97,25,5,16,7,True
6279281,960,3,451,8645,147285147,0,0,0,872.56,7,487086.41,13,0,8,9,True
6363579,960,3,30,1360,147285147,0,0,0,873.34,8,486213.07,13,1,7,10,True
6377137,1196,4,25,8560,147285147,0,0,0,873.04,8,485340.03,24,4,11,11,True
6463297,609,3,451,1763,147285147,0,0,0,872.7,7,484467.33,24,0,4,11,True
6741784,1271,0,20,2678,147285147,0,0,0,873.03,5,483594.3,23,0,23,11,True
6980782,1463,2,25,9393,147285147,0,0,0,872.94,8,482721.36,11,5,0,12,True
7076316,715,0,20,4400,147285147,0,0,0,873.2,5,481848.16,18,0,12,1,True
7100044,794,2,20,4400,147285147,0,0,0,873.07,5,480975.09,11,6,23,2,True
7217691,960,3,451,6730,147285147,0,0,0,873.2,7,480101.89,13,3,18,2,True
7502531,1336,2,451,9388,147285147,0,0,0,873.14,7,479228.75,18,0,12,2,True
7584974,1463,2,30,9393,147285147,0,0,0,873.07,8,478355.68,11,6,16,3,True
7775871,609,3,451,1299,147285147,0,0,0,873.1,7,477482.58,24,4,19,3,True
8280460,816,0,20,4400,147285147,0,0,0,872.89,5,476609.69,18,5,19,3,True
8823659,342,0,20,3597,147285147,0,0,0,872.99,3,475736.7,24,6,22,3,True
8934931,1463,2,25,6651,147285147,0,0,0,872.84,8,474863.86,11,2,23,4,True
8972293,609,3,451,4680,147285147,0,0,0,872.86,7,473991.0,24,5,3,5,True
8986836,1336,2,-1,4556,147285147,0,1,0,872.93,1,473991.0,18,3,15,5,True
9052459,385,1,451,9555,147285147,0,0,0,873.04,7,473117.96,25,4,12,5,True
9181965,960,3,-1,6277,147285147,0,1,0,872.91,4,473117.96,13,1,1,5,True
9199824,1278,0,10,8870,147285147,0,0,0,872.76,6,473990.72,24,2,4,6,True
9243897,609,3,-1,9555,147285147,0,1,0,872.97,4,473990.72,24,4,15,6,True
9257623,609,3,30,9388,147285147,0,0,0,872.95,8,473117.77,24,1,18,7,True
9325722,910,0,20,6277,147285147,0,0,0,872.81,5,472244.96,18,2,12,8,True
9486005,999,4,-1,2024,147285147,0,1,0,872.74,4,472244.96,26,6,6,8,True
9509735,385,1,451,2678,147285147,0,0,0,872.94,7,471372.02,25,6,23,9,True
9549525,1463,2,451,3758,147285147,0,0,0,873.01,7,470499.01,11,6,22,9,True
9629768,999,4,451,7618,147285147,0,0,0,873.09,7,469625.92,26,1,12,9,True
9764167,238,0,20,1299,147285147,0,0,0,872.92,5,468753.0,26,5,3,11,True
9859911,385,1,-1,9388,147285147,0,1,0,873.22,1,468753.0,25,1,17,11,True
9895013,208,0,10,1934,147285147,0,0,0,872.9,6,469625.9,9,4,2,11,True
1045100,711,2,451,5656,531163525,1,0,0,670.84,7,878349.16,18,6,6,1,True
1125627,504,4,30,1172,531163525,1,0,0,671.33,8,877677.83,12,4,9,3,True
1459441,504,4,25,3251,531163525,1,0,0,670.98,8,877006.85,12,0,16,3,True
1537409,660,3,30,5243,531163525,1,0,0,670.85,8,876336.0,18,0,23,3,True
1657280,929,0,10,2790,531163525,1,0,0,671.09,6,877007.09,18,1,13,4,True
2480129,15,4,-1,1196,531163525,1,1,0,671.24,4,877007.09,24,5,23,4,True
2507231,660,3,451,6921,531163525,1,0,0,670.81,7,876336.28,18,4,3,5,True
2534990,1262,0,-1,5232,531163525,1,1,0,670.84,4,876336.28,23,4,2,6,True
2736346,791,3,30,3425,531163525,1,0,0,671.33,8,875664.95,11,0,8,6,True
2822417,791,3,25,2557,531163525,1,0,0,671.21,8,874993.74,11,6,9,7,True
2870848,616,1,10,1465,531163525,1,0,0,670.56,0,875664.3,11,6,13,7,True
3293136,504,4,30,5243,531163525,1,0,0,671.16,8,874993.14,12,5,3,8,True
3315931,504,4,451,3425,531163525,1,0,0,670.88,7,874322.26,12,5,17,8,True
3492205,711,2,25,5243,531163525,1,0,0,671.24,8,873651.02,18,1,5,8,True
3767579,1399,0,10,4564,531163525,1,0,0,670.82,0,874321.84,24,6,6,9,True
4020673,791,3,-1,2810,531163525,1,1,0,670.86,4,874321.84,11,0,9,9,True
4247248,1262,0,451,6576,531163525,1,0,0,670.94,7,873650.9,23,0,9,9,True
4395084,694,2,25,8699,531163525,1,0,0,670.85,8,872980.05,24,3,7,11,True
4446860,711,2,-1,1452,531163525,1,1,0,671.19,4,872980.05,18,4,8,11,True
4626201,15,4,25,4954,531163525,1,0,0,670.95,8,872309.1,24,5,6,12,True
4668793,791,3,-1,3425,531163525,1,1,0,671.03,4,872309.1,11,2,12,12,True
4700250,14,2,20,2810,531163525,1,0,0,671.09,3,871638.01,24,4,7,12,True
4804263,711,2,451,5656,531163525,1,0,0,670.89,7,870967.12,18,0,9,1,True
4850635,660,3,-1,7913,531163525,1,1,0,670.98,4,870967.12,18,4,9,1,True
4917603,334,0,20,4954,531163525,1,0,0,671.02,3,870296.1,11,5,7,3,True
4932877,660,3,451,2557,531163525,1,0,0,670.89,7,869625.21,18,1,19,3,True
5488400,1449,0,10,6231,531163525,1,0,0,671.15,0,870296.36,11,3,10,3,True
5624077,577,0,10,7913,531163525,1,0,0,670.82,6,870967.18,11,4,14,4,False
5950645,504,4,30,6921,531163525,1,0,0,671.01,8,870296.17,12,5,8,4,True
6007264,791,3,451,5656,531163525,1,0,0,670.96,7,869625.21,11,0,14,5,True
6035360,1399,0,20,4954,531163525,1,0,0,671.15,5,868954.06,24,5,12,5,True
6076361,1262,0,451,2557,531163525,1,0,0,671.0,7,868283.06,23,1,4,7,True
6087733,531,0,20,5232,531163525,1,0,0,671.34,5,867611.72,18,0,18,7,True
6124823,1262,0,451,6231,531163525,1,0,0,671.19,7,866940.53,23,1,5,8,True
6143677,504,4,-1,8699,531163525,1,1,0,670.93,1,866940.53,12,0,7,9,True
6165894,694,2,25,3425,531163525,1,0,0,670.89,8,866269.64,24,0,18,9,True
6520056,711,2,-1,3251,531163525,1,1,0,670.9,4,866269.64,18,2,14,10,True
6529220,660,3,451,5656,531163525,1,0,0,671.02,7,865598.62,18,4,9,10,True
6535201,1262,0,30,6576,531163525,1,0,0,671.03,8,864927.59,23,4,20,11,True
6556682,504,4,451,3425,531163525,1,0,0,671.14,7,864256.45,12,4,23,11,True
6657490,660,3,30,9096,531163525,1,0,0,671.07,8,863585.38,18,2,4,11,True
6718251,1262,0,-1,1172,531163525,1,1,0,670.94,1,863585.38,23,1,23,12,True
6853219,635,2,20,1172,531163525,1,0,0,671.04,3,862914.34,24,6,13,1,True
7040284,711,2,30,3251,531163525,1,0,0,671.06,8,862243.28,18,1,21,1,True
7069410,791,3,25,6921,531163525,1,0,0,670.94,8,861572.34,11,0,9,2,True
7078139,15,4,451,1196,531163525,1,0,0,671.24,7,860901.1,24,3,5,3,True
7351654,234,0,10,4954,531163525,1,0,0,670.91,0,861572.01,26,4,7,3,True
7405726,15,4,-1,4564,531163525,1,1,0,670.97,4,861572.01,24,5,0,4,True
7452422,660,3,25,7913,531163525,1,0,0,670.89,8,860901.12,18,0,15,5,True
7811578,504,4,30,7353,531163525,1,0,0,670.93,8,860230.19,12,4,16,6,True
8410839,694,2,25,3251,531163525,1,0,0,671.08,8,859559.11,24,3,23,6,True
8499639,694,2,25,6921,531163525,1,0,0,670.78,8,858888.33,24,4,0,7,True
9257802,630,0,20,4665,531163525,1,0,0,671.02,3,858217.31,11,3,15,8,True
9368677,1101,2,20,2810,531163525,1,0,0,671.1,3,857546.21,0,3,2,9,False
9538188,616,1,10,1196,531163525,1,0,0,671.0,0,858217.21,11,2,13,10,True
9688616,694,2,451,7913,531163525,1,0,0,670.97,7,857546.24,24,3,9,10,False
9844142,791,3,451,4564,531163525,1,0,0,671.33,7,856874.91,11,4,4,10,True
9871040,504,4,451,9096,531163525,1,0,0,670.77,7,856204.14,12,2,23,11,True
1066018,1233,0,10,2271,866774946,1,0,0,165.91,6,599419.91,18,4,13,2,True
1179239,366,0,20,8746,866774946,1,0,0,165.8,5,599254.11,25,0,13,4,True
1586877,511,1,10,4748,866774946,1,0,0,165.84,6,599419.95,12,2,20,5,True
1670105,655,3,30,2271,866774946,1,0,0,165.94,8,599254.01,18,6,4,4,True
1768804,940,1,10,3260,866774946,1,0,0,165.87,6,599419.88,24,1,16,6,True
1835907,1311,2,451,9027,866774946,1,0,0,165.86,7,599254.02,5,2,19,8,True
2019873,286,1,451,8034,866774946,1,0,0,166.16,7,599087.86,24,3,4,10,True
2045199,158,2,20,4683,866774946,1,0,0,165.58,3,598922.28,24,4,0,2,True
2310163,746,4,30,1823,866774946,1,0,0,166.13,8,598756.15,24,2,17,5,True
2576300,930,3,-1,4748,866774946,1,1,0,166.04,4,598756.15,18,3,4,9,False
3030345,286,1,-1,3583,866774946,1,2,0,166.19,4,598756.15,24,4,9,11,True
3228192,1192,2,-1,1002,866774946,1,3,1,165.86,4,598756.15,24,2,17,11,False
1126054,769,3,451,5932,829433057,0,0,0,1147.05,7,900513.95,14,4,4,1,True
1153343,1481,4,451,1250,829433057,0,0,0,1146.99,7,899366.96,24,5,3,2,True
1273460,76,0,20,7294,829433057,0,0,0,1147.17,5,898219.79,20,2,19,3,True
1369359,1468,1,10,1083,829433057,0,0,0,1147.14,6,899366.93,11,6,21,3,True
1548432,269,0,30,4852,829433057,0,0,0,1146.96,8,898219.97,24,3,0,3,True
1716813,388,3,-1,3494,829433057,0,1,0,1146.91,4,898219.97,10,6,14,4,True
1878152,260,0,20,6195,829433057,0,0,0,1146.7,5,897073.27,6,6,0,5,True
2221892,217,4,30,9738,829433057,0,0,0,1147.17,8,895926.1,9,1,1,5,True
2321151,300,0,10,9050,829433057,0,0,0,1147.26,6,897073.36,4,6,17,6,True
2641914,269,0,451,4852,829433057,0,0,0,1147.09,7,895926.27,24,0,3,6,True
2663807,1115,1,10,4223,829433057,0,0,0,1146.95,0,897073.22,0,4,5,6,True
3279814,192,2,451,1250,829433057,0,0,0,1146.95,7,895926.27,18,6,0,6,True
3424593,1112,1,451,1083,829433057,0,0,0,1147.2,7,894779.07,0,1,0,6,True
3425985,192,2,30,8781,829433057,0,0,0,1146.96,8,893632.11,18,1,1,6,True
4034917,607,2,30,9738,829433057,0,0,0,1147.11,8,892485.0,24,5,23,7,True
4056163,769,3,-1,4871,829433057,0,1,0,1147.22,1,892485.0,14,5,2,7,True
4596114,429,0,10,3494,829433057,0,0,0,1146.85,0,893631.85,24,6,22,7,True
4650032,365,0,20,9782,829433057,0,0,0,1147.09,5,892484.76,25,3,12,7,True
4790118,1112,1,30,9738,829433057,0,0,0,1147.13,8,891337.63,0,0,9,8,True
5024317,1124,0,20,9661,829433057,0,0,0,1147.05,5,890190.58,24,2,17,8,True
5034758,1112,1,451,7294,829433057,0,0,0,1146.95,7,889043.63,0,3,1,9,True
5152085,769,3,451,4223,829433057,0,0,0,1147.01,7,887896.62,14,6,16,9,True
5362592,446,1,10,1672,829433057,0,0,0,1147.02,6,889043.64,13,1,1,10,True
5377675,607,2,451,9661,829433057,0,0,0,1147.0,7,887896.64,24,3,0,10,True
5429908,769,3,-1,6892,829433057,0,1,0,1147.02,1,887896.64,14,4,1,10,True
5613641,573,0,10,9738,829433057,0,0,0,1146.94,0,889043.58,11,5,6,11,True
5695590,1476,0,10,7688,829433057,0,0,0,1147.3,6,890190.88,24,0,22,12,True
5794354,388,3,25,9826,829433057,0,0,0,1146.92,8,889043.96,10,4,23,12,True
6043759,1063,0,10,9050,829433057,0,0,0,1146.74,6,890190.7,11,3,18,12,True
6177725,1481,4,-1,8781,829433057,0,1,0,1146.96,4,890190.7,24,3,17,3,True
6241976,1307,0,20,9782,829433057,0,0,0,1147.14,5,889043.56,5,6,14,4,True
6265575,1112,1,-1,9782,829433057,0,1,0,1146.95,4,889043.56,0,0,9,5,True
6271129,769,3,451,3494,829433057,0,0,0,1147.06,7,887896.5,14,3,16,6,True
6312217,607,2,-1,4852,829433057,0,1,0,1146.9,4,887896.5,24,0,15,6,True
6387791,337,1,10,6195,829433057,0,0,0,1147.0,6,889043.5,11,6,13,8,True
6415067,217,4,-1,3052,829433057,0,1,0,1146.95,4,889043.5,9,0,15,9,True
6477607,403,0,10,1672,829433057,0,0,0,1146.9,0,890190.4,10,1,8,9,True
6563591,1481,4,451,6407,829433057,0,0,0,1147.29,7,889043.11,24,5,7,9,True
6790280,269,0,30,5929,829433057,0,0,0,1146.97,8,887896.14,24,1,8,9,True
6987735,889,0,20,6892,829433057,0,0,0,1147.06,5,886749.08,27,4,8,9,True
7221154,217,4,451,1672,829433057,0,0,0,1147.11,7,885601.97,9,3,19,10,True
7294977,769,3,30,8781,829433057,0,0,0,1147.2,8,884454.77,14,5,8,11,True
7617112,1326,3,451,2029,829433057,0,0,0,1146.94,7,883307.83,18,2,18,2,True
7748004,388,3,451,1221,829433057,0,0,0,1147.01,7,882160.82,10,1,15,2,True
7810474,388,3,25,3494,829433057,0,0,0,1146.85,8,881013.97,10,1,19,3,True
7874216,429,0,20,6407,829433057,0,0,0,1147.09,3,879866.88,24,3,20,3,True
8065359,769,3,-1,3052,829433057,0,1,0,1147.05,1,879866.88,14,3,16,4,True
8211510,217,4,451,4223,829433057,0,0,0,1146.99,7,878719.89,9,2,13,4,True
8213645,222,2,20,3494,829433057,0,0,0,1147.23,3,877572.66,26,4,5,6,True
8230075,769,3,30,4852,829433057,0,0,0,1146.87,8,876425.79,14,6,23,6,True
8314345,192,2,25,9826,829433057,0,0,0,1147.19,8,875278.6,18,2,1,6,True
8409756,769,3,451,7688,829433057,0,0,0,1147.12,7,874131.48,14,4,0,7,True
8568694,269,0,-1,1221,829433057,0,1,0,1146.84,1,874131.48,24,6,10,7,True
8727693,192,2,25,1221,829433057,0,0,0,1146.89,8,872984.59,18,3,11,8,True
8728788,269,0,30,4852,829433057,0,0,0,1146.83,8,871837.76,24,2,11,9,True
9300519,217,4,451,7294,829433057,0,0,0,1147.14,7,870690.62,9,0,1,9,True
9320158,1481,4,451,4852,829433057,0,0,0,1147.09,7,869543.53,24,4,10,10,True
9839616,192,2,25,5606,829433057,0,0,0,1146.91,8,868396.62,18,4,9,10,True
9868041,1481,4,-1,1083,829433057,0,1,0,1146.72,4,868396.62,24,5,6,11,True
1217052,457,0,20,4315,242499731,1,0,0,217.9,5,366982.1,13,6,9,1,True
1377145,1492,4,-1,3105,242499731,1,1,0,217.98,4,366982.1,24,1,1,1,True
1423454,916,0,25,5092,242499731,1,0,0,218.06,8,366764.04,18,1,16,1,True
1591803,124,3,451,4315,242499731,1,0,0,218.11,7,366545.93,18,3,22,2,True
1667660,656,2,451,4671,242499731,1,0,0,218.22,7,366327.71,18,0,6,2,True
1719804,935,1,10,9485,242499731,1,0,0,217.93,6,366545.64,24,2,17,3,True
1752627,1426,1,451,7676,242499731,1,0,0,218.0,7,366327.64,24,3,9,3,True
1814957,656,2,30,4951,242499731,1,0,0,218.04,8,366109.6,18,6,21,5,True
1817762,656,2,451,9351,242499731,1,0,0,217.95,7,365891.65,18,0,5,6,True
1920711,916,0,-1,8717,242499731,1,1,0,218.06,4,365891.65,18,2,10,6,True
1961756,1492,4,25,9351,242499731,1,0,0,218.05,8,365673.6,24,5,23,7,True
2082280,1285,1,10,9927,242499731,1,0,0,217.93,0,365891.53,24,6,10,7,True
2223234,1426,1,451,2175,242499731,1,0,0,217.94,7,365673.59,24,2,10,8,True
2395917,1164,0,25,4671,242499731,1,0,0,217.83,8,365455.76,24,6,3,9,True
2408465,498,0,-1,4315,242499731,1,1,0,217.8,4,365455.76,12,2,6,10,True
2496881,1492,4,451,3105,242499731,1,0,0,218.28,7,365237.48,24,6,11,10,True
2620414,1127,0,25,3214,242499731,1,0,0,217.55,8,365019.93,24,3,6,10,True
2827987,726,0,10,1418,242499731,1,0,0,218.2,6,365238.13,11,1,3,11,True
2892194,1127,0,-1,6735,242499731,1,1,0,218.12,1,365238.13,24,3,6,12,True
3388788,916,0,30,8135,242499731,1,0,0,218.36,8,365019.77,18,3,15,12,True
3526418,1492,4,451,5092,242499731,1,0,0,218.09,7,364801.68,24,0,13,12,True
3703423,1164,0,-1,3600,242499731,1,1,0,218.04,4,364801.68,24,0,20,12,True
3835770,656,2,451,3214,242499731,1,0,0,218.11,7,364583.57,18,5,11,1,True
4162441,498,0,-1,4671,242499731,1,1,0,217.96,4,364583.57,12,5,18,1,True
4309923,1164,0,451,9927,242499731,1,0,0,218.02,7,364365.55,24,2,12,1,True
4574878,1426,1,451,3214,242499731,1,0,0,217.91,7,364147.64,24,3,22,1,True
4719144,1012,0,10,7842,242499731,1,0,0,217.97,6,364365.61,26,0,2,4,True
4871822,656,2,451,1781,242499731,1,0,0,218.25,7,364147.36,18,2,20,4,True
4939151,1426,1,25,9485,242499731,1,0,0,217.88,8,363929.48,24,6,8,5,True
4955855,124,3,30,3214,242499731,1,0,0,217.98,8,363711.5,18,5,14,6,True
4961465,916,0,25,4192,242499731,1,0,0,217.77,8,363493.73,18,5,22,7,True
5287082,1127,0,451,3214,242499731,1,0,0,218.23,7,363275.5,24,3,3,8,True
5736580,584,0,10,1539,242499731,1,0,0,217.92,0,363493.42,11,1,23,8,False
6414938,1334,3,451,6216,242499731,1,0,0,218.08,7,363275.34,18,4,9,9,True
6424953,1189,2,20,7842,242499731,1,0,0,218.07,5,363057.27,24,6,17,11,True
6619742,1426,1,25,8135,242499731,1,0,0,217.8,8,362839.47,24,0,2,11,True
6654311,1334,3,25,7676,242499731,1,0,0,218.23,8,362621.24,18,6,18,11,True
6673983,1413,0,10,4192,242499731,1,0,0,217.83,6,362839.07,24,0,13,12,True
6679242,124,3,451,7842,242499731,1,0,0,218.39,7,362620.68,18,3,7,12,True
6766373,128,0,10,5092,242499731,1,0,0,217.68,0,362838.36,18,6,20,12,True
7052964,1127,0,451,6216,242499731,1,0,0,217.95,7,362620.41,24,1,8,1,True
7082150,1247,0,20,8135,242499731,1,0,0,218.02,5,362402.39,23,2,1,1,True
7330648,467,0,10,5529,242499731,1,0,0,217.9,6,362620.29,5,0,7,3,True
7385849,1164,0,30,3105,242499731,1,0,0,218.02,8,362402.27,24,0,9,3,True
7417616,1180,1,10,9045,242499731,1,0,0,217.81,0,362620.08,24,4,15,3,True
7595060,124,3,-1,3105,242499731,1,1,0,218.33,1,362620.08,18,6,8,5,True
7696440,656,2,-1,1418,242499731,1,2,0,217.98,4,362620.08,18,1,15,6,True
7832162,1334,3,25,3214,242499731,1,0,0,217.85,8,362402.23,18,4,11,6,True
7930409,124,3,30,6059,242499731,1,0,0,218.27,8,362183.96,18,0,20,8,False
7989903,124,3,25,5092,242499731,1,0,0,218.12,8,361965.84,18,1,4,8,True
8109826,656,2,451,9485,242499731,1,0,0,217.95,7,361747.89,18,3,11,10,True
8307792,1029,0,20,4951,242499731,1,0,0,217.91,3,361529.98,11,4,0,10,True
9285614,656,2,-1,7842,242499731,1,1,0,218.01,4,361529.98,18,6,1,10,True
9472064,127,1,10,6216,242499731,1,0,0,218.03,6,361748.01,18,0,5,10,True
9536810,443,2,20,4297,242499731,1,0,0,218.03,5,361529.98,24,5,0,11,True
9943033,916,0,451,2175,242499731,1,0,0,218.08,7,361311.9,18,5,5,11,True
1084537,702,4,30,6429,341794334,1,0,0,607.94,8,314425.06,18,4,10,1,True
1250738,647,4,451,1472,341794334,1,0,0,607.95,7,313817.11,24,4,8,3,True
1293811,702,4,-1,9733,341794334,1,1,0,608.16,4,313817.11,18,5,4,5,True
1703266,702,4,25,5271,341794334,1,0,0,607.9,8,313209.21,18,6,9,5,True
1759031,702,4,-1,3251,341794334,1,1,0,608.02,1,313209.21,18,2,14,5,True
1782072,702,4,-1,9733,341794334,1,2,0,608.14,4,313209.21,18,3,15,5,True
1794225,1412,2,451,9704,341794334,1,0,0,607.97,7,312601.24,24,6,8,6,True
1875679,319,0,20,6069,341794334,1,0,0,608.02,3,311993.22,11,6,18,6,True
1915056,366,0,30,2005,341794334,1,0,0,608.04,8,311385.18,25,3,23,6,True
2156343,647,4,451,3960,341794334,1,0,0,608.12,7,310777.06,24,2,3,7,True
2253018,366,0,-1,9915,341794334,1,1,0,607.95,4,310777.06,25,3,2,8,True
2333976,366,0,451,2158,341794334,1,0,0,607.95,7,310169.11,25,3,14,9,True
2382526,647,4,451,3219,341794334,1,0,0,607.98,7,309561.13,24,2,1,9,True
2480626,647,4,451,9915,341794334,1,0,0,608.08,7,308953.05,24,1,9,9,True
2788331,1283,2,20,6069,341794334,1,0,0,607.93,3,308345.12,24,4,6,9,True
3058477,366,0,451,5295,341794334,1,0,0,607.98,7,307737.14,25,3,11,10,True
3070532,647,4,30,4635,341794334,1,0,0,607.85,8,307129.29,24,2,0,11,True
3229013,647,4,-1,5295,341794334,1,1,0,608.08,4,307129.29,24,1,23,11,True
3343467,702,4,451,9650,341794334,1,0,0,607.91,7,306521.38,18,1,12,11,True
3583561,647,4,451,1472,341794334,1,0,0,607.83,7,305913.55,24,5,6,12,True
3702632,647,4,451,1472,341794334,1,0,0,607.93,7,305305.62,24,3,12,12,True
3793467,958,2,20,3219,341794334,1,0,0,607.99,5,304697.63,13,0,9,2,True
3834239,702,4,451,9915,341794334,1,0,0,607.76,7,304089.87,18,4,12,3,True
3834852,1237,4,451,3960,341794334,1,0,0,607.84,7,303482.03,18,5,22,4,True
4262737,702,4,-1,5271,341794334,1,1,0,607.88,1,303482.03,18,4,15,4,True
4360799,366,0,451,4635,341794334,1,0,0,607.95,7,302874.08,25,4,11,6,True
4547322,702,4,451,6069,341794334,1,0,0,607.82,7,302266.26,18,3,22,7,True
4806251,535,0,10,9733,341794334,1,0,0,607.99,6,302874.25,18,0,15,8,True
5187212,1321,0,10,3219,341794334,1,0,0,607.95,6,303482.2,18,3,8,8,True
5417603,255,2,20,9733,341794334,1,0,0,608.29,3,302873.91,6,4,0,8,True
5583348,647,4,25,9915,341794334,1,0,0,608.04,8,302265.87,24,1,6,8,True
5775097,366,0,25,3960,341794334,1,0,0,608.24,8,301657.63,25,6,1,9,True
5855485,1412,2,25,2005,341794334,1,0,0,608.07,8,301049.56,24,5,23,10,True
5955922,366,0,451,9704,341794334,1,0,0,607.81,7,300441.75,25,1,20,3,False
6980169,1237,4,451,9733,341794334,1,0,0,607.94,7,299833.81,18,5,9,3,True
7008606,1010,0,10,5295,341794334,1,0,0,608.13,6,300441.94,26,4,23,3,True
7054598,647,4,451,9733,341794334,1,0,0,607.95,7,299833.99,24,5,9,4,True
7208784,1412,2,30,6069,341794334,1,0,0,607.91,8,299226.08,24,4,8,5,True
7220050,1412,2,30,6429,341794334,1,0,0,607.75,8,298618.33,24,1,23,5,True
7256936,1412,2,30,3251,341794334,1,0,0,608.0,8,298010.33,24,4,14,5,True
7354568,931,0,10,2005,341794334,1,0,0,607.82,0,298618.15,24,0,10,6,True
8251334,1412,2,-1,3219,341794334,1,1,0,608.09,4,298618.15,24,1,11,6,True
8268579,1237,4,25,9733,341794334,1,0,0,607.91,8,298010.24,18,3,23,6,True
8302447,366,0,451,6429,341794334,1,0,0,607.97,7,297402.27,25,2,7,7,True
8341038,366,0,25,9650,341794334,1,0,0,607.9,8,296794.37,25,3,4,8,True
8451477,1237,4,451,3960,341794334,1,0,0,607.94,7,296186.43,18,4,8,8,True
9643914,1000,0,20,2158,341794334,1,0,0,607.91,5,295578.52,26,1,10,9,True
9829854,366,0,-1,6429,341794334,1,1,0,607.78,4,295578.52,25,4,23,9,True
9908235,1014,1,10,9650,341794334,1,0,0,608.24,0,296186.76,26,1,13,10,True
9950420,503,0,20,2005,341794334,1,0,0,608.33,5,295578.43,12,4,20,10,True
1030533,787,0,10,1813,987098139,0,0,0,1166.3,0,908404.3,14,2,21,1,True
1215425,143,4,30,4617,987098139,0,0,0,1165.85,8,907238.45,18,3,15,1,False
1399980,663,4,451,6717,987098139,0,0,0,1166.02,7,906072.43,18,1,18,2,True
1409948,834,0,10,9425,987098139,0,0,0,1166.02,0,907238.45,5,3,4,2,True
1457465,1207,4,25,4790,987098139,0,0,0,1166.05,8,906072.4,24,1,18,3,True
1548255,178,4,25,9125,987098139,0,0,0,1165.77,8,904906.63,24,5,21,3,True
1951765,200,0,10,1082,987098139,0,0,0,1166.21,0,906072.84,9,6,23,4,True
2066904,143,4,451,5715,987098139,0,0,0,1166.22,7,904906.62,18,6,13,4,True
2263753,143,4,-1,1813,987098139,0,1,0,1165.79,1,904906.62,18,0,4,4,True
2443644,185,1,10,1082,987098139,0,0,0,1166.06,6,906072.68,18,3,8,6,True
2515026,663,4,451,3066,987098139,0,0,0,1165.94,7,904906.74,18,1,4,6,True
2517889,143,4,30,3785,987098139,0,0,0,1166.35,8,903740.39,18,6,0,6,True
2620508,1027,0,10,1082,987098139,0,0,0,1166.08,0,904906.47,11,2,23,6,True
2742288,603,0,20,6925,987098139,0,0,0,1165.93,3,903740.54,24,6,5,7,True
2831031,1282,2,451,1063,987098139,0,0,0,1166.11,7,902574.43,24,1,22,8,True
3093954,178,4,451,4790,987098139,0,0,0,1165.87,7,901408.56,24,6,12,8,True
3481940,1482,3,451,5236,987098139,0,0,0,1166.29,7,900242.27,24,2,14,8,True
3624112,663,4,-1,9425,987098139,0,1,0,1166.1,4,900242.27,18,4,8,11,True
3636134,359,2,20,4617,987098139,0,0,0,1166.15,5,899076.12,24,1,20,1,True
3730960,1482,3,30,8897,987098139,0,0,0,1166.19,8,897909.93,24,5,22,2,True
3912912,1145,4,451,5968,987098139,0,0,0,1166.23,7,896743.7,15,0,21,3,True
3967812,1207,4,-1,6925,987098139,0,1,0,1166.16,4,896743.7,24,4,3,3,True
4074737,178,4,30,9125,987098139,0,0,0,1165.79,8,895577.91,24,3,10,4,True
4733555,1282,2,451,9425,987098139,0,0,0,1166.02,7,894411.89,24,4,11,4,True
4951677,1270,1,10,1063,987098139,0,0,0,1166.1,6,895577.99,23,6,2,5,True
5053462,195,1,10,5968,987098139,0,0,0,1165.93,0,896743.92,18,3,23,5,True
5148842,143,4,30,2922,987098139,0,0,0,1165.99,8,895577.93,18,5,3,7,True
5233609,1207,4,451,4790,987098139,0,0,0,1166.02,7,894411.91,24,0,13,7,True
5284739,145,0,10,8121,987098139,0,0,0,1165.85,6,895577.76,18,3,1,8,True
5777720,1282,2,451,5715,987098139,0,0,0,1166.14,7,894411.62,24,2,0,8,True
5906077,1207,4,-1,2811,987098139,0,1,0,1166.06,1,894411.62,24,1,18,9,True
5923847,663,4,30,9425,987098139,0,0,0,1166.04,8,893245.58,18,1,18,9,True
6127911,663,4,30,3619,987098139,0,0,0,1166.03,8,892079.55,18,0,17,9,True
6302475,143,4,30,4790,987098139,0,0,0,1166.01,8,890913.54,18,0,22,10,True
6320122,1044,0,20,2495,987098139,0,0,0,1166.13,3,889747.41,11,1,12,11,True
7024423,143,4,451,9609,987098139,0,0,0,1165.86,7,888581.55,18,4,14,11,True
7183511,663,4,-1,7642,987098139,0,1,0,1166.05,1,888581.55,18,5,17,1,True
7230779,1482,3,451,4790,987098139,0,0,0,1165.89,7,887415.66,24,1,10,1,True
7465747,663,4,25,1725,987098139,0,0,0,1166.17,8,886249.49,18,5,10,2,True
7856592,1207,4,-1,3066,987098139,0,1,0,1166.09,1,886249.49,24,3,7,2,True
7997191,1156,1,10,9085,987098139,0,0,0,1166.08,0,887415.57,15,6,9,2,True
8293851,346,0,20,9425,987098139,0,0,0,1166.02,5,886249.55,24,4,2,3,True
8352220,1282,2,30,1063,987098139,0,0,0,1166.06,8,885083.49,24,1,8,3,True
8367963,1282,2,25,2298,987098139,0,0,0,1166.13,8,883917.36,24,3,9,4,True
8552178,663,4,25,3785,987098139,0,0,0,1165.95,8,882751.41,18,4,23,4,True
8694465,143,4,451,1907,987098139,0,0,0,1165.89,7,881585.52,18,1,0,5,True
8798432,1145,4,30,5236,987098139,0,0,0,1166.11,8,880419.41,15,2,23,7,True
8850143,1207,4,451,1813,987098139,0,0,0,1165.93,7,879253.48,24,4,9,7,True
9091530,1482,3,451,6925,987098139,0,0,0,1166.1,7,878087.38,24,5,5,8,True
9183726,1207,4,451,9085,987098139,0,0,0,1165.93,7,876921.45,24,4,7,8,True
9272320,143,4,451,9125,987098139,0,0,0,1165.95,7,875755.5,18,2,4,9,True
9344158,524,1,10,7642,987098139,0,0,0,1166.06,0,876921.56,18,5,2,9,True
9361587,328,0,20,5236,987098139,0,0,0,1166.06,5,875755.5,11,5,11,9,True
9489670,1210,0,20,8897,987098139,0,0,0,1166.0,5,874589.5,24,1,14,10,True
9529901,1207,4,451,9125,987098139,0,0,0,1166.07,7,873423.43,24,0,22,10,True
9632297,1282,2,-1,2495,987098139,0,1,0,1165.79,1,873423.43,24,2,10,11,True
1016680,240,4,451,5227,410485195,1,0,0,637.17,7,579402.83,26,6,22,1,True
1128782,30,4,-1,3297,410485195,1,1,0,636.91,4,579402.83,11,2,7,1,True
1137154,963,4,451,1111,410485195,1,0,0,636.68,7,578766.15,13,1,10,1,True
1246984,30,4,-1,4765,410485195,1,1,0,636.65,4,578766.15,11,6,19,2,True
1397159,673,0,30,6642,410485195,1,0,0,636.99,8,578129.16,18,2,3,4,True
1554246,30,4,451,8642,410485195,1,0,0,637.01,7,577492.15,11,4,20,4,True
1615071,673,0,30,5227,410485195,1,0,0,637.05,8,576855.1,18,6,1,4,True
1644098,963,4,451,7349,410485195,1,0,0,636.9,7,576218.2,13,6,6,5,True
1721560,342,0,25,3645,410485195,1,0,0,636.76,8,575581.44,24,4,17,7,True
1787089,444,2,451,2639,410485195,1,0,0,636.91,7,574944.53,24,4,1,7,True
2305663,1134,1,10,2639,410485195,1,0,0,637.1,6,575581.63,24,0,21,7,True
2683045,198,0,10,7944,410485195,1,0,0,636.86,6,576218.49,18,4,13,7,True
2733048,240,4,-1,5979,410485195,1,1,0,636.9,4,576218.49,26,2,16,8,True
2955746,129,0,10,5979,410485195,1,0,0,637.09,6,576855.58,18,6,0,8,True
3045671,342,0,25,9345,410485195,1,0,0,636.92,8,576218.66,24,1,3,8,False
3133981,240,4,-1,1957,410485195,1,1,0,636.9,4,576218.66,26,1,4,8,True
3182750,444,2,451,3645,410485195,1,0,0,636.84,7,575581.82,24,6,7,8,True
3276316,30,4,451,3297,410485195,1,0,0,636.95,7,574944.87,11,2,19,8,True
3591814,30,4,451,9524,410485195,1,0,0,637.25,7,574307.62,11,6,7,10,True
3633468,963,4,30,3514,410485195,1,0,0,637.31,8,573670.31,13,4,4,11,True
3917427,444,2,25,1121,410485195,1,0,0,637.1,8,573033.21,24,3,4,11,True
4046081,739,1,10,8642,410485195,1,0,0,636.99,0,573670.2,24,2,7,12,True
4270911,444,2,-1,9524,410485195,1,1,0,636.73,4,573670.2,24,0,1,1,True
4303627,963,4,451,4765,410485195,1,0,0,636.86,7,573033.34,13,4,10,1,True
4455610,580,0,20,7930,410485195,1,0,0,637.03,5,572396.31,11,3,2,2,True
4633110,342,0,451,6642,410485195,1,0,0,636.78,7,571759.53,24,4,2,2,True
4705939,240,4,25,5227,410485195,1,0,0,637.15,8,571122.38,26,2,17,4,True
5049070,673,0,30,9524,410485195,1,0,0,637.05,8,570485.33,18,5,10,4,True
5306620,673,0,-1,9441,410485195,1,1,0,636.92,4,570485.33,18,3,11,5,True
5575713,1010,0,20,1632,410485195,1,0,0,637.01,5,569848.32,26,1,3,5,True
5755444,444,2,451,1111,410485195,1,0,0,636.91,7,569211.41,24,6,0,6,True
5979352,240,4,451,1198,410485195,1,0,0,636.75,7,568574.66,26,2,19,6,True
6213653,963,4,25,1632,410485195,1,0,0,636.91,8,567937.75,13,4,12,7,True
6271106,234,0,20,9524,410485195,1,0,0,636.8,3,567300.95,26,0,15,9,True
6373121,1156,1,10,3514,410485195,1,0,0,637.35,6,567938.3,15,4,7,12,True
6502954,444,2,25,6642,410485195,1,0,0,636.91,8,567301.39,24,3,18,12,False
6506600,444,2,451,7944,410485195,1,0,0,636.95,7,566664.44,24,1,14,1,True
6689576,444,2,451,1632,410485195,1,0,0,636.99,7,566027.45,24,5,5,1,True
6857150,30,4,451,8903,410485195,1,0,0,636.85,7,565390.6,11,0,18,1,True
6904783,787,0,20,4574,410485195,1,0,0,637.12,5,564753.48,14,3,12,2,True
7100451,804,0,10,9441,410485195,1,0,0,637.07,0,565390.55,11,4,20,2,True
7311443,30,4,-1,9524,410485195,1,1,0,637.06,4,565390.55,11,3,16,6,True
7392517,240,4,451,5979,410485195,1,0,0,637.1,7,564753.45,26,0,11,7,True
7417398,673,0,-1,3297,410485195,1,1,0,636.94,4,564753.45,18,3,6,7,True
7432992,963,4,-1,4765,410485195,1,2,0,637.14,1,564753.45,13,5,14,9,True
7505457,963,4,-1,7944,410485195,1,3,1,636.83,4,564753.45,13,0,13,10,True
1049573,404,1,10,2548,651619074,0,0,0,750.01,6,340154.01,10,2,19,2,False
1052628,1393,3,30,3745,651619074,0,0,0,750.08,8,339403.93,24,2,21,3,True
1204405,1255,0,10,9748,651619074,0,0,0,749.92,6,340153.85,23,0,7,3,True
1241045,1277,2,451,8105,651619074,0,0,0,749.63,7,339404.22,24,6,23,5,True
1347313,1393,3,30,2672,651619074,0,0,0,749.88,8,338654.34,24,1,3,5,True
1577386,59,0,451,9254,651619074,0,0,0,749.76,7,337904.58,20,4,5,7,False
1819826,159,2,20,3992,651619074,0,0,0,750.15,5,337154.43,24,3,16,7,True
1917644,574,2,20,8723,651619074,0,0,0,750.04,5,336404.39,11,5,0,7,True
2039343,59,0,-1,7279,651619074,0,1,0,750.11,1,336404.39,20,1,21,8,True
2296402,509,0,-1,9427,651619074,0,2,0,750.04,1,336404.39,12,2,20,8,True
2364492,929,0,20,1931,651619074,0,0,0,750.08,5,335654.31,18,1,12,9,True
2369336,1413,0,10,3389,651619074,0,0,0,750.19,0,336404.5,24,5,8,10,True
2370655,739,1,10,3992,651619074,0,0,0,750.05,6,337154.55,24,2,10,11,True
2464300,59,0,451,5325,651619074,0,0,0,749.89,7,336404.66,20,6,12,12,True
2619919,1423,3,451,9596,651619074,0,0,0,750.09,7,335654.57,24,4,14,12,True
3361813,52,4,451,1667,651619074,0,0,0,750.0,7,334904.57,20,5,11,1,True
3520092,1393,3,-1,4304,651619074,0,1,0,749.76,1,334904.57,24,4,21,2,True
3675681,509,0,451,9596,651619074,0,0,0,749.93,7,334154.64,12,6,14,2,True
3815201,59,0,-1,8105,651619074,0,1,0,749.95,4,334154.64,20,0,17,4,True
4387746,509,0,451,1667,651619074,0,0,0,749.88,7,333404.76,12,3,20,6,True
4501913,1076,1,10,5890,651619074,0,0,0,749.97,6,334154.73,18,0,1,6,True
4995442,804,0,20,6564,651619074,0,0,0,749.78,3,333404.95,11,1,17,7,True
5085022,52,4,451,2978,651619074,0,0,0,750.01,7,332654.94,20,0,14,8,True
5094865,1423,3,451,9427,651619074,0,0,0,749.56,7,331905.38,24,4,0,8,True
5519075,1393,3,-1,2978,651619074,0,1,0,750.14,4,331905.38,24,4,4,9,True
5659581,509,0,30,8111,651619074,0,0,0,750.19,8,331155.19,12,5,6,9,True
5907225,509,0,-1,1481,651619074,0,1,0,750.19,4,331155.19,12,4,12,9,True
6021379,1423,3,30,6293,651619074,0,0,0,749.86,8,330405.33,24,6,16,10,True
6117811,52,4,30,6564,651619074,0,0,0,750.0,8,329655.33,20,2,13,11,True
6223682,1423,3,25,7349,651619074,0,0,0,749.82,8,328905.51,24,0,6,12,True
6340820,59,0,451,2417,651619074,0,0,0,750.1,7,328155.41,20,1,15,12,True
6375394,59,0,25,1481,651619074,0,0,0,749.93,8,327405.48,20,3,6,12,True
6421698,52,4,-1,4660,651619074,0,1,0,749.96,1,327405.48,20,5,7,1,True
6567956,1423,3,-1,2672,651619074,0,2,0,749.96,4,327405.48,24,0,9,1,True
6622194,525,0,20,9226,651619074,0,0,0,750.24,3,326655.24,18,5,12,2,True
6872475,1423,3,30,8921,651619074,0,0,0,750.03,8,325905.21,24,4,12,3,True
7237959,59,0,30,2165,651619074,0,0,0,750.09,8,325155.12,20,0,10,3,True
7721196,205,0,20,7349,651619074,0,0,0,750.08,5,324405.04,9,5,12,3,True
7932986,538,0,10,2417,651619074,0,0,0,750.12,6,325155.16,18,0,15,3,True
7992034,1277,2,-1,1667,651619074,0,1,0,749.9,1,325155.16,24,3,5,4,True
8112379,59,0,25,7279,651619074,0,0,0,750.03,8,324405.13,20,2,20,4,True
8554474,1169,0,20,9254,651619074,0,0,0,749.95,5,323655.18,24,5,17,4,True
8612420,551,0,10,3745,651619074,0,0,0,749.92,6,324405.1,17,4,20,4,True
8651244,1277,2,-1,5926,651619074,0,1,0,749.94,4,324405.1,24,1,21,4,True
8652189,509,0,451,3389,651619074,0,0,0,749.71,7,323655.39,12,4,11,5,True
8696287,1423,3,30,9427,651619074,0,0,0,750.26,8,322905.13,24,6,3,6,False
8938725,1277,2,30,3992,651619074,0,0,0,749.93,8,322155.2,24,3,20,6,True
9145159,1277,2,30,8111,651619074,0,0,0,749.92,8,321405.28,24,4,9,6,False
9289842,1393,3,25,6293,651619074,0,0,0,749.81,8,320655.47,24,1,2,7,True
9450943,1393,3,451,1931,651619074,0,0,0,749.98,7,319905.49,24,2,4,7,True
9506915,1393,3,451,9226,651619074,0,0,0,749.96,7,319155.53,24,0,0,9,True
9640758,1399,0,10,1664,651619074,0,0,0,750.01,6,319905.54,24,1,15,9,True
9968949,52,4,30,7279,651619074,0,0,0,750.05,8,319155.49,20,2,6,9,True
9992351,59,0,30,2672,651619074,0,0,0,750.0,8,318405.49,20,1,20,10,True
1373432,1244,4,30,7480,842361684,1,0,0,480.95,8,966258.05,18,1,23,1,True
1476684,1038,3,451,5346,842361684,1,0,0,481.02,7,965777.03,11,0,12,1,True
1509122,887,2,30,1387,842361684,1,0,0,481.03,8,965296.0,27,3,21,2,True
1558245,887,2,-1,5346,842361684,1,1,0,480.86,1,965296.0,27,3,1,2,True
1619193,898,1,451,2136,842361684,1,0,0,480.9,7,964815.1,24,4,4,2,True
1638635,56,4,451,9413,842361684,1,0,0,481.03,7,964334.07,20,3,8,3,True
1705108,649,0,25,3556,842361684,1,0,0,481.05,8,963853.02,24,0,11,5,True
1828263,1244,4,30,8801,842361684,1,0,0,480.86,8,963372.16,18,0,22,5,True
1945739,673,0,20,9413,842361684,1,0,0,481.14,3,962891.02,18,3,14,6,False
2276186,1244,4,30,8801,842361684,1,0,0,481.4,8,962409.62,18,6,22,6,True
2992361,649,0,451,2136,842361684,1,0,0,480.92,7,961928.7,24,5,0,6,True
3050953,688,0,10,5346,842361684,1,0,0,480.66,6,962409.36,24,3,1,6,True
3181427,480,0,451,4755,842361684,1,0,0,481.0,7,961928.36,5,5,22,7,True
3641321,1311,2,20,5346,842361684,1,0,0,480.9,5,961447.46,5,5,14,7,True
3715804,255,2,20,8592,842361684,1,0,0,480.82,3,960966.64,6,0,15,8,True
4162063,649,0,451,4858,842361684,1,0,0,480.91,7,960485.73,24,3,16,9,True
4306223,887,2,451,9084,842361684,1,0,0,480.94,7,960004.79,27,5,5,9,False
4722727,887,2,25,9407,842361684,1,0,0,481.24,8,959523.55,27,3,3,9,False
4724232,182,1,25,2136,842361684,1,0,0,481.1,8,959042.45,18,5,11,11,True
4754655,348,0,10,1387,842361684,1,0,0,480.95,6,959523.4,24,3,4,11,True
4914672,1244,4,25,9084,842361684,1,0,0,480.84,8,959042.56,18,5,1,11,True
5114068,182,1,30,8413,842361684,1,0,0,481.18,8,958561.38,18,6,1,12,True
5158519,480,0,30,3034,842361684,1,0,0,481.16,8,958080.22,5,0,3,12,True
5209199,182,1,451,2136,842361684,1,0,0,480.94,7,957599.28,18,4,5,12,True
5453160,199,0,10,1387,842361684,1,0,0,480.89,0,958080.17,18,1,0,1,True
5493037,1244,4,30,6239,842361684,1,0,0,481.2,8,957598.97,18,3,14,1,True
5511207,56,4,451,8815,842361684,1,0,0,481.2,7,957117.77,20,4,15,1,True
5983211,159,2,20,8055,842361684,1,0,0,480.9,5,956636.87,24,4,5,4,True
6201953,887,2,25,8592,842361684,1,0,0,480.96,8,956155.91,27,4,17,4,True
6356744,583,2,20,8815,842361684,1,0,0,480.97,5,955674.94,11,0,19,5,True
6636110,376,0,10,8801,842361684,1,0,0,481.29,6,956156.23,25,3,15,6,True
6646757,898,1,451,4858,842361684,1,0,0,480.82,7,955675.41,24,0,2,7,True
6856885,56,4,30,4858,842361684,1,0,0,480.69,8,955194.72,20,4,2,8,True
7005909,649,0,-1,2987,842361684,1,1,0,480.98,4,955194.72,24,5,0,8,True
7115106,962,0,20,3034,842361684,1,0,0,481.01,3,954713.71,13,3,7,9,True
7552475,1244,4,30,9407,842361684,1,0,0,480.65,8,954233.06,18,6,13,12,True
7729648,726,0,10,9084,842361684,1,0,0,480.82,6,954713.88,11,3,23,1,True
8306511,480,0,30,8801,842361684,1,0,0,481.01,8,954232.87,5,5,3,2,True
8603987,56,4,30,3994,842361684,1,0,0,481.01,8,953751.86,20,1,4,2,True
8617277,1244,4,30,8815,842361684,1,0,0,480.96,8,953270.9,18,2,23,3,True
8637994,1406,0,20,4858,842361684,1,0,0,480.77,5,952790.13,24,2,11,4,True
8713843,898,1,30,8815,842361684,1,0,0,481.03,8,952309.1,24,6,23,6,True
8922370,480,0,451,5346,842361684,1,0,0,480.71,7,951828.39,5,3,3,7,True
9150684,480,0,451,2628,842361684,1,0,0,480.79,7,951347.6,5,3,6,7,True
9210286,944,2,20,3994,842361684,1,0,0,481.12,5,950866.48,24,6,0,7,True
9343842,898,1,30,8815,842361684,1,0,0,480.74,8,950385.74,24,3,2,8,True
9364691,887,2,25,2987,842361684,1,0,0,481.07,8,949904.67,27,2,19,8,True
9403397,649,0,451,3994,842361684,1,0,0,480.99,7,949423.68,24,4,3,9,True
9607355,898,1,451,3793,842361684,1,0,0,481.05,7,948942.63,24,3,14,10,True
9674398,337,1,10,8055,842361684,1,0,0,480.88,0,949423.51,11,3,12,10,True
9684576,898,1,30,3793,842361684,1,0,0,480.99,8,948942.52,24,0,17,10,True
9743846,393,1,10,3977,842361684,1,0,0,480.99,0,949423.51,10,4,21,11,True
9999629,900,1,10,3994,842361684,1,0,0,480.74,6,949904.25,24,0,7,11,True
1064200,1284,2,20,8994,384782220,0,0,0,590.76,5,631822.24,24,1,1,1,True
1271565,1361,2,451,6216,384782220,0,0,0,591.05,7,631231.19,16,1,10,1,True
1322420,373,1,25,6654,384782220,0,0,0,591.0,8,630640.19,25,2,22,1,True
1480161,1243,2,30,9394,384782220,0,0,0,591.28,8,630048.91,18,1,10,1,True
1489962,369,1,10,3446,384782220,0,0,0,591.15,6,630640.06,25,1,7,2,True
1798152,895,0,30,2416,384782220,0,0,0,591.21,8,630048.85,24,5,10,6,True
2081486,1377,0,20,4138,384782220,0,0,0,591.17,5,629457.68,16,2,18,7,True
2186171,895,0,25,5018,384782220,0,0,0,590.8,8,628866.88,24,5,17,7,True
2195687,1118,4,30,5909,384782220,0,0,0,590.85,8,628276.03,24,4,23,8,True
2419925,1492,4,-1,3817,384782220,0,1,0,591.01,4,628276.03,24,0,20,8,True
2521646,373,1,25,8098,384782220,0,0,0,590.96,8,627685.07,25,6,1,9,True
2838562,195,1,25,1806,384782220,0,0,0,591.05,8,627094.02,18,5,21,10,True
3105839,355,1,10,3817,384782220,0,0,0,591.09,6,627685.11,24,2,2,10,True
3272707,580,0,10,7341,384782220,0,0,0,591.0,0,628276.11,11,6,16,11,True
3325327,195,1,-1,4604,384782220,0,1,0,591.39,4,628276.11,18,1,2,11,True
3326033,1243,2,30,6216,384782220,0,0,0,591.11,8,627685.0,18,1,15,12,True
3545740,373,1,451,5775,384782220,0,0,0,590.97,7,627094.03,25,1,18,12,True
3739968,1492,4,-1,8569,384782220,0,1,0,591.19,1,627094.03,24,0,2,12,True
3753787,373,1,25,6839,384782220,0,0,0,591.15,8,626502.88,25,3,23,12,True
3917755,195,1,30,8994,384782220,0,0,0,591.11,8,625911.77,18,3,20,1,False
3993819,195,1,25,6839,384782220,0,0,0,590.8,8,625320.97,18,1,23,1,True
4032144,1156,1,-1,3289,384782220,0,1,0,591.18,4,625320.97,15,1,16,1,True
4153236,1156,1,25,1806,384782220,0,0,0,591.2,8,624729.77,15,4,22,2,True
4181003,917,0,20,3497,384782220,0,0,0,591.17,5,624138.6,18,3,4,2,True
4492867,373,1,-1,4604,384782220,0,1,0,591.19,4,624138.6,25,0,21,2,True
4494582,158,2,20,9394,384782220,0,0,0,590.94,3,623547.66,24,4,17,2,True
4674660,1361,2,-1,6654,384782220,0,1,0,591.3,1,623547.66,16,5,12,3,True
4770015,81,0,20,4604,384782220,0,0,0,591.09,5,622956.57,1,1,17,3,True
4930676,858,1,10,3289,384782220,0,0,0,591.06,6,623547.63,24,3,19,4,True
5033974,895,0,451,5530,384782220,0,0,0,590.84,7,622956.79,24,0,6,5,True
5086262,895,0,30,3289,384782220,0,0,0,590.96,8,622365.83,24,2,11,5,False
5119027,1361,2,30,6654,384782220,0,0,0,590.86,8,621774.97,16,2,2,6,True
5393961,467,0,20,9394,384782220,0,0,0,590.96,5,621184.01,5,1,4,7,False
5438985,373,1,-1,1878,384782220,0,1,0,590.82,4,621184.01,25,4,12,7,True
5672647,1361,2,30,3497,384782220,0,0,0,590.93,8,620593.08,16,0,9,7,True
5966798,1492,4,30,4604,384782220,0,0,0,590.98,8,620002.1,24,1,15,8,True
6000237,1399,0,10,5213,384782220,0,0,0,591.14,6,620593.24,24,5,13,9,True
6035230,195,1,25,9723,384782220,0,0,0,590.96,8,620002.28,18,6,12,9,True
6237173,1425,0,10,7341,384782220,0,0,0,590.84,6,620593.12,24,2,21,10,True
6339450,895,0,25,5260,384782220,0,0,0,591.3,8,620001.82,24,5,18,10,True
6427730,180,0,20,6341,384782220,0,0,0,591.18,5,619410.64,18,6,6,10,True
6448821,373,1,451,4330,384782220,0,0,0,590.9,7,618819.74,25,5,7,11,True
6559078,895,0,-1,2416,384782220,0,1,0,591.16,4,618819.74,24,2,7,1,True
6599335,1210,0,10,6216,384782220,0,0,0,590.93,6,619410.67,24,2,16,1,True
6868894,1361,2,30,6216,384782220,0,0,0,591.09,8,618819.58,16,6,3,1,True
7019351,895,0,-1,4138,384782220,0,1,0,591.03,4,618819.58,24,2,18,2,True
7102008,304,0,10,4604,384782220,0,0,0,591.09,0,619410.67,4,5,10,3,True
7138301,195,1,30,1878,384782220,0,0,0,590.99,8,618819.68,18,3,16,4,True
7200796,1243,2,451,3446,384782220,0,0,0,590.95,7,618228.73,18,0,4,4,True
8016612,1239,1,10,9723,384782220,0,0,0,590.9,6,618819.63,18,5,0,5,True
8162681,195,1,30,6839,384782220,0,0,0,591.25,8,618228.38,18,4,23,5,True
8295075,1361,2,30,4330,384782220,0,0,0,591.05,8,617637.33,16,4,11,5,True
8999255,895,0,451,8569,384782220,0,0,0,591.17,7,617046.16,24,2,14,7,True
9220099,1156,1,451,5775,384782220,0,0,0,590.78,7,616455.38,15,2,0,7,True
9402515,1492,4,451,5530,384782220,0,0,0,591.11,7,615864.27,24,0,11,9,True
9422124,1156,1,-1,4604,384782220,0,1,0,590.88,1,615864.27,15,6,8,9,True
9839601,1243,2,451,8569,384782220,0,0,0,591.14,7,615273.13,18,0,7,9,True
9972605,1156,1,25,9394,384782220,0,0,0,590.82,8,614682.31,15,0,16,11,True
1243777,903,3,451,7548,581929313,1,0,0,899.9,7,531029.1,2,5,20,1,True
1251735,1095,4,451,2336,581929313,1,0,0,900.08,7,530129.02,0,0,19,1,True
1282262,903,3,451,6304,581929313,1,0,0,899.98,7,529229.04,2,5,14,1,True
1413665,195,1,10,2336,581929313,1,0,0,900.07,6,530129.11,18,3,6,1,True
1448924,608,4,451,1683,581929313,1,0,0,900.02,7,529229.09,24,3,20,2,True
1454826,273,4,-1,5694,581929313,1,1,0,900.01,1,529229.09,24,5,3,4,True
1534197,1192,2,20,8806,581929313,1,0,0,899.81,5,528329.28,24,6,9,5,False
1685619,1480,4,451,9343,581929313,1,0,0,900.01,7,527429.27,24,3,19,5,True
1836027,665,2,20,3583,581929313,1,0,0,900.08,5,526529.19,18,6,4,5,True
1868778,1094,0,10,6954,581929313,1,0,0,899.89,6,527429.08,0,0,22,5,True
1949328,1095,4,30,1061,581929313,1,0,0,899.85,8,526529.23,0,3,20,6,True
2063406,838,4,25,4401,581929313,1,0,0,900.18,8,525629.05,5,3,1,7,True
2197511,903,3,25,1061,581929313,1,0,0,900.03,8,524729.02,2,6,18,7,True
2614736,465,0,20,6879,581929313,1,0,0,899.98,3,523829.04,13,0,5,7,True
2749741,838,4,-1,8470,581929313,1,1,0,900.15,4,523829.04,5,0,7,7,True
2969653,497,0,10,8286,581929313,1,0,0,899.89,0,524728.93,12,5,5,8,True
2980782,907,0,10,6762,581929313,1,0,0,900.21,0,525629.14,2,1,12,8,True
3053753,903,3,30,3579,581929313,1,0,0,899.83,8,524729.31,2,1,1,8,True
3094016,1044,0,10,9343,581929313,1,0,0,900.28,6,525629.59,11,0,19,9,True
3178293,903,3,25,8806,581929313,1,0,0,899.85,8,524729.74,2,6,18,10,True
3369593,300,0,20,5694,581929313,1,0,0,899.95,3,523829.79,4,5,12,11,True
3450208,1422,1,10,1284,581929313,1,0,0,899.8,0,524729.59,24,2,11,11,True
3531115,1064,0,20,3579,581929313,1,0,0,900.03,3,523829.56,11,2,7,1,True
3702734,608,4,451,7058,581929313,1,0,0,900.15,7,522929.41,24,1,10,3,True
3903472,759,0,10,2336,581929313,1,0,0,900.24,6,523829.65,24,4,15,3,True
3934004,76,0,10,4692,581929313,1,0,0,899.9,6,524729.55,20,6,15,3,True
3982194,1110,0,20,7600,581929313,1,0,0,900.35,5,523829.2,0,3,3,4,True
4520411,956,1,10,5217,581929313,1,0,0,900.01,6,524729.21,13,6,2,5,True
4566714,1036,1,10,8806,581929313,1,0,0,899.95,6,525629.16,11,5,8,5,True
4987439,349,2,20,5352,581929313,1,0,0,899.86,5,524729.3,24,5,21,7,True
5093997,1212,0,10,8806,581929313,1,0,0,899.9,0,525629.2,24,3,18,8,True
5775542,774,2,20,7548,581929313,1,0,0,900.2,5,524729.0,14,5,12,8,True
5819412,1363,0,20,7809,581929313,1,0,0,899.99,3,523829.01,16,6,20,8,True
6663639,273,4,25,7700,581929313,1,0,0,900.13,8,522928.88,24,5,12,9,False
6938131,1480,4,25,6304,581929313,1,0,0,900.12,8,522028.76,24,2,17,11,False
7352531,1125,1,10,8806,581929313,1,0,0,900.26,6,522929.02,24,6,12,1,True
7387441,850,1,10,7058,581929313,1,0,0,900.03,6,523829.05,5,0,3,3,True
7504125,1480,4,451,4692,581929313,1,0,0,899.89,7,522929.16,24,4,10,4,True
7658247,1095,4,30,7600,581929313,1,0,0,900.07,8,522029.09,0,2,2,4,True
8110696,838,4,451,6658,581929313,1,0,0,900.14,7,521128.95,5,1,1,4,True
8134633,1377,0,20,8470,581929313,1,0,0,899.72,5,520229.23,16,1,11,5,True
8339885,608,4,-1,9367,581929313,1,1,0,900.17,4,520229.23,24,4,5,5,True
8467777,1095,4,25,7700,581929313,1,0,0,899.78,8,519329.45,0,5,0,6,True
8516420,608,4,451,8470,581929313,1,0,0,900.09,7,518429.36,24,5,13,6,True
8618571,1095,4,25,4401,581929313,1,0,0,899.85,8,517529.51,0,1,7,7,True
8811938,1467,0,10,7700,581929313,1,0,0,899.85,6,518429.36,11,6,13,8,True
8879506,273,4,-1,7058,581929313,1,1,0,900.03,4,518429.36,24,2,5,8,True
9080326,273,4,451,1284,581929313,1,0,0,899.74,7,517529.62,24,3,15,9,True
9333990,767,0,10,3579,581929313,1,0,0,899.88,0,518429.5,14,1,0,9,True
9399598,732,0,10,1061,581929313,1,0,0,900.22,0,519329.72,11,4,13,9,True
9575609,608,4,25,4401,581929313,1,0,0,900.14,8,518429.58,24,4,10,10,True
9588076,1480,4,-1,8806,581929313,1,1,0,899.91,4,518429.58,24,1,20,11,True
1121908,1075,0,451,3875,975153253,1,0,0,232.15,7,679657.85,18,0,5,1,True
1247092,328,0,20,9214,975153253,1,0,0,232.13,3,679425.72,11,2,10,1,True
1447131,328,0,30,1948,975153253,1,0,0,232.04,8,679193.68,11,4,15,1,True
1487443,1108,1,10,2141,975153253,1,0,0,232.19,0,679425.87,0,3,19,1,True
1512250,481,3,451,2608,975153253,1,0,0,231.87,7,679194.0,5,2,0,2,True
1715690,708,2,30,8543,975153253,1,0,0,232.09,8,678961.91,18,3,9,4,True
1831924,1075,0,-1,9214,975153253,1,1,0,231.85,4,678961.91,18,4,21,5,True
2077656,1075,0,30,4793,975153253,1,0,0,232.11,8,678729.8,18,6,6,6,True
2110867,282,2,20,1088,975153253,1,0,0,231.9,3,678497.9,24,5,8,7,True
2133513,328,0,30,7686,975153253,1,0,0,231.74,8,678266.16,11,5,22,8,True
2664501,328,0,451,6095,975153253,1,0,0,232.01,7,678034.15,11,3,1,8,True
2673856,849,1,-1,2930,975153253,1,1,0,232.08,4,678034.15,5,2,20,9,True
2911207,518,2,451,7879,975153253,1,0,0,231.73,7,677802.42,18,3,5,10,True
3141642,328,0,30,3875,975153253,1,0,0,232.01,8,677570.41,11,5,9,10,True
3454757,1468,1,25,9214,975153253,1,0,0,232.07,8,677338.34,11,3,18,11,True
3662147,696,2,20,4125,975153253,1,0,0,232.16,3,677106.18,24,4,5,12,True
3831093,1075,0,451,4805,975153253,1,0,0,232.06,7,676874.12,18,3,21,1,True
3866304,512,0,20,4125,975153253,1,0,0,231.88,5,676642.24,12,3,7,1,True
3958312,1468,1,451,5407,975153253,1,0,0,232.0,7,676410.24,11,3,10,1,True
4004650,849,1,30,2930,975153253,1,0,0,231.88,8,676178.36,5,2,10,2,True
4327002,147,0,20,1088,975153253,1,0,0,232.03,5,675946.33,18,2,12,3,True
4552725,518,2,451,6095,975153253,1,0,0,232.11,7,675714.22,18,0,21,4,True
4670415,518,2,451,7686,975153253,1,0,0,231.87,7,675482.35,18,4,2,6,True
5068468,1075,0,20,5407,975153253,1,0,0,232.02,3,675250.33,18,0,16,6,True
5071163,518,2,451,9649,975153253,1,0,0,231.87,7,675018.46,18,0,20,7,True
5246046,467,0,10,4793,975153253,1,0,0,232.14,6,675250.6,5,6,2,7,True
5455271,518,2,-1,4793,975153253,1,1,0,231.89,1,675250.6,18,3,11,7,True
5501411,849,1,30,1929,975153253,1,0,0,232.14,8,675018.46,5,0,6,7,True
5608130,333,1,10,1929,975153253,1,0,0,231.93,6,675250.39,11,4,22,8,True
6038637,849,1,451,3026,975153253,1,0,0,232.37,7,675018.02,5,6,16,9,True
6060355,481,3,25,6621,975153253,1,0,0,232.01,8,674786.01,5,3,22,11,True
6114255,328,0,451,5735,975153253,1,0,0,231.86,7,674554.15,11,6,12,11,True
6206824,518,2,451,5407,975153253,1,0,0,232.36,7,674321.79,18,4,2,12,True
6412133,481,3,451,4125,975153253,1,0,0,231.84,7,674089.95,5,5,10,12,True
6589550,1232,1,10,4793,975153253,1,0,0,232.05,0,674322.0,18,5,1,12,True
7117330,579,0,10,7879,975153253,1,0,0,232.06,6,674554.06,11,0,4,1,True
7291879,1075,0,25,9649,975153253,1,0,0,232.1,8,674321.96,18,6,0,1,True
7553922,616,1,10,8543,975153253,1,0,0,231.72,0,674553.68,11,0,22,3,True
7714717,708,2,30,1948,975153253,1,0,0,231.97,8,674321.71,18,1,8,3,True
7786386,1075,0,451,6095,975153253,1,0,0,231.78,7,674089.93,18,1,8,3,True
7927837,849,1,451,7686,975153253,1,0,0,231.94,7,673857.99,5,3,8,4,True
7940321,1075,0,30,6621,975153253,1,0,0,232.24,8,673625.75,18,2,21,4,True
7940963,518,2,25,6621,975153253,1,0,0,232.06,8,673393.69,18,6,21,4,True
7968298,1019,0,20,9214,975153253,1,0,0,232.11,5,673161.58,26,0,8,4,True
8112669,1014,1,10,4430,975153253,1,0,0,232.24,6,673393.82,26,2,8,5,True
8206682,328,0,451,8543,975153253,1,0,0,231.91,7,673161.91,11,1,8,5,True
8297437,1075,0,451,8400,975153253,1,0,0,231.98,7,672929.93,18,5,8,6,True
8317819,1075,0,-1,7686,975153253,1,1,0,232.07,4,672929.93,18,2,3,10,True
8478639,1311,2,20,6621,975153253,1,0,0,232.18,5,672697.75,5,3,0,10,True
8713853,518,2,30,4788,975153253,1,0,0,231.93,8,672465.82,18,4,1,11,True
9082498,849,1,25,6988,975153253,1,0,0,231.87,8,672233.95,5,5,9,11,False
1161980,404,1,451,7740,595753034,1,0,0,874.94,7,428875.06,10,3,1,2,True
1181308,565,4,-1,4437,595753034,1,1,0,874.76,4,428875.06,11,2,6,2,True
1194795,549,1,10,4437,595753034,1,0,0,874.91,6,429749.97,17,3,1,2,True
1496255,130,0,20,8958,595753034,1,0,0,875.04,5,428874.93,18,2,20,3,True
1584618,1471,0,20,8228,595753034,1,0,0,875.11,3,427999.82,24,2,17,4,True
2182286,1169,0,10,8958,595753034,1,0,0,874.87,6,428874.69,24,3,11,5,True
2283835,404,1,451,9058,595753034,1,0,0,874.95,7,427999.74,10,3,2,7,True
2346556,739,1,-1,8228,595753034,1,1,0,875.0,4,427999.74,24,4,11,9,True
2363527,871,0,20,8891,595753034,1,0,0,875.0,5,427124.74,24,3,7,10,True
2490565,739,1,25,2006,595753034,1,0,0,875.06,8,426249.68,24,4,16,10,True
2837739,372,0,30,5660,595753034,1,0,0,875.23,8,425374.45,25,0,6,10,True
3048631,565,4,451,4680,595753034,1,0,0,874.82,7,424499.63,11,4,18,12,True
3141940,1190,3,-1,8891,595753034,1,1,0,875.19,4,424499.63,24,0,6,2,True
3614405,565,4,451,8891,595753034,1,0,0,875.13,7,423624.5,11,1,10,3,True
3648472,1190,3,451,4642,595753034,1,0,0,875.22,7,422749.28,24,1,8,3,True
3963706,1390,0,20,1631,595753034,1,0,0,875.09,5,421874.19,24,3,5,4,True
3981671,404,1,25,8986,595753034,1,0,0,875.05,8,420999.14,10,2,1,4,True
4032640,1190,3,25,9058,595753034,1,0,0,874.64,8,420124.5,24,6,22,4,True
4625503,23,0,10,4967,595753034,1,0,0,874.89,6,420999.39,11,0,10,4,True
4801207,739,1,451,8986,595753034,1,0,0,875.06,7,420124.33,24,1,3,5,True
4850380,404,1,30,4680,595753034,1,0,0,874.85,8,419249.48,10,1,10,5,True
4879371,1190,3,30,6436,595753034,1,0,0,874.99,8,418374.49,24,4,5,6,True
5078571,1190,3,451,6429,595753034,1,0,0,875.11,7,417499.38,24,0,14,7,True
5409229,1190,3,451,6567,595753034,1,0,0,874.84,7,416624.54,24,3,16,7,True
5495238,372,0,25,6429,595753034,1,0,0,875.3,8,415749.24,25,1,7,8,True
5848753,739,1,451,8986,595753034,1,0,0,874.74,7,414874.5,24,5,0,8,True
5849210,739,1,30,7091,595753034,1,0,0,874.97,8,413999.53,24,1,23,8,True
5859239,1190,3,451,8958,595753034,1,0,0,875.15,7,413124.38,24,1,7,9,True
5902275,670,0,20,9058,595753034,1,0,0,875.09,3,412249.29,18,2,13,9,True
5991152,404,1,30,8986,595753034,1,0,0,875.11,8,411374.18,10,0,4,9,True
5995498,1190,3,451,5983,595753034,1,0,0,874.82,7,410499.36,24,0,8,9,True
6106131,565,4,451,3626,595753034,1,0,0,874.93,7,409624.43,11,4,17,10,True
6288533,372,0,451,7740,595753034,1,0,0,875.12,7,408749.31,25,1,11,10,True
6408580,1361,2,20,8019,595753034,1,0,0,875.02,5,407874.29,16,6,4,10,True
6444741,372,0,25,5660,595753034,1,0,0,874.89,8,406999.4,25,0,2,11,True
6513360,404,1,451,7091,595753034,1,0,0,874.94,7,406124.46,10,2,6,11,True
6567736,1190,3,451,6333,595753034,1,0,0,875.17,7,405249.29,24,3,14,12,False
6647428,565,4,25,4437,595753034,1,0,0,874.92,8,404374.37,11,1,21,1,True
7065360,1190,3,30,2006,595753034,1,0,0,875.1,8,403499.27,24,2,16,1,True
7126271,454,1,10,3776,595753034,1,0,0,875.01,6,404374.28,13,6,16,1,True
7344092,565,4,451,4437,595753034,1,0,0,875.05,7,403499.23,11,4,16,2,True
7445941,1210,0,20,5660,595753034,1,0,0,874.86,5,402624.37,24,3,5,4,True
7628136,485,1,10,6271,595753034,1,0,0,875.22,6,403499.59,5,2,19,5,True
8332623,739,1,30,2006,595753034,1,0,0,875.14,8,402624.45,24,5,18,5,True
8390886,1190,3,451,8891,595753034,1,0,0,874.86,7,401749.59,24,1,20,5,True
8420936,739,1,451,9058,595753034,1,0,0,875.2,7,400874.39,24,2,12,7,True
8429736,565,4,25,5660,595753034,1,0,0,875.08,8,399999.31,11,5,16,7,True
8557302,404,1,451,5234,595753034,1,0,0,874.92,7,399124.39,10,6,2,9,True
8728549,1190,3,25,4437,595753034,1,0,0,874.91,8,398249.48,24,4,21,11,True
9477901,404,1,25,4680,595753034,1,0,0,874.9,8,397374.58,10,1,1,11,True
9493591,580,0,20,5234,595753034,1,0,0,875.12,3,396499.46,11,3,17,11,True
9736647,404,1,30,8228,595753034,1,0,0,874.76,8,395624.7,10,6,10,11,True
9980255,739,1,451,5983,595753034,1,0,0,875.19,7,394749.51,24,1,0,11,True
1052126,633,4,451,5905,525536354,0,0,0,584.08,7,849054.92,11,2,1,3,True
1198009,735,1,10,4963,525536354,0,0,0,583.74,0,849638.66,11,6,15,9,True
1399100,280,4,-1,4070,525536354,0,1,0,584.19,1,849638.66,24,6,13,12,True
1452961,633,4,-1,9546,525536354,0,2,0,584.03,4,849638.66,11,1,2,8,True
1494061,643,4,-1,9996,525536354,0,3,1,584.0,4,0.0,24,2,12,8,True
1176545,685,3,30,5819,992042996,1,0,0,763.79,8,952831.21,24,3,7,1,True
1687314,834,0,20,4574,992042996,1,0,0,764.21,5,952067.0,5,1,22,2,True
1810591,685,3,25,3288,992042996,1,0,0,763.99,8,951303.01,24,6,0,3,True
2042892,1058,4,25,8480,992042996,1,0,0,763.99,8,950539.02,11,0,9,3,True
2160449,1283,2,20,8626,992042996,1,0,0,763.7,5,949775.32,24,1,2,3,True
2362555,117,1,30,9334,992042996,1,0,0,763.72,8,949011.6,18,0,16,5,True
2409218,1058,4,451,8626,992042996,1,0,0,763.98,7,948247.62,11,6,13,6,True
2534197,1369,3,451,1566,992042996,1,0,0,764.47,7,947483.15,16,1,18,6,True
2648878,117,1,30,7414,992042996,1,0,0,763.95,8,946719.2,18,2,14,6,True
2816477,1010,0,20,1616,992042996,1,0,0,764.11,5,945955.09,26,2,9,7,True
2944386,685,3,-1,3200,992042996,1,1,0,763.78,4,945955.09,24,1,21,9,True
3034317,685,3,451,8480,992042996,1,0,0,764.14,7,945190.95,24,5,3,10,True
3149280,1058,4,451,2381,992042996,1,0,0,764.17,7,944426.78,11,0,22,10,True
3335076,871,0,10,4574,992042996,1,0,0,764.06,6,945190.84,24,4,8,11,True
3399974,1369,3,451,3200,992042996,1,0,0,764.05,7,944426.79,16,2,18,11,True
3400956,1369,3,30,1616,992042996,1,0,0,763.66,8,943663.13,16,3,5,12,True
3618488,1058,4,30,7322,992042996,1,0,0,763.99,8,942899.14,11,3,0,12,True
3760562,1406,0,20,4574,992042996,1,0,0,763.91,3,942135.23,24,2,0,1,True
3931708,353,1,10,5188,992042996,1,0,0,763.9,0,942899.13,24,2,10,1,True
3969393,117,1,-1,1566,992042996,1,1,0,763.84,1,942899.13,18,4,18,1,True
4372290,340,4,-1,9334,992042996,1,2,0,763.91,4,942899.13,24,6,7,2,True
4541752,117,1,451,7322,992042996,1,0,0,763.78,7,942135.35,18,1,20,2,True
4623560,340,4,451,1616,992042996,1,0,0,764.01,7,941371.34,24,3,3,3,True
4735253,340,4,451,5188,992042996,1,0,0,764.04,7,940607.3,24,5,12,4,True
4962758,348,0,20,6971,992042996,1,0,0,764.02,5,939843.28,24,2,7,6,True
5082122,685,3,25,1616,992042996,1,0,0,764.13,8,939079.15,24,2,11,6,True
5319788,1058,4,25,9888,992042996,1,0,0,763.83,8,938315.32,11,4,13,7,True
5442323,1058,4,-1,8626,992042996,1,1,0,764.05,1,938315.32,11,2,15,7,True
5829551,1419,1,10,3200,992042996,1,0,0,763.86,6,939079.18,24,4,18,8,True
6148789,117,1,25,5188,992042996,1,0,0,763.96,8,938315.22,18,3,12,9,True
6163327,1058,4,-1,2983,992042996,1,1,0,763.92,4,938315.22,11,0,23,9,True
6290518,685,3,25,6971,992042996,1,0,0,763.99,8,937551.23,24,3,19,10,True
6351967,685,3,25,3200,992042996,1,0,0,763.92,8,936787.31,24,6,13,10,True
6461468,203,0,10,5112,992042996,1,0,0,764.39,6,937551.7,9,5,6,10,True
6978146,685,3,25,3288,992042996,1,0,0,763.86,8,936787.84,24,3,8,1,True
7390187,685,3,25,5819,992042996,1,0,0,764.32,8,936023.52,24,4,22,1,True
7599268,1369,3,30,7322,992042996,1,0,0,764.15,8,935259.37,16,1,8,1,True
7621505,144,1,10,6971,992042996,1,0,0,764.04,6,936023.41,18,2,9,1,True
8085982,956,1,10,3200,992042996,1,0,0,764.01,0,936787.42,13,3,21,2,True
8399636,1461,0,10,5150,992042996,1,0,0,764.04,6,937551.46,11,6,2,3,True
8662894,685,3,451,2983,992042996,1,0,0,764.0,7,936787.46,24,6,4,5,True
8664289,780,0,20,1566,992042996,1,0,0,763.97,5,936023.49,14,3,22,5,True
8758134,117,1,25,3200,992042996,1,0,0,764.1,8,935259.39,18,3,23,5,True
9015616,1058,4,451,4574,992042996,1,0,0,763.82,7,934495.57,11,4,5,8,True
9331166,340,4,30,4794,992042996,1,0,0,763.82,8,933731.75,24,1,10,8,True
9361619,373,1,10,7322,992042996,1,0,0,764.1,0,934495.85,25,6,23,9,True
9393525,1000,0,10,5112,992042996,1,0,0,764.28,6,935260.13,26,2,13,9,True
9659029,117,1,-1,5112,992042996,1,1,0,764.04,4,935260.13,18,1,1,10,True
9883505,340,4,-1,2661,992042996,1,2,0,764.08,4,935260.13,24,4,13,11,True
9978744,951,0,10,1566,992042996,1,0,0,763.8,6,936023.93,24,6,7,11,True
9987290,557,1,10,3288,992042996,1,0,0,764.12,6,936788.05,17,1,17,11,True
1391342,286,1,10,8682,483027660,0,0,0,1105.92,6,791056.92,24,5,10,3,True
1446294,1167,4,30,6673,483027660,0,0,0,1105.84,8,789951.08,24,1,18,4,True
1473922,120,4,451,8682,483027660,0,0,0,1106.05,7,788845.03,18,4,8,4,True
1647314,882,0,30,9821,483027660,0,0,0,1105.9,8,787739.13,27,5,22,5,True
2129691,287,0,10,6595,483027660,0,0,0,1105.87,6,788845.0,24,3,11,5,True
2308814,1167,4,-1,9709,483027660,0,1,0,1105.83,4,788845.0,24,3,19,6,False
2676680,1325,0,30,5108,483027660,0,0,0,1105.88,8,787739.12,18,4,11,7,True
2698383,120,4,-1,6284,483027660,0,1,0,1106.13,1,787739.12,18,3,22,8,True
2885318,1449,0,10,6818,483027660,0,0,0,1106.12,0,788845.24,11,4,20,9,True
2935070,1421,0,10,1858,483027660,0,0,0,1105.95,6,789951.19,24,0,2,9,True
3073473,1167,4,-1,5112,483027660,0,1,0,1106.2,4,789951.19,24,4,7,10,True
3118160,1167,4,30,7148,483027660,0,0,0,1106.02,8,788845.17,24,1,2,12,True
3190796,605,0,451,5112,483027660,0,0,0,1105.68,7,787739.49,24,1,4,1,True
3365210,882,0,25,2808,483027660,0,0,0,1106.17,8,786633.32,27,4,11,2,True
3597159,1325,0,25,8682,483027660,0,0,0,1106.28,8,785527.04,18,1,21,2,True
3749448,990,0,10,8904,483027660,0,0,0,1106.19,6,786633.23,22,4,11,2,True
3819377,1000,0,30,2538,483027660,0,0,0,1105.65,8,785527.58,26,6,12,2,True
3834620,130,0,10,6284,483027660,0,0,0,1105.99,6,786633.57,18,0,17,4,True
4142864,882,0,30,3328,483027660,0,0,0,1106.08,8,785527.49,27,0,17,4,True
4242354,882,0,30,2808,483027660,0,0,0,1106.0,8,784421.49,27,3,16,4,True
4506103,1116,0,20,7745,483027660,0,0,0,1105.96,3,783315.53,24,4,9,5,True
4543099,522,0,10,7148,483027660,0,0,0,1106.02,0,784421.55,18,5,4,5,True
4664583,228,0,-1,9709,483027660,0,1,0,1106.24,4,784421.55,26,5,22,5,True
4921087,1124,0,10,5476,483027660,0,0,0,1106.11,6,785527.66,24,6,0,5,True
5012938,1140,0,20,5354,483027660,0,0,0,1105.98,5,784421.68,15,5,10,5,True
5250150,882,0,30,2688,483027660,0,0,0,1106.01,8,783315.67,27,6,6,5,True
5528618,605,0,451,8904,483027660,0,0,0,1105.87,7,782209.8,24,2,7,6,False
5586252,120,4,25,9821,483027660,0,0,0,1106.09,8,781103.71,18,1,4,7,True
5615846,1444,3,30,3328,483027660,0,0,0,1106.04,8,779997.67,24,3,19,8,True
5799639,120,4,-1,2662,483027660,0,1,0,1105.93,4,779997.67,18,6,2,9,True
5888845,228,0,451,2688,483027660,0,0,0,1105.87,7,778891.8,26,6,17,9,True
6005953,1170,0,10,6595,483027660,0,0,0,1105.74,6,779997.54,24,4,23,9,True
6185207,605,0,30,7679,483027660,0,0,0,1106.04,8,778891.5,24,1,14,10,True
6407450,605,0,451,8682,483027660,0,0,0,1105.77,7,777785.73,24,4,9,10,True
6702880,111,3,30,9821,483027660,0,0,0,1105.61,8,776680.12,3,0,15,10,False
6966088,1409,1,10,7679,483027660,0,0,0,1106.03,0,777786.15,24,2,12,11,True
6978518,687,0,20,7745,483027660,0,0,0,1105.81,5,776680.34,24,3,8,11,True
7197556,438,1,10,5108,483027660,0,0,0,1105.75,0,777786.09,24,6,16,11,True
7424980,1444,3,451,7679,483027660,0,0,0,1106.08,7,776680.01,24,0,19,11,True
7528129,111,3,-1,8960,483027660,0,1,0,1106.07,4,776680.01,3,5,4,12,True
7833830,81,0,20,9821,483027660,0,0,0,1105.82,5,775574.19,1,6,18,1,True
7840074,304,0,10,2808,483027660,0,0,0,1106.3,6,776680.49,4,5,14,1,True
8007579,228,0,451,9478,483027660,0,0,0,1106.44,7,775574.05,26,2,2,4,True
8033637,1325,0,451,9478,483027660,0,0,0,1105.98,7,774468.07,18,4,16,4,True
8098389,882,0,-1,7148,483027660,0,1,0,1105.96,1,774468.07,27,2,4,5,True
8303297,228,0,451,7745,483027660,0,0,0,1105.94,7,773362.13,26,5,12,5,False
8566523,120,4,451,9709,483027660,0,0,0,1105.8,7,772256.33,18,3,23,5,False
8612570,1167,4,451,8960,483027660,0,0,0,1106.16,7,771150.17,24,2,12,6,True
8887489,576,2,20,8960,483027660,0,0,0,1105.98,5,770044.19,11,5,2,6,True
8918168,228,0,451,7148,483027660,0,0,0,1105.97,7,768938.22,26,5,18,6,True
9146645,605,0,-1,7745,483027660,0,1,0,1106.2,1,768938.22,24,5,12,7,True
9217271,1167,4,25,5476,483027660,0,0,0,1106.04,8,767832.18,24,0,0,7,True
9230386,111,3,30,8904,483027660,0,0,0,1106.0,8,766726.18,3,1,11,7,True
9431404,1167,4,451,5354,483027660,0,0,0,1106.35,7,765619.83,24,0,1,8,True
9432107,882,0,-1,9709,483027660,0,1,0,1106.01,1,765619.83,27,0,21,8,True
9540705,111,3,-1,4410,483027660,0,2,0,1105.97,4,765619.83,3,1,19,8,True
9555477,996,0,10,6818,483027660,0,0,0,1105.95,6,766725.78,26,3,14,8,True
9785606,1063,0,20,8904,483027660,0,0,0,1106.12,5,765619.66,11,0,19,8,True
9920180,1325,0,451,2688,483027660,0,0,0,1106.06,7,764513.6,18,4,19,10,True
1081035,1012,0,10,9763,456450627,1,0,0,608.16,6,695936.16,26,1,4,1,True
1119315,366,0,451,3799,456450627,1,0,0,608.05,7,695328.11,25,3,14,1,True
1345818,1347,4,25,5689,456450627,1,0,0,608.22,8,694719.89,24,5,18,1,True
1378920,980,1,-1,5689,456450627,1,1,0,608.0,1,694719.89,22,2,14,1,True
1499906,949,4,25,9763,456450627,1,0,0,607.91,8,694111.98,24,6,16,2,True
1576567,705,1,10,8141,456450627,1,0,0,608.1,6,694720.08,18,3,3,3,True
1716514,1262,0,20,3144,456450627,1,0,0,607.9,5,694112.18,23,0,1,5,True
1832672,1347,4,451,9888,456450627,1,0,0,607.97,7,693504.21,24,0,17,5,True
1879290,949,4,-1,3144,456450627,1,1,0,608.27,1,693504.21,24,6,15,7,True
2089229,1037,0,20,3144,456450627,1,0,0,608.1,5,692896.11,11,5,11,7,True
2804351,949,4,-1,5999,456450627,1,1,0,607.92,4,692896.11,24,2,19,8,False
3072654,1247,0,20,9888,456450627,1,0,0,608.09,5,692288.02,23,1,18,10,True
3149751,366,0,-1,7199,456450627,1,1,0,608.04,4,692288.02,25,0,12,10,True
3418214,1347,4,-1,3144,456450627,1,2,0,608.05,4,692288.02,24,6,1,10,True
3514164,254,0,10,5689,456450627,1,0,0,608.06,0,692896.08,6,4,0,11,True
4173434,679,0,10,5999,456450627,1,0,0,607.81,0,693503.89,24,2,21,1,True
4228632,977,4,-1,5999,456450627,1,1,0,608.06,1,693503.89,22,0,6,1,True
4323809,637,4,30,3927,456450627,1,0,0,608.06,8,692895.83,24,3,10,1,True
4523086,1347,4,-1,3651,456450627,1,1,0,608.07,4,692895.83,24,2,2,1,True
4784047,1461,0,10,3799,456450627,1,0,0,608.07,0,693503.9,11,2,11,2,True
5318080,980,1,30,8957,456450627,1,0,0,608.01,8,692895.89,22,0,0,2,True
5341969,907,0,20,5263,456450627,1,0,0,608.08,3,692287.81,2,5,11,2,True
5456351,1175,2,20,2863,456450627,1,0,0,608.19,5,691679.62,24,1,20,3,True
5514966,1374,4,25,5728,456450627,1,0,0,607.66,8,691071.96,16,5,18,4,False
5615853,977,4,-1,7734,456450627,1,1,0,607.96,1,691071.96,22,4,22,5,True
5626334,239,1,10,3750,456450627,1,0,0,608.04,0,691680.0,26,6,7,5,True
5700802,1090,0,20,3927,456450627,1,0,0,607.93,5,691072.07,18,3,1,5,True
6230254,531,0,10,8608,456450627,1,0,0,607.96,6,691680.03,18,3,4,7,True
6287384,1474,0,10,5263,456450627,1,0,0,608.12,6,692288.15,24,2,22,8,True
6357443,278,1,10,5999,456450627,1,0,0,608.18,0,692896.33,24,2,8,9,True
6430449,977,4,451,1482,456450627,1,0,0,608.06,7,692288.27,22,6,19,10,True
6585967,980,1,25,9763,456450627,1,0,0,607.71,8,691680.56,22,2,22,11,True
6765400,949,4,451,7199,456450627,1,0,0,607.92,7,691072.64,24,4,1,12,True
6930475,980,1,451,7734,456450627,1,0,0,607.8,7,690464.84,22,1,1,1,True
7062203,991,1,10,9351,456450627,1,0,0,607.97,0,691072.81,22,6,19,1,True
7102276,1483,0,20,9763,456450627,1,0,0,607.95,5,690464.86,24,4,4,2,True
7174421,373,1,451,5728,456450627,1,0,0,608.13,7,689856.73,25,1,10,2,True
7184657,25,3,451,8608,456450627,1,0,0,608.03,7,689248.7,11,5,6,3,True
7233599,977,4,30,9763,456450627,1,0,0,607.76,8,688640.94,22,5,11,4,True
7520714,1219,1,10,3651,456450627,1,0,0,608.12,6,689249.06,24,3,18,4,True
7595924,205,0,20,8608,456450627,1,0,0,608.2,3,688640.86,9,1,16,5,True
7784527,977,4,30,3927,456450627,1,0,0,608.0,8,688032.86,22,6,4,5,True
7839046,637,4,25,9763,456450627,1,0,0,607.89,8,687424.97,24,5,22,6,True
8000348,373,1,451,8957,456450627,1,0,0,607.93,7,686817.04,25,6,18,6,True
8030665,637,4,451,3750,456450627,1,0,0,608.07,7,686208.97,24,3,13,6,True
8108003,373,1,-1,7734,456450627,1,1,0,607.87,1,686208.97,25,1,10,6,True
8176384,145,0,10,2863,456450627,1,0,0,608.07,6,686817.04,18,1,10,7,True
8218790,977,4,25,3619,456450627,1,0,0,607.82,8,686209.22,22,2,4,7,True
8549076,350,0,10,5689,456450627,1,0,0,607.93,0,686817.15,24,4,11,8,True
8621775,1347,4,-1,7734,456450627,1,1,0,608.0,1,686817.15,24,1,6,8,True
8917837,1140,0,10,1145,456450627,1,0,0,607.99,6,687425.14,15,4,1,8,True
8954917,219,0,20,9763,456450627,1,0,0,607.87,5,686817.27,9,1,12,10,True
9437934,977,4,-1,3927,456450627,1,1,0,608.05,1,686817.27,22,5,19,10,True
9829771,980,1,451,5263,456450627,1,0,0,607.87,7,686209.4,22,2,0,10,True
9869741,1245,1,10,3927,456450627,1,0,0,608.03,0,686817.43,18,1,2,10,True
9941127,366,0,25,7734,456450627,1,0,0,608.02,8,686209.41,25,5,7,10,True
9962402,605,0,20,1145,456450627,1,0,0,607.91,3,685601.5,24,0,2,11,True
1029787,774,2,-1,4264,568684881,0,1,0,602.86,4,807894.0,14,0,2,1,True
1366565,562,1,10,2250,568684881,0,0,0,603.03,6,808497.03,17,1,11,1,True
1474981,134,4,451,7653,568684881,0,0,0,602.85,7,807894.18,18,0,11,1,True
1988023,979,0,20,9362,568684881,0,0,0,602.88,5,807291.3,22,3,1,3,True
2241066,211,0,20,9621,568684881,0,0,0,602.91,5,806688.39,9,5,3,3,True
2244207,185,1,10,9469,568684881,0,0,0,602.95,6,807291.34,18,2,18,4,True
2292149,134,4,25,7930,568684881,0,0,0,603.1,8,806688.24,18,6,17,4,True
2424596,550,0,20,9362,568684881,0,0,0,602.8,3,806085.44,17,6,21,4,False
2650056,134,4,-1,2934,568684881,0,1,0,602.89,4,806085.44,18,4,22,4,True
2669662,134,4,25,4763,568684881,0,0,0,603.14,8,805482.3,18,3,3,7,True
2759029,774,2,451,9469,568684881,0,0,0,602.77,7,804879.53,14,2,4,8,False
2804411,134,4,-1,5288,568684881,0,1,0,603.01,4,804879.53,18,3,1,9,True
2849849,126,1,25,7653,568684881,0,0,0,602.8,8,804276.73,18,2,9,9,True
2923874,551,0,20,3765,568684881,0,0,0,602.98,3,803673.75,17,5,20,10,True
3257617,669,2,20,3373,568684881,0,0,0,603.18,5,803070.57,18,4,9,11,True
3496650,1278,0,20,4368,568684881,0,0,0,603.19,3,802467.38,24,0,0,1,True
3501942,126,1,-1,8090,568684881,0,1,0,602.68,4,802467.38,18,0,20,1,True
3987041,557,1,10,6522,568684881,0,0,0,602.69,6,803070.07,17,1,15,2,True
4083835,850,1,10,1157,568684881,0,0,0,603.03,6,803673.1,5,6,18,4,True
4263881,126,1,30,1086,568684881,0,0,0,603.1,8,803070.0,18,5,8,5,True
4298953,1406,0,10,9469,568684881,0,0,0,603.05,6,803673.05,24,0,7,6,False
4346193,65,3,25,8090,568684881,0,0,0,602.66,8,803070.39,20,0,23,6,True
4399272,134,4,25,1054,568684881,0,0,0,603.11,8,802467.28,18,3,14,6,True
4675794,766,4,25,4763,568684881,0,0,0,602.88,8,801864.4,14,1,12,6,True
4806266,766,4,25,8090,568684881,0,0,0,602.85,8,801261.55,14,5,9,7,True
4932379,65,3,451,2690,568684881,0,0,0,603.24,7,800658.31,20,5,0,7,True
5815905,766,4,-1,4368,568684881,0,1,0,602.8,4,800658.31,14,0,19,7,True
5913988,774,2,30,8090,568684881,0,0,0,602.85,8,800055.46,14,0,10,7,True
6023139,192,2,20,6522,568684881,0,0,0,602.97,5,799452.49,18,0,15,8,True
6035064,877,2,20,5288,568684881,0,0,0,602.95,5,798849.54,24,3,6,9,True
6444357,65,3,451,9362,568684881,0,0,0,602.71,7,798246.83,20,6,21,9,True
6465528,65,3,451,2562,568684881,0,0,0,603.1,7,797643.73,20,6,4,10,True
6605821,980,1,10,2934,568684881,0,0,0,603.17,0,798246.9,22,4,4,10,True
6622761,267,0,10,9621,568684881,0,0,0,602.89,6,798849.79,6,2,9,10,True
6713215,65,3,30,1054,568684881,0,0,0,602.74,8,798247.05,20,1,5,11,True
6721335,1247,0,10,4264,568684881,0,0,0,602.82,6,798849.87,23,2,11,11,True
6953306,573,0,10,9621,568684881,0,0,0,602.98,6,799452.85,11,3,6,12,True
6954671,276,0,20,5270,568684881,0,0,0,603.04,5,798849.81,24,6,1,1,True
7175517,65,3,-1,9469,568684881,0,1,0,602.87,4,798849.81,20,1,8,1,True
7821079,1288,0,10,4763,568684881,0,0,0,602.98,0,799452.79,24,4,11,3,True
8130363,1075,0,10,2562,568684881,0,0,0,603.19,6,800055.98,18,6,23,3,True
8257279,766,4,-1,3765,568684881,0,1,0,602.8,4,800055.98,14,4,8,3,True
8570646,766,4,451,2934,568684881,0,0,0,603.02,7,799452.96,14,2,17,4,True
8814586,126,1,451,3765,568684881,0,0,0,602.8,7,798850.16,18,0,14,4,True
9465301,998,0,20,1054,568684881,0,0,0,603.08,3,798247.08,26,0,10,5,True
9868721,628,0,20,2690,568684881,0,0,0,603.14,5,797643.94,11,4,17,6,True
9915633,134,4,451,4264,568684881,0,0,0,602.86,7,797041.08,18,2,20,7,True
9923218,65,3,25,1086,568684881,0,0,0,602.67,8,796438.41,20,6,19,8,True
9968657,1235,1,10,8030,568684881,0,0,0,603.05,0,797041.46,18,5,18,10,True
9999808,457,0,20,5270,568684881,0,0,0,603.08,3,796438.38,13,5,19,10,True
1046943,146,4,30,6733,596081835,0,0,0,568.78,8,109304.22,18,4,12,1,True
1137939,326,4,30,4969,596081835,0,0,0,569.15,8,108735.07,11,0,21,4,True
1546985,465,0,20,6394,596081835,0,0,0,568.93,5,108166.14,13,0,21,4,True
1565127,146,4,25,9732,596081835,0,0,0,568.99,8,107597.15,18,1,11,4,True
1703268,1164,0,20,9255,596081835,0,0,0,569.01,5,107028.14,24,1,6,5,True
1715287,146,4,25,9419,596081835,0,0,0,569.1,8,106459.04,18,5,6,6,True
1841232,96,0,10,4274,596081835,0,0,0,568.78,6,107027.82,1,6,22,6,True
1904934,326,4,451,9284,596081835,0,0,0,569.09,7,106458.73,11,4,19,7,True
2169117,1213,2,20,7473,596081835,0,0,0,568.89,5,105889.84,24,2,7,7,True
2309140,1094,0,451,4969,596081835,0,0,0,568.79,7,105321.05,0,1,5,10,False
2335861,146,4,30,5120,596081835,0,0,0,569.19,8,104751.86,18,1,16,10,True
2368832,1094,0,451,9419,596081835,0,0,0,568.79,7,104183.07,0,6,18,10,True
2500217,146,4,25,9419,596081835,0,0,0,568.93,8,103614.14,18,3,20,11,True
2565115,1443,4,-1,5769,596081835,0,1,0,568.85,1,103614.14,24,3,21,11,True
2615391,757,0,10,4274,596081835,0,0,0,569.06,0,104183.2,24,3,7,11,True
3102115,326,4,451,9284,596081835,0,0,0,569.0,7,103614.2,11,6,20,12,True
3250912,146,4,25,7653,596081835,0,0,0,568.95,8,103045.25,18,0,20,1,True
3252607,326,4,25,6733,596081835,0,0,0,568.95,8,102476.3,11,5,12,1,True
3411307,326,4,25,2706,596081835,0,0,0,568.9,8,101907.4,11,5,15,4,True
3616971,1179,0,10,5774,596081835,0,0,0,569.08,6,102476.48,24,6,6,6,True
3829985,850,1,10,2523,596081835,0,0,0,568.89,6,103045.37,5,0,8,6,True
4011783,1246,0,10,5120,596081835,0,0,0,568.99,0,103614.36,23,2,9,6,True
5056105,533,2,20,5120,596081835,0,0,0,568.93,3,103045.43,18,1,12,7,True
5097866,1443,4,30,2523,596081835,0,0,0,569.23,8,102476.2,24,3,14,7,True
5122697,610,0,20,9732,596081835,0,0,0,569.02,5,101907.18,11,4,17,8,True
5226671,27,0,10,4630,596081835,0,0,0,569.09,6,102476.27,11,5,0,8,True
5447463,569,4,451,5203,596081835,0,0,0,569.2,7,101907.07,11,0,9,9,True
5616651,146,4,30,9419,596081835,0,0,0,569.26,8,101337.81,18,1,11,9,True
5703822,326,4,451,8776,596081835,0,0,0,568.94,7,100768.87,11,3,14,10,False
5880429,883,0,10,9796,596081835,0,0,0,569.0,6,101337.87,24,4,19,10,False
6209375,952,0,20,3888,596081835,0,0,0,569.06,5,100768.81,13,5,9,10,True
6640615,142,4,451,9284,596081835,0,0,0,568.83,7,100199.98,18,6,2,10,True
7042125,326,4,451,4969,596081835,0,0,0,568.95,7,99631.03,11,1,7,11,False
7523203,146,4,451,2706,596081835,0,0,0,569.08,7,99061.95,18,3,0,11,True
7923167,142,4,451,5406,596081835,0,0,0,569.01,7,98492.94,18,1,23,11,True
8009913,1094,0,451,9841,596081835,0,0,0,569.07,7,97923.87,0,1,0,12,True
8027219,569,4,451,5254,596081835,0,0,0,568.95,7,97354.92,11,1,11,12,True
8132468,1094,0,451,5203,596081835,0,0,0,568.8,7,96786.12,0,2,0,12,True
8362481,326,4,451,9284,596081835,0,0,0,568.93,7,96217.19,11,5,1,12,True
8373317,146,4,30,3888,596081835,0,0,0,569.14,8,95648.05,18,5,18,1,True
8396691,1443,4,451,7483,596081835,0,0,0,569.11,7,95078.94,24,6,12,2,True
8566752,1094,0,25,5120,596081835,0,0,0,569.17,8,94509.77,0,3,21,3,True
8835979,184,0,10,9419,596081835,0,0,0,569.0,0,95078.77,18,2,18,3,True
8841808,569,4,451,9255,596081835,0,0,0,569.15,7,94509.62,11,6,21,4,True
8945884,326,4,-1,3999,596081835,0,1,0,568.88,1,94509.62,11,3,1,5,True
9081089,142,4,25,5406,596081835,0,0,0,568.97,8,93940.65,18,1,8,7,True
9223053,326,4,451,7000,596081835,0,0,0,569.18,7,93371.47,11,4,2,8,True
9534629,569,4,451,9850,596081835,0,0,0,568.99,7,92802.48,11,4,15,8,True
9671795,1443,4,25,5406,596081835,0,0,0,568.89,8,92233.59,24,1,13,8,True
9878090,34,1,10,5774,596081835,0,0,0,568.71,6,92802.3,11,3,9,9,True
9957592,146,4,451,7435,596081835,0,0,0,569.02,7,92233.28,18,0,5,10,True
1526296,1174,3,25,7600,123611684,1,0,0,1144.89,8,707779.11,24,6,2,1,True
1902789,1475,3,25,6603,123611684,1,0,0,1145.03,8,706634.08,24,0,20,2,True
2244701,1009,0,451,6603,123611684,1,0,0,1145.28,7,705488.8,26,1,1,3,True
2659131,1009,0,451,5184,123611684,1,0,0,1144.96,7,704343.84,26,4,11,3,True
2670542,1475,3,-1,2157,123611684,1,1,0,1145.17,1,704343.84,24,3,0,4,True
2697569,279,2,20,2157,123611684,1,0,0,1144.91,5,703198.93,24,0,13,5,True
2781732,318,0,20,1458,123611684,1,0,0,1145.19,5,702053.74,11,0,16,5,True
2840452,774,2,20,4847,123611684,1,0,0,1144.76,3,700908.98,14,4,3,5,True
2972949,349,2,451,1628,123611684,1,0,0,1144.82,7,699764.16,24,6,13,5,True
3245986,1475,3,25,2557,123611684,1,0,0,1144.87,8,698619.29,24,5,16,7,True
3253360,215,0,10,6202,123611684,1,0,0,1145.04,0,699764.33,9,2,11,10,True
3427419,1174,3,30,1618,123611684,1,0,0,1145.07,8,698619.26,24,0,1,10,True
3547988,198,0,10,1458,123611684,1,0,0,1144.9,0,699764.16,18,0,6,11,True
3579100,349,2,25,2184,123611684,1,0,0,1145.05,8,698619.11,24,4,10,12,True
3591675,1036,1,10,5184,123611684,1,0,0,1145.04,6,699764.15,11,2,12,1,True
3612525,1093,0,20,2157,123611684,1,0,0,1145.01,5,698619.14,18,5,4,1,True
3703810,1399,0,30,8663,123611684,1,0,0,1144.93,8,697474.21,24,5,16,1,True
3937083,349,2,30,1618,123611684,1,0,0,1144.95,8,696329.26,24,5,2,2,True
4507888,1015,0,451,9574,123611684,1,0,0,1144.9,7,695184.36,26,5,20,3,True
4581506,1399,0,451,2157,123611684,1,0,0,1145.02,7,694039.34,24,6,6,4,True
4662889,1475,3,30,6658,123611684,1,0,0,1145.11,8,692894.23,24,6,14,4,True
4947431,1015,0,25,1336,123611684,1,0,0,1144.79,8,691749.44,26,5,21,4,True
5103977,1015,0,30,6142,123611684,1,0,0,1144.87,8,690604.57,26,3,8,5,True
5191991,558,0,10,3951,123611684,1,0,0,1145.24,6,691749.81,17,5,14,5,True
5420945,1475,3,25,1628,123611684,1,0,0,1145.0,8,690604.81,24,2,19,6,True
5475633,1009,0,30,4005,123611684,1,0,0,1145.12,8,689459.69,26,3,16,7,True
5692331,1399,0,25,7054,123611684,1,0,0,1145.23,8,688314.46,24,5,8,7,True
5782830,349,2,-1,4553,123611684,1,1,0,1145.02,4,688314.46,24,6,14,8,True
5827341,611,0,20,4532,123611684,1,0,0,1144.77,5,687169.69,11,6,16,9,True
6282234,349,2,30,1943,123611684,1,0,0,1144.78,8,686024.91,24,1,9,10,True
6323302,1475,3,30,1943,123611684,1,0,0,1145.23,8,684879.68,24,5,6,10,True
6375202,1399,0,30,2557,123611684,1,0,0,1145.06,8,683734.62,24,1,23,10,True
6701302,349,2,25,2184,123611684,1,0,0,1145.07,8,682589.55,24,1,17,11,True
6829098,1174,3,25,7054,123611684,1,0,0,1144.96,8,681444.59,24,1,22,11,True
6922981,372,0,20,9574,123611684,1,0,0,1145.14,5,680299.45,25,5,11,12,True
6928629,349,2,25,6142,123611684,1,0,0,1144.89,8,679154.56,24,4,19,1,True
7100875,1009,0,451,4847,123611684,1,0,0,1144.65,7,678009.91,26,4,8,2,True
7147699,349,2,25,1197,123611684,1,0,0,1144.93,8,676864.98,24,0,7,3,True
7191941,1009,0,451,2432,123611684,1,0,0,1144.82,7,675720.16,26,1,5,3,True
7226038,1009,0,-1,7539,123611684,1,1,0,1144.98,4,675720.16,26,5,17,4,True
7300709,1399,0,451,2432,123611684,1,0,0,1145.17,7,674574.99,24,2,18,5,True
7822142,1399,0,451,6142,123611684,1,0,0,1144.93,7,673430.06,24,4,1,5,True
7929980,1475,3,30,2432,123611684,1,0,0,1145.07,8,672284.99,24,0,18,6,True
7970895,1174,3,25,1197,123611684,1,0,0,1144.83,8,671140.16,24,1,4,6,True
8006694,1399,0,451,2184,123611684,1,0,0,1144.98,7,669995.18,24,5,6,7,True
8132554,1009,0,451,6142,123611684,1,0,0,1145.06,7,668850.12,26,0,23,8,True
8312257,1210,0,10,6658,123611684,1,0,0,1145.2,6,669995.32,24,2,3,8,True
8385524,1174,3,451,6142,123611684,1,0,0,1144.95,7,668850.37,24,4,6,9,True
8522039,1174,3,30,3951,123611684,1,0,0,1144.99,8,667705.38,24,5,14,9,True
9234097,1009,0,25,1618,123611684,1,0,0,1145.21,8,666560.17,26,2,18,10,True
9263865,127,1,10,2432,123611684,1,0,0,1144.96,0,667705.13,18,5,19,11,True
9339227,267,0,10,7054,123611684,1,0,0,1144.74,6,668849.87,6,4,16,11,True
9680626,956,1,10,1628,123611684,1,0,0,1145.18,6,669995.05,13,4,20,11,True
1108797,349,2,-1,3348,556760800,1,1,0,955.92,4,80887.0,24,5,16,1,True
1200443,549,1,451,6868,556760800,1,0,0,955.93,7,79931.07,17,1,5,1,True
1281838,761,2,25,3427,556760800,1,0,0,956.11,8,78974.96,24,6,15,1,True
1291634,761,2,30,1899,556760800,1,0,0,955.86,8,78019.1,24,3,0,2,True
1560279,549,1,-1,8649,556760800,1,1,0,955.82,4,78019.1,17,6,3,2,True
1642338,761,2,25,4163,556760800,1,0,0,956.01,8,77063.09,24,3,11,2,True
1926107,699,4,25,2214,556760800,1,0,0,955.72,8,76107.37,18,1,4,3,True
2025919,980,1,10,8386,556760800,1,0,0,956.26,6,77063.63,22,4,12,3,True
2060861,1063,0,10,5962,556760800,1,0,0,955.86,0,78019.49,11,4,1,3,True
2233044,956,1,451,8903,556760800,1,0,0,956.02,7,77063.47,13,6,5,3,True
2609148,761,2,25,3348,556760800,1,0,0,956.07,8,76107.4,24,3,5,4,True
3171351,699,4,30,2570,556760800,1,0,0,955.79,8,75151.61,18,3,3,4,True
3178192,956,1,25,3137,556760800,1,0,0,956.12,8,74195.49,13,6,6,4,True
3180098,484,0,20,8903,556760800,1,0,0,956.02,3,73239.47,5,0,18,4,True
3181800,340,4,451,8386,556760800,1,0,0,956.19,7,72283.28,24,5,3,5,True
3222816,761,2,25,5286,556760800,1,0,0,956.05,8,71327.23,24,1,9,5,True
3534565,126,1,10,5962,556760800,1,0,0,956.1,0,72283.33,18,3,11,7,True
3632506,300,0,10,2214,556760800,1,0,0,956.05,6,73239.38,4,1,15,7,True
3806940,780,0,20,2570,556760800,1,0,0,956.11,5,72283.27,14,2,12,8,True
3974050,907,0,10,2570,556760800,1,0,0,956.0,6,73239.27,2,2,15,10,True
4162289,761,2,-1,2570,556760800,1,1,0,956.19,4,73239.27,24,5,15,12,True
4261761,340,4,30,5093,556760800,1,0,0,955.85,8,72283.42,24,5,23,1,False
4438012,761,2,451,3348,556760800,1,0,0,955.95,7,71327.47,24,5,18,2,True
4571257,956,1,451,2214,556760800,1,0,0,956.22,7,70371.25,13,1,1,2,True
4824033,1471,0,20,3137,556760800,1,0,0,956.3,3,69414.95,24,2,19,3,True
4837849,215,0,20,3928,556760800,1,0,0,955.93,5,68459.02,9,2,21,5,False
4888312,549,1,30,2214,556760800,1,0,0,956.2,8,67502.82,17,4,18,7,True
4946684,588,0,20,3928,556760800,1,0,0,956.06,3,66546.76,24,3,16,7,True
5091838,349,2,25,4163,556760800,1,0,0,955.9,8,65590.86,24,3,20,8,True
5188405,956,1,-1,1899,556760800,1,1,0,956.17,4,65590.86,13,1,8,8,False
5432660,549,1,451,3427,556760800,1,0,0,955.87,7,64634.99,17,1,23,9,True
5567747,761,2,451,4163,556760800,1,0,0,956.14,7,63678.85,24,5,23,11,True
5634738,1471,0,10,2320,556760800,1,0,0,955.86,6,64634.71,24,4,2,11,True
5816287,956,1,451,8196,556760800,1,0,0,956.19,7,63678.52,13,0,7,11,True
7025528,535,0,10,5093,556760800,1,0,0,956.31,6,64634.83,18,2,4,1,True
7132049,194,1,10,3427,556760800,1,0,0,956.13,6,65590.96,18,4,19,1,True
7262686,349,2,25,7938,556760800,1,0,0,955.88,8,64635.08,24,5,10,1,True
7451380,761,2,-1,4460,556760800,1,1,0,956.09,4,64635.08,24,6,7,2,True
7454202,761,2,451,6613,556760800,1,0,0,955.9,7,63679.18,24,2,3,2,True
7509994,761,2,-1,6868,556760800,1,1,0,956.05,4,63679.18,24,0,2,3,True
7619753,761,2,-1,8196,556760800,1,2,0,956.14,4,63679.18,24,5,14,4,True
7642973,1412,2,20,2570,556760800,1,0,0,955.94,5,62723.24,24,2,17,5,True
8023292,340,4,-1,2214,556760800,1,1,0,956.01,4,62723.24,24,4,6,6,True
8402391,549,1,451,7938,556760800,1,0,0,956.07,7,61767.17,17,5,6,6,True
8423494,349,2,30,2570,556760800,1,0,0,956.07,8,60811.1,24,4,14,7,True
9003980,956,1,451,6868,556760800,1,0,0,955.82,7,59855.28,13,3,11,7,True
9137746,956,1,451,3137,556760800,1,0,0,955.99,7,58899.29,13,6,19,8,True
9233113,211,0,10,2684,556760800,1,0,0,955.88,6,59855.17,9,3,2,8,True
9299646,549,1,-1,6868,556760800,1,1,0,955.86,1,59855.17,17,6,10,8,True
9390432,349,2,-1,3137,556760800,1,2,0,955.94,4,59855.17,24,4,4,8,True
9418051,549,1,25,4477,556760800,1,0,0,955.8,8,58899.37,17,5,8,9,True
9527288,309,0,10,6613,556760800,1,0,0,955.83,6,59855.2,4,6,19,9,True
9576367,956,1,30,9977,556760800,1,0,0,956.37,8,58898.83,13,1,10,10,True
9598665,699,4,30,1515,556760800,1,0,0,955.95,8,57942.88,18,4,9,10,True
9613409,1474,0,20,8196,556760800,1,0,0,956.0,5,56986.88,24,5,1,10,True
9949871,549,1,25,2570,556760800,1,0,0,956.08,8,56030.8,17,6,7,11,True
1038877,57,3,30,3808,374393674,1,0,0,1088.99,8,451520.01,20,5,4,1,True
1588146,749,4,451,9785,374393674,1,0,0,1089.17,7,450430.84,24,6,14,3,True
1660966,749,4,25,7331,374393674,1,0,0,1088.83,8,449342.01,24,0,8,5,True
1779770,479,2,20,2656,374393674,1,0,0,1088.85,5,448253.16,5,4,22,7,True
2221337,1079,4,30,5925,374393674,1,0,0,1088.96,8,447164.2,18,2,0,7,True
2242894,1017,2,-1,6372,374393674,1,1,0,1089.12,4,447164.2,26,3,17,1,True
2310333,57,3,451,1639,374393674,1,0,0,1088.87,7,446075.33,20,6,1,3,True
2322635,724,3,25,3210,374393674,1,0,0,1089.0,8,444986.33,11,3,7,5,True
2334504,749,4,30,6787,374393674,1,0,0,1088.92,8,443897.41,24,1,20,6,True
2365110,1017,2,25,8984,374393674,1,0,0,1088.72,8,442808.69,26,5,1,9,True
2457121,549,1,-1,2656,374393674,1,1,0,1089.11,4,442808.69,17,0,5,10,True
2596344,1123,2,20,9888,374393674,1,0,0,1089.0,5,441719.69,24,4,15,10,True
2764109,57,3,30,1581,374393674,1,0,0,1088.87,8,440630.82,20,2,22,11,True
2958709,57,3,30,7003,374393674,1,0,0,1089.2,8,439541.62,20,0,5,12,True
3183334,266,2,20,2656,374393674,1,0,0,1089.1,3,438452.52,6,3,3,2,True
3254260,1079,4,-1,6372,374393674,1,1,0,1089.1,4,438452.52,18,1,23,3,True
3274226,724,3,451,6031,374393674,1,0,0,1088.97,7,437363.55,11,3,13,4,True
3306825,1017,2,25,8299,374393674,1,0,0,1089.01,8,436274.54,26,4,12,5,True
3407788,1079,4,451,1639,374393674,1,0,0,1088.8,7,435185.74,18,0,1,6,True
3567594,1079,4,25,2702,374393674,1,0,0,1089.17,8,434096.57,18,0,23,6,True
3666831,1017,2,30,3210,374393674,1,0,0,1088.76,8,433007.81,26,3,21,8,True
3873508,549,1,-1,4457,374393674,1,1,0,1089.21,4,433007.81,17,2,7,10,True
3927558,1017,2,-1,8317,374393674,1,2,0,1088.79,1,433007.81,26,6,4,10,True
4087358,749,4,-1,2457,374393674,1,3,1,1088.91,4,433007.81,24,6,23,10,True
1386219,597,4,30,7332,931754355,1,0,0,481.96,8,935033.04,24,5,7,1,True
1861193,544,3,451,2611,931754355,1,0,0,482.03,7,934551.01,17,3,11,1,True
2111179,1272,0,-1,6567,931754355,1,1,0,481.97,1,934551.01,24,2,17,2,True
2192875,917,0,10,7332,931754355,1,0,0,482.1,6,935033.11,18,3,15,3,True
2218623,544,3,30,4712,931754355,1,0,0,482.08,8,934551.03,17,3,8,4,True
2569074,851,1,25,3713,931754355,1,0,0,481.93,8,934069.1,5,0,7,6,True
3122735,1050,4,451,3713,931754355,1,0,0,481.95,7,933587.15,11,6,20,7,True
3155933,597,4,25,2605,931754355,1,0,0,481.8,8,933105.35,24,4,6,7,True
3186108,597,4,451,9690,931754355,1,0,0,482.07,7,932623.28,24,6,5,7,True
3197155,1399,0,20,1175,931754355,1,0,0,482.12,5,932141.16,24,0,11,8,True
3200221,220,0,451,4856,931754355,1,0,0,481.89,7,931659.27,26,1,10,8,True
3774913,597,4,25,2905,931754355,1,0,0,481.84,8,931177.43,24,3,2,8,True
3914296,220,0,10,4975,931754355,1,0,0,482.23,0,931659.66,26,1,19,10,False
4148826,851,1,451,3839,931754355,1,0,0,482.15,7,931177.51,5,3,13,12,True
4265836,480,0,20,4712,931754355,1,0,0,482.09,5,930695.42,5,1,14,1,True
4563069,851,1,30,7383,931754355,1,0,0,482.01,8,930213.41,5,3,15,1,True
4675720,1050,4,-1,6567,931754355,1,1,0,481.79,4,930213.41,11,6,6,1,True
4690165,851,1,25,1633,931754355,1,0,0,481.47,8,929731.94,5,2,2,2,True
4994425,851,1,-1,5393,931754355,1,1,0,482.0,4,929731.94,5,0,22,2,True
5238372,1477,2,20,7332,931754355,1,0,0,482.01,5,929249.93,24,5,14,2,True
5444303,851,1,-1,4299,931754355,1,1,0,481.86,4,929249.93,5,3,6,3,True
5777670,996,0,20,5393,931754355,1,0,0,482.04,3,928767.89,26,3,2,3,True
5895623,597,4,451,4712,931754355,1,0,0,481.89,7,928286.0,24,5,16,4,True
6336282,220,0,25,9690,931754355,1,0,0,481.92,8,927804.08,26,1,10,5,True
6342778,597,4,451,3839,931754355,1,0,0,482.19,7,927321.89,24,5,2,5,True
6590220,597,4,25,3713,931754355,1,0,0,481.95,8,926839.94,24,2,12,6,True
6597322,1050,4,451,4712,931754355,1,0,0,482.11,7,926357.83,11,0,8,7,True
6879560,851,1,25,9690,931754355,1,0,0,481.82,8,925876.01,5,4,3,7,True
7066816,525,0,10,7452,931754355,1,0,0,481.96,6,926357.97,18,2,16,8,True
7158229,1272,0,25,3839,931754355,1,0,0,482.32,8,925875.65,24,6,21,8,True
7174969,851,1,451,4068,931754355,1,0,0,482.02,7,925393.63,5,2,11,9,True
7234662,1272,0,20,8853,931754355,1,0,0,482.06,5,924911.57,24,2,10,10,True
7407138,1050,4,451,7383,931754355,1,0,0,481.82,7,924429.75,11,5,18,11,True
7643055,1272,0,25,4068,931754355,1,0,0,481.88,8,923947.87,24,3,20,11,True
7698031,1050,4,25,4712,931754355,1,0,0,481.73,8,923466.14,11,3,22,12,True
8092400,1050,4,451,8853,931754355,1,0,0,482.25,7,922983.89,11,6,8,12,True
8217662,220,0,451,1175,931754355,1,0,0,482.15,7,922501.74,26,5,10,1,True
8312812,544,3,30,7846,931754355,1,0,0,482.01,8,922019.73,17,4,15,3,True
8560735,597,4,-1,4068,931754355,1,1,0,482.04,1,922019.73,24,5,10,3,True
8910819,597,4,451,9164,931754355,1,0,0,482.18,7,921537.55,24,5,11,3,True
9019047,1050,4,25,6567,931754355,1,0,0,481.85,8,921055.7,11,2,20,4,True
9239086,1050,4,25,2611,931754355,1,0,0,482.16,8,920573.54,11,1,23,4,True
9337661,544,3,25,4712,931754355,1,0,0,482.01,8,920091.53,17,4,11,6,True
9337949,851,1,30,2611,931754355,1,0,0,482.0,8,919609.53,5,4,21,6,True
9367184,544,3,30,2905,931754355,1,0,0,481.97,8,919127.56,17,3,5,8,True
9638044,220,0,-1,3839,931754355,1,1,0,481.91,1,919127.56,26,5,10,8,True
9666306,544,3,-1,9164,931754355,1,2,0,482.1,1,919127.56,17,0,20,10,True
9809575,1272,0,25,4712,931754355,1,0,0,482.11,8,918645.45,24,5,0,11,True
9828198,738,2,20,1639,931754355,1,0,0,481.83,3,918163.62,11,0,9,11,True
9843465,723,1,10,2611,931754355,1,0,0,481.97,0,918645.59,11,4,21,11,True
9976267,851,1,-1,5315,931754355,1,1,0,482.12,4,918645.59,5,4,14,11,True
1016662,599,0,10,5343,964243678,0,0,0,852.0,6,857231.0,24,3,18,1,True
1069697,866,0,25,6428,964243678,0,0,0,851.97,8,856379.03,24,0,11,2,True
1144773,599,0,10,4944,964243678,0,0,0,851.95,6,857230.98,24,0,19,3,False
1271061,502,0,451,8614,964243678,0,0,0,851.91,7,856379.07,12,2,3,5,True
1406816,531,0,10,1087,964243678,0,0,0,851.81,6,857230.88,18,4,1,5,True
1496203,182,1,25,5918,964243678,0,0,0,852.03,8,856378.85,18,1,23,5,True
1705513,182,1,451,8614,964243678,0,0,0,851.97,7,855526.88,18,3,4,6,False
1743606,182,1,25,4170,964243678,0,0,0,852.09,8,854674.79,18,0,23,6,True
1994180,866,0,451,4170,964243678,0,0,0,852.06,7,853822.73,24,5,21,9,True
2078021,434,3,451,1287,964243678,0,0,0,852.14,7,852970.59,24,0,19,9,True
2130056,1436,0,10,1087,964243678,0,0,0,852.02,6,853822.61,24,0,8,9,True
2319888,502,0,25,5918,964243678,0,0,0,851.98,8,852970.63,12,3,7,9,True
2413549,434,3,25,6428,964243678,0,0,0,851.9,8,852118.73,24,6,3,10,True
2552217,799,2,25,6088,964243678,0,0,0,851.9,8,851266.83,11,3,6,10,True
2933525,866,0,451,3748,964243678,0,0,0,852.16,7,850414.67,24,5,11,10,True
2994820,799,2,451,3933,964243678,0,0,0,851.93,7,849562.74,11,4,1,10,True
3177625,182,1,25,8614,964243678,0,0,0,851.89,8,848710.85,18,6,7,10,True
3202647,182,1,25,6053,964243678,0,0,0,852.13,8,847858.72,18,6,8,12,True
3401035,502,0,-1,8614,964243678,0,1,0,852.12,4,847858.72,12,2,17,12,True
3421699,799,2,30,7369,964243678,0,0,0,852.23,8,847006.49,11,4,9,1,True
3600123,502,0,451,7369,964243678,0,0,0,852.08,7,846154.41,12,5,4,1,True
4178022,184,0,10,2656,964243678,0,0,0,851.93,0,847006.34,18,5,4,1,True
4357761,262,2,20,6053,964243678,0,0,0,851.95,3,846154.39,6,4,1,1,True
4788355,182,1,451,8285,964243678,0,0,0,851.96,7,845302.43,18,5,17,1,True
4843512,502,0,25,6327,964243678,0,0,0,851.91,8,844450.52,12,1,21,4,True
4849826,434,3,25,5918,964243678,0,0,0,852.01,8,843598.51,24,3,0,6,True
4907318,434,3,-1,6327,964243678,0,1,0,852.14,1,843598.51,24,0,20,7,True
5050530,824,2,20,7369,964243678,0,0,0,851.91,5,842746.6,18,1,2,8,True
5120765,182,1,30,3748,964243678,0,0,0,852.13,8,841894.47,18,3,0,8,True
5253887,866,0,451,2877,964243678,0,0,0,852.13,7,841042.34,24,4,22,10,True
5383135,866,0,25,8774,964243678,0,0,0,852.07,8,840190.27,24,4,10,11,True
5584903,866,0,-1,6428,964243678,0,1,0,851.81,4,840190.27,24,2,13,11,True
5804647,434,3,451,5444,964243678,0,0,0,852.09,7,839338.18,24,2,1,12,True
6201141,785,0,10,5444,964243678,0,0,0,852.09,6,840190.27,14,0,6,1,True
6227829,1413,0,20,8774,964243678,0,0,0,851.87,3,839338.4,24,6,18,3,True
6260906,866,0,30,8285,964243678,0,0,0,852.05,8,838486.35,24,1,11,3,True
6288103,59,0,20,3748,964243678,0,0,0,852.21,3,837634.14,20,3,11,3,True
6295397,319,0,20,6327,964243678,0,0,0,851.99,5,836782.15,11,1,17,3,True
6360002,182,1,-1,5444,964243678,0,1,0,851.92,1,836782.15,18,1,14,4,True
6405040,728,1,10,3176,964243678,0,0,0,851.92,6,837634.07,11,3,18,5,True
6447847,1170,0,10,3748,964243678,0,0,0,851.89,6,838485.96,24,5,7,5,True
6909087,518,2,20,8208,964243678,0,0,0,851.87,3,837634.09,18,2,21,5,True
7389012,522,0,20,6088,964243678,0,0,0,852.05,5,836782.04,18,1,10,6,True
7654699,168,0,20,3522,964243678,0,0,0,852.22,3,835929.82,24,2,7,6,True
8137663,799,2,25,8285,964243678,0,0,0,851.99,8,835077.83,11,5,19,7,True
8333098,262,2,20,2877,964243678,0,0,0,852.14,5,834225.69,6,1,0,7,True
8570537,182,1,451,3748,964243678,0,0,0,852.0,7,833373.69,18,1,6,8,True
8610935,502,0,25,5343,964243678,0,0,0,852.11,8,832521.58,12,5,9,9,True
8882844,577,0,10,6038,964243678,0,0,0,851.93,6,833373.51,11,1,16,9,True
9243787,434,3,25,7011,964243678,0,0,0,851.77,8,832521.74,24,5,1,10,True
9367554,114,0,10,6053,964243678,0,0,0,852.06,6,833373.8,3,2,20,10,True
9692609,799,2,30,5343,964243678,0,0,0,852.02,8,832521.78,11,3,0,10,True
9810711,502,0,451,6038,964243678,0,0,0,852.13,7,831669.65,12,0,5,11,True
1220026,98,0,20,1498,976393135,0,0,0,355.12,3,116874.88,3,2,23,1,True
1295839,1036,1,451,1398,976393135,0,0,0,354.76,7,116520.12,11,5,0,1,True
1314897,205,0,25,9933,976393135,0,0,0,355.14,8,116164.98,9,0,9,2,True
1465906,319,0,20,9881,976393135,0,0,0,355.19,5,115809.79,11,0,12,3,True
1494386,1358,4,-1,5587,976393135,0,1,0,355.02,4,115809.79,24,0,22,4,True
1686069,767,0,20,3771,976393135,0,0,0,355.03,5,115454.76,14,3,7,5,True
2422619,96,0,10,6790,976393135,0,0,0,354.92,6,115809.68,1,4,17,5,True
2429797,1186,2,20,6800,976393135,0,0,0,355.29,3,115454.39,24,1,17,5,True
2431977,1358,4,451,6800,976393135,0,0,0,355.17,7,115099.22,24,4,13,5,True
2617192,832,3,-1,1498,976393135,0,1,0,354.98,1,115099.22,5,0,7,5,True
2784030,53,0,20,3501,976393135,0,0,0,354.91,5,114744.31,20,0,21,5,True
2963355,674,4,-1,3501,976393135,0,1,0,354.92,4,114744.31,24,5,15,6,True
3281528,558,0,451,8753,976393135,0,0,0,354.81,7,114389.5,17,5,23,7,True
3474368,1213,2,20,7370,976393135,0,0,0,354.99,3,114034.51,24,0,19,7,True
3784041,832,3,30,6800,976393135,0,0,0,355.11,8,113679.4,5,2,20,10,True
3922390,365,0,451,7475,976393135,0,0,0,354.91,7,113324.49,25,4,6,10,True
4006123,611,0,10,1498,976393135,0,0,0,355.26,6,113679.75,11,2,1,12,True
4436484,1036,1,30,1413,976393135,0,0,0,354.99,8,113324.76,11,2,20,12,True
4490917,832,3,30,3465,976393135,0,0,0,354.89,8,112969.87,5,1,11,1,True
4497122,674,4,30,1382,976393135,0,0,0,354.82,8,112615.05,24,4,10,1,True
4661257,365,0,451,1413,976393135,0,0,0,354.85,7,112260.2,25,2,14,2,True
5025716,365,0,-1,6790,976393135,0,1,0,355.09,1,112260.2,25,6,18,3,True
5087761,1036,1,25,4088,976393135,0,0,0,354.92,8,111905.28,11,0,6,4,True
5135967,832,3,-1,8753,976393135,0,1,0,355.13,4,111905.28,5,3,6,6,True
5261128,365,0,30,4088,976393135,0,0,0,354.95,8,111550.33,25,3,11,7,True
5382061,365,0,-1,3501,976393135,0,1,0,355.1,1,111550.33,25,3,13,7,True
5432196,832,3,30,3771,976393135,0,0,0,354.84,8,111195.49,5,5,8,7,True
5706939,1255,0,10,1398,976393135,0,0,0,355.07,6,111550.56,23,3,0,7,True
5780959,365,0,30,3749,976393135,0,0,0,354.74,8,111195.82,25,3,5,9,True
5932267,703,0,10,3465,976393135,0,0,0,354.82,0,111550.64,18,3,14,11,True
5996264,732,0,10,3749,976393135,0,0,0,355.19,6,111905.83,11,2,0,1,False
6374241,205,0,25,9933,976393135,0,0,0,355.16,8,111550.67,9,3,0,1,True
6408091,1036,1,451,6800,976393135,0,0,0,355.08,7,111195.59,11,4,13,1,True
6672961,1321,0,451,6359,976393135,0,0,0,354.93,7,110840.66,18,1,9,3,True
7041584,846,3,25,4088,976393135,0,0,0,355.17,8,110485.49,5,0,23,3,True
7581160,1451,1,10,7475,976393135,0,0,0,354.67,0,110840.16,11,2,15,4,True
7695156,205,0,30,8753,976393135,0,0,0,355.12,8,110485.04,9,5,3,5,True
7756966,365,0,25,9933,976393135,0,0,0,354.69,8,110130.35,25,2,1,5,True
7766714,674,4,451,1382,976393135,0,0,0,355.06,7,109775.29,24,3,23,6,True
7998535,365,0,25,3160,976393135,0,0,0,355.04,8,109420.25,25,6,19,7,True
8410144,867,0,20,9933,976393135,0,0,0,355.0,3,109065.25,24,6,13,8,True
8489406,558,0,451,3771,976393135,0,0,0,355.19,7,108710.06,17,2,9,8,True
8516317,1358,4,451,3749,976393135,0,0,0,354.94,7,108355.12,24,6,14,9,True
8716908,97,0,20,7475,976393135,0,0,0,355.0,5,108000.12,3,5,6,9,True
8800024,883,0,20,1382,976393135,0,0,0,355.06,3,107645.06,24,1,19,9,True
8817663,365,0,30,7475,976393135,0,0,0,354.84,8,107290.22,25,3,7,9,True
8885752,365,0,451,1498,976393135,0,0,0,355.38,7,106934.84,25,4,1,9,True
9062427,205,0,25,9933,976393135,0,0,0,355.0,8,106579.84,9,6,5,9,True
9171737,952,0,10,7205,976393135,0,0,0,354.94,0,106934.78,13,5,14,10,True
9218847,29,0,20,6790,976393135,0,0,0,355.08,5,106579.7,11,3,7,10,True
9677427,674,4,30,1382,976393135,0,0,0,355.01,8,106224.69,24,5,9,11,True
9987106,28,1,10,4886,976393135,0,0,0,355.15,0,106579.84,11,5,22,11,True
1338107,952,0,10,9690,508124574,1,0,0,535.21,6,177756.21,13,5,6,1,True
1341579,1195,1,10,6587,508124574,1,0,0,535.14,6,178291.35,24,4,20,1,True
1457306,1474,0,30,6267,508124574,1,0,0,535.15,8,177756.2,24,2,2,1,True
1681360,514,4,451,6587,508124574,1,0,0,535.27,7,177220.93,12,5,16,2,True
1691430,1413,0,451,8893,508124574,1,0,0,534.93,7,176686.0,24,2,16,2,True
1726833,1205,0,10,6122,508124574,1,0,0,535.13,0,177221.13,24,1,5,2,True
1890724,980,1,25,9690,508124574,1,0,0,535.17,8,176685.96,22,2,22,3,True
1930097,759,0,10,8893,508124574,1,0,0,534.86,6,177220.82,24,1,15,3,True
2191769,1063,0,20,7635,508124574,1,0,0,535.2,5,176685.62,11,4,1,3,True
2442211,1029,0,20,8470,508124574,1,0,0,535.27,3,176150.35,11,4,9,4,False
2562186,972,3,25,8893,508124574,1,0,0,534.78,8,175615.57,13,0,23,4,True
2644421,215,0,10,8893,508124574,1,0,0,534.93,6,176150.5,9,0,21,5,True
2698362,972,3,451,7635,508124574,1,0,0,534.7,7,175615.8,13,4,1,6,True
2740499,987,4,30,7505,508124574,1,0,0,535.11,8,175080.69,22,6,15,7,True
3067743,1474,0,451,7635,508124574,1,0,0,534.82,7,174545.87,24,6,20,8,True
3079405,980,1,451,3201,508124574,1,0,0,534.96,7,174010.91,22,3,22,9,True
3436289,525,0,20,2632,508124574,1,0,0,534.92,5,173475.99,18,1,3,9,True
3619773,1297,0,10,6122,508124574,1,0,0,534.87,6,174010.86,5,0,17,10,True
3778810,145,0,10,6122,508124574,1,0,0,534.83,0,174545.69,18,3,23,11,False
3884502,1474,0,451,6587,508124574,1,0,0,534.93,7,174010.76,24,3,15,11,False
4114778,987,4,25,3583,508124574,1,0,0,535.24,8,173475.52,22,0,0,1,True
4370690,735,1,10,8893,508124574,1,0,0,534.89,6,174010.41,11,1,18,3,True
4386026,514,4,30,3201,508124574,1,0,0,535.24,8,173475.17,12,3,17,5,True
4416338,1413,0,451,2632,508124574,1,0,0,534.67,7,172940.5,24,3,23,5,False
4601908,1413,0,-1,5960,508124574,1,1,0,535.21,4,172940.5,24,4,11,5,False
4654799,1173,1,10,3583,508124574,1,0,0,534.89,6,173475.39,24,3,9,6,True
5342554,514,4,25,5838,508124574,1,0,0,535.26,8,172940.13,12,3,11,6,True
5401807,1413,0,25,7635,508124574,1,0,0,535.17,8,172404.96,24,4,17,6,True
5407045,514,4,451,6267,508124574,1,0,0,534.82,7,171870.14,12,3,14,7,True
5430127,1474,0,25,6267,508124574,1,0,0,535.04,8,171335.1,24,2,13,7,True
5858296,1272,0,10,8893,508124574,1,0,0,535.03,6,171870.13,24,6,2,7,True
6211191,1169,0,20,6587,508124574,1,0,0,535.35,5,171334.78,24,0,15,8,True
6322932,1298,0,10,7505,508124574,1,0,0,534.98,6,171869.76,5,6,5,8,True
6541967,205,0,20,5912,508124574,1,0,0,534.93,3,171334.83,9,1,18,9,True
6671278,1137,1,10,5838,508124574,1,0,0,534.96,0,171869.79,24,3,0,10,True
6849507,980,1,30,6044,508124574,1,0,0,534.99,8,171334.8,22,6,22,12,True
7018190,605,0,10,8893,508124574,1,0,0,535.04,6,171869.84,24,1,9,1,True
7151793,1482,3,25,6587,508124574,1,0,0,535.22,8,171334.62,24,2,1,1,True
7333683,467,0,10,7505,508124574,1,0,0,534.73,0,171869.35,5,0,15,2,True
7652163,972,3,30,5960,508124574,1,0,0,535.19,8,171334.16,13,6,16,2,True
7970240,1413,0,30,6267,508124574,1,0,0,534.98,8,170799.18,24,5,18,3,True
7987452,1474,0,25,8470,508124574,1,0,0,534.94,8,170264.24,24,1,1,4,True
8138141,987,4,451,6122,508124574,1,0,0,534.89,7,169729.35,22,4,12,5,True
8143952,1474,0,-1,5960,508124574,1,1,0,535.03,4,169729.35,24,5,22,5,True
8471456,1482,3,451,8470,508124574,1,0,0,535.14,7,169194.21,24,4,18,6,True
8541168,987,4,451,6122,508124574,1,0,0,535.08,7,168659.13,22,6,18,6,True
8563907,514,4,-1,7635,508124574,1,1,0,534.8,1,168659.13,12,4,20,7,True
8619112,980,1,30,5912,508124574,1,0,0,534.83,8,168124.3,22,1,19,8,True
8653738,1474,0,451,6267,508124574,1,0,0,535.19,7,167589.11,24,3,17,8,True
9029323,972,3,30,5960,508124574,1,0,0,534.92,8,167054.19,13,6,23,9,True
9035932,972,3,30,3201,508124574,1,0,0,535.05,8,166519.14,13,0,11,11,True
9166770,972,3,-1,5960,508124574,1,1,0,535.12,4,166519.14,13,0,16,11,True
9249304,470,1,10,6044,508124574,1,0,0,535.09,6,167054.23,5,3,22,11,True
9701401,987,4,451,7635,508124574,1,0,0,534.68,7,166519.55,22,6,15,11,False
9759340,1482,3,451,8470,508124574,1,0,0,534.94,7,165984.61,24,3,16,11,False
1066178,457,0,25,7711,637434812,0,0,0,1051.06,8,872180.94,13,2,9,1,True
1088626,497,0,20,4897,637434812,0,0,0,1051.13,5,871129.81,12,5,9,1,True
1140537,457,0,451,8660,637434812,0,0,0,1051.09,7,870078.72,13,0,0,1,True
1154227,599,0,451,9800,637434812,0,0,0,1050.75,7,869027.97,24,1,23,2,True
1189714,457,0,-1,8785,637434812,0,1,0,1051.13,4,869027.97,13,1,9,2,True
1706283,331,4,25,9245,637434812,0,0,0,1051.15,8,867976.82,11,4,8,4,True
1935066,457,0,25,5641,637434812,0,0,0,1051.01,8,866925.81,13,3,20,4,True
2193409,599,0,30,4897,637434812,0,0,0,1051.0,8,865874.81,24,6,3,5,True
2667851,962,0,20,9800,637434812,0,0,0,1050.72,3,864824.09,13,6,19,6,True
2780893,916,0,10,6804,637434812,0,0,0,1051.24,6,865875.33,18,0,3,6,True
2931220,331,4,25,8660,637434812,0,0,0,1051.1,8,864824.23,11,2,15,7,True
2931490,429,0,10,8264,637434812,0,0,0,1050.96,6,865875.19,24,6,4,7,True
3128367,81,0,20,8264,637434812,0,0,0,1051.04,3,864824.15,1,3,2,9,True
3300943,46,1,25,8785,637434812,0,0,0,1051.29,8,863772.86,24,0,9,10,True
3415598,362,0,20,3174,637434812,0,0,0,1051.07,3,862721.79,24,1,4,10,True
3467137,46,1,25,6804,637434812,0,0,0,1051.13,8,861670.66,24,4,6,11,True
3535148,1226,2,20,2167,637434812,0,0,0,1051.0,5,860619.66,18,4,20,12,True
3572012,168,0,20,1319,637434812,0,0,0,1050.82,3,859568.84,24,6,17,1,True
3876514,46,1,451,8264,637434812,0,0,0,1051.05,7,858517.79,24,0,1,1,True
4011156,1339,2,451,8900,637434812,0,0,0,1050.86,7,857466.93,18,4,18,1,False
4116421,331,4,-1,1830,637434812,0,1,0,1051.03,4,857466.93,11,2,17,1,True
4302133,816,0,20,1830,637434812,0,0,0,1051.21,5,856415.72,18,6,2,2,True
4487776,212,4,25,6918,637434812,0,0,0,1051.03,8,855364.69,9,1,15,2,True
4527767,96,0,10,6269,637434812,0,0,0,1050.89,0,856415.58,1,6,3,2,False
4666771,1108,1,451,8660,637434812,0,0,0,1050.71,7,855364.87,0,4,9,2,True
4675250,337,1,10,6269,637434812,0,0,0,1050.9,0,856415.77,11,5,18,3,True
5139543,1314,2,20,3174,637434812,0,0,0,1050.93,3,855364.84,5,2,10,4,True
5530423,457,0,25,3174,637434812,0,0,0,1050.84,8,854314.0,13,6,8,4,False
5582223,1108,1,25,4897,637434812,0,0,0,1050.97,8,853263.03,0,1,21,5,True
5636683,1206,0,10,6918,637434812,0,0,0,1050.8,6,854313.83,24,5,22,6,True
5917392,599,0,25,1866,637434812,0,0,0,1050.91,8,853262.92,24,6,18,6,True
6194328,212,4,451,9800,637434812,0,0,0,1050.93,7,852211.99,9,3,22,7,True
6271815,1339,2,451,8785,637434812,0,0,0,1050.88,7,851161.11,18,1,5,8,True
6591104,46,1,30,2167,637434812,0,0,0,1050.88,8,850110.23,24,6,19,9,True
6899256,560,2,20,6269,637434812,0,0,0,1051.03,5,849059.2,17,5,13,10,True
6958910,599,0,30,9800,637434812,0,0,0,1050.63,8,848008.57,24,0,15,10,True
6965979,424,1,30,8900,637434812,0,0,0,1050.93,8,846957.64,18,1,0,10,True
7047653,212,4,30,7961,637434812,0,0,0,1050.99,8,845906.65,9,2,23,10,True
7170373,403,0,20,3174,637434812,0,0,0,1051.37,3,844855.28,10,6,3,12,False
7226974,1339,2,451,1319,637434812,0,0,0,1051.0,7,843804.28,18,6,6,12,True
7583462,1108,1,451,1319,637434812,0,0,0,1050.94,7,842753.34,0,2,8,12,True
7606035,714,2,20,8889,637434812,0,0,0,1050.72,5,841702.62,18,2,13,1,True
7988506,305,1,10,1319,637434812,0,0,0,1051.13,6,842753.75,4,2,3,3,True
8408167,1108,1,25,1319,637434812,0,0,0,1050.96,8,841702.79,0,2,11,3,True
8415053,212,4,451,3174,637434812,0,0,0,1050.89,7,840651.9,9,3,3,3,True
8443086,548,2,20,6918,637434812,0,0,0,1050.99,5,839600.91,17,5,19,5,True
8492154,46,1,451,5641,637434812,0,0,0,1051.17,7,838549.74,24,0,0,6,True
8493892,212,4,-1,1319,637434812,0,1,0,1051.02,1,838549.74,9,1,6,6,True
8837321,599,0,-1,6918,637434812,0,2,0,1051.27,4,838549.74,24,5,0,7,True
8896506,564,0,10,9800,637434812,0,0,0,1050.86,6,839600.6,17,6,10,7,True
9009020,599,0,30,8264,637434812,0,0,0,1051.11,8,838549.49,24,3,6,8,True
9322299,1134,1,10,4897,637434812,0,0,0,1050.86,6,839600.35,24,2,2,9,True
9483482,1164,0,20,8785,637434812,0,0,0,1050.87,5,838549.48,24,3,6,9,True
9582309,599,0,25,8660,637434812,0,0,0,1050.94,8,837498.54,24,1,9,9,True
9647984,1219,1,10,7711,637434812,0,0,0,1050.88,6,838549.42,24,4,19,9,True
9871919,1339,2,30,7383,637434812,0,0,0,1051.13,8,837498.29,18,0,10,10,True
1041968,939,0,20,4165,247822289,1,0,0,762.9,3,304867.1,24,6,8,1,True
1059225,212,4,25,3907,247822289,1,0,0,763.33,8,304103.77,9,1,11,2,True
1061954,569,4,-1,6728,247822289,1,1,0,763.17,4,304103.77,11,2,6,2,True
1242721,1105,2,20,1550,247822289,1,0,0,763.05,5,303340.72,0,2,7,2,True
1382026,876,4,451,6827,247822289,1,0,0,762.76,7,302577.96,24,5,9,3,True
1398501,569,4,30,1090,247822289,1,0,0,762.67,8,301815.29,11,2,19,4,True
2177489,876,4,-1,6827,247822289,1,1,0,762.97,4,301815.29,24,3,17,5,True
2301473,876,4,25,3889,247822289,1,0,0,762.86,8,301052.43,24,5,2,8,True
2306894,910,0,20,8344,247822289,1,0,0,763.12,5,300289.31,18,4,1,8,True
2657157,876,4,451,2384,247822289,1,0,0,763.11,7,299526.2,24,3,1,8,True
2750124,569,4,25,6002,247822289,1,0,0,763.09,8,298763.11,11,3,7,9,True
2881399,1086,0,20,2098,247822289,1,0,0,762.96,5,298000.15,18,5,21,9,False
2979805,569,4,451,8615,247822289,1,0,0,762.87,7,297237.28,11,1,18,10,False
3301128,569,4,451,2735,247822289,1,0,0,762.78,7,296474.5,11,2,10,11,True
3651836,212,4,451,2384,247822289,1,0,0,762.76,7,295711.74,9,2,16,11,True
3679688,569,4,-1,2735,247822289,1,1,0,762.88,4,295711.74,11,0,18,11,True
3708985,147,0,-1,3881,247822289,1,2,0,763.19,1,295711.74,18,6,11,12,True
3781819,212,4,30,5876,247822289,1,0,0,763.11,8,294948.63,9,0,4,12,True
3795036,876,4,-1,2362,247822289,1,1,0,763.12,4,294948.63,24,0,16,12,True
3965049,1455,2,20,8584,247822289,1,0,0,763.16,3,294185.47,11,3,18,2,True
3989686,688,0,10,1090,247822289,1,0,0,762.7,6,294948.17,24,0,5,2,True
4088968,812,0,451,8344,247822289,1,0,0,762.99,7,294185.18,18,2,12,3,True
4405251,503,0,10,3889,247822289,1,0,0,763.23,0,294948.41,12,0,8,4,True
4597965,599,0,25,6728,247822289,1,0,0,763.28,8,294185.13,24,1,19,5,True
4882885,569,4,-1,6758,247822289,1,1,0,762.99,4,294185.13,11,5,19,5,True
5021487,569,4,451,1550,247822289,1,0,0,762.97,7,293422.16,11,5,21,5,True
5188071,147,0,451,6758,247822289,1,0,0,762.91,7,292659.25,18,4,8,6,True
5246605,812,0,-1,8615,247822289,1,1,0,762.9,1,292659.25,18,1,3,6,True
5434720,599,0,30,2098,247822289,1,0,0,763.02,8,291896.23,24,4,1,7,True
5694926,569,4,25,2098,247822289,1,0,0,763.11,8,291133.12,11,0,12,7,True
5889141,341,0,10,2384,247822289,1,0,0,762.87,0,291895.99,24,5,1,7,True
5901384,147,0,25,2362,247822289,1,0,0,763.16,8,291132.83,18,0,0,7,True
6399422,729,0,20,9314,247822289,1,0,0,762.8,5,290370.03,11,2,14,8,True
6557533,168,0,20,2098,247822289,1,0,0,763.18,5,289606.85,24,5,5,9,True
6659009,147,0,451,8344,247822289,1,0,0,762.9,7,288843.95,18,5,9,9,True
6772156,204,0,20,3663,247822289,1,0,0,763.25,3,288080.7,9,4,14,11,True
6789841,564,0,10,2384,247822289,1,0,0,763.08,6,288843.78,17,1,2,12,True
6902903,218,0,10,8615,247822289,1,0,0,763.18,6,289606.96,9,3,8,12,True
7130769,812,0,25,1090,247822289,1,0,0,762.99,8,288843.97,18,1,12,1,True
7283616,569,4,30,4165,247822289,1,0,0,762.83,8,288081.14,11,3,13,1,True
7346873,147,0,25,3889,247822289,1,0,0,762.8,8,287318.34,18,1,9,3,True
7543932,147,0,30,2362,247822289,1,0,0,763.03,8,286555.31,18,2,14,4,True
7621701,569,4,30,7713,247822289,1,0,0,762.89,8,285792.42,11,3,18,4,True
7967362,199,0,20,9314,247822289,1,0,0,763.04,5,285029.38,18,2,19,4,True
7997395,569,4,451,3866,247822289,1,0,0,762.97,7,284266.41,11,3,9,4,True
8264700,599,0,-1,6002,247822289,1,1,0,763.05,4,284266.41,24,0,11,5,True
8702468,212,4,25,3881,247822289,1,0,0,763.04,8,283503.37,9,5,13,6,False
8921984,212,4,30,8615,247822289,1,0,0,762.84,8,282740.53,9,5,18,6,True
9009615,286,1,10,3889,247822289,1,0,0,763.12,6,283503.65,24,6,7,6,True
9023488,569,4,-1,1550,247822289,1,1,0,763.12,4,283503.65,11,5,3,8,True
9182300,1089,0,20,8834,247822289,1,0,0,762.75,5,282740.9,18,5,6,9,True
9496968,569,4,25,3907,247822289,1,0,0,763.14,8,281977.76,11,2,3,10,False
9999707,599,0,451,1090,247822289,1,0,0,762.88,7,281214.88,24,1,4,11,True
1517441,234,0,10,1244,230910910,1,0,0,270.12,0,866973.12,26,4,0,1,True
1583672,138,3,25,7108,230910910,1,0,0,270.03,8,866703.09,18,2,17,1,True
1604202,138,3,30,9336,230910910,1,0,0,270.15,8,866432.94,18,3,11,2,True
1773957,1369,3,25,3498,230910910,1,0,0,269.85,8,866163.09,16,4,7,3,False
1852899,1316,3,451,3661,230910910,1,0,0,270.11,7,865892.98,5,6,2,3,True
1856150,1316,3,30,2032,230910910,1,0,0,269.9,8,865623.08,5,3,11,3,True
1883560,1155,0,30,3509,230910910,1,0,0,270.42,8,865352.66,15,1,18,4,True
1967690,1316,3,25,3415,230910910,1,0,0,270.09,8,865082.57,5,3,22,6,True
2252951,726,0,25,4584,230910910,1,0,0,270.08,8,864812.49,11,2,20,7,True
2255182,422,4,30,1920,230910910,1,0,0,270.15,8,864542.34,18,6,23,7,True
2261460,1155,0,451,9540,230910910,1,0,0,269.78,7,864272.56,15,6,19,7,True
2481941,1155,0,451,9141,230910910,1,0,0,269.92,7,864002.64,15,6,16,8,True
2610671,422,4,451,3498,230910910,1,0,0,270.22,7,863732.42,18,4,15,8,True
2637572,448,0,10,9336,230910910,1,0,0,270.15,0,864002.57,13,5,2,8,True
2810484,1155,0,25,5600,230910910,1,0,0,270.08,8,863732.49,15,2,17,10,False
2855791,114,0,10,5600,230910910,1,0,0,270.14,0,864002.63,3,3,12,10,True
2873701,1316,3,25,5600,230910910,1,0,0,269.75,8,863732.88,5,4,11,10,True
3001037,138,3,451,3498,230910910,1,0,0,270.01,7,863462.87,18,0,5,10,True
3034937,28,1,10,9336,230910910,1,0,0,269.94,6,863732.81,11,6,8,11,True
3152860,1316,3,25,3509,230910910,1,0,0,270.14,8,863462.67,5,6,2,2,True
3189225,1369,3,30,2032,230910910,1,0,0,269.97,8,863192.7,16,0,21,3,True
3409873,422,4,30,1316,230910910,1,0,0,270.13,8,862922.57,18,4,13,3,True
3477025,422,4,25,3162,230910910,1,0,0,270.13,8,862652.44,18,1,2,4,True
3704396,1316,3,451,4688,230910910,1,0,0,270.08,7,862382.36,5,1,1,4,True
3919870,1316,3,451,3498,230910910,1,0,0,270.19,7,862112.17,5,5,3,4,True
4331986,726,0,25,4200,230910910,1,0,0,269.96,8,861842.21,11,4,17,5,False
4415637,138,3,-1,5600,230910910,1,1,0,270.07,1,861842.21,18,0,4,5,True
4567149,204,0,10,1244,230910910,1,0,0,269.83,6,862112.04,9,5,9,5,True
4678197,726,0,-1,3582,230910910,1,1,0,270.03,4,862112.04,11,3,13,6,True
4827660,726,0,-1,3566,230910910,1,2,0,270.05,4,862112.04,11,5,18,6,True
4930426,23,0,10,6144,230910910,1,0,0,269.54,6,862381.58,11,0,2,6,True
5025718,422,4,-1,1920,230910910,1,1,0,270.13,4,862381.58,18,3,3,6,True
5141423,108,2,20,3509,230910910,1,0,0,270.06,5,862111.52,3,0,21,7,True
5383966,1155,0,25,9336,230910910,1,0,0,269.75,8,861841.77,15,4,10,9,True
5760147,1025,1,10,2032,230910910,1,0,0,270.13,6,862111.9,11,5,13,10,True
5768137,1316,3,25,8696,230910910,1,0,0,270.07,8,861841.83,5,5,18,10,True
5771474,255,2,20,8696,230910910,1,0,0,270.09,3,861571.74,6,6,19,11,True
5923047,1369,3,451,5949,230910910,1,0,0,270.22,7,861301.52,16,3,11,12,True
5973936,1382,0,20,5792,230910910,1,0,0,269.93,5,861031.59,16,5,13,12,True
6115916,726,0,25,1920,230910910,1,0,0,270.14,8,860761.45,11,3,9,12,True
6331017,1272,0,30,9336,230910910,1,0,0,270.06,8,860491.39,24,2,16,2,True
6962321,138,3,451,9141,230910910,1,0,0,270.03,7,860221.36,18,1,6,2,True
7016671,1369,3,-1,8696,230910910,1,1,0,270.08,4,860221.36,16,0,17,3,True
7246383,577,0,20,3661,230910910,1,0,0,269.93,5,859951.43,11,0,22,3,True
7249802,422,4,-1,3582,230910910,1,1,0,269.97,1,859951.43,18,3,20,3,True
7383583,1069,1,10,1316,230910910,1,0,0,270.11,6,860221.54,18,4,18,4,True
7392551,1155,0,30,1316,230910910,1,0,0,270.1,8,859951.44,15,3,23,5,True
7402502,1369,3,-1,4200,230910910,1,1,0,269.96,4,859951.44,16,1,10,5,True
7429233,1369,3,-1,9622,230910910,1,2,0,270.11,1,859951.44,16,2,12,7,True
7989199,1023,2,20,3509,230910910,1,0,0,270.37,3,859681.07,11,5,10,7,True
8023216,1155,0,25,8696,230910910,1,0,0,270.1,8,859410.97,15,6,14,7,True
8397293,138,3,25,8696,230910910,1,0,0,269.95,8,859141.02,18,4,5,8,True
8663466,726,0,30,9540,230910910,1,0,0,270.07,8,858870.95,11,6,16,8,True
8997356,1316,3,30,9540,230910910,1,0,0,269.94,8,858601.01,5,5,2,9,True
9360380,422,4,25,1920,230910910,1,0,0,269.9,8,858331.11,18,6,20,10,True
9721122,422,4,30,1920,230910910,1,0,0,270.25,8,858060.86,18,5,5,11,True
1138774,49,3,25,5123,578900606,1,0,0,995.31,8,782811.69,20,6,7,1,True
1278819,49,3,25,9915,578900606,1,0,0,994.88,8,781816.81,20,1,12,2,True
1319899,542,0,-1,2209,578900606,1,1,0,995.01,4,781816.81,17,0,0,2,True
1642198,542,0,-1,4936,578900606,1,2,0,995.16,4,781816.81,17,6,1,4,True
2068608,531,0,20,5123,578900606,1,0,0,995.08,5,780821.73,18,2,21,4,True
2321694,542,0,25,6160,578900606,1,0,0,995.09,8,779826.64,17,4,4,4,True
2387424,524,1,10,1759,578900606,1,0,0,995.11,6,780821.75,18,2,3,5,True
2537030,1399,0,20,1515,578900606,1,0,0,994.98,3,779826.77,24,1,5,6,True
2545482,49,3,451,7749,578900606,1,0,0,995.03,7,778831.74,20,5,11,7,True
3044129,49,3,451,1264,578900606,1,0,0,995.08,7,777836.66,20,1,7,7,True
3208473,866,0,-1,2209,578900606,1,1,0,994.79,4,777836.66,24,3,5,7,True
3334139,542,0,451,8119,578900606,1,0,0,994.98,7,776841.68,17,3,7,8,True
3397757,1015,0,-1,7749,578900606,1,1,0,995.1,1,776841.68,26,4,12,10,True
3420339,1107,3,-1,1657,578900606,1,2,0,994.97,4,776841.68,0,3,13,11,True
3433643,542,0,25,9781,578900606,1,0,0,995.24,8,775846.44,17,5,1,11,True
3450594,866,0,451,2019,578900606,1,0,0,994.96,7,774851.48,24,1,8,12,True
3770849,542,0,451,9523,578900606,1,0,0,995.08,7,773856.4,17,6,3,12,True
3997275,49,3,25,4803,578900606,1,0,0,995.09,8,772861.31,20,6,21,12,True
4016745,802,2,20,5297,578900606,1,0,0,995.05,5,771866.26,11,0,19,12,True
4102525,1015,0,30,9738,578900606,1,0,0,995.11,8,770871.15,26,2,9,1,True
4112741,538,0,10,1759,578900606,1,0,0,994.82,6,771865.97,18,3,20,1,True
4191389,542,0,451,6160,578900606,1,0,0,994.84,7,770871.13,17,2,5,2,True
4594593,917,0,20,9523,578900606,1,0,0,995.02,5,769876.11,18,6,6,3,True
4806698,1015,0,25,4803,578900606,1,0,0,994.68,8,768881.43,26,5,6,3,True
4825961,1107,3,451,1976,578900606,1,0,0,994.99,7,767886.44,0,6,4,4,True
5098698,1015,0,30,2702,578900606,1,0,0,994.93,8,766891.51,26,5,10,4,True
5181395,1107,3,30,1759,578900606,1,0,0,994.86,8,765896.65,0,4,13,5,True
5400319,1162,2,20,5123,578900606,1,0,0,994.84,5,764901.81,24,1,21,5,True
5630696,542,0,451,1515,578900606,1,0,0,995.04,7,763906.77,17,6,12,8,True
5867878,49,3,451,8526,578900606,1,0,0,994.99,7,762911.78,20,3,10,8,True
5984464,49,3,451,9140,578900606,1,0,0,995.08,7,761916.7,20,4,12,9,True
6471063,49,3,451,1759,578900606,1,0,0,995.07,7,760921.63,20,2,3,9,True
6482709,1015,0,451,9781,578900606,1,0,0,995.04,7,759926.59,26,1,3,10,True
6749077,49,3,30,3001,578900606,1,0,0,994.94,8,758931.65,20,4,7,11,True
6878122,1107,3,451,1515,578900606,1,0,0,995.2,7,757936.45,0,2,7,12,True
6932967,866,0,25,2019,578900606,1,0,0,995.05,8,756941.4,24,4,23,12,False
7218601,1015,0,-1,7650,578900606,1,1,0,994.96,4,756941.4,26,1,22,12,True
7218605,1245,1,10,1976,578900606,1,0,0,994.88,6,757936.28,18,3,19,1,True
7250326,49,3,30,9738,578900606,1,0,0,994.82,8,756941.46,20,2,18,2,False
7284408,518,2,20,3422,578900606,1,0,0,994.97,3,755946.49,18,3,2,3,True
7356397,97,0,20,4936,578900606,1,0,0,994.92,5,754951.57,3,0,18,4,True
7600105,297,0,20,5123,578900606,1,0,0,995.07,3,753956.5,4,4,20,5,True
7686435,1015,0,25,9738,578900606,1,0,0,994.98,8,752961.52,26,2,0,6,True
7906633,49,3,-1,1965,578900606,1,1,0,995.02,4,752961.52,20,1,12,7,True
7955996,866,0,451,5962,578900606,1,0,0,995.39,7,751966.13,24,4,2,7,True
8062817,192,2,20,1928,578900606,1,0,0,994.75,3,750971.38,18,4,5,7,True
8295463,49,3,30,7749,578900606,1,0,0,995.07,8,749976.31,20,4,6,7,True
8444766,1107,3,30,3785,578900606,1,0,0,995.05,8,748981.26,0,6,21,7,True
8467648,1015,0,30,5948,578900606,1,0,0,995.07,8,747986.19,26,4,3,8,True
8527041,1409,1,10,8119,578900606,1,0,0,995.28,6,748981.47,24,2,13,9,True
8552818,49,3,-1,4936,578900606,1,1,0,995.02,4,748981.47,20,2,11,9,False
8780238,239,1,10,8300,578900606,1,0,0,995.21,0,749976.68,26,3,6,9,True
9289341,1015,0,25,9313,578900606,1,0,0,994.72,8,748981.96,26,6,21,10,True
9301411,97,0,20,2019,578900606,1,0,0,994.92,3,747987.04,3,0,4,10,True
9836390,1015,0,25,5563,578900606,1,0,0,994.81,8,746992.23,26,2,1,10,True
1114273,388,3,30,6540,923039857,0,0,0,1067.86,8,806055.14,10,3,15,2,False
1184343,1206,0,30,6041,923039857,0,0,0,1067.94,8,804987.2,24,3,10,2,True
1254661,1044,0,25,4237,923039857,0,0,0,1068.02,8,803919.18,11,4,20,5,True
1279387,537,0,20,6041,923039857,0,0,0,1068.03,5,802851.15,18,4,13,5,True
1311035,1045,4,451,6041,923039857,0,0,0,1068.2,7,801782.95,11,1,17,7,True
1632456,1246,0,20,8737,923039857,0,0,0,1067.84,5,800715.11,23,6,2,8,True
1799998,1044,0,30,8159,923039857,0,0,0,1067.61,8,799647.5,11,2,3,8,True
1898382,304,0,10,6540,923039857,0,0,0,1068.03,6,800715.53,4,4,16,10,True
2124576,703,0,10,1227,923039857,0,0,0,1067.92,6,801783.45,18,0,0,10,True
2166698,108,2,20,8159,923039857,0,0,0,1067.81,5,800715.64,3,2,12,11,True
2195919,1418,3,30,1227,923039857,0,0,0,1068.09,8,799647.55,24,4,18,1,True
2276610,403,0,-1,7435,923039857,0,1,0,1068.08,1,799647.55,10,2,21,2,True
2331688,797,3,30,9107,923039857,0,0,0,1068.01,8,798579.54,11,6,16,2,True
2474871,567,1,10,1227,923039857,0,0,0,1068.17,6,799647.71,11,2,8,2,True
2771257,388,3,25,5493,923039857,0,0,0,1067.86,8,798579.85,10,3,3,2,True
2794269,1044,0,25,4615,923039857,0,0,0,1067.83,8,797512.02,11,6,22,3,True
3041429,403,0,30,1227,923039857,0,0,0,1067.8,8,796444.22,10,4,8,3,True
3177386,611,0,20,7418,923039857,0,0,0,1068.01,5,795376.21,11,5,12,4,True
3737071,1418,3,451,9728,923039857,0,0,0,1068.0,7,794308.21,24,2,16,4,True
3754634,524,1,10,4362,923039857,0,0,0,1067.78,0,795375.99,18,4,23,4,True
3817529,1045,4,-1,9742,923039857,0,1,0,1068.03,4,795375.99,11,5,6,4,True
4010905,1044,0,30,9742,923039857,0,0,0,1068.2,8,794307.79,11,6,1,4,True
4219412,716,0,20,4890,923039857,0,0,0,1067.95,5,793239.84,18,1,12,5,True
4220075,797,3,451,5417,923039857,0,0,0,1068.02,7,792171.82,11,2,20,6,True
4441023,1019,0,20,8159,923039857,0,0,0,1067.92,3,791103.9,26,2,8,6,True
4454952,68,0,20,4362,923039857,0,0,0,1067.87,5,790036.03,20,3,4,6,True
4709127,403,0,25,7435,923039857,0,0,0,1068.09,8,788967.94,10,1,10,6,True
5063624,1418,3,30,5322,923039857,0,0,0,1067.92,8,787900.02,24,1,21,8,True
5435463,329,1,10,5322,923039857,0,0,0,1067.87,6,788967.89,11,4,3,8,True
5482393,1206,0,451,4362,923039857,0,0,0,1067.83,7,787900.06,24,6,20,8,True
5733474,403,0,-1,5868,923039857,0,1,0,1068.01,4,787900.06,10,2,12,10,True
5752941,797,3,451,8376,923039857,0,0,0,1068.04,7,786832.02,11,2,12,10,True
5934447,1044,0,-1,8514,923039857,0,1,0,1067.88,1,786832.02,11,3,9,11,True
6151935,1045,4,451,4990,923039857,0,0,0,1068.0,7,785764.02,11,2,6,11,True
6263456,1045,4,451,5285,923039857,0,0,0,1067.9,7,784696.12,11,6,10,12,True
6354112,1044,0,451,6041,923039857,0,0,0,1068.12,7,783628.0,11,3,6,2,True
6476809,1206,0,451,2182,923039857,0,0,0,1068.07,7,782559.93,24,2,7,2,True
6531394,1206,0,25,4615,923039857,0,0,0,1068.09,8,781491.84,24,4,15,2,True
7003051,403,0,30,5285,923039857,0,0,0,1067.85,8,780423.99,10,1,19,3,True
7264358,1045,4,-1,4615,923039857,0,1,0,1067.86,4,780423.99,11,4,22,3,True
7304968,797,3,30,4362,923039857,0,0,0,1068.14,8,779355.85,11,6,3,3,True
7755719,403,0,-1,1227,923039857,0,1,0,1067.88,1,779355.85,10,2,7,4,True
8147855,203,0,20,5270,923039857,0,0,0,1068.02,5,778287.83,9,2,16,4,True
8162137,1045,4,-1,7435,923039857,0,1,0,1067.99,4,778287.83,11,1,17,4,True
8271630,388,3,-1,6540,923039857,0,2,0,1067.77,4,778287.83,10,4,1,5,True
8326812,1119,0,10,8514,923039857,0,0,0,1068.15,0,779355.98,24,6,13,5,True
8483464,403,0,30,4311,923039857,0,0,0,1067.87,8,778288.11,10,4,21,5,True
8812950,1044,0,451,1037,923039857,0,0,0,1067.93,7,777220.18,11,1,5,5,True
8821897,403,0,-1,4237,923039857,0,1,0,1067.98,4,777220.18,10,4,13,6,True
8910609,1206,0,25,4237,923039857,0,0,0,1067.91,8,776152.27,24,2,17,8,True
9120658,797,3,25,5270,923039857,0,0,0,1068.01,8,775084.26,11,4,20,8,True
9372063,1418,3,-1,5493,923039857,0,1,0,1068.08,1,775084.26,24,1,12,9,True
9623308,1045,4,30,4990,923039857,0,0,0,1068.11,8,774016.15,11,2,3,10,False
9642179,757,0,20,8350,923039857,0,0,0,1067.91,3,772948.24,24,2,16,10,True
9904841,1045,4,30,1173,923039857,0,0,0,1067.99,8,771880.25,11,3,11,11,True
1078177,573,0,451,9831,550404976,1,0,0,623.09,7,619689.91,11,1,17,1,True
1088094,1360,4,451,1666,550404976,1,0,0,623.12,7,619066.79,24,4,20,2,True
1230010,423,3,-1,8623,550404976,1,1,0,623.14,4,619066.79,18,4,0,2,True
1493061,605,0,20,5687,550404976,1,0,0,622.85,5,618443.94,24,2,22,3,True
1504738,1116,0,20,4137,550404976,1,0,0,623.2,5,617820.74,24,0,5,3,True
1929759,1460,2,20,8623,550404976,1,0,0,623.17,5,617197.57,11,3,11,5,True
2222079,64,0,25,8396,550404976,1,0,0,622.86,8,616574.71,20,1,23,6,True
2486008,1156,1,10,9205,550404976,1,0,0,622.9,6,617197.61,15,5,1,7,True
2499928,1413,0,10,9831,550404976,1,0,0,622.98,6,617820.59,24,1,7,8,True
2975570,538,0,20,7158,550404976,1,0,0,623.21,3,617197.38,18,6,3,8,True
3433565,14,2,451,1183,550404976,1,0,0,623.1,7,616574.28,24,2,18,8,True
3519240,423,3,-1,4084,550404976,1,1,0,622.95,4,616574.28,18,2,11,9,True
3699588,1456,4,30,3126,550404976,1,0,0,623.26,8,615951.02,11,2,5,9,True
3770682,761,2,451,3047,550404976,1,0,0,622.87,7,615328.15,24,2,7,9,True
3773902,14,2,451,4084,550404976,1,0,0,623.08,7,614705.07,24,2,6,9,False
3814846,639,4,25,5687,550404976,1,0,0,623.12,8,614081.95,24,2,19,9,True
3871147,639,4,451,1183,550404976,1,0,0,623.0,7,613458.95,24,4,23,10,True
3894426,1451,1,10,6692,550404976,1,0,0,623.01,6,614081.96,11,3,22,10,True
3962885,842,2,20,6930,550404976,1,0,0,622.99,5,613458.97,5,2,19,11,True
4230260,573,0,451,5122,550404976,1,0,0,623.01,7,612835.96,11,2,3,11,True
4381079,761,2,25,5687,550404976,1,0,0,622.92,8,612213.04,24,6,16,12,True
4382088,1258,3,451,8396,550404976,1,0,0,622.77,7,611590.27,23,1,14,1,True
4432096,850,1,10,7965,550404976,1,0,0,623.04,6,612213.31,5,2,20,2,True
4772367,14,2,451,5687,550404976,1,0,0,622.97,7,611590.34,24,6,0,2,True
5069435,1360,4,-1,7965,550404976,1,1,0,623.2,1,611590.34,24,0,8,2,True
5323453,1360,4,451,8623,550404976,1,0,0,622.86,7,610967.48,24,2,14,3,True
5832118,1456,4,25,6692,550404976,1,0,0,623.41,8,610344.07,11,3,6,3,True
6217885,1105,2,20,5967,550404976,1,0,0,623.04,3,609721.03,0,3,22,3,True
6239383,939,0,10,5687,550404976,1,0,0,622.77,0,610343.8,24,0,18,5,True
6261925,990,0,20,8623,550404976,1,0,0,622.97,5,609720.83,22,2,1,6,True
6281198,1360,4,451,5967,550404976,1,0,0,622.95,7,609097.88,24,0,2,7,True
6290678,944,2,20,4137,550404976,1,0,0,623.04,3,608474.84,24,0,13,7,True
6404662,423,3,-1,1432,550404976,1,1,0,622.87,4,608474.84,18,3,14,8,True
6767932,1456,4,451,7965,550404976,1,0,0,623.08,7,607851.76,11,6,14,9,False
6845876,1456,4,-1,8623,550404976,1,1,0,622.85,1,607851.76,11,6,5,10,True
6977546,726,0,20,3126,550404976,1,0,0,622.98,5,607228.78,11,0,15,10,True
7469501,267,0,10,8623,550404976,1,0,0,622.92,6,607851.7,6,5,6,12,True
7731928,14,2,-1,4137,550404976,1,1,0,622.88,1,607851.7,24,2,15,1,True
7796917,64,0,-1,5687,550404976,1,2,0,622.76,4,607851.7,20,0,3,1,True
7914320,639,4,451,3047,550404976,1,0,0,623.09,7,607228.61,24,1,21,2,True
8352335,281,1,10,5967,550404976,1,0,0,622.99,6,607851.6,24,5,4,2,True
8505030,1258,3,-1,3126,550404976,1,1,0,622.57,4,607851.6,23,1,14,3,True
8618472,1360,4,451,5967,550404976,1,0,0,622.85,7,607228.75,24,5,14,3,True
8622505,1264,0,20,3126,550404976,1,0,0,622.88,5,606605.87,23,4,9,4,True
8732629,64,0,30,3126,550404976,1,0,0,622.92,8,605982.95,20,0,4,5,True
8738104,639,4,-1,8623,550404976,1,1,0,622.96,4,605982.95,24,0,7,5,True
8738672,639,4,25,8623,550404976,1,0,0,622.86,8,605360.09,24,3,17,6,True
8778865,639,4,451,3126,550404976,1,0,0,622.95,7,604737.14,24,4,19,6,True
9022477,64,0,-1,3126,550404976,1,1,0,623.03,4,604737.14,20,6,13,6,True
9052286,1360,4,451,7158,550404976,1,0,0,623.01,7,604114.13,24,1,19,8,True
9103429,14,2,-1,4137,550404976,1,1,0,623.24,1,604114.13,24,5,21,8,True
9326199,1258,3,-1,6692,550404976,1,2,0,622.72,4,604114.13,23,6,9,8,True
9571830,761,2,30,4084,550404976,1,0,0,623.03,8,603491.1,24,2,6,10,True
9666830,761,2,30,6692,550404976,1,0,0,622.95,8,602868.15,24,3,10,11,True
9689789,761,2,30,3126,550404976,1,0,0,623.25,8,602244.9,24,0,10,11,True
9913708,990,0,20,8396,550404976,1,0,0,623.12,5,601621.78,22,0,4,11,True
1015160,268,2,-1,1178,679813296,1,1,0,1181.01,1,968831.0,24,2,22,2,True
1092395,422,4,-1,3986,679813296,1,2,0,1180.8,4,968831.0,18,0,21,4,True
1337591,422,4,451,6976,679813296,1,0,0,1180.97,7,967650.03,18,5,11,4,True
1967329,42,2,20,5364,679813296,1,0,0,1181.03,5,966469.0,24,4,13,4,True
2104327,1198,4,-1,1490,679813296,1,1,0,1180.72,4,966469.0,24,2,12,6,True
2173320,207,4,451,3986,679813296,1,0,0,1180.87,7,965288.13,9,0,2,7,True
2412589,422,4,30,8335,679813296,1,0,0,1181.31,8,964106.82,18,2,13,7,True
2430581,268,2,30,4325,679813296,1,0,0,1180.95,8,962925.87,24,4,5,8,True
2971468,422,4,451,7908,679813296,1,0,0,1180.86,7,961745.01,18,5,4,9,True
3248952,1072,0,10,5364,679813296,1,0,0,1180.84,6,962925.85,18,6,3,9,True
3289297,942,0,10,1097,679813296,1,0,0,1180.99,6,964106.84,24,6,19,9,True
3809639,832,3,30,1097,679813296,1,0,0,1181.2,8,962925.64,5,3,2,9,True
4097243,877,2,20,1145,679813296,1,0,0,1181.05,3,961744.59,24,4,9,9,True
4308290,832,3,30,3986,679813296,1,0,0,1181.05,8,960563.54,5,0,9,9,True
4370386,1307,0,10,1178,679813296,1,0,0,1181.02,0,961744.56,5,5,0,10,True
4465585,1198,4,30,1178,679813296,1,0,0,1181.11,8,960563.45,24,3,3,12,True
4757445,832,3,451,1097,679813296,1,0,0,1181.2,7,959382.25,5,5,18,2,True
5064879,551,0,-1,3986,679813296,1,1,0,1180.5,4,959382.25,17,0,13,2,True
5352398,250,4,-1,9517,679813296,1,2,0,1181.26,1,959382.25,6,1,0,2,True
5497301,551,0,30,9406,679813296,1,0,0,1180.92,8,958201.33,17,0,21,4,True
5510862,422,4,25,1178,679813296,1,0,0,1180.92,8,957020.41,18,4,15,6,True
6036466,68,0,20,4325,679813296,1,0,0,1181.04,5,955839.37,20,2,20,6,True
6047913,207,4,30,4325,679813296,1,0,0,1181.01,8,954658.36,9,6,7,8,True
6131205,1198,4,-1,6976,679813296,1,1,0,1180.96,4,954658.36,24,1,4,9,True
6426758,250,4,30,1097,679813296,1,0,0,1181.02,8,953477.34,6,4,20,10,True
6453302,268,2,451,4748,679813296,1,0,0,1181.05,7,952296.29,24,1,0,10,True
6467766,1198,4,-1,4974,679813296,1,1,0,1181.05,4,952296.29,24,2,0,10,True
6560777,1273,0,20,1490,679813296,1,0,0,1181.0,5,951115.29,24,1,6,11,True
6566432,268,2,25,5364,679813296,1,0,0,1180.89,8,949934.4,24,4,1,12,True
6585597,268,2,451,9517,679813296,1,0,0,1180.78,7,948753.62,24,0,10,12,True
6846218,268,2,30,2746,679813296,1,0,0,1180.91,8,947572.71,24,3,6,1,True
6994496,1198,4,-1,5494,679813296,1,1,0,1181.09,1,947572.71,24,5,19,2,True
7060951,1198,4,-1,4579,679813296,1,2,0,1180.75,4,947572.71,24,3,5,3,True
7550357,422,4,451,1490,679813296,1,0,0,1180.74,7,946391.97,18,2,4,3,False
7812940,268,2,-1,1145,679813296,1,1,0,1180.95,1,946391.97,24,4,17,3,True
7816970,268,2,-1,1097,679813296,1,2,0,1181.04,4,946391.97,24,1,11,4,False
7851268,1198,4,451,9517,679813296,1,0,0,1180.87,7,945211.1,24,6,3,4,True
8132378,250,4,451,4579,679813296,1,0,0,1181.06,7,944030.04,6,0,3,5,True
8141270,1198,4,25,1490,679813296,1,0,0,1181.26,8,942848.78,24,1,0,6,True
8350085,207,4,451,4325,679813296,1,0,0,1180.89,7,941667.89,9,3,12,6,True
8753060,250,4,451,1490,679813296,1,0,0,1181.03,7,940486.86,6,1,12,6,True
8758228,832,3,451,4579,679813296,1,0,0,1180.95,7,939305.91,5,4,0,7,True
9328361,250,4,-1,4579,679813296,1,1,0,1180.85,4,939305.91,6,3,9,7,True
9330997,832,3,25,5364,679813296,1,0,0,1181.23,8,938124.68,5,2,14,7,True
9377600,1198,4,25,4974,679813296,1,0,0,1181.19,8,936943.49,24,3,9,8,True
9638495,1198,4,-1,4325,679813296,1,1,0,1180.78,1,936943.49,24,4,22,8,True
9689022,268,2,30,4748,679813296,1,0,0,1181.06,8,935762.43,24,2,11,8,True
9743212,832,3,-1,1490,679813296,1,1,0,1181.24,1,935762.43,5,4,10,8,True
9812899,832,3,-1,7908,679813296,1,2,0,1180.89,1,935762.43,5,1,5,10,True
9888412,250,4,30,1178,679813296,1,0,0,1180.91,8,934581.52,6,5,17,10,True
9905613,551,0,25,1097,679813296,1,0,0,1181.2,8,933400.32,17,2,8,11,True
1134649,1356,2,25,8293,713494989,1,0,0,592.04,8,695968.96,24,4,20,1,True
1322002,818,1,451,3795,713494989,1,0,0,592.26,7,695376.7,18,5,0,2,True
1640441,818,1,-1,3795,713494989,1,1,0,591.65,1,695376.7,18,4,20,3,True
1717870,1356,2,-1,9012,713494989,1,2,0,592.09,4,695376.7,24,3,21,3,True
1758718,101,3,25,5871,713494989,1,0,0,592.04,8,694784.66,3,5,17,3,True
1987593,1356,2,451,9994,713494989,1,0,0,591.8,7,694192.86,24,2,8,3,True
2076065,887,2,30,5780,713494989,1,0,0,592.23,8,693600.63,27,3,8,3,True
2342513,1063,0,10,8094,713494989,1,0,0,591.67,6,694192.3,11,5,3,5,True
2498788,101,3,-1,8298,713494989,1,1,0,591.96,1,694192.3,3,3,18,6,True
2823573,1366,4,-1,2925,713494989,1,2,0,592.1,1,694192.3,16,4,6,7,True
3089019,201,1,10,8293,713494989,1,0,0,591.87,6,694784.17,9,5,6,8,True
3179017,101,3,30,9604,713494989,1,0,0,591.81,8,694192.36,3,0,16,8,True
3416496,887,2,30,8293,713494989,1,0,0,591.94,8,693600.42,27,4,8,10,True
3452471,752,0,25,5780,713494989,1,0,0,591.9,8,693008.52,24,5,6,10,True
3462152,665,2,20,8293,713494989,1,0,0,591.82,5,692416.7,18,6,5,1,True
3858808,887,2,-1,2925,713494989,1,1,0,591.87,1,692416.7,27,6,3,1,True
3965381,101,3,-1,5871,713494989,1,2,0,591.74,4,692416.7,3,6,6,1,True
4221829,220,0,25,9141,713494989,1,0,0,592.12,8,691824.58,26,2,4,2,True
4449752,675,2,20,9141,713494989,1,0,0,591.68,3,691232.9,24,6,8,2,True
4599037,818,1,-1,8557,713494989,1,1,0,592.1,4,691232.9,18,3,1,3,True
4625885,818,1,451,8293,713494989,1,0,0,591.95,7,690640.95,18,2,23,4,True
4743971,1366,4,451,8557,713494989,1,0,0,592.12,7,690048.83,16,0,8,5,True
4770642,887,2,30,9494,713494989,1,0,0,592.04,8,689456.79,27,0,20,5,True
4890748,916,0,20,5867,713494989,1,0,0,591.85,5,688864.94,18,0,18,5,True
4928951,752,0,30,5871,713494989,1,0,0,592.02,8,688272.92,24,6,12,5,True
5096297,887,2,25,8463,713494989,1,0,0,592.03,8,687680.89,27,1,21,6,True
5109903,1366,4,451,8463,713494989,1,0,0,592.12,7,687088.77,16,2,22,6,False
5435196,101,3,451,8094,713494989,1,0,0,592.12,7,686496.65,3,0,19,7,True
5453965,1067,4,30,4938,713494989,1,0,0,592.03,8,685904.62,11,6,19,7,True
6019086,818,1,30,7483,713494989,1,0,0,591.77,8,685312.85,18,0,21,7,True
6027504,220,0,30,5572,713494989,1,0,0,591.87,8,684720.98,26,0,5,8,True
6076132,1089,0,20,9604,713494989,1,0,0,591.99,3,684128.99,18,6,16,9,True
6217452,220,0,451,1919,713494989,1,0,0,592.12,7,683536.87,26,2,7,9,True
6366374,220,0,451,5572,713494989,1,0,0,591.96,7,682944.91,26,2,12,10,True
6734333,96,0,20,5871,713494989,1,0,0,592.02,3,682352.89,1,0,14,11,True
6761191,818,1,451,8557,713494989,1,0,0,591.9,7,681760.99,18,5,17,12,True
6837488,825,2,20,3795,713494989,1,0,0,591.93,5,681169.06,18,5,19,1,True
7006899,1356,2,25,7483,713494989,1,0,0,592.26,8,680576.8,24,2,20,2,True
7027414,502,0,10,3795,713494989,1,0,0,592.0,6,681168.8,12,4,17,2,True
7222270,220,0,30,8557,713494989,1,0,0,591.96,8,680576.84,26,5,2,5,True
7258056,752,0,451,7248,713494989,1,0,0,592.14,7,679984.7,24,5,7,5,True
7285256,1067,4,25,9494,713494989,1,0,0,591.9,8,679392.8,11,1,9,6,True
7504964,1356,2,451,9012,713494989,1,0,0,591.96,7,678800.84,24,6,15,6,True
7524390,1366,4,451,1919,713494989,1,0,0,591.88,7,678208.96,16,4,21,6,True
7597072,1366,4,25,8094,713494989,1,0,0,592.19,8,677616.77,16,3,11,8,True
7608670,101,3,451,8094,713494989,1,0,0,592.0,7,677024.77,3,6,3,8,False
7646414,818,1,451,7248,713494989,1,0,0,591.89,7,676432.88,18,4,10,9,True
8093569,887,2,30,5780,713494989,1,0,0,591.94,8,675840.94,27,2,20,9,True
8105142,1412,2,20,9494,713494989,1,0,0,592.04,5,675248.9,24,4,10,10,True
8467956,518,2,20,3726,713494989,1,0,0,592.14,5,674656.76,18,5,5,10,True
8571605,800,0,10,9012,713494989,1,0,0,592.23,0,675248.99,11,3,3,11,True
8687552,818,1,30,3795,713494989,1,0,0,591.81,8,674657.18,18,3,19,11,True
9163110,1067,4,451,7483,713494989,1,0,0,591.85,7,674065.33,11,5,12,11,True
1039541,1044,0,10,1019,175836677,1,0,0,942.16,6,372493.16,11,6,23,1,True
1218848,972,3,451,1619,175836677,1,0,0,942.09,7,371551.07,13,4,17,2,True
1341352,1406,0,451,6913,175836677,1,0,0,941.71,7,370609.36,24,0,9,2,True
1369458,184,0,10,6096,175836677,1,0,0,942.11,6,371551.47,18,3,16,3,False
1455918,398,0,25,6096,175836677,1,0,0,942.18,8,370609.29,10,2,4,5,True
1503598,972,3,30,7388,175836677,1,0,0,941.86,8,369667.43,13,6,2,5,True
1748630,1381,4,451,1019,175836677,1,0,0,942.07,7,368725.36,16,0,22,5,True
2254099,375,4,25,7052,175836677,1,0,0,941.57,8,367783.79,25,5,1,6,True
2411875,398,0,30,9581,175836677,1,0,0,942.1,8,366841.69,10,2,6,6,False
2446843,1164,0,20,7373,175836677,1,0,0,942.14,5,365899.55,24,3,6,6,True
2544901,1406,0,-1,6824,175836677,1,1,0,942.27,4,365899.55,24,2,5,7,True
2552197,479,2,451,1019,175836677,1,0,0,942.22,7,364957.33,5,2,11,7,True
2633385,479,2,25,5221,175836677,1,0,0,941.88,8,364015.45,5,3,14,8,True
2645632,1406,0,451,5221,175836677,1,0,0,941.61,7,363073.84,24,5,18,9,True
2931175,610,0,10,7490,175836677,1,0,0,942.19,0,364016.03,11,2,13,9,True
3100073,1381,4,25,2941,175836677,1,0,0,942.03,8,363074.0,16,3,19,10,True
3159610,1255,0,20,2941,175836677,1,0,0,941.93,3,362132.07,23,2,12,11,True
3233476,1025,1,10,7388,175836677,1,0,0,942.07,6,363074.14,11,2,12,12,True
3236609,375,4,451,9785,175836677,1,0,0,942.06,7,362132.08,25,3,23,2,True
3917788,1406,0,30,7569,175836677,1,0,0,942.31,8,361189.77,24,0,20,2,True
4158673,1406,0,25,3115,175836677,1,0,0,941.88,8,360247.89,24,2,17,2,True
4172472,972,3,25,2165,175836677,1,0,0,942.08,8,359305.81,13,3,13,3,True
4537231,1406,0,451,1619,175836677,1,0,0,941.98,7,358363.83,24,1,13,4,True
4833073,850,1,10,9785,175836677,1,0,0,941.79,6,359305.62,5,3,8,4,True
4859042,972,3,25,7388,175836677,1,0,0,942.02,8,358363.6,13,3,13,5,True
4871081,457,0,20,6824,175836677,1,0,0,942.36,5,357421.24,13,1,22,5,False
5113375,972,3,25,1019,175836677,1,0,0,942.23,8,356479.01,13,5,17,6,True
5417676,972,3,25,1619,175836677,1,0,0,942.14,8,355536.87,13,3,14,7,True
5455088,1381,4,451,9785,175836677,1,0,0,941.96,7,354594.91,16,0,22,7,True
5532660,972,3,30,6913,175836677,1,0,0,941.9,8,353653.01,13,1,11,7,True
5566290,1381,4,-1,8523,175836677,1,1,0,942.06,1,353653.01,16,1,22,7,True
5841652,479,2,25,7490,175836677,1,0,0,942.38,8,352710.63,5,6,7,7,True
5899616,479,2,-1,6096,175836677,1,1,0,942.15,4,352710.63,5,2,13,9,True
5989054,1052,0,20,6913,175836677,1,0,0,942.08,5,351768.55,11,3,5,10,True
6144694,1381,4,451,2165,175836677,1,0,0,942.11,7,350826.44,16,0,8,11,True
6791679,398,0,451,1619,175836677,1,0,0,942.2,7,349884.24,10,2,5,11,True
6793738,1381,4,30,5221,175836677,1,0,0,942.08,8,348942.16,16,5,19,11,True
6876094,713,0,10,1619,175836677,1,0,0,942.03,6,349884.19,18,2,16,12,True
6880591,627,0,10,7052,175836677,1,0,0,941.88,6,350826.07,11,5,1,12,True
7089476,479,2,451,7052,175836677,1,0,0,941.94,7,349884.13,5,3,2,2,True
7131240,471,0,20,2941,175836677,1,0,0,942.19,5,348941.94,5,4,20,3,True
7244838,375,4,25,7490,175836677,1,0,0,941.85,8,348000.09,25,3,14,3,True
7679638,972,3,451,9785,175836677,1,0,0,942.19,7,347057.9,13,4,21,3,True
7790933,398,0,25,6913,175836677,1,0,0,941.92,8,346115.98,10,3,17,3,True
7859264,360,0,10,2165,175836677,1,0,0,942.13,6,347058.11,24,5,17,4,True
8062376,1445,2,20,9581,175836677,1,0,0,941.88,3,346116.23,24,4,19,5,True
8082941,503,0,20,7388,175836677,1,0,0,941.88,5,345174.35,12,0,6,5,True
8088784,398,0,451,7388,175836677,1,0,0,942.01,7,344232.34,10,2,15,5,True
8285809,479,2,-1,7052,175836677,1,1,0,942.3,1,344232.34,5,0,13,5,True
8313284,1406,0,30,1619,175836677,1,0,0,941.82,8,343290.52,24,6,19,6,True
8746349,479,2,-1,6913,175836677,1,1,0,941.97,1,343290.52,5,4,11,7,True
8830790,375,4,30,6096,175836677,1,0,0,941.83,8,342348.69,25,0,12,10,True
9243988,479,2,451,6913,175836677,1,0,0,941.97,7,341406.72,5,5,8,10,True
9480874,1406,0,25,7373,175836677,1,0,0,942.01,8,340464.71,24,0,2,10,True
9824407,398,0,451,1619,175836677,1,0,0,941.8,7,339522.91,10,0,19,11,True
9983432,1406,0,25,7569,175836677,1,0,0,941.81,8,338581.1,24,3,17,11,True
1165146,887,2,30,9938,853518193,0,0,0,142.94,8,906485.06,27,1,9,1,True
1203129,208,0,451,7178,853518193,0,0,0,142.7,7,906342.36,9,1,13,2,True
1207473,871,0,10,4583,853518193,0,0,0,143.04,0,906485.4,24,2,3,2,True
1260798,883,0,20,6075,853518193,0,0,0,142.86,5,906342.54,24,1,16,2,True
1473783,518,2,-1,4777,853518193,0,1,0,142.79,4,906342.54,18,4,2,3,True
1591166,1406,0,20,7960,853518193,0,0,0,142.92,3,906199.62,24,0,22,3,True
1793316,80,4,451,4777,853518193,0,0,0,142.86,7,906056.76,1,1,13,3,True
1797240,80,4,451,7178,853518193,0,0,0,143.02,7,905913.74,1,1,20,4,True
1971759,80,4,451,7625,853518193,0,0,0,143.0,7,905770.74,1,5,17,5,True
2242119,465,0,451,8929,853518193,0,0,0,142.95,7,905627.79,13,4,23,5,True
2313218,329,1,10,2030,853518193,0,0,0,142.66,0,905770.45,11,3,7,6,True
2544558,80,4,-1,4583,853518193,0,1,0,143.22,4,905770.45,1,6,11,8,True
2602824,465,0,451,9938,853518193,0,0,0,143.25,7,905627.2,13,0,18,9,True
2637643,1017,2,20,3328,853518193,0,0,0,143.05,5,905484.15,26,4,17,10,True
2647152,80,4,451,9043,853518193,0,0,0,142.99,7,905341.16,1,3,3,10,True
2684320,465,0,25,7960,853518193,0,0,0,142.92,8,905198.24,13,3,17,10,True
2983683,80,4,25,4054,853518193,0,0,0,142.97,8,905055.27,1,6,3,12,True
3163662,1210,0,20,9043,853518193,0,0,0,142.88,5,904912.39,24,6,4,12,True
3370889,887,2,-1,7178,853518193,0,1,0,143.03,4,904912.39,27,1,21,4,True
3895824,842,2,20,7178,853518193,0,0,0,143.02,3,904769.37,5,5,12,4,True
4065779,80,4,451,4653,853518193,0,0,0,142.66,7,904626.71,1,1,20,5,True
4249404,465,0,-1,9280,853518193,0,1,0,142.77,1,904626.71,13,3,12,5,True
4508839,518,2,451,8255,853518193,0,0,0,142.78,7,904483.93,18,1,16,6,True
4806373,518,2,25,1306,853518193,0,0,0,143.01,8,904340.92,18,1,16,6,True
5617832,648,3,451,2331,853518193,0,0,0,142.93,7,904197.99,24,4,3,7,True
5798312,80,4,-1,9065,853518193,0,1,0,143.12,1,904197.99,1,6,22,7,True
5850875,518,2,30,4777,853518193,0,0,0,143.23,8,904054.76,18,2,23,7,True
5970601,465,0,451,4653,853518193,0,0,0,142.84,7,903911.92,13,1,18,8,True
6314264,573,0,10,3328,853518193,0,0,0,142.75,0,904054.67,11,2,6,9,True
6502674,711,2,20,6075,853518193,0,0,0,142.7,3,903911.97,18,4,17,9,True
6851887,729,0,20,4583,853518193,0,0,0,142.79,5,903769.18,11,2,2,10,True
7505030,80,4,451,6631,853518193,0,0,0,143.07,7,903626.11,1,6,10,11,True
7588377,208,0,451,7825,853518193,0,0,0,142.99,7,903483.12,9,0,2,11,True
7842508,518,2,-1,9280,853518193,0,1,0,143.02,1,903483.12,18,3,13,11,True
7999408,887,2,25,6631,853518193,0,0,0,142.82,8,903340.3,27,6,7,11,True
8018071,518,2,30,8273,853518193,0,0,0,143.04,8,903197.26,18,4,7,11,True
8109288,1336,2,20,6631,853518193,0,0,0,143.04,3,903054.22,18,1,21,12,True
8481087,757,0,10,2331,853518193,0,0,0,143.25,0,903197.47,24,4,5,12,True
8526817,518,2,30,2331,853518193,0,0,0,142.82,8,903054.65,18,2,5,1,False
8536416,790,0,10,7960,853518193,0,0,0,143.08,6,903197.73,11,6,18,1,True
8548342,1132,0,20,7960,853518193,0,0,0,143.06,5,903054.67,24,4,9,2,True
8651553,648,3,25,7825,853518193,0,0,0,142.56,8,902912.11,24,3,14,4,True
8932599,80,4,25,4886,853518193,0,0,0,143.22,8,902768.89,1,0,22,5,True
9027872,648,3,-1,5916,853518193,0,1,0,143.15,4,902768.89,24,2,22,7,True
9096069,80,4,451,9043,853518193,0,0,0,142.87,7,902626.02,1,0,11,8,True
9207505,518,2,451,4653,853518193,0,0,0,143.37,7,902482.65,18,3,15,8,True
9391769,642,0,20,9280,853518193,0,0,0,143.04,5,902339.61,24,2,2,9,True
9878296,518,2,30,8929,853518193,0,0,0,142.89,8,902196.72,18,4,17,9,False
9894307,208,0,451,8929,853518193,0,0,0,142.93,7,902053.79,9,0,6,9,True
9967254,648,3,451,2030,853518193,0,0,0,143.41,7,901910.38,24,3,20,9,True
9983531,648,3,25,1756,853518193,0,0,0,142.98,8,901767.4,24,4,3,9,True
1003785,658,4,451,4972,567438568,0,0,0,785.04,7,200188.96,18,1,15,2,True
1075982,677,0,25,4972,567438568,0,0,0,785.11,8,199403.85,24,1,19,3,True
1099231,1189,2,20,9042,567438568,0,0,0,785.05,5,198618.8,24,0,15,4,True
1233335,1297,0,20,5589,567438568,0,0,0,784.87,5,197833.93,5,6,3,5,True
1299701,260,0,451,2907,567438568,0,0,0,784.75,7,197049.18,6,4,22,6,True
1433370,958,2,20,8535,567438568,0,0,0,785.03,3,196264.15,13,2,17,8,True
1446234,525,0,451,4480,567438568,0,0,0,784.73,7,195479.42,18,2,18,8,True
1704595,260,0,25,8535,567438568,0,0,0,785.13,8,194694.29,6,1,9,9,True
1738983,123,0,25,6172,567438568,0,0,0,784.92,8,193909.37,18,5,7,10,True
1960298,931,0,10,9398,567438568,0,0,0,784.98,0,194694.35,24,3,3,10,True
2064296,677,0,451,6685,567438568,0,0,0,784.81,7,193909.54,24,5,18,10,True
2098421,1110,0,20,6172,567438568,0,0,0,785.0,3,193124.54,0,6,1,10,True
2244755,525,0,451,8906,567438568,0,0,0,784.93,7,192339.61,18,6,11,11,True
2415152,658,4,25,9049,567438568,0,0,0,784.96,8,191554.65,18,3,1,12,True
2453758,260,0,451,1685,567438568,0,0,0,784.7,7,190769.95,6,2,5,1,True
2588361,525,0,30,9049,567438568,0,0,0,784.93,8,189985.02,18,4,9,2,True
2821624,658,4,451,7162,567438568,0,0,0,785.16,7,189199.86,18,0,19,3,True
3554838,714,2,20,1706,567438568,0,0,0,784.59,3,188415.27,18,5,19,5,True
3754648,525,0,451,7705,567438568,0,0,0,785.04,7,187630.23,18,0,13,5,True
3775093,260,0,30,8627,567438568,0,0,0,784.77,8,186845.46,6,2,6,5,True
4044660,208,0,20,8627,567438568,0,0,0,785.24,3,186060.22,9,2,19,6,True
4090562,123,0,25,1706,567438568,0,0,0,784.88,8,185275.34,18,3,19,7,True
4179804,260,0,-1,7162,567438568,0,1,0,784.84,4,185275.34,6,2,22,7,True
4276081,260,0,451,9113,567438568,0,0,0,784.81,7,184490.53,6,5,6,7,True
4587968,525,0,-1,8535,567438568,0,1,0,785.17,1,184490.53,18,4,7,7,True
4832031,525,0,25,4972,567438568,0,0,0,785.0,8,183705.53,18,5,2,8,True
4914613,260,0,451,2413,567438568,0,0,0,784.96,7,182920.57,6,2,8,8,True
5093498,123,0,25,1706,567438568,0,0,0,784.87,8,182135.7,18,1,17,9,True
5229471,726,0,10,7162,567438568,0,0,0,785.08,6,182920.78,11,5,5,9,True
5234307,658,4,-1,5589,567438568,0,1,0,784.97,1,182920.78,18,0,19,9,True
5457003,260,0,-1,9042,567438568,0,2,0,785.13,4,182920.78,6,5,7,10,True
5474640,525,0,451,6172,567438568,0,0,0,784.76,7,182136.02,18,3,20,11,True
5592029,658,4,30,2413,567438568,0,0,0,784.68,8,181351.34,18,6,19,11,True
5909592,962,0,20,9042,567438568,0,0,0,785.17,5,180566.17,13,5,15,12,True
5920141,21,0,20,6153,567438568,0,0,0,784.86,5,179781.31,11,5,15,12,True
6291350,1311,2,20,4972,567438568,0,0,0,785.24,5,178996.07,5,3,15,12,True
6335844,658,4,-1,8535,567438568,0,1,0,785.09,1,178996.07,18,1,4,12,True
6824609,658,4,451,9113,567438568,0,0,0,784.98,7,178211.09,18,4,12,1,True
7460884,658,4,-1,6685,567438568,0,1,0,784.79,4,178211.09,18,2,4,1,True
7595784,443,2,20,9042,567438568,0,0,0,784.97,3,177426.12,24,2,14,1,True
7760669,123,0,30,2907,567438568,0,0,0,784.94,8,176641.18,18,1,18,2,True
7770370,658,4,25,4972,567438568,0,0,0,785.02,8,175856.16,18,2,19,3,True
8017564,123,0,25,8330,567438568,0,0,0,784.9,8,175071.26,18,0,10,4,True
8176107,658,4,30,8553,567438568,0,0,0,785.11,8,174286.15,18,6,21,6,True
8321735,677,0,25,3255,567438568,0,0,0,784.87,8,173501.28,24,1,12,6,True
8433188,525,0,30,8627,567438568,0,0,0,785.01,8,172716.27,18,0,8,6,True
8533343,1380,0,20,2907,567438568,0,0,0,784.99,5,171931.28,16,6,16,7,True
8801587,677,0,451,6153,567438568,0,0,0,785.01,7,171146.27,24,4,14,8,True
8853086,314,0,20,5589,567438568,0,0,0,785.05,5,170361.22,4,1,8,9,True
9081278,677,0,30,8906,567438568,0,0,0,784.94,8,169576.28,24,2,6,9,True
9445851,123,0,30,5589,567438568,0,0,0,784.9,8,168791.38,18,5,20,9,True
9660745,509,0,10,9113,567438568,0,0,0,785.15,6,169576.53,12,1,0,10,True
9780167,20,0,10,9049,567438568,0,0,0,785.13,6,170361.66,24,5,22,10,True
9890547,123,0,30,2907,567438568,0,0,0,784.93,8,169576.73,18,6,7,10,True
9921530,350,0,10,5589,567438568,0,0,0,785.16,6,170361.89,24,2,17,11,True
1078464,572,0,20,5338,291071571,1,0,0,1133.94,5,91831.06,11,5,12,1,True
1528594,116,0,-1,8739,291071571,1,1,0,1134.11,4,91831.06,3,2,21,1,True
1699362,138,3,25,5708,291071571,1,0,0,1133.95,8,90697.11,18,4,8,2,True
1851162,847,3,-1,6051,291071571,1,1,0,1133.89,4,90697.11,5,5,9,2,True
2110159,1354,0,451,6377,291071571,1,0,0,1134.14,7,89562.97,24,3,6,2,True
2498002,728,1,30,5509,291071571,1,0,0,1134.19,8,88428.78,11,6,4,3,True
2600714,728,1,-1,5471,291071571,1,1,0,1133.75,4,88428.78,11,0,8,4,True
2689944,951,0,10,6051,291071571,1,0,0,1134.1,0,89562.88,24,1,15,7,True
2694267,445,0,10,3195,291071571,1,0,0,1133.97,6,90696.85,13,6,23,7,True
2806551,116,0,451,1247,291071571,1,0,0,1133.9,7,89562.95,3,1,13,8,True
2832269,116,0,-1,5956,291071571,1,1,0,1133.89,4,89562.95,3,5,4,9,True
2955734,728,1,451,5708,291071571,1,0,0,1134.17,7,88428.78,11,3,1,9,True
3015866,641,0,10,5695,291071571,1,0,0,1134.29,6,89563.07,24,0,5,11,True
3134708,847,3,30,6051,291071571,1,0,0,1133.99,8,88429.08,5,0,14,1,True
3137350,728,1,25,2415,291071571,1,0,0,1134.27,8,87294.81,11,5,2,1,True
3390620,357,4,451,2938,291071571,1,0,0,1133.99,7,86160.82,24,5,0,2,True
3504198,585,2,20,8739,291071571,1,0,0,1133.85,5,85026.97,11,4,21,2,True
3701334,728,1,30,4200,291071571,1,0,0,1133.95,8,83893.02,11,6,15,2,True
3873631,847,3,451,6159,291071571,1,0,0,1134.01,7,82759.01,5,1,2,2,True
3914250,1461,0,10,2938,291071571,1,0,0,1134.16,0,83893.17,11,5,2,3,True
4527308,138,3,451,5471,291071571,1,0,0,1134.05,7,82759.12,18,0,21,3,True
4577822,847,3,-1,1247,291071571,1,1,0,1133.85,4,82759.12,5,0,15,3,True
4744003,847,3,451,2938,291071571,1,0,0,1133.85,7,81625.27,5,2,0,3,True
4808129,116,0,30,5509,291071571,1,0,0,1133.99,8,80491.28,3,4,7,3,False
5172007,357,4,25,5956,291071571,1,0,0,1133.98,8,79357.3,24,3,1,4,True
5859045,116,0,30,6194,291071571,1,0,0,1133.85,8,78223.45,3,0,3,5,True
6241334,1354,0,451,5471,291071571,1,0,0,1134.14,7,77089.31,24,4,15,7,True
6256989,496,1,10,4487,291071571,1,0,0,1134.24,0,78223.55,12,5,14,8,True
6291094,357,4,451,2422,291071571,1,0,0,1134.11,7,77089.44,24,5,20,8,True
6648503,357,4,30,2938,291071571,1,0,0,1133.73,8,75955.71,24,0,20,9,True
6701140,95,2,20,8918,291071571,1,0,0,1134.06,5,74821.65,1,2,5,9,True
6768199,847,3,-1,8918,291071571,1,1,0,1134.21,4,74821.65,5,2,11,11,True
7063893,940,1,10,5695,291071571,1,0,0,1133.83,6,75955.48,24,4,6,11,True
7331996,357,4,451,5509,291071571,1,0,0,1133.93,7,74821.55,24,3,3,11,True
7355200,357,4,25,5338,291071571,1,0,0,1134.04,8,73687.51,24,1,6,11,True
7492680,728,1,25,5956,291071571,1,0,0,1133.94,8,72553.57,11,4,14,12,True
7721423,21,0,20,1443,291071571,1,0,0,1134.11,3,71419.46,11,0,3,2,True
8034883,465,0,10,5708,291071571,1,0,0,1133.98,6,72553.44,13,4,2,2,False
8236662,1027,0,20,8739,291071571,1,0,0,1134.01,5,71419.43,11,0,12,2,True
8487156,1000,0,10,6377,291071571,1,0,0,1134.0,6,72553.43,26,3,19,3,True
8518197,847,3,451,6377,291071571,1,0,0,1134.1,7,71419.33,5,1,12,3,True
8547973,116,0,25,3597,291071571,1,0,0,1133.71,8,70285.62,3,6,20,6,True
8884870,804,0,10,5708,291071571,1,0,0,1133.63,0,71419.25,11,0,3,7,False
9323759,138,3,30,8739,291071571,1,0,0,1133.98,8,70285.27,18,5,10,8,True
9453382,357,4,30,2415,291071571,1,0,0,1134.08,8,69151.19,24,3,16,8,True
9509580,357,4,451,5338,291071571,1,0,0,1133.95,7,68017.24,24,5,7,8,True
9572142,728,1,30,6995,291071571,1,0,0,1134.0,8,66883.24,11,6,17,9,True
9627855,116,0,25,5956,291071571,1,0,0,1133.9,8,65749.34,3,1,19,9,True
9648611,116,0,-1,2422,291071571,1,1,0,1134.05,1,65749.34,3,0,12,9,True
9661131,116,0,451,4487,291071571,1,0,0,1133.9,7,64615.44,3,4,2,9,True
9776729,1354,0,451,2415,291071571,1,0,0,1134.13,7,63481.31,24,6,20,10,True
9878315,116,0,25,6194,291071571,1,0,0,1134.08,8,62347.23,3,3,23,11,True
9992018,847,3,-1,4200,291071571,1,1,0,1133.92,4,62347.23,5,0,7,11,True
1087320,400,4,30,1945,360934287,1,0,0,940.02,8,544433.98,10,6,9,2,True
1389746,1065,0,25,2305,360934287,1,0,0,939.95,8,543494.03,11,2,19,3,True
1545048,400,4,25,4299,360934287,1,0,0,939.83,8,542554.2,10,6,22,3,True
1570185,30,4,25,2481,360934287,1,0,0,939.86,8,541614.34,11,3,17,3,True
1695932,484,0,25,6809,360934287,1,0,0,939.65,8,540674.69,5,1,8,3,True
1749102,199,0,30,8216,360934287,1,0,0,939.92,8,539734.77,18,1,4,4,True
1765761,30,4,30,9433,360934287,1,0,0,939.93,8,538794.84,11,3,7,4,True
1953236,1160,0,10,9433,360934287,1,0,0,939.92,6,539734.76,15,6,12,4,True
2361032,531,0,25,6804,360934287,1,0,0,940.15,8,538794.61,18,4,4,5,True
2391203,1065,0,451,2305,360934287,1,0,0,940.18,7,537854.43,11,5,6,5,True
2776070,1288,0,10,2481,360934287,1,0,0,939.93,6,538794.36,24,5,4,6,True
2783079,199,0,-1,7800,360934287,1,1,0,940.14,4,538794.36,18,4,8,6,True
3078265,531,0,30,4067,360934287,1,0,0,940.0,8,537854.36,18,0,19,6,True
3121017,1125,1,10,2159,360934287,1,0,0,939.9,6,538794.26,24,1,14,7,True
3199895,1065,0,-1,5474,360934287,1,1,0,939.8,1,538794.26,11,2,4,8,True
3313839,30,4,25,9433,360934287,1,0,0,940.3,8,537853.96,11,1,0,8,True
3604603,30,4,25,5690,360934287,1,0,0,940.14,8,536913.82,11,5,3,9,True
3849348,713,0,20,5124,360934287,1,0,0,939.89,3,535973.93,18,4,20,11,True
3981411,400,4,451,6832,360934287,1,0,0,939.81,7,535034.12,10,6,7,1,True
4351430,1065,0,30,5124,360934287,1,0,0,939.77,8,534094.35,11,4,12,1,True
4362019,1007,2,20,3884,360934287,1,0,0,940.28,3,533154.07,26,1,5,2,True
4534938,535,0,10,4299,360934287,1,0,0,940.04,6,534094.11,18,4,16,2,True
4556742,1065,0,25,2159,360934287,1,0,0,939.98,8,533154.13,11,6,7,2,True
4722568,865,0,20,5474,360934287,1,0,0,939.82,5,532214.31,24,0,23,2,True
5002664,484,0,451,6809,360934287,1,0,0,939.9,7,531274.41,5,5,5,5,True
5569430,503,0,10,2958,360934287,1,0,0,940.18,6,532214.59,12,6,7,5,True
5700489,30,4,30,9497,360934287,1,0,0,940.14,8,531274.45,11,4,9,5,True
6001504,199,0,451,9601,360934287,1,0,0,939.9,7,530334.55,18,5,14,5,True
6027223,484,0,451,7618,360934287,1,0,0,940.04,7,529394.51,5,5,9,6,True
6529488,1247,0,10,6809,360934287,1,0,0,939.93,6,530334.44,23,2,9,6,True
6734602,531,0,30,2481,360934287,1,0,0,940.16,8,529394.28,18,4,15,8,True
6738662,1065,0,30,4299,360934287,1,0,0,940.0,8,528454.28,11,5,23,10,True
6981160,1065,0,25,2159,360934287,1,0,0,939.95,8,527514.33,11,1,14,10,True
7278007,484,0,25,9203,360934287,1,0,0,940.27,8,526574.06,5,1,1,10,True
7320369,531,0,451,2597,360934287,1,0,0,940.19,7,525633.87,18,0,5,11,True
7384308,30,4,451,9497,360934287,1,0,0,939.91,7,524693.96,11,2,20,11,True
7531849,30,4,-1,8216,360934287,1,1,0,940.13,4,524693.96,11,5,12,12,True
7645065,747,1,10,2305,360934287,1,0,0,939.92,0,525633.88,24,6,22,12,True
7700595,531,0,25,6804,360934287,1,0,0,940.2,8,524693.68,18,4,2,12,True
7870493,780,0,20,5690,360934287,1,0,0,939.79,5,523753.89,14,2,12,1,True
7878933,300,0,10,3044,360934287,1,0,0,939.87,6,524693.76,4,6,13,3,True
8780887,334,0,10,6832,360934287,1,0,0,940.07,6,525633.83,11,6,20,3,True
9144909,616,1,10,3884,360934287,1,0,0,940.17,6,526574.0,11,0,8,4,True
9282378,1179,0,20,8216,360934287,1,0,0,939.92,5,525634.08,24,5,10,5,True
9392046,400,4,451,2597,360934287,1,0,0,939.83,7,524694.25,10,5,14,5,True
9397798,716,0,10,8216,360934287,1,0,0,940.14,6,525634.39,18,1,18,7,True
9439719,400,4,25,2159,360934287,1,0,0,939.95,8,524694.44,10,6,2,7,True
9658281,400,4,25,7975,360934287,1,0,0,939.94,8,523754.5,10,5,0,8,True
9719057,531,0,30,7800,360934287,1,0,0,939.93,8,522814.57,18,1,6,8,True
9862739,942,0,20,2305,360934287,1,0,0,940.15,5,521874.42,24,4,23,8,True
9913606,400,4,30,2597,360934287,1,0,0,940.07,8,520934.35,10,2,0,8,True
9924339,484,0,30,6832,360934287,1,0,0,939.74,8,519994.61,5,6,0,9,True
9969143,30,4,451,3884,360934287,1,0,0,940.05,7,519054.56,11,4,11,9,True
1550423,44,4,451,1047,776435697,0,0,0,1079.12,7,375783.88,24,3,7,1,True
1682320,871,0,10,5754,776435697,0,0,0,1078.91,6,376862.79,24,3,10,2,True
1926593,846,3,25,3497,776435697,0,0,0,1079.02,8,375783.77,5,2,7,4,True
2321123,398,0,25,4279,776435697,0,0,0,1079.05,8,374704.72,10,3,7,4,True
2346078,86,4,25,9203,776435697,0,0,0,1078.92,8,373625.8,1,6,4,5,True
2355729,585,2,20,5754,776435697,0,0,0,1078.93,5,372546.87,11,1,14,6,True
2668501,1169,0,451,6578,776435697,0,0,0,1078.98,7,371467.89,24,6,6,6,True
2714839,677,0,20,4341,776435697,0,0,0,1079.03,3,370388.86,24,4,22,8,True
2717977,117,1,10,3497,776435697,0,0,0,1078.74,6,371467.6,18,2,22,8,True
2785951,846,3,-1,9203,776435697,0,1,0,1079.06,1,371467.6,5,3,9,9,True
3150241,398,0,-1,3571,776435697,0,2,0,1078.88,4,371467.6,10,2,18,10,True
3267681,202,4,451,4283,776435697,0,0,0,1078.84,7,370388.76,9,3,18,11,True
3372255,398,0,451,1790,776435697,0,0,0,1079.03,7,369309.73,10,4,11,1,True
3653706,86,4,451,6578,776435697,0,0,0,1079.13,7,368230.6,1,6,3,1,True
3810982,44,4,25,1790,776435697,0,0,0,1078.74,8,367151.86,24,4,20,1,True
4042144,44,4,25,3949,776435697,0,0,0,1078.96,8,366072.9,24,3,6,2,True
4233585,44,4,-1,3897,776435697,0,1,0,1078.81,4,366072.9,24,6,22,2,True
4335149,202,4,-1,2675,776435697,0,2,0,1078.76,4,366072.9,9,2,6,3,True
4394968,44,4,25,3571,776435697,0,0,0,1078.8,8,364994.1,24,5,6,4,True
4571234,846,3,30,9945,776435697,0,0,0,1079.02,8,363915.08,5,1,16,4,True
4705665,1124,0,20,2308,776435697,0,0,0,1079.05,3,362836.03,24,2,16,4,True
5040338,703,0,10,3930,776435697,0,0,0,1079.03,6,363915.06,18,4,11,4,True
5054559,1270,1,10,4341,776435697,0,0,0,1078.99,6,364994.05,23,5,20,4,True
5226183,1169,0,451,2308,776435697,0,0,0,1079.03,7,363915.02,24,2,7,5,True
5307534,86,4,30,6673,776435697,0,0,0,1079.02,8,362836.0,1,5,21,5,True
5475173,360,0,10,7054,776435697,0,0,0,1079.14,6,363915.14,24,0,19,5,True
5563364,846,3,25,4283,776435697,0,0,0,1079.12,8,362836.02,5,3,15,6,True
5724076,846,3,30,7054,776435697,0,0,0,1079.0,8,361757.02,5,6,7,7,True
5795450,1446,1,10,3571,776435697,0,0,0,1078.88,6,362835.9,24,0,17,7,True
5940270,1169,0,-1,6578,776435697,0,1,0,1078.98,1,362835.9,24,6,18,8,True
6157132,816,0,20,9945,776435697,0,0,0,1079.1,3,361756.8,18,3,19,8,True
6389243,202,4,30,6578,776435697,0,0,0,1078.97,8,360677.83,9,2,12,9,True
6389870,1169,0,451,5786,776435697,0,0,0,1078.97,7,359598.86,24,2,21,9,True
6429527,726,0,10,6578,776435697,0,0,0,1079.07,6,360677.93,11,6,7,11,True
6585235,202,4,451,5754,776435697,0,0,0,1078.89,7,359599.04,9,1,19,11,True
6671249,739,1,10,4514,776435697,0,0,0,1078.97,6,360678.01,24,1,4,11,True
6998429,1169,0,25,3497,776435697,0,0,0,1079.14,8,359598.87,24,0,4,12,True
7444627,202,4,30,2675,776435697,0,0,0,1078.93,8,358519.94,9,3,23,1,True
7451377,44,4,451,6615,776435697,0,0,0,1078.88,7,357441.06,24,1,5,2,True
7496988,202,4,451,5786,776435697,0,0,0,1079.01,7,356362.05,9,6,0,2,True
7688355,846,3,-1,1047,776435697,0,1,0,1079.03,4,356362.05,5,5,6,2,True
7919499,1036,1,10,1790,776435697,0,0,0,1078.99,0,357441.04,11,0,1,2,True
8065896,448,0,20,6673,776435697,0,0,0,1078.93,5,356362.11,13,5,12,4,True
8419972,398,0,-1,5754,776435697,0,1,0,1079.09,1,356362.11,10,1,23,4,True
8619393,1459,1,10,4283,776435697,0,0,0,1078.92,6,357441.03,11,2,11,6,True
8716270,44,4,-1,3497,776435697,0,1,0,1078.95,4,357441.03,24,3,13,7,True
9038249,1169,0,25,7802,776435697,0,0,0,1079.14,8,356361.89,24,6,11,7,True
9170680,834,0,10,3949,776435697,0,0,0,1078.66,6,357440.55,5,1,2,8,True
9594423,1169,0,-1,2675,776435697,0,1,0,1078.61,1,357440.55,24,5,12,9,True
9596512,1169,0,451,1047,776435697,0,0,0,1078.75,7,356361.8,24,1,1,10,True
9795796,398,0,-1,9437,776435697,0,1,0,1079.26,4,356361.8,10,5,22,10,True
9910801,1134,1,10,4283,776435697,0,0,0,1078.92,6,357440.72,24,0,15,10,True
9946981,202,4,30,5754,776435697,0,0,0,1078.89,8,356361.83,9,2,21,11,True
1271428,1206,0,10,4491,161628126,1,0,0,767.7,6,754887.7,24,5,18,2,True
1354146,1321,0,10,9782,161628126,1,0,0,767.88,0,755655.58,18,5,21,3,True
1402854,689,0,20,2785,161628126,1,0,0,767.84,3,754887.74,24,0,19,5,True
1450401,887,2,20,1339,161628126,1,0,0,767.94,3,754119.8,27,2,12,6,True
1523086,1107,3,-1,4343,161628126,1,1,0,767.96,4,754119.8,0,6,4,7,True
1729268,1233,0,20,9782,161628126,1,0,0,768.02,5,753351.78,18,6,2,7,True
2377100,1107,3,451,8092,161628126,1,0,0,768.3,7,752583.48,0,0,18,8,True
2378513,195,1,10,3533,161628126,1,0,0,768.06,6,753351.54,18,1,8,8,True
2660526,1370,4,451,2140,161628126,1,0,0,768.15,7,752583.39,16,0,20,8,True
2700391,844,1,30,5841,161628126,1,0,0,768.0,8,751815.39,5,0,1,9,True
2831011,114,0,20,4343,161628126,1,0,0,767.88,5,751047.51,3,3,17,10,True
3182301,304,0,10,4962,161628126,1,0,0,767.94,0,751815.45,4,2,7,1,True
3327064,1039,1,10,4491,161628126,1,0,0,768.2,6,752583.65,11,3,4,1,True
3546334,260,0,20,1299,161628126,1,0,0,768.11,5,751815.54,6,1,21,1,True
3738180,844,1,451,4791,161628126,1,0,0,768.02,7,751047.52,5,1,15,3,True
3889418,1140,0,10,3636,161628126,1,0,0,767.99,6,751815.51,15,6,20,3,True
4080499,1107,3,-1,2140,161628126,1,1,0,767.99,4,751815.51,0,1,18,3,True
4086869,1107,3,30,5917,161628126,1,0,0,767.86,8,751047.65,0,4,18,4,True
4231385,650,3,-1,1335,161628126,1,1,0,768.2,4,751047.65,24,3,15,4,True
4280119,650,3,-1,2785,161628126,1,2,0,768.13,1,751047.65,24,2,21,6,True
4596588,100,4,451,2415,161628126,1,0,0,767.91,7,750279.74,3,4,19,6,True
4761063,100,4,-1,9803,161628126,1,1,0,768.34,4,750279.74,3,6,8,7,True
5098040,100,4,25,5622,161628126,1,0,0,767.85,8,749511.89,3,5,14,8,True
5316155,1069,1,10,1299,161628126,1,0,0,767.97,0,750279.86,18,2,18,8,True
5392561,100,4,25,6580,161628126,1,0,0,767.82,8,749512.04,3,1,2,9,True
5481732,816,0,20,2415,161628126,1,0,0,767.89,5,748744.15,18,1,14,9,True
5693381,650,3,451,6715,161628126,1,0,0,767.8,7,747976.35,24,5,1,9,True
5700880,100,4,30,4491,161628126,1,0,0,768.0,8,747208.35,3,5,2,9,True
6044096,650,3,-1,4491,161628126,1,1,0,768.04,4,747208.35,24,0,8,10,True
6080283,844,1,30,9803,161628126,1,0,0,768.13,8,746440.22,5,6,19,11,True
6151578,1250,1,10,8092,161628126,1,0,0,768.0,6,747208.22,23,0,5,12,True
6210523,98,0,10,1335,161628126,1,0,0,767.81,6,747976.03,3,3,23,1,True
6401797,844,1,30,5917,161628126,1,0,0,768.22,8,747207.81,5,0,10,3,True
6511404,1107,3,-1,4962,161628126,1,1,0,767.7,4,747207.81,0,1,21,3,True
6519006,694,2,20,5815,161628126,1,0,0,768.09,3,746439.72,24,1,2,4,True
6520653,650,3,25,9759,161628126,1,0,0,767.85,8,745671.87,24,1,8,4,True
6598005,100,4,451,9782,161628126,1,0,0,768.26,7,744903.61,3,5,14,5,True
6765015,1107,3,-1,1335,161628126,1,1,0,768.1,4,744903.61,0,2,7,5,True
6947248,1338,0,20,4791,161628126,1,0,0,768.18,3,744135.43,18,1,16,6,False
7169246,844,1,25,4381,161628126,1,0,0,768.13,8,743367.3,5,1,6,7,True
7359972,650,3,451,9759,161628126,1,0,0,768.06,7,742599.24,24,1,23,7,True
7522008,1370,4,451,1335,161628126,1,0,0,768.28,7,741830.96,16,2,11,7,True
7543019,844,1,25,6715,161628126,1,0,0,767.94,8,741063.02,5,6,8,8,True
7576998,1107,3,-1,7274,161628126,1,1,0,768.11,4,741063.02,0,4,13,10,True
7625112,1370,4,991,4381,161628126,1,1,1,767.73,2,741063.02,16,3,9,10,True
1373255,976,4,451,4849,193658755,0,0,0,356.87,7,894893.13,22,5,7,1,True
1393416,1044,0,10,3412,193658755,0,0,0,357.1,6,895250.23,11,1,19,1,True
1505524,634,1,-1,5998,193658755,0,1,0,357.14,1,895250.23,24,3,11,2,True
1518788,616,1,10,8498,193658755,0,0,0,357.01,0,895607.24,11,3,7,3,True
1614846,634,1,30,8524,193658755,0,0,0,357.2,8,895250.04,24,4,23,4,True
1703341,976,4,451,9720,193658755,0,0,0,357.02,7,894893.02,22,5,13,5,False
1732255,634,1,30,8524,193658755,0,0,0,356.82,8,894536.2,24,4,18,5,False
1892892,372,0,10,4849,193658755,0,0,0,357.23,6,894893.43,25,2,14,6,True
2077897,976,4,451,1104,193658755,0,0,0,357.09,7,894536.34,22,3,22,6,True
2242918,281,1,10,6148,193658755,0,0,0,357.07,6,894893.41,24,5,7,7,True
2373220,909,2,20,5089,193658755,0,0,0,357.0,5,894536.41,18,5,23,7,True
2414340,976,4,-1,4564,193658755,0,1,0,357.14,4,894536.41,22,6,1,8,True
2423492,464,1,-1,6148,193658755,0,2,0,356.93,4,894536.41,13,1,22,8,True
2485482,464,1,25,8257,193658755,0,0,0,357.01,8,894179.4,13,6,19,9,True
2494876,1483,0,20,2478,193658755,0,0,0,356.93,5,893822.47,24,2,1,9,True
2602123,464,1,451,4849,193658755,0,0,0,356.78,7,893465.69,13,6,7,9,True
3434463,1052,0,20,6304,193658755,0,0,0,357.1,5,893108.59,11,6,3,10,False
3510470,461,4,30,3845,193658755,0,0,0,357.0,8,892751.59,13,5,3,11,True
3540408,976,4,30,8498,193658755,0,0,0,357.24,8,892394.35,22,6,7,11,True
3718895,580,0,451,4761,193658755,0,0,0,357.14,7,892037.21,11,5,0,12,True
3764757,976,4,451,9720,193658755,0,0,0,357.05,7,891680.16,22,4,23,1,True
3864418,998,0,10,8524,193658755,0,0,0,356.95,0,892037.11,26,4,7,1,False
3872904,461,4,-1,9115,193658755,0,1,0,356.99,4,892037.11,13,3,15,1,True
4326994,634,1,-1,3412,193658755,0,2,0,356.88,1,892037.11,24,1,3,1,True
4327059,976,4,451,5568,193658755,0,0,0,357.06,7,891680.05,22,2,16,2,True
4414735,616,1,10,5568,193658755,0,0,0,356.92,6,892036.97,11,3,4,2,True
4431885,464,1,-1,6148,193658755,0,1,0,357.08,4,892036.97,13,0,10,5,True
4476361,634,1,30,4564,193658755,0,0,0,357.04,8,891679.93,24,0,12,5,False
4882365,634,1,30,2074,193658755,0,0,0,357.03,8,891322.9,24,4,2,6,True
4908303,497,0,20,2478,193658755,0,0,0,357.16,5,890965.74,12,6,23,7,True
5063778,580,0,451,8257,193658755,0,0,0,356.8,7,890608.94,11,5,6,8,True
5067763,976,4,451,4849,193658755,0,0,0,356.98,7,890251.96,22,4,10,10,True
5125606,580,0,-1,4761,193658755,0,1,0,356.93,4,890251.96,11,2,7,11,True
5150050,634,1,451,5568,193658755,0,0,0,357.12,7,889894.84,24,4,8,11,True
5334234,634,1,30,4761,193658755,0,0,0,357.21,8,889537.63,24,2,13,12,True
5358685,603,0,20,5998,193658755,0,0,0,357.15,5,889180.48,24,1,10,1,True
5541876,1037,0,20,2074,193658755,0,0,0,356.75,5,888823.73,11,2,6,1,True
5696372,577,0,10,8524,193658755,0,0,0,357.06,6,889180.79,11,5,14,1,True
6323575,1206,0,20,8257,193658755,0,0,0,356.8,3,888823.99,24,3,4,1,True
6329077,461,4,451,9720,193658755,0,0,0,357.07,7,888466.92,13,4,9,1,True
6833295,464,1,451,2478,193658755,0,0,0,357.22,7,888109.7,13,6,18,2,True
6973009,1166,2,20,5568,193658755,0,0,0,356.95,3,887752.75,24,3,19,2,True
7117022,464,1,30,3412,193658755,0,0,0,356.85,8,887395.9,13,5,16,2,True
7122482,461,4,451,2478,193658755,0,0,0,357.03,7,887038.87,13,6,12,3,True
7229404,580,0,451,8524,193658755,0,0,0,357.03,7,886681.84,11,5,10,3,True
7281687,461,4,451,4564,193658755,0,0,0,356.8,7,886325.04,13,0,1,6,True
7359062,976,4,25,6304,193658755,0,0,0,357.19,8,885967.85,22,1,22,6,True
7395852,464,1,-1,8468,193658755,0,1,0,357.02,4,885967.85,13,3,8,6,True
7589629,297,0,20,8498,193658755,0,0,0,357.12,5,885610.73,4,6,17,6,True
7831194,464,1,-1,4761,193658755,0,1,0,356.84,4,885610.73,13,1,13,7,True
8165444,342,0,20,1104,193658755,0,0,0,357.08,5,885253.65,24,2,19,8,True
8182268,580,0,30,2478,193658755,0,0,0,357.12,8,884896.53,11,5,11,8,True
8463598,461,4,25,8498,193658755,0,0,0,357.06,8,884539.47,13,6,8,9,True
8526348,1476,0,10,8468,193658755,0,0,0,356.97,0,884896.44,24,3,0,9,True
8593777,464,1,25,3845,193658755,0,0,0,357.1,8,884539.34,13,6,3,10,True
8702699,976,4,25,2074,193658755,0,0,0,356.89,8,884182.45,22,2,16,10,True
8711819,603,0,20,1061,193658755,0,0,0,356.98,3,883825.47,24,4,1,11,True
9427888,461,4,451,8257,193658755,0,0,0,357.02,7,883468.45,13,4,16,11,True
9941597,461,4,-1,8468,193658755,0,1,0,357.24,4,883468.45,13,1,8,11,True
1197494,626,2,20,4566,679234207,0,0,0,1157.05,3,67762.95,11,6,23,4,False
1324718,579,0,451,2524,679234207,0,0,0,1157.21,7,66605.74,11,4,11,4,True
1332829,579,0,-1,2524,679234207,0,1,0,1156.91,4,66605.74,11,4,13,7,True
1470282,276,0,-1,4566,679234207,0,2,0,1157.12,4,66605.74,24,6,0,7,True
1788314,234,0,20,4456,679234207,0,0,0,1157.1,3,65448.64,26,4,4,9,True
1816874,1383,4,30,4320,679234207,0,0,0,1156.74,8,64291.9,16,5,1,9,False
2041517,276,0,451,2908,679234207,0,0,0,1157.05,7,63134.85,24,5,13,9,True
2086853,678,4,451,4401,679234207,0,0,0,1157.02,7,61977.83,24,6,10,9,True
2103014,823,4,451,4401,679234207,0,0,0,1157.02,7,60820.81,18,2,4,9,True
2244070,823,4,30,5085,679234207,0,0,0,1156.97,8,59663.84,18,4,0,9,True
2274566,30,4,25,2968,679234207,0,0,0,1156.96,8,58506.88,11,6,9,10,True
2322347,234,0,10,4973,679234207,0,0,0,1156.97,6,59663.85,26,5,3,12,True
2333901,1195,1,30,3273,679234207,0,0,0,1157.07,8,58506.78,24,2,13,12,True
2459794,678,4,451,2376,679234207,0,0,0,1157.13,7,57349.65,24,3,1,1,True
2876527,678,4,451,4401,679234207,0,0,0,1157.08,7,56192.57,24,4,6,1,True
2893621,823,4,451,2968,679234207,0,0,0,1157.08,7,55035.49,18,5,17,1,True
2962225,30,4,451,2524,679234207,0,0,0,1157.03,7,53878.46,11,6,2,2,True
2974361,849,1,10,3273,679234207,0,0,0,1157.02,0,55035.48,5,0,21,3,True
2974856,1205,0,10,8282,679234207,0,0,0,1157.14,6,56192.62,24,4,10,3,True
3534305,76,0,10,2376,679234207,0,0,0,1157.14,0,57349.76,20,0,11,3,True
3877240,551,0,10,9008,679234207,0,0,0,1156.88,6,58506.64,17,2,1,4,True
4202223,917,0,10,2908,679234207,0,0,0,1157.01,6,59663.65,18,1,11,4,True
4441986,1383,4,-1,4566,679234207,0,1,0,1156.96,4,59663.65,16,5,1,4,True
4716476,276,0,451,4973,679234207,0,0,0,1157.11,7,58506.54,24,6,9,5,True
5209221,588,0,10,8582,679234207,0,0,0,1156.96,0,59663.5,24,0,22,5,True
5258022,783,0,10,4320,679234207,0,0,0,1156.88,0,60820.38,14,6,5,5,True
5559101,329,1,10,7643,679234207,0,0,0,1156.94,0,61977.32,11,1,16,6,True
5656771,30,4,451,4156,679234207,0,0,0,1156.92,7,60820.4,11,3,12,7,True
6078774,200,0,10,3273,679234207,0,0,0,1156.93,6,61977.33,9,2,6,7,True
6135000,262,2,20,4456,679234207,0,0,0,1157.1,3,60820.23,6,5,16,7,True
6338512,1485,0,10,2524,679234207,0,0,0,1156.99,0,61977.22,24,3,7,8,True
6471146,1325,0,10,4320,679234207,0,0,0,1156.8,6,63134.02,18,4,8,8,True
6520134,1383,4,451,2524,679234207,0,0,0,1156.87,7,61977.15,16,6,20,8,True
6604449,103,3,25,2968,679234207,0,0,0,1157.04,8,60820.11,3,5,9,12,True
6653320,319,0,20,4320,679234207,0,0,0,1156.81,5,59663.3,11,3,14,1,True
6755321,103,3,25,4456,679234207,0,0,0,1157.02,8,58506.28,3,0,21,1,True
6786939,823,4,451,9008,679234207,0,0,0,1157.17,7,57349.11,18,2,2,1,True
6826520,276,0,30,8282,679234207,0,0,0,1156.84,8,56192.27,24,2,15,1,True
7000917,1306,4,30,4156,679234207,0,0,0,1157.02,8,55035.25,5,4,15,2,True
7038853,823,4,-1,2968,679234207,0,1,0,1157.15,4,55035.25,18,6,12,2,True
7502869,877,2,20,3273,679234207,0,0,0,1156.8,5,53878.45,24,1,15,2,True
7571576,1195,1,-1,2908,679234207,0,1,0,1157.05,4,53878.45,24,3,17,3,True
8244119,823,4,25,2524,679234207,0,0,0,1156.76,8,52721.69,18,3,15,4,True
8436355,579,0,25,4973,679234207,0,0,0,1157.04,8,51564.65,11,0,6,4,True
8566113,584,0,10,2968,679234207,0,0,0,1156.94,0,52721.59,11,5,8,6,True
8570610,649,0,20,2968,679234207,0,0,0,1157.01,3,51564.58,24,4,3,6,True
8876723,1116,0,10,4566,679234207,0,0,0,1157.14,6,52721.72,24,1,16,6,True
8984992,276,0,30,9008,679234207,0,0,0,1156.83,8,51564.89,24,5,10,7,True
9143396,276,0,-1,4456,679234207,0,1,0,1157.06,4,51564.89,24,2,17,7,True
9413355,1306,4,30,2524,679234207,0,0,0,1157.02,8,50407.87,5,6,4,7,True
9665803,732,0,10,5085,679234207,0,0,0,1157.14,6,51565.01,11,2,21,7,True
9673473,678,4,30,5045,679234207,0,0,0,1157.0,8,50408.01,24,4,7,8,True
9918337,269,0,20,7643,679234207,0,0,0,1156.93,5,49251.08,24,4,21,9,True
1132955,862,4,-1,3163,626057645,0,1,0,1032.9,1,420886.0,24,4,12,1,True
1446779,963,4,25,9711,626057645,0,0,0,1032.84,8,419853.16,13,2,18,2,True
1505714,862,4,25,8157,626057645,0,0,0,1033.02,8,418820.14,24,3,2,3,True
1656826,645,0,10,3260,626057645,0,0,0,1033.08,6,419853.22,24,3,22,3,True
1949656,963,4,30,3260,626057645,0,0,0,1033.24,8,418819.98,13,0,6,3,True
1998102,689,0,10,3596,626057645,0,0,0,1032.89,6,419852.87,24,5,1,4,True
2203718,151,4,-1,8437,626057645,0,1,0,1032.96,1,419852.87,18,3,11,5,True
2456678,253,2,30,8437,626057645,0,0,0,1033.22,8,418819.65,6,6,14,5,True
2481509,730,4,-1,2302,626057645,0,1,0,1033.0,4,418819.65,11,3,15,6,True
2528242,538,0,10,9043,626057645,0,0,0,1032.94,6,419852.59,18,0,13,6,True
2533092,398,0,30,9446,626057645,0,0,0,1032.99,8,418819.6,10,3,19,8,True
2603842,963,4,451,9711,626057645,0,0,0,1033.31,7,417786.29,13,1,23,8,True
2891233,151,4,451,9711,626057645,0,0,0,1033.11,7,416753.18,18,5,11,8,True
2935414,239,1,10,2302,626057645,0,0,0,1033.19,6,417786.37,26,1,12,10,True
3084991,730,4,30,9711,626057645,0,0,0,1032.94,8,416753.43,11,5,14,10,True
3186047,402,3,-1,1750,626057645,0,1,0,1033.0,4,416753.43,10,5,21,11,False
3196165,730,4,-1,9446,626057645,0,2,0,1033.12,1,416753.43,11,6,3,12,True
3205336,402,3,30,6383,626057645,0,0,0,1033.13,8,415720.3,10,5,8,1,True
3467229,151,4,451,3163,626057645,0,0,0,1032.87,7,414687.43,18,2,10,1,True
3658688,362,0,20,1947,626057645,0,0,0,1032.89,5,413654.54,24,0,3,2,True
4064770,253,2,25,1750,626057645,0,0,0,1033.18,8,412621.36,6,4,0,2,True
4116734,509,0,20,3645,626057645,0,0,0,1033.08,5,411588.28,12,0,22,4,True
4210004,502,0,20,1750,626057645,0,0,0,1033.14,3,410555.14,12,0,19,4,True
4240328,730,4,451,1533,626057645,0,0,0,1032.86,7,409522.28,11,2,11,4,True
4357937,151,4,30,3163,626057645,0,0,0,1033.25,8,408489.03,18,6,15,7,True
4483039,402,3,30,8437,626057645,0,0,0,1032.74,8,407456.29,10,0,19,7,True
4655148,1390,0,10,1947,626057645,0,0,0,1033.14,0,408489.43,24,3,11,8,True
4901906,862,4,-1,8157,626057645,0,1,0,1032.71,4,408489.43,24,4,21,10,True
4974983,730,4,-1,3163,626057645,0,2,0,1033.19,4,408489.43,11,0,19,10,True
5333021,1421,0,20,9886,626057645,0,0,0,1033.16,5,407456.27,24,0,3,10,True
5337304,398,0,30,9446,626057645,0,0,0,1033.15,8,406423.12,10,4,22,10,True
5830199,963,4,451,1750,626057645,0,0,0,1033.29,7,405389.83,13,0,22,11,True
6195722,23,0,20,1947,626057645,0,0,0,1032.77,5,404357.06,11,3,14,11,True
6549988,151,4,30,8612,626057645,0,0,0,1032.99,8,403324.07,18,0,22,12,True
6551524,402,3,-1,9886,626057645,0,1,0,1032.9,4,403324.07,10,6,6,12,True
6608496,963,4,-1,3645,626057645,0,2,0,1032.83,4,403324.07,13,6,7,12,True
6917088,402,3,451,1750,626057645,0,0,0,1032.9,7,402291.17,10,5,15,1,True
7031468,862,4,25,6383,626057645,0,0,0,1033.09,8,401258.08,24,4,8,3,True
7056237,398,0,451,3260,626057645,0,0,0,1033.26,7,400224.82,10,3,5,4,True
7556919,484,0,20,8104,626057645,0,0,0,1033.0,5,399191.82,5,1,20,4,True
7611183,402,3,451,8157,626057645,0,0,0,1032.67,7,398159.15,10,4,16,5,True
7764918,253,2,25,3645,626057645,0,0,0,1032.86,8,397126.29,6,3,4,6,True
7946657,579,0,20,4184,626057645,0,0,0,1032.83,5,396093.46,11,3,5,6,True
8191584,1111,0,20,2302,626057645,0,0,0,1032.91,3,395060.55,0,4,11,6,True
8280569,402,3,-1,9711,626057645,0,1,0,1033.26,4,395060.55,10,5,15,7,True
8289826,402,3,451,4184,626057645,0,0,0,1033.06,7,394027.49,10,0,16,7,True
8420191,642,0,20,8157,626057645,0,0,0,1033.27,3,392994.22,24,6,12,7,True
8610410,1023,2,20,6383,626057645,0,0,0,1033.13,5,391961.09,11,0,9,8,True
8691578,1063,0,20,3260,626057645,0,0,0,1033.13,5,390927.96,11,2,19,8,True
8771192,497,0,10,1947,626057645,0,0,0,1033.0,6,391960.96,12,0,15,9,True
8928845,151,4,451,8612,626057645,0,0,0,1033.08,7,390927.88,18,4,6,9,True
9147915,1111,0,20,1533,626057645,0,0,0,1033.11,3,389894.77,0,0,6,9,True
9333777,398,0,-1,8104,626057645,0,1,0,1033.31,4,389894.77,10,6,9,10,True
9584393,192,2,20,1750,626057645,0,0,0,1032.91,5,388861.86,18,0,2,10,True
9793059,68,0,20,9477,626057645,0,0,0,1033.05,5,387828.81,20,2,21,10,True
1239132,643,4,-1,5356,870265001,1,1,0,478.9,1,654381.0,24,1,9,1,True
1263298,643,4,25,2449,870265001,1,0,0,478.91,8,653902.09,24,3,21,2,True
1376694,283,4,25,9247,870265001,1,0,0,479.01,8,653423.08,24,4,5,3,True
1601197,1100,4,30,1366,870265001,1,0,0,479.27,8,652943.81,0,6,7,1,True
1650817,378,0,10,8366,870265001,1,0,0,478.92,0,653422.73,25,5,15,2,True
1984787,723,1,30,2684,870265001,1,0,0,478.8,8,652943.93,11,3,14,2,False
2111153,894,3,25,9926,870265001,1,0,0,479.23,8,652464.7,24,4,10,5,True
2131856,643,4,30,6694,870265001,1,0,0,479.38,8,651985.32,24,0,3,5,True
2166177,1212,0,25,3254,870265001,1,0,0,478.87,8,651506.45,24,2,15,10,True
2354946,1100,4,30,9926,870265001,1,0,0,478.9,8,651027.55,0,5,2,10,True
2373605,643,4,25,5560,870265001,1,0,0,479.25,8,650548.3,24,4,6,10,True
2689269,643,4,-1,8200,870265001,1,1,0,479.01,1,650548.3,24,6,6,1,True
2818482,723,1,-1,8789,870265001,1,2,0,478.97,1,650548.3,11,2,9,1,True
2866880,894,3,-1,2910,870265001,1,3,1,479.2,4,650548.3,24,4,10,4,True
1425866,1179,0,30,1813,966746926,0,0,0,649.83,8,329145.17,24,6,0,1,True
1470720,144,1,10,3115,966746926,0,0,0,649.95,6,329795.12,18,2,23,3,True
1559722,1086,0,451,6127,966746926,0,0,0,649.96,7,329145.16,18,3,14,4,True
2037097,1086,0,451,6127,966746926,0,0,0,649.96,7,328495.2,18,1,9,4,True
2257561,1086,0,25,5092,966746926,0,0,0,650.11,8,327845.09,18,5,10,4,True
2615068,1179,0,30,1350,966746926,0,0,0,649.96,8,327195.13,24,6,2,5,True
2705302,72,4,30,4872,966746926,0,0,0,649.95,8,326545.18,20,4,0,6,True
2973621,372,0,20,2110,966746926,0,0,0,649.72,3,325895.46,25,2,23,6,True
3286955,1409,1,10,7588,966746926,0,0,0,649.85,6,326545.31,24,5,11,6,True
3363437,72,4,25,7402,966746926,0,0,0,650.17,8,325895.14,20,1,7,6,True
3423831,72,4,-1,4872,966746926,0,1,0,650.19,1,325895.14,20,6,4,7,True
3590367,159,2,451,6867,966746926,0,0,0,650.19,7,325244.95,24,1,9,8,True
3638171,1086,0,30,2923,966746926,0,0,0,649.96,8,324594.99,18,4,1,8,True
3887246,1086,0,-1,6867,966746926,0,1,0,649.83,1,324594.99,18,4,23,9,True
4264846,1086,0,30,9196,966746926,0,0,0,650.12,8,323944.87,18,5,14,9,True
4318992,72,4,-1,2923,966746926,0,1,0,650.19,1,323944.87,20,2,21,9,True
4368351,1388,1,10,1813,966746926,0,0,0,650.06,6,324594.93,24,2,7,9,True
4871010,560,2,25,2110,966746926,0,0,0,649.91,8,323945.02,17,3,2,10,True
5106691,532,4,30,2751,966746926,0,0,0,650.21,8,323294.81,18,2,20,11,True
5106999,532,4,451,8990,966746926,0,0,0,649.84,7,322644.97,18,4,2,12,True
5172392,854,0,10,2621,966746926,0,0,0,649.93,6,323294.9,24,1,9,12,True
5236878,551,0,20,4872,966746926,0,0,0,649.88,5,322645.02,17,0,1,1,True
5275980,727,0,20,2923,966746926,0,0,0,650.09,5,321994.93,11,2,5,2,True
5398704,72,4,-1,9196,966746926,0,1,0,649.95,4,321994.93,20,4,14,3,True
5468509,560,2,25,2163,966746926,0,0,0,649.79,8,321345.14,17,5,7,4,True
5615355,72,4,451,2110,966746926,0,0,0,650.11,7,320695.03,20,2,15,5,True
5738848,1086,0,30,6867,966746926,0,0,0,650.22,8,320044.81,18,5,9,6,True
5911389,159,2,25,2163,966746926,0,0,0,649.93,8,319394.88,24,6,21,6,True
6232345,378,0,20,4872,966746926,0,0,0,650.32,3,318744.56,25,4,19,7,True
6245627,560,2,-1,4872,966746926,0,1,0,649.86,4,318744.56,17,2,22,7,True
6438721,560,2,451,6867,966746926,0,0,0,650.11,7,318094.45,17,0,5,8,True
6980476,1086,0,-1,6451,966746926,0,1,0,649.91,1,318094.45,18,6,8,9,True
7010616,72,4,451,3115,966746926,0,0,0,649.76,7,317444.69,20,2,16,9,True
7017591,1179,0,-1,6451,966746926,0,1,0,649.8,1,317444.69,24,2,13,11,True
7099883,1179,0,30,4202,966746926,0,0,0,650.15,8,316794.54,24,3,15,11,True
7134063,72,4,451,7588,966746926,0,0,0,649.67,7,316144.87,20,3,7,11,True
7249328,560,2,25,7318,966746926,0,0,0,649.84,8,315495.03,17,3,14,12,True
7510955,159,2,451,2163,966746926,0,0,0,650.07,7,314844.96,24,1,23,12,True
7624772,72,4,451,5413,966746926,0,0,0,650.04,7,314194.92,20,2,20,1,True
7867979,532,4,451,2923,966746926,0,0,0,649.99,7,313544.93,18,1,8,1,True
7888666,1179,0,25,6127,966746926,0,0,0,650.07,8,312894.86,24,4,21,1,True
8038335,1271,0,10,1813,966746926,0,0,0,649.94,0,313544.8,23,1,19,2,True
8050958,560,2,25,2923,966746926,0,0,0,649.9,8,312894.9,17,6,12,3,True
8142040,297,0,20,7588,966746926,0,0,0,649.83,5,312245.07,4,3,8,5,True
8718951,1192,2,20,1813,966746926,0,0,0,649.96,3,311595.11,24,2,10,7,True
8810971,1270,1,10,2110,966746926,0,0,0,650.13,6,312245.24,23,3,21,8,True
8954446,1406,0,20,5413,966746926,0,0,0,650.18,5,311595.06,24,5,12,10,True
9096177,366,0,20,3115,966746926,0,0,0,650.33,5,310944.73,25,2,6,10,True
9121288,1179,0,-1,6451,966746926,0,1,0,649.69,4,310944.73,24,2,9,10,True
9195599,1312,0,10,2621,966746926,0,0,0,649.87,6,311594.6,5,1,17,10,True
9648957,1086,0,25,4202,966746926,0,0,0,649.98,8,310944.62,18,3,7,11,True
1039566,1352,1,10,8596,400484308,1,0,0,1116.22,0,738320.22,24,4,15,3,True
1109633,1140,0,-1,4000,400484308,1,1,0,1115.86,4,738320.22,15,4,13,3,True
1310337,747,1,451,4000,400484308,1,0,0,1115.91,7,737204.31,24,2,16,4,True
1601528,309,0,20,3674,400484308,1,0,0,1115.84,3,736088.47,4,2,4,5,True
1683861,880,1,10,8189,400484308,1,0,0,1115.97,6,737204.44,27,3,16,7,True
1738708,1495,3,451,8596,400484308,1,0,0,1115.98,7,736088.46,24,5,0,7,True
1866055,504,4,30,2050,400484308,1,0,0,1116.05,8,734972.41,12,4,8,8,True
1887163,125,4,25,5232,400484308,1,0,0,1116.1,8,733856.31,18,0,5,8,True
2398251,228,0,10,1780,400484308,1,0,0,1116.1,6,734972.41,26,2,9,9,True
2407620,605,0,10,2451,400484308,1,0,0,1115.98,6,736088.39,24,6,2,9,True
2418442,767,0,30,5072,400484308,1,0,0,1115.92,8,734972.47,14,1,22,9,True
2518717,303,0,20,4243,400484308,1,0,0,1116.07,3,733856.4,4,5,3,10,True
2944618,517,4,451,2050,400484308,1,0,0,1115.89,7,732740.51,12,0,3,10,True
2974707,1465,4,25,2741,400484308,1,0,0,1116.0,8,731624.51,11,4,4,11,True
3214313,517,4,451,9418,400484308,1,0,0,1115.98,7,730508.53,12,2,1,1,True
4230638,747,1,10,8890,400484308,1,0,0,1115.76,0,731624.29,24,4,2,2,True
4234015,831,1,10,1780,400484308,1,0,0,1115.83,0,732740.12,5,3,19,2,True
4404497,1465,4,451,4885,400484308,1,0,0,1115.88,7,731624.24,11,6,13,2,True
4505090,125,4,-1,8474,400484308,1,1,0,1116.01,1,731624.24,18,0,2,3,True
4662559,504,4,30,5232,400484308,1,0,0,1116.01,8,730508.23,12,4,3,3,True
4922489,1160,0,25,2741,400484308,1,0,0,1116.2,8,729392.03,15,1,0,4,True
5027330,747,1,30,6748,400484308,1,0,0,1116.11,8,728275.92,24,6,16,4,True
5031528,1465,4,25,8474,400484308,1,0,0,1116.02,8,727159.9,11,0,15,5,True
5133664,125,4,25,8596,400484308,1,0,0,1116.13,8,726043.77,18,6,20,5,True
5135343,747,1,451,7808,400484308,1,0,0,1116.4,7,724927.37,24,1,0,5,True
5215906,1495,3,25,4000,400484308,1,0,0,1116.04,8,723811.33,24,0,3,6,True
5265941,767,0,-1,2234,400484308,1,1,0,1115.89,1,723811.33,14,1,11,6,True
5446032,1140,0,451,7445,400484308,1,0,0,1116.19,7,722695.14,15,6,9,7,True
5588013,504,4,-1,8451,400484308,1,1,0,1115.93,4,722695.14,12,1,13,7,True
5769237,747,1,30,2451,400484308,1,0,0,1116.14,8,721579.0,24,4,3,9,True
5876159,1140,0,451,4000,400484308,1,0,0,1115.86,7,720463.14,15,2,22,9,True
6177795,630,0,20,1780,400484308,1,0,0,1116.1,5,719347.04,11,6,15,9,True
6640638,1303,0,20,1780,400484308,1,0,0,1116.08,3,718230.96,5,1,20,10,True
6923788,1459,1,10,3992,400484308,1,0,0,1116.03,0,719346.99,11,0,9,10,True
7012529,747,1,25,3210,400484308,1,0,0,1116.08,8,718230.91,24,0,10,10,True
7068569,1160,0,30,4243,400484308,1,0,0,1115.99,8,717114.92,15,4,8,10,True
7135332,1140,0,30,6748,400484308,1,0,0,1116.06,8,715998.86,15,0,2,11,True
7277024,1160,0,25,9418,400484308,1,0,0,1115.9,8,714882.96,15,5,2,12,True
7592505,644,0,20,3674,400484308,1,0,0,1116.19,5,713766.77,24,5,11,12,True
7592713,1465,4,25,9803,400484308,1,0,0,1115.93,8,712650.84,11,2,16,1,True
7616255,1465,4,30,2050,400484308,1,0,0,1115.89,8,711534.95,11,2,8,1,True
7675128,1140,0,25,7808,400484308,1,0,0,1116.08,8,710418.87,15,4,15,1,True
7682942,53,0,20,3674,400484308,1,0,0,1115.81,5,709303.06,20,6,18,2,True
7905804,517,4,30,8451,400484308,1,0,0,1115.9,8,708187.16,12,6,5,3,False
7956684,504,4,451,7445,400484308,1,0,0,1116.22,7,707070.94,12,6,1,5,True
8014952,517,4,25,7808,400484308,1,0,0,1116.08,8,705954.86,12,3,22,5,True
8058705,125,4,25,7564,400484308,1,0,0,1115.96,8,704838.9,18,1,22,6,True
8181826,605,0,20,7564,400484308,1,0,0,1116.02,5,703722.88,24,4,2,7,True
8458831,1465,4,451,7952,400484308,1,0,0,1115.95,7,702606.93,11,6,21,7,True
8509307,996,0,10,7952,400484308,1,0,0,1116.24,6,703723.17,26,6,18,7,True
8602570,1465,4,451,6748,400484308,1,0,0,1116.03,7,702607.14,11,3,12,8,True
8720859,767,0,30,4000,400484308,1,0,0,1115.76,8,701491.38,14,5,7,8,True
8844961,1495,3,30,2234,400484308,1,0,0,1115.99,8,700375.39,24,4,6,8,True
8897801,1140,0,451,8474,400484308,1,0,0,1116.01,7,699259.38,15,2,18,9,True
8994980,767,0,-1,2234,400484308,1,1,0,1116.07,4,699259.38,14,4,7,9,True
9071815,1273,0,10,2234,400484308,1,0,0,1116.12,0,700375.5,24,2,14,10,True
9354643,621,2,20,9418,400484308,1,0,0,1116.05,3,699259.45,11,4,23,11,True
9465743,1160,0,-1,9803,400484308,1,1,0,1115.84,4,699259.45,15,1,11,11,True
9690069,125,4,-1,8474,400484308,1,2,0,1116.06,1,699259.45,18,1,1,11,True
1124161,814,4,30,8603,748587402,1,0,0,268.87,8,336238.13,18,2,14,1,True
1361822,223,2,451,9995,748587402,1,0,0,269.17,7,335968.96,26,0,5,1,True
1437556,276,0,30,9995,748587402,1,0,0,269.34,8,335699.62,24,0,5,1,True
1493370,670,0,20,9066,748587402,1,0,0,268.95,3,335430.67,18,0,11,1,True
1565492,1379,3,451,7013,748587402,1,0,0,269.06,7,335161.61,16,2,16,2,True
1608224,484,0,30,9995,748587402,1,0,0,269.09,8,334892.52,5,5,4,2,True
1929639,1379,3,-1,2025,748587402,1,1,0,269.1,1,334892.52,16,3,3,3,True
2313410,276,0,25,4185,748587402,1,0,0,268.75,8,334623.77,24,4,8,4,True
2759448,1379,3,30,9995,748587402,1,0,0,268.81,8,334354.96,16,0,11,4,True
2838586,276,0,25,7013,748587402,1,0,0,269.14,8,334085.82,24,6,0,4,True
2923519,276,0,-1,2766,748587402,1,1,0,269.18,4,334085.82,24,1,2,5,True
2945282,1379,3,451,2992,748587402,1,0,0,269.14,7,333816.68,16,5,2,6,True
2987532,276,0,-1,4597,748587402,1,1,0,268.87,1,333816.68,24,3,22,7,True
3168244,484,0,451,3030,748587402,1,0,0,269.13,7,333547.55,5,1,7,7,True
3404280,814,4,-1,4185,748587402,1,1,0,269.26,4,333547.55,18,4,1,8,True
3727936,193,1,25,4597,748587402,1,0,0,269.08,8,333278.47,18,1,9,8,True
4114618,276,0,-1,4185,748587402,1,1,0,268.77,4,333278.47,24,0,13,8,True
4163979,193,1,25,4597,748587402,1,0,0,268.92,8,333009.55,18,3,0,8,True
4227678,193,1,30,2025,748587402,1,0,0,268.81,8,332740.74,18,6,13,8,True
4453277,223,2,451,8603,748587402,1,0,0,269.05,7,332471.69,26,6,17,8,True
4494848,193,1,451,9995,748587402,1,0,0,268.75,7,332202.94,18,4,10,9,True
4496698,193,1,25,4185,748587402,1,0,0,269.14,8,331933.8,18,6,21,11,True
4585876,1277,2,30,8603,748587402,1,0,0,269.05,8,331664.75,24,2,14,11,False
5088775,962,0,10,9995,748587402,1,0,0,268.9,6,331933.65,13,2,4,12,True
5142279,1379,3,451,2025,748587402,1,0,0,269.15,7,331664.5,16,3,13,12,True
5193972,814,4,451,2992,748587402,1,0,0,268.92,7,331395.58,18,3,10,1,True
5301091,394,0,10,9995,748587402,1,0,0,268.9,6,331664.48,10,4,9,1,True
5475307,276,0,30,2992,748587402,1,0,0,268.93,8,331395.55,24,5,5,4,True
5550551,1277,2,25,2025,748587402,1,0,0,268.95,8,331126.6,24,3,0,4,True
5586758,193,1,451,4185,748587402,1,0,0,268.97,7,330857.63,18,0,23,5,True
5857527,223,2,25,2992,748587402,1,0,0,269.08,8,330588.55,26,2,14,6,True
5989103,857,1,10,2025,748587402,1,0,0,269.19,0,330857.74,24,5,8,7,True
6058680,193,1,25,7013,748587402,1,0,0,268.87,8,330588.87,18,6,4,7,True
6102889,484,0,10,8280,748587402,1,0,0,268.76,6,330857.63,5,3,0,8,True
6249413,1379,3,30,8603,748587402,1,0,0,268.86,8,330588.77,16,0,18,8,True
6294771,937,0,20,4273,748587402,1,0,0,269.0,3,330319.77,24,1,9,8,True
6317605,1277,2,25,7013,748587402,1,0,0,269.02,8,330050.75,24,3,19,8,True
6419008,1272,0,20,8073,748587402,1,0,0,269.12,3,329781.63,24,2,8,9,True
6438709,223,2,25,9066,748587402,1,0,0,268.87,8,329512.76,26,6,0,9,False
6756773,1435,2,20,4185,748587402,1,0,0,268.73,3,329244.03,24,0,1,9,True
7379781,193,1,-1,7013,748587402,1,1,0,268.63,4,329244.03,18,0,18,10,True
7423988,1023,2,20,8073,748587402,1,0,0,269.02,3,328975.01,11,5,22,11,True
7560025,223,2,451,2025,748587402,1,0,0,268.77,7,328706.24,26,5,4,12,True
7688067,814,4,25,4597,748587402,1,0,0,269.11,8,328437.13,18,0,2,12,True
7931636,193,1,30,8073,748587402,1,0,0,269.09,8,328168.04,18,5,12,1,True
7980300,1243,2,20,8280,748587402,1,0,0,268.94,5,327899.1,18,1,8,1,True
8138909,276,0,25,3030,748587402,1,0,0,268.8,8,327630.3,24,1,19,2,True
8234352,1379,3,451,4273,748587402,1,0,0,269.12,7,327361.18,16,5,23,4,True
8394521,193,1,25,8280,748587402,1,0,0,268.98,8,327092.2,18,4,17,7,True
8514159,484,0,30,4185,748587402,1,0,0,269.1,8,326823.1,5,1,16,7,True
8711480,814,4,-1,2025,748587402,1,1,0,269.01,4,326823.1,18,2,15,9,True
9046577,193,1,25,2025,748587402,1,0,0,269.1,8,326554.0,18,4,10,9,True
9098709,1277,2,30,4597,748587402,1,0,0,269.02,8,326284.98,24,2,0,10,True
9519773,193,1,25,9066,748587402,1,0,0,269.08,8,326015.9,18,3,20,10,True
9531674,814,4,30,8280,748587402,1,0,0,269.06,8,325746.84,18,3,5,10,True
9970484,1213,2,20,8280,748587402,1,0,0,268.87,5,325477.97,24,6,15,11,True
1157429,329,1,451,1364,173275626,0,0,0,211.88,7,752871.12,11,3,1,2,True
1212892,1212,0,451,1703,173275626,0,0,0,212.01,7,752659.11,24,4,1,2,True
1455432,227,4,30,8014,173275626,0,0,0,212.04,8,752447.07,26,6,6,2,True
1768983,1141,4,30,1364,173275626,0,0,0,211.77,8,752235.3,15,2,3,3,True
1911217,280,4,30,1703,173275626,0,0,0,212.08,8,752023.22,24,1,5,4,True
1914593,123,0,20,1337,173275626,0,0,0,211.74,3,751811.48,18,5,14,5,True
2206482,250,4,451,9851,173275626,0,0,0,211.89,7,751599.59,6,0,20,8,True
2305765,1234,3,-1,5366,173275626,0,1,0,212.31,4,751599.59,18,1,4,8,True
2421306,353,1,451,7965,173275626,0,0,0,212.28,7,751387.31,24,6,18,8,True
3754470,673,0,451,3844,173275626,0,0,0,211.9,7,751175.41,18,1,14,8,True
3933171,280,4,-1,1337,173275626,0,1,0,212.03,1,751175.41,24,2,17,8,True
4105810,250,4,30,9173,173275626,0,0,0,211.96,8,750963.45,6,1,18,10,True
4212318,424,1,10,1703,173275626,0,0,0,211.93,0,751175.38,18,2,12,10,True
4292816,1212,0,451,9173,173275626,0,0,0,212.21,7,750963.17,24,6,3,11,True
4407028,250,4,451,8121,173275626,0,0,0,211.88,7,750751.29,6,2,17,11,True
4473043,1141,4,30,5366,173275626,0,0,0,212.21,8,750539.08,15,0,0,1,True
4577891,280,4,25,8121,173275626,0,0,0,211.95,8,750327.13,24,2,21,1,True
4675436,353,1,25,1337,173275626,0,0,0,212.06,8,750115.07,24,4,9,2,True
4749833,227,4,-1,7736,173275626,0,1,0,212.0,1,750115.07,26,2,14,3,True
4813110,1234,3,451,2005,173275626,0,0,0,211.87,7,749903.2,18,3,22,3,True
4949285,249,0,20,7965,173275626,0,0,0,212.39,5,749690.81,6,5,12,3,True
5078048,1141,4,-1,7775,173275626,0,1,0,211.98,4,749690.81,15,5,20,3,True
5482991,1234,3,30,2530,173275626,0,0,0,212.23,8,749478.58,18,6,8,3,True
5573648,250,4,25,9399,173275626,0,0,0,211.89,8,749266.69,6,1,14,3,True
5587070,227,4,451,7775,173275626,0,0,0,212.15,7,749054.54,26,6,15,4,True
5744358,694,2,20,1364,173275626,0,0,0,211.92,5,748842.62,24,2,16,5,True
5867016,280,4,451,2005,173275626,0,0,0,211.96,7,748630.66,24,4,15,7,True
6006725,774,2,20,2440,173275626,0,0,0,211.76,5,748418.9,14,4,19,7,True
6150273,673,0,25,7736,173275626,0,0,0,211.99,8,748206.91,18,4,3,9,True
6309430,993,0,20,1020,173275626,0,0,0,212.08,5,747994.83,22,6,4,9,True
6704685,1164,0,10,9173,173275626,0,0,0,211.89,0,748206.72,24,4,20,9,True
6955156,108,2,20,1364,173275626,0,0,0,212.02,3,747994.7,3,4,23,9,True
7078954,227,4,25,1795,173275626,0,0,0,211.99,8,747782.71,26,4,10,10,True
7090108,1234,3,451,9173,173275626,0,0,0,212.03,7,747570.68,18,0,4,10,True
7117262,227,4,25,4343,173275626,0,0,0,211.86,8,747358.82,26,0,13,11,True
7139968,319,0,20,9851,173275626,0,0,0,211.84,5,747146.98,11,0,5,12,True
7241512,1219,1,10,9173,173275626,0,0,0,211.92,6,747358.9,24,0,14,1,True
7355020,280,4,30,1364,173275626,0,0,0,211.94,8,747146.96,24,3,16,2,True
7438932,353,1,451,2005,173275626,0,0,0,211.85,7,746935.11,24,2,4,2,True
7505004,1234,3,-1,1364,173275626,0,1,0,211.91,1,746935.11,18,2,4,3,True
7616661,1234,3,-1,3432,173275626,0,2,0,212.13,4,746935.11,18,6,16,3,True
7733861,1283,2,20,2440,173275626,0,0,0,212.19,5,746722.92,24,3,7,4,True
8073484,366,0,20,9173,173275626,0,0,0,212.08,3,746510.84,25,1,17,4,True
8302763,1212,0,-1,1795,173275626,0,1,0,211.88,1,746510.84,24,3,22,7,True
8377726,192,2,20,7775,173275626,0,0,0,212.02,5,746298.82,18,6,7,8,True
8425985,673,0,451,1020,173275626,0,0,0,211.79,7,746087.03,18,2,16,9,True
8572075,280,4,30,1795,173275626,0,0,0,212.17,8,745874.86,24,3,9,9,True
8619998,329,1,25,7775,173275626,0,0,0,212.23,8,745662.63,11,4,20,9,True
8675826,1037,0,20,9851,173275626,0,0,0,212.07,3,745450.56,11,5,3,9,True
8722889,1212,0,25,2440,173275626,0,0,0,212.31,8,745238.25,24,3,6,10,True
9059842,227,4,-1,9173,173275626,0,1,0,211.96,4,745238.25,26,0,7,10,True
9067873,787,0,10,1295,173275626,0,0,0,212.13,0,745450.38,14,5,20,11,True
9260116,1399,0,10,2530,173275626,0,0,0,211.96,6,745662.34,24,6,18,11,True
1899386,1459,1,30,9504,365145700,1,0,0,413.11,8,113235.89,11,0,13,1,True
2018711,621,2,30,2132,365145700,1,0,0,413.1,8,112822.79,11,6,19,1,True
2343674,1459,1,30,1233,365145700,1,0,0,413.08,8,112409.71,11,0,22,1,True
2656467,734,0,10,3129,365145700,1,0,0,413.09,6,112822.8,11,0,5,2,True
2813050,1210,0,10,4873,365145700,1,0,0,413.17,6,113235.97,24,5,10,3,True
2940403,621,2,-1,5715,365145700,1,1,0,412.98,4,113235.97,11,3,14,4,True
3056730,1007,2,-1,3475,365145700,1,2,0,413.13,4,113235.97,26,6,7,4,True
3244771,1485,0,20,7561,365145700,1,0,0,412.89,5,112823.08,24,0,16,4,True
3268194,1356,2,30,3939,365145700,1,0,0,413.07,8,112410.01,24,5,8,4,True
3426175,848,2,451,1482,365145700,1,0,0,412.92,7,111997.09,5,3,3,4,True
3428302,1266,4,451,2996,365145700,1,0,0,412.85,7,111584.24,23,4,15,5,True
3689269,342,0,10,3332,365145700,1,0,0,412.88,6,111997.12,24,6,19,5,True
3947281,255,2,-1,3274,365145700,1,1,0,413.03,1,111997.12,6,6,21,6,True
4226874,1007,2,451,3129,365145700,1,0,0,412.85,7,111584.27,26,2,11,6,True
4341635,255,2,25,9504,365145700,1,0,0,412.75,8,111171.52,6,6,13,7,True
4349313,848,2,-1,4873,365145700,1,1,0,412.76,4,111171.52,5,5,4,8,True
4423284,255,2,-1,4522,365145700,1,2,0,413.0,1,111171.52,6,6,22,8,True
4480976,1356,2,451,4711,365145700,1,0,0,413.14,7,110758.38,24,5,20,9,True
4484003,621,2,30,4323,365145700,1,0,0,413.15,8,110345.23,11,4,16,10,True
4730448,1007,2,-1,1466,365145700,1,1,0,413.01,4,110345.23,26,6,2,11,True
4785243,1459,1,-1,9504,365145700,1,2,0,412.93,1,110345.23,11,1,0,11,True
4826522,1266,4,451,2175,365145700,1,0,0,412.98,7,109932.25,23,4,21,11,True
5045933,255,2,30,5606,365145700,1,0,0,413.03,8,109519.22,6,6,2,12,True
5341415,319,0,10,4711,365145700,1,0,0,413.19,6,109932.41,11,1,0,1,True
5437445,1266,4,-1,8592,365145700,1,1,0,413.04,4,109932.41,23,4,7,1,True
5682038,621,2,451,7561,365145700,1,0,0,412.94,7,109519.47,11,4,1,2,True
5697499,1459,1,30,4522,365145700,1,0,0,413.3,8,109106.17,11,1,23,2,True
5706740,255,2,30,2996,365145700,1,0,0,412.95,8,108693.22,6,4,22,4,True
5709881,1436,0,20,5594,365145700,1,0,0,412.78,5,108280.44,24,3,3,6,True
5958634,411,2,20,3885,365145700,1,0,0,413.07,3,107867.37,18,4,1,6,True
6084164,53,0,20,2132,365145700,1,0,0,413.24,5,107454.13,20,6,4,7,True
6107204,1266,4,451,2132,365145700,1,0,0,413.0,7,107041.13,23,4,2,7,True
6252858,621,2,25,9504,365145700,1,0,0,413.04,8,106628.09,11,6,2,7,True
6428480,1035,0,10,3475,365145700,1,0,0,413.15,6,107041.24,11,4,4,7,True
6705032,1266,4,-1,1466,365145700,1,1,0,412.69,1,107041.24,23,5,2,7,True
6826037,1007,2,451,1461,365145700,1,0,0,413.02,7,106628.22,26,4,7,8,True
7147293,621,2,-1,2996,365145700,1,1,0,412.85,4,106628.22,11,5,12,9,True
7311392,255,2,451,2175,365145700,1,0,0,413.03,7,106215.19,6,6,10,9,True
7344490,1255,0,20,3129,365145700,1,0,0,412.65,5,105802.54,23,0,18,9,True
7417852,1356,2,451,3332,365145700,1,0,0,413.16,7,105389.38,24,1,12,9,True
7437690,1266,4,-1,4323,365145700,1,1,0,412.95,1,105389.38,23,3,21,11,True
7707619,621,2,25,9055,365145700,1,0,0,413.02,8,104976.36,11,0,9,1,True
7754957,942,0,20,3885,365145700,1,0,0,412.98,3,104563.38,24,4,12,1,True
8173853,1262,0,20,5606,365145700,1,0,0,412.89,5,104150.49,23,2,11,2,True
8352677,580,0,20,9055,365145700,1,0,0,413.33,5,103737.16,11,0,21,3,True
8567386,1429,0,10,1482,365145700,1,0,0,412.84,6,104150.0,24,4,4,5,True
8942769,812,0,10,5606,365145700,1,0,0,412.93,0,104562.93,18,4,7,6,True
9273686,1201,0,10,3129,365145700,1,0,0,412.93,6,104975.86,24,1,23,6,True
9521847,1459,1,451,8592,365145700,1,0,0,412.97,7,104562.89,11,5,15,7,True
9533940,848,2,451,3475,365145700,1,0,0,412.98,7,104149.91,5,2,4,8,True
9752166,1356,2,25,9504,365145700,1,0,0,413.12,8,103736.79,24,3,16,9,True
9756494,1007,2,25,2996,365145700,1,0,0,413.2,8,103323.59,26,5,5,9,True
9759471,1459,1,451,3939,365145700,1,0,0,413.06,7,102910.53,11,2,23,9,True
9829007,1266,4,-1,3129,365145700,1,1,0,413.28,4,102910.53,23,2,5,11,True
1072847,1310,4,25,8178,159878092,0,0,0,1163.17,8,550066.83,5,0,18,1,True
1101198,1404,2,30,6934,159878092,0,0,0,1163.14,8,548903.69,24,2,7,1,True
1256593,542,0,10,8178,159878092,0,0,0,1163.09,0,550066.78,17,6,2,1,True
1281717,1103,4,451,5300,159878092,0,0,0,1163.03,7,548903.75,0,5,12,1,True
1290912,1404,2,451,8178,159878092,0,0,0,1162.78,7,547740.97,24,4,14,1,True
1768564,156,4,25,8178,159878092,0,0,0,1163.06,8,546577.91,18,2,23,2,True
1768627,1404,2,30,9000,159878092,0,0,0,1162.73,8,545415.18,24,6,18,3,True
1804815,549,1,30,2609,159878092,0,0,0,1162.98,8,544252.2,17,6,21,3,True
1822368,518,2,20,2013,159878092,0,0,0,1163.03,5,543089.17,18,2,9,4,True
2161431,605,0,20,6799,159878092,0,0,0,1162.99,5,541926.18,24,4,9,5,True
2240294,994,4,451,8071,159878092,0,0,0,1163.05,7,540763.13,22,1,0,6,True
2334291,1063,0,20,2609,159878092,0,0,0,1162.98,5,539600.15,11,3,14,6,True
2370418,1310,4,451,2611,159878092,0,0,0,1163.12,7,538437.03,5,1,18,7,True
2479003,454,1,25,6934,159878092,0,0,0,1163.19,8,537273.84,13,2,11,7,True
2574204,1310,4,25,9000,159878092,0,0,0,1163.17,8,536110.67,5,5,9,7,True
2890212,549,1,30,7583,159878092,0,0,0,1162.94,8,534947.73,17,5,1,10,True
2908623,994,4,30,8071,159878092,0,0,0,1163.08,8,533784.65,22,4,13,11,True
3045646,496,1,10,6739,159878092,0,0,0,1162.84,6,534947.49,12,0,12,11,True
3573926,156,4,-1,9789,159878092,0,1,0,1162.93,1,534947.49,18,0,11,12,True
3769169,156,4,30,8071,159878092,0,0,0,1162.97,8,533784.52,18,0,7,12,True
3783655,1310,4,-1,5300,159878092,0,1,0,1162.78,1,533784.52,5,6,17,1,False
4014909,1404,2,25,6799,159878092,0,0,0,1163.11,8,532621.41,24,5,9,2,True
4489105,1310,4,451,5300,159878092,0,0,0,1162.98,7,531458.43,5,2,17,3,True
4774498,1404,2,30,8071,159878092,0,0,0,1163.04,8,530295.39,24,3,10,3,True
5617215,1103,4,-1,8071,159878092,0,1,0,1162.9,4,530295.39,0,5,6,3,True
5906136,1404,2,25,6739,159878092,0,0,0,1162.97,8,529132.42,24,5,11,3,True
6129248,675,2,20,2609,159878092,0,0,0,1163.02,3,527969.4,24,4,7,4,True
6230543,182,1,10,6596,159878092,0,0,0,1163.19,6,529132.59,18,2,17,4,True
6579454,611,0,10,9453,159878092,0,0,0,1163.16,6,530295.75,11,5,16,8,True
6679217,591,0,10,9623,159878092,0,0,0,1162.99,6,531458.74,24,3,7,8,True
6705684,1232,1,10,6596,159878092,0,0,0,1163.09,0,532621.83,18,3,11,8,True
6782090,156,4,-1,8071,159878092,0,1,0,1163.31,4,532621.83,18,4,12,8,True
6782119,652,0,20,2013,159878092,0,0,0,1162.97,5,531458.86,24,6,10,9,True
6989170,994,4,25,9623,159878092,0,0,0,1162.99,8,530295.87,22,4,12,9,True
7129557,220,0,10,2013,159878092,0,0,0,1163.01,0,531458.88,26,4,22,9,True
7190150,1103,4,-1,8178,159878092,0,1,0,1162.95,1,531458.88,0,0,22,9,True
7228230,1103,4,30,9623,159878092,0,0,0,1162.75,8,530296.13,0,5,1,9,True
7838433,1404,2,25,6596,159878092,0,0,0,1162.71,8,529133.42,24,1,9,10,True
8025368,677,0,20,9789,159878092,0,0,0,1163.12,3,527970.3,24,2,10,11,True
8113937,156,4,451,9623,159878092,0,0,0,1162.94,7,526807.36,18,2,17,12,True
8154425,1404,2,451,6799,159878092,0,0,0,1163.07,7,525644.29,24,6,18,12,True
8213952,156,4,30,6596,159878092,0,0,0,1162.79,8,524481.5,18,6,14,1,True
8513454,549,1,25,9789,159878092,0,0,0,1163.19,8,523318.31,17,5,3,1,True
8611540,156,4,451,6739,159878092,0,0,0,1162.99,7,522155.32,18,1,18,1,True
8685646,1103,4,30,2611,159878092,0,0,0,1163.17,8,520992.15,0,4,8,2,True
9014001,790,0,20,9453,159878092,0,0,0,1162.91,5,519829.24,11,1,3,2,True
9090385,916,0,10,8071,159878092,0,0,0,1163.12,6,520992.36,18,2,15,6,True
9115488,549,1,30,2609,159878092,0,0,0,1163.23,8,519829.13,17,2,0,7,True
9302634,1064,0,10,7583,159878092,0,0,0,1163.12,6,520992.25,11,1,11,8,True
9486754,1404,2,451,2609,159878092,0,0,0,1162.96,7,519829.29,24,4,23,8,True
9585819,156,4,451,9000,159878092,0,0,0,1163.22,7,518666.07,18,0,16,9,True
9616364,1093,0,20,6739,159878092,0,0,0,1162.6,3,517503.47,18,6,18,9,True
9804512,454,1,25,6596,159878092,0,0,0,1163.03,8,516340.44,13,0,3,10,True
9897459,677,0,10,6596,159878092,0,0,0,1163.33,6,517503.77,24,5,12,10,True
9957396,669,2,20,5481,159878092,0,0,0,1163.13,5,516340.64,18,4,15,10,True
1209784,1349,3,-1,6952,506341585,0,1,0,300.97,1,331645.0,24,4,23,3,True
1419787,284,3,451,5015,506341585,0,0,0,301.25,7,331343.75,24,3,7,3,True
1539128,883,0,451,3630,506341585,0,0,0,301.17,7,331042.58,24,1,2,4,True
1839671,428,0,30,6431,506341585,0,0,0,300.86,8,330741.72,18,3,11,4,True
1890210,284,3,30,1352,506341585,0,0,0,300.96,8,330440.76,24,5,23,5,True
2257955,734,0,20,5740,506341585,0,0,0,301.0,3,330139.76,11,6,16,5,True
2305134,284,3,30,6431,506341585,0,0,0,300.91,8,329838.85,24,5,8,5,True
2364499,956,1,451,9429,506341585,0,0,0,300.96,7,329537.89,13,3,3,6,True
2668968,284,3,25,8058,506341585,0,0,0,300.73,8,329237.16,24,2,16,6,True
2869429,956,1,451,9196,506341585,0,0,0,300.99,7,328936.17,13,6,9,6,False
3069834,889,0,10,1045,506341585,0,0,0,300.86,6,329237.03,27,2,22,7,True
3256235,956,1,25,1259,506341585,0,0,0,301.02,8,328936.01,13,2,14,8,True
3373168,428,0,451,4500,506341585,0,0,0,301.11,7,328634.9,18,2,8,10,True
3601067,205,0,20,6939,506341585,0,0,0,300.95,5,328333.95,9,6,1,10,True
3769902,1349,3,-1,3210,506341585,0,1,0,300.91,1,328333.95,24,2,18,11,True
3967755,284,3,451,1205,506341585,0,0,0,301.18,7,328032.77,24,2,22,11,True
4034002,428,0,30,2429,506341585,0,0,0,301.14,8,327731.63,18,4,19,12,True
4046332,883,0,30,5740,506341585,0,0,0,301.24,8,327430.39,24,1,6,12,True
4239228,883,0,30,4084,506341585,0,0,0,300.91,8,327129.48,24,4,12,12,True
4239487,883,0,-1,6200,506341585,0,1,0,300.83,4,327129.48,24,0,11,1,True
4401893,956,1,-1,6939,506341585,0,2,0,301.06,4,327129.48,13,6,9,3,True
4882163,585,2,20,4500,506341585,0,0,0,301.09,5,326828.39,11,0,4,3,True
5065194,428,0,451,1205,506341585,0,0,0,300.93,7,326527.46,18,3,10,3,True
5331132,883,0,451,5740,506341585,0,0,0,300.98,7,326226.48,24,3,13,4,True
5350208,883,0,451,3043,506341585,0,0,0,301.06,7,325925.42,24,2,17,4,True
5403435,284,3,451,9196,506341585,0,0,0,301.09,7,325624.33,24,5,19,5,True
5981715,428,0,25,5740,506341585,0,0,0,301.03,8,325323.3,18,4,6,6,True
6085335,956,1,30,1352,506341585,0,0,0,301.01,8,325022.29,13,5,18,7,True
6261657,865,0,20,2429,506341585,0,0,0,301.15,5,324721.14,24,1,19,7,True
6308514,883,0,-1,2429,506341585,0,1,0,300.95,1,324721.14,24,3,12,7,True
6425245,824,2,20,6200,506341585,0,0,0,301.04,5,324420.1,18,5,6,7,True
6874807,675,2,20,3630,506341585,0,0,0,301.19,3,324118.91,24,0,0,7,True
6982342,1264,0,10,5015,506341585,0,0,0,300.82,0,324419.73,23,3,0,8,True
7013511,428,0,25,2429,506341585,0,0,0,300.82,8,324118.91,18,4,6,8,True
7171315,956,1,451,5807,506341585,0,0,0,301.37,7,323817.54,13,6,21,8,True
7331194,1349,3,25,3630,506341585,0,0,0,301.17,8,323516.37,24,5,8,9,True
7551470,428,0,451,6952,506341585,0,0,0,301.06,7,323215.31,18,4,18,9,True
7997153,428,0,25,9429,506341585,0,0,0,301.2,8,322914.11,18,4,16,10,True
8254427,1349,3,451,1352,506341585,0,0,0,300.88,7,322613.23,24,2,23,11,True
8356288,428,0,30,4084,506341585,0,0,0,301.14,8,322312.09,18,2,5,12,True
8452115,284,3,451,5015,506341585,0,0,0,300.76,7,322011.33,24,6,13,12,True
8476536,284,3,451,9379,506341585,0,0,0,300.96,7,321710.37,24,6,2,1,True
8755726,1064,0,10,4500,506341585,0,0,0,301.02,6,322011.39,11,6,21,1,True
8819539,428,0,30,9196,506341585,0,0,0,301.01,8,321710.38,18,0,14,2,True
8824899,1086,0,20,2429,506341585,0,0,0,300.96,5,321409.42,18,1,7,3,True
8875598,160,0,20,6952,506341585,0,0,0,301.24,3,321108.18,24,5,19,4,True
9024111,883,0,25,6200,506341585,0,0,0,301.4,8,320806.78,24,3,15,5,True
9051990,883,0,451,1205,506341585,0,0,0,301.19,7,320505.59,24,0,14,7,True
9096667,116,0,20,4500,506341585,0,0,0,301.12,3,320204.47,3,3,7,9,True
9370731,428,0,-1,6939,506341585,0,1,0,301.15,1,320204.47,18,2,9,9,True
9464768,428,0,25,5807,506341585,0,0,0,301.07,8,319903.4,18,0,16,9,True
9528050,956,1,451,9196,506341585,0,0,0,300.93,7,319602.47,13,2,21,10,True
1261503,1111,0,20,2249,583657772,1,0,0,464.87,5,513614.13,0,5,5,1,True
1286463,249,0,10,7501,583657772,1,0,0,465.04,6,514079.17,6,0,22,1,True
1386281,1403,4,-1,3110,583657772,1,1,0,465.0,1,514079.17,24,5,5,2,True
1542538,57,3,30,5387,583657772,1,0,0,464.81,8,513614.36,20,6,18,2,True
1770807,331,4,-1,8332,583657772,1,1,0,464.85,4,513614.36,11,0,11,2,True
1796012,147,0,30,4953,583657772,1,0,0,465.17,8,513149.19,18,0,8,3,True
1886679,1403,4,451,3110,583657772,1,0,0,464.93,7,512684.26,24,3,17,4,True
1904706,57,3,-1,2249,583657772,1,1,0,464.96,4,512684.26,20,1,7,5,True
1969654,1114,1,-1,5219,583657772,1,2,0,465.27,1,512684.26,0,2,11,6,True
2203435,57,3,25,1568,583657772,1,0,0,464.99,8,512219.27,20,5,14,6,True
2247966,1403,4,451,8562,583657772,1,0,0,465.07,7,511754.2,24,6,22,6,True
2438296,57,3,30,5268,583657772,1,0,0,464.92,8,511289.28,20,1,23,8,True
2535085,537,0,20,7501,583657772,1,0,0,465.01,3,510824.27,18,1,9,8,True
2639687,1378,3,451,1720,583657772,1,0,0,465.04,7,510359.23,16,0,5,10,True
2643441,57,3,451,9865,583657772,1,0,0,464.99,7,509894.24,20,4,4,10,True
2778477,147,0,451,5063,583657772,1,0,0,464.82,7,509429.42,18,1,2,11,True
2846634,1113,1,-1,1568,583657772,1,1,0,464.97,4,509429.42,0,5,16,12,True
3030143,300,0,20,5268,583657772,1,0,0,464.87,5,508964.55,4,1,5,12,True
3094847,1114,1,25,3884,583657772,1,0,0,464.87,8,508499.68,0,1,10,1,True
3234420,849,1,10,5063,583657772,1,0,0,464.98,6,508964.66,5,2,4,2,True
3413406,172,4,451,5063,583657772,1,0,0,464.94,7,508499.72,24,1,13,2,True
3490418,147,0,30,9865,583657772,1,0,0,465.0,8,508034.72,18,5,19,3,True
3678527,172,4,30,5063,583657772,1,0,0,464.91,8,507569.81,24,6,2,4,False
4012311,309,0,20,7501,583657772,1,0,0,464.87,5,507104.94,4,4,1,4,True
4198275,480,0,10,9865,583657772,1,0,0,464.81,6,507569.75,5,5,19,4,True
4609377,471,0,10,1720,583657772,1,0,0,465.09,0,508034.84,5,5,14,5,True
5204263,1114,1,451,5268,583657772,1,0,0,464.96,7,507569.88,0,3,8,9,True
5493693,673,0,20,9250,583657772,1,0,0,465.14,5,507104.74,18,1,19,9,True
5816905,325,0,20,6518,583657772,1,0,0,464.78,5,506639.96,11,1,6,10,True
6161119,331,4,451,2249,583657772,1,0,0,465.08,7,506174.88,11,1,19,10,True
6188352,530,0,20,6518,583657772,1,0,0,464.94,3,505709.94,18,4,17,11,True
6484268,1114,1,25,5268,583657772,1,0,0,464.95,8,505244.99,0,6,8,11,True
6674557,1113,1,451,5387,583657772,1,0,0,465.14,7,504779.85,0,3,2,12,True
6740303,57,3,451,6518,583657772,1,0,0,465.08,7,504314.77,20,0,2,12,True
6831119,1134,1,10,3110,583657772,1,0,0,465.04,6,504779.81,24,3,6,12,False
6878567,172,4,30,5063,583657772,1,0,0,465.04,8,504314.77,24,6,20,1,True
6889594,1072,0,10,3110,583657772,1,0,0,465.08,6,504779.85,18,0,15,1,True
7129771,331,4,25,6904,583657772,1,0,0,464.9,8,504314.95,11,6,11,4,True
7469765,1113,1,-1,1720,583657772,1,1,0,465.01,4,504314.95,0,3,23,4,True
7682314,57,3,25,9250,583657772,1,0,0,465.0,8,503849.95,20,1,14,5,True
7893998,208,0,10,5268,583657772,1,0,0,465.15,6,504315.1,9,5,4,6,True
7974727,404,1,10,5063,583657772,1,0,0,464.91,6,504780.01,10,3,11,7,True
8265711,147,0,25,6518,583657772,1,0,0,465.09,8,504314.92,18,2,19,7,True
8277246,331,4,30,2588,583657772,1,0,0,465.2,8,503849.72,11,6,9,8,True
8281902,57,3,451,5268,583657772,1,0,0,465.03,7,503384.69,20,0,16,8,True
8473354,1114,1,-1,6904,583657772,1,1,0,464.92,1,503384.69,0,3,15,8,True
8577430,1113,1,25,8332,583657772,1,0,0,464.91,8,502919.78,0,5,16,8,True
8806685,1446,1,10,7501,583657772,1,0,0,465.03,0,503384.81,24,2,23,9,True
8938043,1113,1,25,5063,583657772,1,0,0,465.02,8,502919.79,0,3,23,9,True
9167157,319,0,20,8332,583657772,1,0,0,465.06,5,502454.73,11,5,4,9,True
9256674,331,4,25,8332,583657772,1,0,0,465.02,8,501989.71,11,3,0,10,True
9673165,331,4,25,3884,583657772,1,0,0,464.75,8,501524.96,11,0,20,11,True
9704242,1471,0,20,8562,583657772,1,0,0,464.93,5,501060.03,24,1,6,11,True
9969831,1378,3,25,5219,583657772,1,0,0,464.94,8,500595.09,16,6,4,11,True
1033415,1115,1,10,4517,245466948,1,0,0,356.18,6,427544.18,0,0,0,2,True
1085780,1190,3,451,4181,245466948,1,0,0,355.85,7,427188.33,24,5,14,2,True
1318970,1101,2,30,8573,245466948,1,0,0,355.85,8,426832.48,0,6,8,4,False
1327316,917,0,25,4181,245466948,1,0,0,355.72,8,426476.76,18,6,17,4,True
1351067,757,0,20,4181,245466948,1,0,0,356.03,5,426120.73,24,0,22,5,True
1370963,869,2,30,8573,245466948,1,0,0,356.29,8,425764.44,24,3,8,6,True
1518730,917,0,-1,4517,245466948,1,1,0,356.04,4,425764.44,18,4,20,7,True
1571520,869,2,451,3849,245466948,1,0,0,355.9,7,425408.54,24,1,20,7,True
1871930,1086,0,10,4181,245466948,1,0,0,356.05,6,425764.59,18,3,23,7,True
2019527,917,0,25,9862,245466948,1,0,0,356.18,8,425408.41,18,1,18,7,True
2278325,1175,2,20,8386,245466948,1,0,0,356.08,3,425052.33,24,2,19,7,True
2674775,869,2,30,9862,245466948,1,0,0,356.01,8,424696.32,24,4,17,8,True
3203143,1406,0,20,3531,245466948,1,0,0,355.9,5,424340.42,24,4,0,9,True
3496264,1101,2,451,5036,245466948,1,0,0,356.18,7,423984.24,0,1,8,9,True
3985890,1339,2,451,5327,245466948,1,0,0,356.19,7,423628.05,18,4,9,10,True
4061430,398,0,20,1544,245466948,1,0,0,355.95,5,423272.1,10,4,2,10,True
4212370,443,2,20,9977,245466948,1,0,0,356.32,5,422915.78,24,1,14,11,True
4599033,917,0,25,1544,245466948,1,0,0,355.99,8,422559.79,18,3,20,12,True
4669808,869,2,30,9977,245466948,1,0,0,355.86,8,422203.93,24,2,14,1,True
5067355,1101,2,451,4181,245466948,1,0,0,356.14,7,421847.79,0,2,15,2,True
5184432,1339,2,25,8386,245466948,1,0,0,355.83,8,421491.96,18,6,1,3,True
5459102,1101,2,25,9977,245466948,1,0,0,356.01,8,421135.95,0,2,2,3,True
5471809,1190,3,451,5228,245466948,1,0,0,355.84,7,420780.11,24,5,4,4,True
5537445,869,2,-1,5327,245466948,1,1,0,356.18,4,420780.11,24,6,22,4,True
5641581,1101,2,451,8031,245466948,1,0,0,356.04,7,420424.07,0,4,6,4,True
5671780,1304,0,20,9977,245466948,1,0,0,355.94,5,420068.13,5,5,6,4,True
5978970,1101,2,451,4517,245466948,1,0,0,356.14,7,419711.99,0,1,1,5,True
5994025,585,2,20,4506,245466948,1,0,0,356.0,3,419355.99,11,0,1,5,True
6069750,1339,2,30,8031,245466948,1,0,0,356.2,8,418999.79,18,5,1,6,True
6217336,736,1,10,4517,245466948,1,0,0,355.87,6,419355.66,11,0,7,7,True
6394698,1250,1,10,6929,245466948,1,0,0,356.3,6,419711.96,23,3,6,7,True
6538347,1339,2,451,3849,245466948,1,0,0,356.2,7,419355.76,18,5,21,9,True
6736849,1190,3,451,4181,245466948,1,0,0,356.0,7,418999.76,24,2,6,9,True
6740943,1339,2,451,4506,245466948,1,0,0,356.03,7,418643.73,18,6,5,10,True
6773446,1101,2,-1,3531,245466948,1,1,0,355.85,1,418643.73,0,0,4,10,True
6890358,1101,2,25,6929,245466948,1,0,0,355.91,8,418287.82,0,6,21,11,True
6941118,869,2,30,8386,245466948,1,0,0,356.15,8,417931.67,24,1,13,11,True
6966011,869,2,451,4517,245466948,1,0,0,356.11,7,417575.56,24,0,18,12,True
6995668,1119,0,10,4181,245466948,1,0,0,356.0,0,417931.56,24,4,23,12,True
7418639,917,0,30,4517,245466948,1,0,0,356.13,8,417575.43,18,3,21,12,True
7433837,1101,2,-1,8386,245466948,1,1,0,356.27,1,417575.43,0,2,23,1,True
7516014,917,0,-1,9977,245466948,1,2,0,355.8,4,417575.43,18,4,9,1,True
7710134,1190,3,451,1544,245466948,1,0,0,356.1,7,417219.33,24,4,19,2,True
7764476,869,2,451,4517,245466948,1,0,0,356.07,7,416863.26,24,2,16,3,True
7775861,869,2,-1,5327,245466948,1,1,0,355.97,4,416863.26,24,4,11,3,True
7907049,1339,2,25,5228,245466948,1,0,0,355.96,8,416507.3,18,6,8,4,True
7934274,611,0,20,8573,245466948,1,0,0,356.25,5,416151.05,11,4,12,6,True
7959779,1190,3,25,8573,245466948,1,0,0,356.23,8,415794.82,24,5,3,6,True
8525524,1190,3,-1,3849,245466948,1,1,0,356.39,4,415794.82,24,2,21,6,True
8620881,1339,2,451,9862,245466948,1,0,0,355.73,7,415439.09,18,0,20,6,True
8679649,917,0,30,9977,245466948,1,0,0,356.04,8,415083.05,18,6,17,7,True
8694447,1339,2,-1,3531,245466948,1,1,0,356.08,4,415083.05,18,2,7,7,True
8711212,1101,2,451,6929,245466948,1,0,0,355.81,7,414727.24,0,3,23,10,True
8814939,1190,3,30,6929,245466948,1,0,0,355.63,8,414371.61,24,0,17,10,True
8852640,1339,2,25,5036,245466948,1,0,0,356.07,8,414015.54,18,2,5,10,True
9411371,869,2,30,4181,245466948,1,0,0,356.01,8,413659.53,24,3,23,10,True
9757225,557,1,-1,9977,245466948,1,1,0,355.82,1,413659.53,17,4,8,11,True
9854145,253,2,20,8031,245466948,1,0,0,355.96,5,413303.57,6,2,13,11,True
1245388,949,4,30,7807,371375757,1,0,0,265.96,8,129269.04,24,6,0,2,True
1344712,1388,1,10,5266,371375757,1,0,0,265.81,0,129534.85,24,6,7,3,True
1432433,471,0,20,4930,371375757,1,0,0,265.91,5,129268.94,5,0,6,3,True
1669862,1114,1,451,2312,371375757,1,0,0,266.04,7,129002.9,0,2,14,3,True
1691158,1114,1,25,9497,371375757,1,0,0,266.09,8,128736.81,0,3,0,4,True
1702844,399,2,20,1308,371375757,1,0,0,265.98,5,128470.83,10,6,2,5,False
1835071,933,4,25,4404,371375757,1,0,0,266.07,8,128204.76,24,5,4,5,True
1958075,1114,1,451,8982,371375757,1,0,0,265.87,7,127938.89,0,4,8,5,True
2025249,639,4,30,8396,371375757,1,0,0,265.9,8,127672.99,24,2,8,6,True
2278678,498,0,10,3355,371375757,1,0,0,265.98,6,127938.97,12,0,11,6,True
2283898,184,0,30,9497,371375757,1,0,0,266.03,8,127672.94,18,3,21,8,True
2560126,949,4,451,9497,371375757,1,0,0,265.81,7,127407.13,24,5,7,8,True
2590752,1114,1,-1,4313,371375757,1,1,0,265.81,4,127407.13,0,6,17,8,True
2792146,1424,4,25,2312,371375757,1,0,0,265.62,8,127141.51,24,2,1,9,True
2800867,1114,1,25,4018,371375757,1,0,0,266.19,8,126875.32,0,4,11,9,True
2915058,184,0,451,6044,371375757,1,0,0,266.1,7,126609.22,18,6,11,10,True
3180278,607,2,20,9497,371375757,1,0,0,266.01,5,126343.21,24,5,16,10,True
3189626,933,4,-1,6044,371375757,1,1,0,266.13,4,126343.21,24,4,9,11,True
3230717,68,0,20,2312,371375757,1,0,0,265.98,3,126077.23,20,5,6,12,True
3241645,917,0,451,4404,371375757,1,0,0,266.0,7,125811.23,18,2,4,12,True
3562219,639,4,25,4018,371375757,1,0,0,265.93,8,125545.3,24,2,21,12,True
3787242,1424,4,30,5161,371375757,1,0,0,266.1,8,125279.2,24,3,7,12,True
4036555,1271,0,10,8982,371375757,1,0,0,266.14,0,125545.34,23,4,2,12,True
4040599,949,4,30,3418,371375757,1,0,0,265.91,8,125279.43,24,5,22,1,True
4164744,1114,1,30,6117,371375757,1,0,0,265.99,8,125013.44,0,3,9,2,True
4242828,939,0,10,8325,371375757,1,0,0,266.01,0,125279.45,24,1,2,2,True
4416204,949,4,25,8982,371375757,1,0,0,265.91,8,125013.54,24,3,12,3,True
4631157,394,0,10,4404,371375757,1,0,0,265.93,0,125279.47,10,0,2,3,True
5115319,933,4,451,1173,371375757,1,0,0,266.17,7,125013.3,24,0,21,4,True
5562362,184,0,30,8463,371375757,1,0,0,266.0,8,124747.3,18,6,22,4,True
5735116,1114,1,30,6434,371375757,1,0,0,265.96,8,124481.34,0,4,6,5,True
5855978,949,4,451,1362,371375757,1,0,0,265.84,7,124215.5,24,0,4,5,True
6022039,933,4,-1,9497,371375757,1,1,0,266.5,1,124215.5,24,1,22,5,True
6034913,303,0,10,9497,371375757,1,0,0,265.97,6,124481.47,4,1,2,6,True
6197499,81,0,10,6945,371375757,1,0,0,266.16,6,124747.63,1,5,13,7,True
6343937,1186,2,20,8325,371375757,1,0,0,266.05,5,124481.58,24,5,11,8,True
6404653,639,4,451,6579,371375757,1,0,0,265.98,7,124215.6,24,3,0,8,True
6440898,933,4,30,4404,371375757,1,0,0,265.99,8,123949.61,24,2,17,9,True
6532980,757,0,25,8396,371375757,1,0,0,266.14,8,123683.47,24,3,17,11,True
6806976,639,4,451,8396,371375757,1,0,0,265.78,7,123417.69,24,0,18,12,True
6880997,1166,2,20,4930,371375757,1,0,0,266.0,5,123151.69,24,5,1,12,True
6928968,917,0,451,7392,371375757,1,0,0,266.13,7,122885.56,18,3,19,1,True
6952633,184,0,30,8325,371375757,1,0,0,266.01,8,122619.55,18,6,18,1,True
7004690,1424,4,451,6434,371375757,1,0,0,265.87,7,122353.68,24,1,22,2,True
7055918,1406,0,451,1362,371375757,1,0,0,265.89,7,122087.79,24,1,17,6,True
7521437,639,4,25,1445,371375757,1,0,0,265.82,8,121821.97,24,6,0,7,False
8213106,184,0,451,6579,371375757,1,0,0,266.1,7,121555.87,18,3,16,7,True
8293646,1406,0,30,8463,371375757,1,0,0,265.92,8,121289.95,24,0,9,7,True
8654838,1424,4,25,6579,371375757,1,0,0,265.99,8,121023.96,24,5,20,8,True
8763731,639,4,-1,9497,371375757,1,1,0,265.91,4,121023.96,24,2,22,10,True
9561146,1114,1,-1,5266,371375757,1,2,0,266.2,4,121023.96,0,4,3,10,True
9615367,1424,4,-1,5266,371375757,1,3,1,265.96,4,121023.96,24,5,11,10,True
1559661,1327,4,25,7858,518655870,1,0,0,743.11,8,444923.89,18,3,19,1,False
1824301,1118,4,25,8399,518655870,1,0,0,742.95,8,444180.94,24,6,23,1,True
2003836,1380,0,-1,3792,518655870,1,1,0,742.87,4,444180.94,16,5,5,2,True
2387309,1195,1,25,1567,518655870,1,0,0,743.0,8,443437.94,24,1,14,3,True
2507189,1118,4,25,1809,518655870,1,0,0,742.78,8,442695.16,24,0,20,4,True
2519466,1380,0,25,4238,518655870,1,0,0,743.43,8,441951.73,16,6,9,4,True
2621687,1380,0,30,1809,518655870,1,0,0,742.98,8,441208.75,16,1,1,4,True
2805265,804,0,10,6785,518655870,1,0,0,743.13,6,441951.88,11,5,5,6,True
2938682,1195,1,451,5937,518655870,1,0,0,742.99,7,441208.89,24,0,22,6,True
3062101,309,0,10,1809,518655870,1,0,0,742.96,6,441951.85,4,4,22,7,True
3409636,1278,0,-1,4732,518655870,1,1,0,743.06,4,441951.85,24,4,23,7,True
3435026,830,3,30,5939,518655870,1,0,0,743.12,8,441208.73,18,1,16,8,True
3508366,1380,0,-1,1567,518655870,1,1,0,742.91,4,441208.73,16,5,10,9,True
3528226,1278,0,30,4737,518655870,1,0,0,743.1,8,440465.63,24,3,13,10,True
3684662,1278,0,-1,1809,518655870,1,1,0,742.95,4,440465.63,24,4,9,10,False
3799257,1425,0,30,1809,518655870,1,0,0,743.04,8,439722.59,24,3,23,10,True
4088874,1195,1,451,5939,518655870,1,0,0,743.07,7,438979.52,24,4,10,12,True
4152079,1425,0,25,9826,518655870,1,0,0,743.06,8,438236.46,24,1,19,12,True
4299690,830,3,-1,6785,518655870,1,1,0,743.0,4,438236.46,18,3,0,12,True
4471762,192,2,451,8555,518655870,1,0,0,742.95,7,437493.51,18,4,5,12,True
4489718,800,0,20,1809,518655870,1,0,0,742.98,5,436750.53,11,2,7,1,True
4492201,935,1,10,6662,518655870,1,0,0,743.16,6,437493.69,24,3,2,1,True
4509276,1327,4,30,4737,518655870,1,0,0,742.9,8,436750.79,18,1,18,3,True
4546205,830,3,451,7858,518655870,1,0,0,742.82,7,436007.97,18,2,10,3,True
4681249,316,2,451,5939,518655870,1,0,0,743.1,7,435264.87,4,4,23,4,True
4788261,1195,1,451,4238,518655870,1,0,0,743.24,7,434521.63,24,5,8,4,True
5182416,830,3,-1,1809,518655870,1,1,0,742.86,1,434521.63,18,4,14,5,True
5239322,535,0,10,1567,518655870,1,0,0,742.86,0,435264.49,18,2,14,5,True
5897661,316,2,-1,4732,518655870,1,1,0,743.18,4,435264.49,4,3,2,6,True
6190000,316,2,451,3792,518655870,1,0,0,743.17,7,434521.32,4,5,22,6,True
6232719,1041,0,10,1809,518655870,1,0,0,743.0,6,435264.32,11,0,4,6,True
6304807,1278,0,451,8399,518655870,1,0,0,742.94,7,434521.38,24,5,17,6,True
6448112,1380,0,-1,5939,518655870,1,1,0,743.13,4,434521.38,16,6,13,6,True
6844114,830,3,451,6785,518655870,1,0,0,743.07,7,433778.31,18,1,15,10,True
6995119,1195,1,25,5937,518655870,1,0,0,742.88,8,433035.43,24,6,7,10,True
7098993,192,2,-1,9826,518655870,1,1,0,743.02,1,433035.43,18,5,18,11,True
7137770,1467,0,10,4238,518655870,1,0,0,742.9,6,433778.33,11,1,15,11,True
7138082,1425,0,25,3069,518655870,1,0,0,742.83,8,433035.5,24,3,20,2,True
7178753,916,0,10,8555,518655870,1,0,0,742.72,0,433778.22,18,3,11,3,True
7307138,316,2,451,6662,518655870,1,0,0,742.88,7,433035.34,4,0,15,4,True
7482015,1278,0,-1,9826,518655870,1,1,0,743.02,1,433035.34,24,5,15,4,True
7544469,192,2,25,3069,518655870,1,0,0,742.93,8,432292.41,18,6,13,5,True
7601133,1195,1,30,3069,518655870,1,0,0,743.25,8,431549.16,24,3,8,5,True
7765712,192,2,25,5937,518655870,1,0,0,743.03,8,430806.13,18,6,11,6,True
7851839,1195,1,451,1809,518655870,1,0,0,743.15,7,430062.98,24,5,10,6,True
7854307,1118,4,451,6785,518655870,1,0,0,742.8,7,429320.18,24,5,14,8,True
8190076,1327,4,-1,5937,518655870,1,1,0,742.69,4,429320.18,18,0,19,8,True
8571826,1327,4,451,3069,518655870,1,0,0,742.91,7,428577.27,18,0,17,10,True
8649902,316,2,-1,6662,518655870,1,1,0,742.9,4,428577.27,4,3,18,10,True
8940381,1118,4,25,5937,518655870,1,0,0,743.06,8,427834.21,24,4,9,10,True
9061139,804,0,20,1567,518655870,1,0,0,742.85,5,427091.36,11,5,16,10,True
9071383,1327,4,30,7858,518655870,1,0,0,742.85,8,426348.51,18,6,7,11,True
9786083,467,0,20,5937,518655870,1,0,0,743.29,3,425605.22,5,3,5,11,True
9826902,1064,0,20,7858,518655870,1,0,0,742.98,5,424862.24,11,5,5,11,True
9843600,1485,0,10,5939,518655870,1,0,0,743.18,6,425605.42,24,5,23,11,True
1018508,1072,0,20,4304,727185884,1,0,0,680.02,5,945795.98,18,0,1,1,True
1231955,1238,0,20,5832,727185884,1,0,0,679.72,5,945116.26,18,3,14,2,True
1324744,1004,4,451,2521,727185884,1,0,0,679.94,7,944436.32,26,3,13,2,True
1391741,129,0,20,9441,727185884,1,0,0,679.84,3,943756.48,18,4,22,2,True
1941221,1004,4,451,9441,727185884,1,0,0,680.0,7,943076.48,26,0,4,3,True
2463061,797,3,451,8957,727185884,1,0,0,680.21,7,942396.27,11,1,2,3,True
2540499,797,3,25,5097,727185884,1,0,0,679.97,8,941716.3,11,3,14,5,True
2572831,1004,4,25,9766,727185884,1,0,0,680.26,8,941036.04,26,1,3,5,True
2733711,417,3,-1,4862,727185884,1,1,0,680.11,4,941036.04,18,1,0,5,True
2954924,1283,2,30,6329,727185884,1,0,0,679.92,8,940356.12,24,1,20,6,True
3062252,167,2,20,8314,727185884,1,0,0,679.58,3,939676.54,24,2,21,7,True
3066418,1004,4,451,9441,727185884,1,0,0,679.87,7,938996.67,26,6,4,7,True
3211850,1283,2,25,5832,727185884,1,0,0,679.95,8,938316.72,24,1,1,9,True
3243802,158,2,30,6608,727185884,1,0,0,679.83,8,937636.89,24,4,9,9,True
3523582,530,0,10,6229,727185884,1,0,0,680.12,0,938317.01,18,0,12,9,True
3623212,1283,2,30,6608,727185884,1,0,0,680.18,8,937636.83,24,0,10,11,True
3727094,1283,2,451,5097,727185884,1,0,0,680.04,7,936956.79,24,4,11,11,True
4175231,417,3,451,8550,727185884,1,0,0,680.02,7,936276.77,18,3,3,12,True
4310407,1119,0,10,4304,727185884,1,0,0,679.7,6,936956.47,24,6,1,12,True
4416626,417,3,451,3155,727185884,1,0,0,679.85,7,936276.62,18,1,16,1,True
4431287,1004,4,-1,5051,727185884,1,1,0,680.1,4,936276.62,26,3,13,2,True
4486643,1239,1,451,4718,727185884,1,0,0,680.03,7,935596.59,18,5,18,2,True
4624933,797,3,-1,4007,727185884,1,1,0,680.07,1,935596.59,11,3,9,3,True
5094150,158,2,-1,4718,727185884,1,2,0,680.11,1,935596.59,24,0,13,4,True
5406523,1239,1,25,9441,727185884,1,0,0,679.76,8,934916.83,18,2,2,5,True
5479394,417,3,25,4477,727185884,1,0,0,679.92,8,934236.91,18,1,16,5,True
5502307,129,0,20,4304,727185884,1,0,0,680.02,3,933556.89,18,2,4,5,True
5520185,1352,1,10,4718,727185884,1,0,0,680.04,6,934236.93,24,4,10,5,True
5623778,871,0,20,5051,727185884,1,0,0,680.05,5,933556.88,24,5,2,6,True
5798588,1283,2,451,9441,727185884,1,0,0,679.79,7,932877.09,24,4,15,7,True
5884570,1004,4,30,4477,727185884,1,0,0,679.77,8,932197.32,26,4,5,8,True
6226768,1201,0,10,9766,727185884,1,0,0,680.23,6,932877.55,24,3,6,8,True
6375408,158,2,-1,8697,727185884,1,1,0,679.96,4,932877.55,24,5,14,8,True
6435303,114,0,20,6229,727185884,1,0,0,679.92,3,932197.63,3,3,11,10,True
6613532,1239,1,30,5832,727185884,1,0,0,679.68,8,931517.95,18,2,8,11,True
6849162,417,3,30,9932,727185884,1,0,0,680.1,8,930837.85,18,4,23,12,True
7030603,759,0,10,8550,727185884,1,0,0,680.04,0,931517.89,24,3,11,3,True
7093688,417,3,-1,9766,727185884,1,1,0,679.69,1,931517.89,18,2,18,3,True
7228050,797,3,25,5097,727185884,1,0,0,680.22,8,930837.67,11,6,4,4,True
7405170,68,0,20,8314,727185884,1,0,0,680.0,5,930157.67,20,2,21,5,True
7411995,797,3,30,1146,727185884,1,0,0,680.06,8,929477.61,11,3,0,6,True
8113319,1004,4,451,6229,727185884,1,0,0,679.95,7,928797.66,26,0,4,6,True
8373993,1232,1,10,8314,727185884,1,0,0,679.81,6,929477.47,18,0,14,6,False
8447968,417,3,25,9932,727185884,1,0,0,680.2,8,928797.27,18,2,16,7,True
8968448,797,3,25,5832,727185884,1,0,0,679.95,8,928117.32,11,3,7,8,True
9050989,158,2,-1,8697,727185884,1,1,0,679.91,1,928117.32,24,6,8,8,True
9051745,14,2,20,9932,727185884,1,0,0,679.96,3,927437.36,24,3,17,8,True
9359991,797,3,-1,4007,727185884,1,1,0,680.0,4,927437.36,11,4,18,8,False
9405410,1219,1,10,2521,727185884,1,0,0,680.1,6,928117.46,24,2,17,9,True
9613066,208,0,20,5051,727185884,1,0,0,679.9,5,927437.56,9,6,13,10,True
9700800,1283,2,25,6329,727185884,1,0,0,679.86,8,926757.7,24,3,3,10,True
9939238,1239,1,-1,4862,727185884,1,1,0,680.05,4,926757.7,18,1,18,11,False
9970598,1283,2,451,2521,727185884,1,0,0,680.18,7,926077.52,24,1,23,11,False
1009375,824,2,25,9713,202802628,0,0,0,284.0,8,483793.0,18,6,12,1,True
1201816,895,0,-1,7555,202802628,0,1,0,283.86,4,483793.0,24,5,6,3,True
1249063,895,0,451,8134,202802628,0,0,0,284.01,7,483508.99,24,2,7,5,True
1296345,1486,2,20,8310,202802628,0,0,0,284.15,5,483224.84,24,1,0,5,True
1477484,895,0,451,5298,202802628,0,0,0,284.15,7,482940.69,24,2,4,6,True
1601386,1205,0,10,6903,202802628,0,0,0,283.92,6,483224.61,24,1,16,6,True
2041095,266,2,451,4520,202802628,0,0,0,284.03,7,482940.58,6,6,11,7,True
2274758,1363,0,30,8310,202802628,0,0,0,284.33,8,482656.25,16,3,12,8,True
2328315,895,0,30,5298,202802628,0,0,0,283.92,8,482372.33,24,5,4,8,True
2564816,824,2,-1,1333,202802628,0,1,0,284.5,4,482372.33,18,1,4,8,True
2651648,667,4,25,6311,202802628,0,0,0,284.18,8,482088.15,18,4,16,9,True
3080725,1421,0,25,6311,202802628,0,0,0,283.66,8,481804.49,24,4,23,9,True
3103002,266,2,30,5829,202802628,0,0,0,283.94,8,481520.55,6,5,19,9,True
3375938,824,2,25,5958,202802628,0,0,0,284.0,8,481236.55,18,0,8,10,True
3404738,1421,0,451,7401,202802628,0,0,0,284.02,7,480952.53,24,3,10,11,True
3605605,266,2,451,8310,202802628,0,0,0,284.05,7,480668.48,6,3,21,11,True
3766070,1363,0,30,6513,202802628,0,0,0,283.93,8,480384.55,16,4,13,11,False
3797697,266,2,30,4284,202802628,0,0,0,283.85,8,480100.7,6,4,4,11,True
3967373,1421,0,20,9059,202802628,0,0,0,284.1,5,479816.6,24,0,4,12,True
4048683,895,0,25,8134,202802628,0,0,0,283.98,8,479532.62,24,1,6,12,True
4293254,1363,0,25,8134,202802628,0,0,0,283.7,8,479248.92,16,5,10,1,True
4644793,27,0,10,4520,202802628,0,0,0,284.08,0,479533.0,11,1,22,2,True
4712827,1017,2,20,6598,202802628,0,0,0,284.08,5,479248.92,26,4,0,2,True
4909389,1238,0,10,5829,202802628,0,0,0,283.81,6,479532.73,18,1,1,2,True
5021533,667,4,30,8310,202802628,0,0,0,284.04,8,479248.69,18,6,12,3,True
5043130,266,2,30,1704,202802628,0,0,0,283.97,8,478964.72,6,1,16,3,True
5239830,266,2,25,4520,202802628,0,0,0,284.06,8,478680.66,6,3,4,3,True
5256135,1089,0,10,5829,202802628,0,0,0,284.16,0,478964.82,18,3,17,4,True
5329246,266,2,30,5958,202802628,0,0,0,283.88,8,478680.94,6,1,5,4,True
5363425,1363,0,451,1715,202802628,0,0,0,284.07,7,478396.87,16,6,15,4,True
5423819,1041,0,20,5958,202802628,0,0,0,283.97,3,478112.9,11,5,22,5,True
5659425,1421,0,451,5298,202802628,0,0,0,283.85,7,477829.05,24,6,6,7,True
5766735,266,2,451,9059,202802628,0,0,0,283.83,7,477545.22,6,2,5,9,True
6049407,266,2,25,2601,202802628,0,0,0,284.07,8,477261.15,6,4,19,9,True
6186867,667,4,451,7331,202802628,0,0,0,284.16,7,476976.99,18,2,10,10,True
6254473,667,4,451,1715,202802628,0,0,0,283.99,7,476693.0,18,3,21,10,True
6493417,854,0,20,3868,202802628,0,0,0,283.81,5,476409.19,24,5,11,11,True
6534050,858,1,10,8310,202802628,0,0,0,284.28,6,476693.47,24,6,19,12,True
6611639,1387,1,10,7469,202802628,0,0,0,283.89,0,476977.36,24,4,1,1,True
6623378,1363,0,25,1333,202802628,0,0,0,283.89,8,476693.47,16,1,10,1,True
6789259,266,2,451,5298,202802628,0,0,0,283.78,7,476409.69,6,6,20,2,True
6794278,895,0,-1,7555,202802628,0,1,0,283.85,4,476409.69,24,3,1,2,True
7029177,667,4,30,9713,202802628,0,0,0,283.93,8,476125.76,18,1,20,4,True
7086283,155,1,10,6903,202802628,0,0,0,283.83,6,476409.59,18,0,19,5,True
7261029,824,2,451,9059,202802628,0,0,0,283.91,7,476125.68,18,1,11,5,True
7406588,1363,0,-1,3998,202802628,0,1,0,284.19,4,476125.68,16,3,2,6,True
7624418,895,0,25,9713,202802628,0,0,0,283.94,8,475841.74,24,1,23,6,True
7970949,667,4,30,9713,202802628,0,0,0,283.92,8,475557.82,18,3,19,6,True
8141769,266,2,25,7555,202802628,0,0,0,284.05,8,475273.77,6,6,12,6,True
8402384,266,2,30,3868,202802628,0,0,0,283.86,8,474989.91,6,6,8,7,True
8603582,471,0,10,5829,202802628,0,0,0,284.07,0,475273.98,5,6,11,7,True
8904603,1421,0,451,7469,202802628,0,0,0,284.24,7,474989.74,24,5,13,9,True
8947228,1363,0,451,6311,202802628,0,0,0,283.9,7,474705.84,16,1,22,10,False
8981538,266,2,-1,6233,202802628,0,1,0,283.88,1,474705.84,6,4,19,10,True
9500573,1422,1,10,9059,202802628,0,0,0,283.73,6,474989.57,24,6,23,10,True
9680685,603,0,20,3868,202802628,0,0,0,284.1,5,474705.47,24,2,5,10,True
9687935,266,2,451,8310,202802628,0,0,0,284.23,7,474421.24,6,5,0,11,True
9783986,584,0,10,9713,202802628,0,0,0,283.81,6,474705.05,11,5,12,11,True
1000378,522,0,10,7820,313395413,0,0,0,904.97,6,248532.97,18,0,17,1,True
1139095,475,4,30,3637,313395413,0,0,0,905.02,8,247627.95,5,1,18,3,True
1425796,475,4,451,8295,313395413,0,0,0,905.19,7,246722.76,5,3,7,4,True
1719036,1342,3,451,1061,313395413,0,0,0,904.89,7,245817.87,24,5,17,4,False
1755709,1173,1,451,3314,313395413,0,0,0,905.07,7,244912.8,24,4,8,4,True
1877045,1173,1,25,1273,313395413,0,0,0,904.93,8,244007.87,24,4,3,5,True
2092696,81,0,20,8258,313395413,0,0,0,904.9,3,243102.97,1,0,13,5,True
2094360,475,4,451,8295,313395413,0,0,0,905.01,7,242197.96,5,0,1,6,True
2181238,1173,1,30,3183,313395413,0,0,0,904.99,8,241292.97,24,2,9,6,True
2285958,1312,0,20,5182,313395413,0,0,0,905.05,5,240387.92,5,4,12,7,True
2451296,937,0,30,3637,313395413,0,0,0,904.89,8,239483.03,24,5,1,7,True
2503538,389,3,-1,5435,313395413,0,1,0,904.93,4,239483.03,10,0,18,8,False
2525168,937,0,30,6660,313395413,0,0,0,905.11,8,238577.92,24,2,11,8,True
2645117,362,0,10,8828,313395413,0,0,0,905.18,6,239483.1,24,0,13,8,True
2645495,1476,0,20,3314,313395413,0,0,0,905.19,3,238577.91,24,0,20,9,True
2652227,389,3,-1,8295,313395413,0,1,0,905.06,4,238577.91,10,0,5,9,True
2825548,475,4,451,2609,313395413,0,0,0,904.99,7,237672.92,5,0,2,10,True
2950421,1342,3,451,1061,313395413,0,0,0,905.27,7,236767.65,24,3,19,11,True
3064854,1342,3,30,3183,313395413,0,0,0,905.21,8,235862.44,24,4,18,11,False
3302322,937,0,-1,1273,313395413,0,1,0,904.82,4,235862.44,24,5,12,11,True
3327934,389,3,451,7215,313395413,0,0,0,904.86,7,234957.58,10,4,7,12,True
3573438,937,0,451,8828,313395413,0,0,0,904.82,7,234052.76,24,6,10,12,True
3940404,475,4,25,1867,313395413,0,0,0,904.79,8,233147.97,5,1,4,12,True
4526801,1173,1,30,6660,313395413,0,0,0,904.77,8,232243.2,24,4,5,1,True
4862024,1342,3,451,3183,313395413,0,0,0,904.84,7,231338.36,24,5,21,1,True
5194793,389,3,30,1952,313395413,0,0,0,905.07,8,230433.29,10,0,20,1,True
5338974,1434,0,10,7820,313395413,0,0,0,904.77,6,231338.06,24,4,2,2,True
5433083,194,1,10,2609,313395413,0,0,0,904.85,6,232242.91,18,1,16,2,True
5498246,475,4,451,5506,313395413,0,0,0,904.93,7,231337.98,5,3,0,3,True
5655570,1342,3,-1,3637,313395413,0,1,0,905.1,1,231337.98,24,5,10,3,True
5756489,937,0,451,1273,313395413,0,0,0,904.85,7,230433.13,24,0,12,3,True
5978502,1173,1,-1,1867,313395413,0,1,0,904.7,4,230433.13,24,2,8,3,True
6103290,1342,3,-1,3183,313395413,0,2,0,905.12,4,230433.13,24,2,20,4,False
6171325,937,0,25,7820,313395413,0,0,0,905.1,8,229528.03,24,5,13,4,True
6277424,937,0,25,3451,313395413,0,0,0,904.98,8,228623.05,24,1,4,5,True
6341874,1342,3,25,7982,313395413,0,0,0,904.77,8,227718.28,24,4,0,5,True
6351119,937,0,451,1952,313395413,0,0,0,904.79,7,226813.49,24,4,13,5,True
6426647,1342,3,451,1061,313395413,0,0,0,905.11,7,225908.38,24,5,21,5,True
6609645,937,0,30,1273,313395413,0,0,0,905.13,8,225003.25,24,6,8,9,True
6693345,1173,1,451,5683,313395413,0,0,0,904.89,7,224098.36,24,1,1,11,True
6765479,389,3,25,8377,313395413,0,0,0,905.13,8,223193.23,10,5,16,12,True
7155858,937,0,30,8828,313395413,0,0,0,904.99,8,222288.24,24,5,0,2,True
7257716,1173,1,-1,3183,313395413,0,1,0,904.86,4,222288.24,24,6,2,3,True
7279226,28,1,10,8295,313395413,0,0,0,904.66,6,223192.9,11,0,20,4,True
7622065,937,0,30,8258,313395413,0,0,0,905.0,8,222287.9,24,6,7,5,True
7699174,937,0,451,1273,313395413,0,0,0,905.29,7,221382.61,24,4,9,5,True
7773992,1015,0,20,8258,313395413,0,0,0,904.87,5,220477.74,26,0,23,6,True
8166029,1342,3,451,1273,313395413,0,0,0,904.82,7,219572.92,24,2,6,7,True
8290698,1255,0,10,7215,313395413,0,0,0,905.21,6,220478.13,23,0,0,8,True
8483242,1201,0,10,2609,313395413,0,0,0,905.31,6,221383.44,24,5,16,8,True
8613428,1342,3,451,3183,313395413,0,0,0,904.62,7,220478.82,24,2,19,9,True
8619746,1132,0,10,5683,313395413,0,0,0,905.15,6,221383.97,24,2,2,9,True
8712836,1342,3,30,1061,313395413,0,0,0,904.83,8,220479.14,24,2,17,9,True
8803279,1173,1,30,7854,313395413,0,0,0,905.0,8,219574.14,24,1,5,9,True
9000796,1173,1,451,8258,313395413,0,0,0,904.95,7,218669.19,24,3,5,9,True
9315845,1015,0,10,5506,313395413,0,0,0,904.57,0,219573.76,26,5,4,10,True
9696431,1173,1,451,5182,313395413,0,0,0,904.96,7,218668.8,24,3,20,10,True
9996886,937,0,451,8258,313395413,0,0,0,905.38,7,217763.42,24,4,10,10,False
1810945,1297,0,20,6611,889412206,1,0,0,301.28,5,589795.72,5,3,1,1,True
1839016,76,0,10,4320,889412206,1,0,0,301.16,6,590096.88,20,4,15,2,True
1896136,689,0,20,1625,889412206,1,0,0,301.13,5,589795.75,24,5,7,2,False
2012881,364,4,451,4320,889412206,1,0,0,301.24,7,589494.51,25,6,12,2,True
2493039,893,4,451,9422,889412206,1,0,0,301.05,7,589193.46,24,1,7,2,True
2705427,364,4,-1,1924,889412206,1,1,0,300.99,1,589193.46,25,6,18,2,True
2815303,641,0,451,6766,889412206,1,0,0,301.03,7,588892.43,24,4,18,3,False
3181883,641,0,25,1924,889412206,1,0,0,301.31,8,588591.12,24,1,1,4,True
3415911,910,0,10,3710,889412206,1,0,0,300.83,6,588891.95,18,2,16,4,True
3614262,1317,4,451,3094,889412206,1,0,0,301.01,7,588590.94,18,1,9,4,True
3703605,1352,1,10,1058,889412206,1,0,0,300.99,0,588891.93,24,0,5,5,True
3757945,428,0,20,3627,889412206,1,0,0,300.88,5,588591.05,18,2,8,5,True
3945020,893,4,451,3191,889412206,1,0,0,301.12,7,588289.93,24,5,2,6,True
4002791,1317,4,-1,6611,889412206,1,1,0,301.01,4,588289.93,18,0,2,8,True
4036899,1317,4,-1,1527,889412206,1,2,0,301.13,1,588289.93,18,2,13,9,True
4060150,641,0,451,1924,889412206,1,0,0,300.89,7,587989.04,24,5,14,10,True
4154365,1317,4,451,3615,889412206,1,0,0,300.91,7,587688.13,18,2,14,11,True
4331224,893,4,25,7788,889412206,1,0,0,301.0,8,587387.13,24,6,23,11,True
4677248,893,4,451,7120,889412206,1,0,0,301.02,7,587086.11,24,4,2,12,True
4716561,579,0,10,6421,889412206,1,0,0,301.31,0,587387.42,11,6,20,2,True
4794138,522,0,10,1058,889412206,1,0,0,301.02,6,587688.44,18,2,20,3,True
4999212,641,0,25,7417,889412206,1,0,0,300.87,8,587387.57,24,6,17,4,True
5357923,267,0,20,6015,889412206,1,0,0,301.22,5,587086.35,6,0,10,4,True
5363281,694,2,20,7331,889412206,1,0,0,301.25,5,586785.1,24,2,19,4,True
5484024,364,4,451,4320,889412206,1,0,0,301.04,7,586484.06,25,5,5,5,True
5857559,641,0,451,1527,889412206,1,0,0,301.2,7,586182.86,24,0,19,5,True
6147341,1212,0,-1,8844,889412206,1,1,0,301.32,4,586182.86,24,2,20,6,True
6523300,577,0,25,1924,889412206,1,0,0,300.98,8,585881.88,11,5,12,6,True
6769250,641,0,451,6766,889412206,1,0,0,301.26,7,585580.62,24,4,1,7,True
6869932,641,0,30,1527,889412206,1,0,0,301.15,8,585279.47,24,6,5,7,True
7242364,893,4,25,6015,889412206,1,0,0,301.05,8,584978.42,24,5,4,9,True
7360263,1092,1,10,5730,889412206,1,0,0,300.87,6,585279.29,18,0,17,9,True
7629647,577,0,451,6338,889412206,1,0,0,300.97,7,584978.32,11,5,10,9,True
7869097,1317,4,-1,3627,889412206,1,1,0,301.05,1,584978.32,18,1,11,9,True
8099592,1317,4,-1,6611,889412206,1,2,0,301.03,4,584978.32,18,1,5,10,True
8123960,1317,4,451,9422,889412206,1,0,0,301.12,7,584677.2,18,3,1,1,True
8228476,309,0,10,7788,889412206,1,0,0,300.69,0,584977.89,4,6,9,2,True
8346287,577,0,25,7809,889412206,1,0,0,300.89,8,584677.0,11,5,22,2,True
8466905,1317,4,451,6611,889412206,1,0,0,300.87,7,584376.13,18,0,14,3,True
8634398,577,0,-1,4086,889412206,1,1,0,300.93,1,584376.13,11,3,6,4,True
8791585,1212,0,-1,4086,889412206,1,2,0,301.07,4,584376.13,24,3,4,6,True
8926478,1052,0,20,1909,889412206,1,0,0,301.34,5,584074.79,11,0,6,7,True
8942747,577,0,-1,6421,889412206,1,1,0,301.32,4,584074.79,11,4,1,7,True
8954083,524,1,10,1512,889412206,1,0,0,301.02,6,584375.81,18,4,20,7,True
9140125,1317,4,-1,7331,889412206,1,1,0,300.93,1,584375.81,18,1,6,8,True
9353429,641,0,25,7788,889412206,1,0,0,300.89,8,584074.92,24,4,23,8,True
9386869,577,0,30,7809,889412206,1,0,0,301.13,8,583773.79,11,5,8,8,True
9730271,577,0,451,2037,889412206,1,0,0,300.78,7,583473.01,11,2,13,9,True
9791440,1267,2,20,7809,889412206,1,0,0,301.03,5,583171.98,23,1,15,10,True
9816055,562,1,10,3094,889412206,1,0,0,300.87,6,583472.85,17,1,15,11,True
9890256,1212,0,-1,6654,889412206,1,1,0,300.84,1,583472.85,24,2,13,11,True
1140045,306,4,451,2371,426753339,0,0,0,606.77,7,494955.23,4,1,15,1,True
1734553,372,0,451,7367,426753339,0,0,0,606.96,7,494348.27,25,1,7,1,True
1798589,1173,1,30,4082,426753339,0,0,0,607.25,8,493741.02,24,0,1,2,True
1816232,1173,1,30,5877,426753339,0,0,0,607.08,8,493133.94,24,2,3,4,True
1946875,727,0,451,6694,426753339,0,0,0,607.08,7,492526.86,11,3,2,4,True
2383196,343,1,10,6921,426753339,0,0,0,607.22,0,493134.08,24,2,9,4,True
2549497,802,2,-1,7214,426753339,0,1,0,606.79,1,493134.08,11,6,1,4,True
2649235,907,0,10,7214,426753339,0,0,0,607.02,0,493741.1,2,4,7,5,True
2652153,1032,4,25,1321,426753339,0,0,0,606.98,8,493134.12,11,2,0,5,True
2760987,802,2,30,9288,426753339,0,0,0,607.11,8,492527.01,11,4,23,6,True
3058979,1032,4,-1,6625,426753339,0,1,0,606.99,1,492527.01,11,0,3,6,True
3173514,669,2,20,2985,426753339,0,0,0,607.2,5,491919.81,18,2,9,6,True
3293249,218,0,10,7529,426753339,0,0,0,607.11,6,492526.92,9,2,22,8,True
3426510,665,2,20,5972,426753339,0,0,0,606.62,5,491920.3,18,1,14,9,True
3806696,372,0,-1,5972,426753339,0,1,0,606.82,4,491920.3,25,0,3,10,True
3909724,1032,4,25,3838,426753339,0,0,0,607.02,8,491313.28,11,0,16,10,False
4265122,727,0,25,4082,426753339,0,0,0,606.84,8,490706.44,11,5,12,10,True
4265579,1173,1,30,1321,426753339,0,0,0,606.85,8,490099.59,24,2,18,11,True
4355527,550,0,10,7529,426753339,0,0,0,607.12,6,490706.71,17,3,15,11,True
4460703,373,1,10,6921,426753339,0,0,0,607.25,6,491313.96,25,0,10,11,False
4547773,1173,1,451,9288,426753339,0,0,0,607.33,7,490706.63,24,0,14,11,True
4763302,712,0,451,6921,426753339,0,0,0,606.93,7,490099.7,18,1,17,11,True
4833107,1173,1,30,5972,426753339,0,0,0,606.84,8,489492.86,24,2,15,12,True
5110932,727,0,25,7367,426753339,0,0,0,607.04,8,488885.82,11,3,19,1,True
5261909,851,1,10,4999,426753339,0,0,0,606.97,6,489492.79,5,0,10,2,True
5488961,1072,0,10,7214,426753339,0,0,0,607.33,6,490100.12,18,5,4,2,True
5742603,1032,4,30,1988,426753339,0,0,0,606.99,8,489493.13,11,3,21,3,True
6161663,712,0,30,2985,426753339,0,0,0,606.97,8,488886.16,18,4,16,4,True
6188564,1032,4,-1,6921,426753339,0,1,0,607.08,4,488886.16,11,3,20,4,True
6442051,372,0,25,3838,426753339,0,0,0,607.05,8,488279.11,25,4,23,4,True
6471658,1128,2,20,1381,426753339,0,0,0,607.05,3,487672.06,24,4,2,5,True
6666532,802,2,25,2371,426753339,0,0,0,607.12,8,487064.94,11,1,5,5,True
6744563,1173,1,451,7529,426753339,0,0,0,606.97,7,486457.97,24,3,12,5,True
6791926,708,2,20,9925,426753339,0,0,0,606.74,5,485851.23,18,0,21,5,True
7236729,1032,4,30,2041,426753339,0,0,0,607.15,8,485244.08,11,1,11,8,True
7273490,727,0,451,1988,426753339,0,0,0,606.98,7,484637.1,11,2,8,8,True
7443310,372,0,30,6459,426753339,0,0,0,606.79,8,484030.31,25,5,7,8,True
7524310,1032,4,-1,6217,426753339,0,1,0,607.05,4,484030.31,11,6,22,8,True
7821625,1173,1,25,6459,426753339,0,0,0,607.01,8,483423.3,24,4,5,9,True
7832496,1173,1,30,6694,426753339,0,0,0,607.11,8,482816.19,24,1,21,10,True
7888910,727,0,451,1381,426753339,0,0,0,607.13,7,482209.06,11,4,3,11,True
7891097,1032,4,30,7367,426753339,0,0,0,606.98,8,481602.08,11,1,18,11,True
8020547,372,0,451,1988,426753339,0,0,0,606.84,7,480995.24,25,1,18,11,True
8057273,1173,1,25,9031,426753339,0,0,0,606.94,8,480388.3,24,3,15,12,True
8106109,1032,4,-1,2179,426753339,0,1,0,607.21,4,480388.3,11,2,17,2,True
8399772,802,2,25,1381,426753339,0,0,0,606.96,8,479781.34,11,0,1,3,True
8735013,152,4,451,7367,426753339,0,0,0,607.23,7,479174.11,18,1,7,3,True
8835084,360,0,20,4999,426753339,0,0,0,607.27,3,478566.84,24,6,0,4,True
8842335,630,0,20,9288,426753339,0,0,0,607.07,5,477959.77,11,2,5,5,True
8898939,913,0,10,2371,426753339,0,0,0,607.03,6,478566.8,18,5,23,6,True
8957185,1213,2,20,1381,426753339,0,0,0,607.15,3,477959.65,24,0,9,8,True
8995824,564,0,10,1988,426753339,0,0,0,607.05,6,478566.7,17,4,7,9,True
9033450,1173,1,451,3838,426753339,0,0,0,606.85,7,477959.85,24,1,15,9,True
9100613,372,0,30,7065,426753339,0,0,0,606.92,8,477352.93,25,5,5,9,True
9355297,1032,4,25,2985,426753339,0,0,0,606.94,8,476745.99,11,0,7,10,True
9599854,1173,1,25,6459,426753339,0,0,0,607.13,8,476138.86,24,3,8,10,True
9605194,372,0,451,4999,426753339,0,0,0,606.91,7,475531.95,25,4,6,10,True
9724123,306,4,451,6694,426753339,0,0,0,606.79,7,474925.16,4,6,8,11,True
9778131,1173,1,451,6459,426753339,0,0,0,606.99,7,474318.17,24,6,5,11,True
1085943,1037,0,451,5017,831317152,0,0,0,389.02,7,448632.98,11,5,23,2,True
1102394,991,1,25,9953,831317152,0,0,0,389.05,8,448243.93,22,1,17,3,True
1104578,47,1,10,8370,831317152,0,0,0,389.07,6,448633.0,24,2,6,3,True
1222111,255,2,20,6756,831317152,0,0,0,388.89,5,448244.11,6,1,9,4,True
1257481,885,3,30,5865,831317152,0,0,0,389.02,8,447855.09,24,0,9,4,True
1452438,885,3,25,1723,831317152,0,0,0,389.12,8,447465.97,24,1,11,4,True
1664232,1037,0,25,6283,831317152,0,0,0,389.13,8,447076.84,11,4,11,5,True
1825482,409,4,25,8370,831317152,0,0,0,389.19,8,446687.65,10,4,18,5,True
1844448,409,4,25,7079,831317152,0,0,0,388.85,8,446298.8,10,1,11,7,True
2189033,834,0,20,7079,831317152,0,0,0,389.1,5,445909.7,5,2,14,7,True
2235028,1364,0,10,4326,831317152,0,0,0,389.39,6,446299.09,16,1,19,8,True
2304053,1037,0,30,5758,831317152,0,0,0,389.04,8,445910.05,11,3,4,8,True
2369227,409,4,30,2630,831317152,0,0,0,389.11,8,445520.94,10,3,3,9,True
2396751,1037,0,30,1575,831317152,0,0,0,389.32,8,445131.62,11,3,21,9,True
2497973,885,3,451,3236,831317152,0,0,0,389.27,7,444742.35,24,5,18,9,True
2734999,71,1,10,8808,831317152,0,0,0,389.01,6,445131.36,20,5,13,10,True
3001179,991,1,451,5264,831317152,0,0,0,388.96,7,444742.4,22,6,10,10,True
3325674,1406,0,20,9953,831317152,0,0,0,388.95,5,444353.45,24,2,13,11,True
3327595,1017,2,30,2360,831317152,0,0,0,389.11,8,443964.34,26,6,6,12,True
3350936,531,0,20,6331,831317152,0,0,0,389.04,3,443575.3,18,2,23,12,True
3498330,991,1,451,2630,831317152,0,0,0,388.74,7,443186.56,22,3,19,1,True
3550082,811,0,20,7079,831317152,0,0,0,388.7,5,442797.86,18,5,19,1,True
3824510,409,4,451,5016,831317152,0,0,0,389.14,7,442408.72,10,0,12,1,True
3856405,885,3,25,6283,831317152,0,0,0,389.06,8,442019.66,24,1,0,1,True
3908352,885,3,-1,4040,831317152,0,1,0,388.86,1,442019.66,24,0,20,2,True
4132093,1272,0,20,9769,831317152,0,0,0,389.17,3,441630.49,24,4,5,2,True
4308666,1034,1,10,6756,831317152,0,0,0,388.85,6,442019.34,11,3,3,3,True
4393241,1017,2,451,4918,831317152,0,0,0,388.89,7,441630.45,26,6,11,4,True
4420584,991,1,30,6331,831317152,0,0,0,389.26,8,441241.19,22,5,21,4,True
4475044,885,3,25,2435,831317152,0,0,0,388.99,8,440852.2,24,0,13,5,True
4595692,1017,2,30,5865,831317152,0,0,0,388.99,8,440463.21,26,3,5,5,True
4872688,991,1,451,4326,831317152,0,0,0,389.06,7,440074.15,22,0,11,6,True
4934165,1017,2,30,4040,831317152,0,0,0,388.89,8,439685.26,26,4,1,7,True
5099190,1017,2,30,6756,831317152,0,0,0,389.27,8,439295.99,26,1,17,7,True
5104095,991,1,30,2650,831317152,0,0,0,389.04,8,438906.95,22,6,2,7,True
5428118,962,0,10,6283,831317152,0,0,0,388.89,6,439295.84,13,1,3,8,True
5472386,409,4,451,3145,831317152,0,0,0,389.33,7,438906.51,10,4,3,8,True
5485682,885,3,30,5016,831317152,0,0,0,388.86,8,438517.65,24,4,2,9,True
5504184,991,1,25,1575,831317152,0,0,0,389.13,8,438128.52,22,2,2,9,True
5693605,885,3,451,8370,831317152,0,0,0,388.74,7,437739.78,24,1,1,10,True
6126753,885,3,-1,4918,831317152,0,1,0,389.2,4,437739.78,24,5,13,10,True
6268098,1037,0,30,8370,831317152,0,0,0,388.94,8,437350.84,11,3,18,10,True
6890419,316,2,20,5055,831317152,0,0,0,389.08,5,436961.76,4,3,23,1,True
7134195,219,0,20,8808,831317152,0,0,0,388.88,5,436572.88,9,4,18,5,True
7263859,1264,0,10,1723,831317152,0,0,0,389.24,6,436962.12,23,1,5,5,True
7351351,1476,0,10,5055,831317152,0,0,0,389.22,6,437351.34,24,1,18,5,True
7537021,991,1,-1,6283,831317152,0,1,0,389.13,1,437351.34,22,5,9,6,True
7566663,727,0,10,2360,831317152,0,0,0,389.02,6,437740.36,11,3,13,6,True
7604249,1318,0,10,2630,831317152,0,0,0,389.08,6,438129.44,18,2,22,6,True
7736193,885,3,-1,9953,831317152,0,1,0,389.12,4,438129.44,24,0,5,6,True
7774707,409,4,30,2423,831317152,0,0,0,388.86,8,437740.58,10,0,19,7,True
7775304,854,0,10,5758,831317152,0,0,0,388.94,0,438129.52,24,2,10,9,True
7876664,885,3,451,3107,831317152,0,0,0,388.99,7,437740.53,24,4,12,9,True
8001034,1017,2,-1,2650,831317152,0,1,0,389.02,1,437740.53,26,5,8,9,True
8251945,1037,0,-1,6283,831317152,0,2,0,388.81,4,437740.53,11,4,21,10,True
8323023,885,3,-1,5758,831317152,0,3,1,389.14,4,0.0,24,1,6,10,True
1022774,876,4,25,1407,199529444,0,0,0,324.18,8,967858.82,24,2,20,1,True
1061193,679,0,-1,8710,199529444,0,1,0,324.14,4,967858.82,24,1,7,1,True
1425683,1465,4,451,2100,199529444,0,0,0,323.87,7,967534.95,11,0,13,1,True
1440235,808,3,451,8898,199529444,0,0,0,324.3,7,967210.65,11,2,20,1,False
1681412,850,1,-1,5384,199529444,0,1,0,324.07,1,967210.65,5,2,1,2,True
1938492,850,1,451,8710,199529444,0,0,0,323.74,7,966886.91,5,3,14,3,True
1950445,679,0,25,8710,199529444,0,0,0,323.66,8,966563.25,24,4,2,3,True
2388510,470,1,451,5700,199529444,0,0,0,324.19,7,966239.06,5,6,11,5,True
2613888,549,1,10,5700,199529444,0,0,0,324.02,6,966563.08,17,1,12,5,True
2988868,808,3,25,5274,199529444,0,0,0,324.38,8,966238.7,11,0,4,5,True
3090692,1465,4,30,5069,199529444,0,0,0,323.95,8,965914.75,11,3,13,5,True
3186372,993,0,10,5587,199529444,0,0,0,324.19,0,966238.94,22,0,12,6,True
3258592,858,1,10,6420,199529444,0,0,0,324.13,6,966563.07,24,2,17,6,False
3596029,664,2,20,6703,199529444,0,0,0,323.95,5,966239.12,18,1,12,8,True
3662000,1465,4,30,1407,199529444,0,0,0,323.98,8,965915.14,11,0,16,9,False
3678391,1298,0,30,6254,199529444,0,0,0,324.01,8,965591.13,5,0,21,9,True
4563373,367,1,-1,3124,199529444,0,1,0,323.98,4,965591.13,25,4,0,10,True
4882411,1465,4,451,6703,199529444,0,0,0,324.05,7,965267.08,11,2,1,10,True
5176348,434,3,25,6995,199529444,0,0,0,324.0,8,964943.08,24,4,14,11,True
5187612,434,3,-1,8288,199529444,0,1,0,324.32,4,964943.08,24,6,7,11,True
5828133,1465,4,451,9212,199529444,0,0,0,323.95,7,964619.13,11,6,20,12,True
5937790,850,1,451,5700,199529444,0,0,0,324.2,7,964294.93,5,0,13,1,True
6131817,1298,0,451,8084,199529444,0,0,0,323.65,7,963971.28,5,4,3,1,True
6134994,367,1,451,6177,199529444,0,0,0,324.06,7,963647.22,25,5,12,1,True
6253902,367,1,30,6177,199529444,0,0,0,324.09,8,963323.13,25,0,20,2,True
6356587,808,3,451,6254,199529444,0,0,0,323.91,7,962999.22,11,5,4,3,True
6384400,652,0,10,5619,199529444,0,0,0,324.11,0,963323.33,24,2,20,4,True
6414938,1363,0,20,2100,199529444,0,0,0,323.91,5,962999.42,16,1,23,5,True
6454656,679,0,25,7967,199529444,0,0,0,324.05,8,962675.37,24,4,5,5,True
6516733,876,4,30,5384,199529444,0,0,0,323.83,8,962351.54,24,1,1,6,True
6939560,1298,0,451,1536,199529444,0,0,0,324.12,7,962027.42,5,2,14,8,True
7067117,367,1,25,8898,199529444,0,0,0,323.87,8,961703.55,25,2,7,8,True
7380613,1166,2,20,6995,199529444,0,0,0,324.03,5,961379.52,24,5,3,9,True
7538958,679,0,25,5587,199529444,0,0,0,323.91,8,961055.61,24,5,6,10,True
7907548,434,3,-1,6995,199529444,0,1,0,323.98,4,961055.61,24,0,8,11,True
8016700,998,0,10,6420,199529444,0,0,0,324.1,0,961379.71,26,1,3,11,True
8216309,376,0,20,5684,199529444,0,0,0,324.15,5,961055.56,25,0,5,12,True
8379845,679,0,25,5069,199529444,0,0,0,324.13,8,960731.43,24,0,22,12,True
8532077,1298,0,30,5619,199529444,0,0,0,324.19,8,960407.24,5,2,0,12,True
8763515,850,1,25,9212,199529444,0,0,0,323.96,8,960083.28,5,6,2,2,True
8764936,434,3,451,2100,199529444,0,0,0,323.86,7,959759.42,24,0,15,2,True
8774592,876,4,-1,4705,199529444,0,1,0,324.32,4,959759.42,24,4,15,4,True
8949656,530,0,20,6420,199529444,0,0,0,323.9,5,959435.52,18,5,8,4,False
8985886,876,4,25,6420,199529444,0,0,0,323.68,8,959111.84,24,3,19,5,True
8998250,498,0,20,8898,199529444,0,0,0,323.93,5,958787.91,12,0,17,5,True
9522943,367,1,30,5384,199529444,0,0,0,324.01,8,958463.9,25,6,6,5,True
9689323,434,3,25,6420,199529444,0,0,0,324.1,8,958139.8,24,5,14,6,True
9699880,850,1,30,6177,199529444,0,0,0,324.03,8,957815.77,5,0,4,8,True
9783176,850,1,-1,1407,199529444,0,1,0,324.0,4,957815.77,5,1,8,9,True
9873996,876,4,30,5069,199529444,0,0,0,323.87,8,957491.9,24,1,18,10,True
9906372,1465,4,451,1407,199529444,0,0,0,323.88,7,957168.02,11,1,16,11,True
9999697,679,0,451,1407,199529444,0,0,0,323.96,7,956844.06,24,6,11,11,True
1011815,1076,1,25,1542,734726720,0,0,0,709.98,8,883726.02,18,5,23,1,True
1144924,795,4,451,1031,734726720,0,0,0,710.03,7,883015.99,11,6,8,1,True
1257109,1142,2,20,6822,734726720,0,0,0,710.02,5,882305.97,15,1,17,2,True
1605299,942,0,30,9963,734726720,0,0,0,710.07,8,881595.9,24,4,6,2,True
1764980,135,2,20,8728,734726720,0,0,0,709.88,3,880886.02,18,1,6,2,True
1776717,1076,1,25,3592,734726720,0,0,0,710.18,8,880175.84,18,1,3,3,True
1786149,1076,1,30,1031,734726720,0,0,0,710.34,8,879465.5,18,4,13,4,True
1908608,365,0,-1,1031,734726720,0,1,0,710.08,4,879465.5,25,5,12,5,True
2012523,518,2,20,7739,734726720,0,0,0,710.06,3,878755.44,18,6,10,5,True
2076355,1089,0,10,8728,734726720,0,0,0,709.82,6,879465.26,18,5,1,6,True
2219037,942,0,-1,7739,734726720,0,1,0,710.19,1,879465.26,24,3,18,6,True
2574217,1076,1,451,3584,734726720,0,0,0,710.23,7,878755.03,18,4,13,7,False
2582725,503,0,10,1542,734726720,0,0,0,709.85,6,879464.88,12,6,5,7,True
2730708,52,4,25,3605,734726720,0,0,0,710.05,8,878754.83,20,0,20,10,True
2750198,365,0,451,9640,734726720,0,0,0,710.2,7,878044.63,25,4,10,10,True
2802095,1206,0,20,7739,734726720,0,0,0,710.1,5,877334.53,24,0,12,11,True
2939344,224,3,-1,1031,734726720,0,1,0,709.86,4,877334.53,26,3,6,12,True
3188349,1076,1,-1,9963,734726720,0,2,0,709.6,1,877334.53,18,4,7,12,True
3218951,148,1,10,3584,734726720,0,0,0,710.08,0,878044.61,18,5,13,1,True
3287477,52,4,-1,1031,734726720,0,1,0,709.99,4,878044.61,20,0,18,1,True
3447041,365,0,30,8728,734726720,0,0,0,710.18,8,877334.43,25,4,12,3,True
3634307,865,0,10,6387,734726720,0,0,0,709.94,6,878044.37,24,0,21,4,True
4194793,795,4,451,6387,734726720,0,0,0,710.11,7,877334.26,11,5,2,6,True
4406204,224,3,451,7279,734726720,0,0,0,710.1,7,876624.16,26,2,16,6,True
4488174,914,2,20,7841,734726720,0,0,0,710.15,3,875914.01,18,2,10,7,True
4621287,696,2,20,9963,734726720,0,0,0,709.97,3,875204.04,24,3,10,7,True
4637521,365,0,451,9084,734726720,0,0,0,709.71,7,874494.33,25,2,10,7,False
4983907,211,0,10,2685,734726720,0,0,0,710.34,0,875204.67,9,1,12,7,True
5171186,224,3,30,7841,734726720,0,0,0,709.72,8,874494.95,26,6,0,8,True
5318791,795,4,451,9640,734726720,0,0,0,709.8,7,873785.15,11,1,5,8,True
5565066,52,4,451,5264,734726720,0,0,0,709.89,7,873075.26,20,1,18,8,True
5611023,1076,1,25,7279,734726720,0,0,0,709.96,8,872365.3,18,0,12,8,True
5778445,224,3,25,5576,734726720,0,0,0,709.95,8,871655.35,26,3,7,8,True
5868363,52,4,25,3592,734726720,0,0,0,709.98,8,870945.37,20,3,21,11,True
6257864,114,0,20,1031,734726720,0,0,0,709.93,5,870235.44,3,4,6,12,True
6522298,1076,1,30,6822,734726720,0,0,0,710.09,8,869525.35,18,1,2,12,True
6700695,795,4,25,5015,734726720,0,0,0,710.08,8,868815.27,11,5,15,12,True
7159591,804,0,20,5015,734726720,0,0,0,709.8,5,868105.47,11,1,14,1,True
7187041,1076,1,25,3592,734726720,0,0,0,709.9,8,867395.57,18,1,5,1,True
7390919,942,0,-1,6822,734726720,0,1,0,710.17,4,867395.57,24,1,0,5,True
7430325,1076,1,-1,3605,734726720,0,2,0,710.14,4,867395.57,18,5,12,5,True
8062005,365,0,30,5576,734726720,0,0,0,709.87,8,866685.7,25,5,5,6,True
8336400,677,0,10,5264,734726720,0,0,0,709.94,6,867395.64,24,6,16,6,True
8443429,795,4,451,3592,734726720,0,0,0,710.23,7,866685.41,11,0,3,7,True
8788429,942,0,451,7739,734726720,0,0,0,710.02,7,865975.39,24,4,9,7,True
8788731,1076,1,25,3592,734726720,0,0,0,709.95,8,865265.44,18,1,10,7,True
8932268,1445,2,20,1542,734726720,0,0,0,710.2,3,864555.24,24,0,15,7,True
9173752,365,0,-1,7739,734726720,0,1,0,709.96,4,864555.24,25,2,5,9,True
9202702,135,2,20,7279,734726720,0,0,0,710.06,5,863845.18,18,0,8,9,True
9379193,942,0,451,9243,734726720,0,0,0,709.91,7,863135.27,24,1,11,10,True
9563050,795,4,25,8728,734726720,0,0,0,710.15,8,862425.12,11,6,0,11,True
9800931,52,4,30,9640,734726720,0,0,0,710.3,8,861714.82,20,6,10,11,True
9885122,942,0,30,7167,734726720,0,0,0,710.1,8,861004.72,24,3,9,11,True
1069326,41,2,-1,3590,266837317,0,1,0,1152.11,1,199897.0,11,2,15,1,True
1092648,41,2,451,4623,266837317,0,0,0,1152.23,7,198744.77,11,1,23,2,True
1534013,333,1,-1,1037,266837317,0,1,0,1152.11,1,198744.77,11,4,12,3,True
2186785,1315,0,451,7885,266837317,0,0,0,1151.73,7,197593.04,5,6,11,3,True
2573937,1315,0,30,3955,266837317,0,0,0,1151.82,8,196441.22,5,5,1,3,True
2634395,1429,0,-1,9261,266837317,0,1,0,1152.08,4,196441.22,24,6,4,3,True
3117134,1429,0,-1,3955,266837317,0,2,0,1152.38,1,196441.22,24,2,11,4,True
3260052,333,1,25,3955,266837317,0,0,0,1152.13,8,195289.09,11,5,14,4,False
3405639,1429,0,451,1218,266837317,0,0,0,1151.78,7,194137.31,24,3,10,5,True
3431657,1315,0,451,9914,266837317,0,0,0,1152.01,7,192985.3,5,0,10,5,True
3436124,605,0,10,6239,266837317,0,0,0,1151.98,6,194137.28,24,2,20,6,True
3451933,1315,0,451,6713,266837317,0,0,0,1151.93,7,192985.35,5,5,22,6,True
3495180,333,1,451,3955,266837317,0,0,0,1151.95,7,191833.4,11,1,16,8,True
3721465,1429,0,30,5749,266837317,0,0,0,1151.95,8,190681.45,24,4,17,9,True
3740311,1315,0,25,9914,266837317,0,0,0,1152.26,8,189529.19,5,3,22,10,True
3758613,605,0,20,3598,266837317,0,0,0,1152.19,5,188377.0,24,6,5,11,True
4118356,130,0,20,5550,266837317,0,0,0,1152.0,5,187225.0,18,6,9,11,True
4232698,1429,0,451,9820,266837317,0,0,0,1152.01,7,186072.99,24,0,17,11,True
4246760,1429,0,25,5593,266837317,0,0,0,1151.95,8,184921.04,24,2,10,11,True
4388210,1429,0,30,8651,266837317,0,0,0,1152.05,8,183768.99,24,2,7,12,True
4430003,1429,0,25,6239,266837317,0,0,0,1151.82,8,182617.17,24,2,19,12,True
4458726,1215,3,-1,9913,266837317,0,1,0,1151.66,4,182617.17,24,3,6,12,True
4591274,1429,0,25,7886,266837317,0,0,0,1151.88,8,181465.29,24,3,22,12,True
4803651,1429,0,-1,1037,266837317,0,1,0,1151.85,1,181465.29,24,2,15,1,True
5162109,627,0,10,1901,266837317,0,0,0,1152.06,0,182617.35,11,4,18,2,True
5241443,1429,0,-1,1508,266837317,0,1,0,1152.18,4,182617.35,24,4,17,2,True
5944421,1215,3,25,9371,266837317,0,0,0,1152.12,8,181465.23,24,6,5,4,True
5980271,459,1,10,9820,266837317,0,0,0,1152.09,6,182617.32,13,2,12,4,True
6151607,1315,0,25,6276,266837317,0,0,0,1152.18,8,181465.14,5,0,0,4,True
6269108,333,1,30,9371,266837317,0,0,0,1151.96,8,180313.18,11,6,2,5,True
6515955,551,0,20,7886,266837317,0,0,0,1152.25,5,179160.93,17,3,19,5,True
6574929,1012,0,20,4461,266837317,0,0,0,1151.86,5,178009.07,26,6,22,5,True
6871531,333,1,451,9914,266837317,0,0,0,1151.78,7,176857.29,11,2,23,8,True
6962981,1315,0,451,5749,266837317,0,0,0,1151.83,7,175705.46,5,1,15,8,True
7138924,1227,0,20,5593,266837317,0,0,0,1152.19,3,174553.27,18,3,22,9,True
7274523,1215,3,30,3955,266837317,0,0,0,1151.98,8,173401.29,24,1,11,10,True
7284057,1215,3,451,9913,266837317,0,0,0,1151.96,7,172249.33,24,4,0,10,True
7373720,1169,0,20,3098,266837317,0,0,0,1151.9,5,171097.43,24,1,10,1,True
7501016,41,2,-1,4461,266837317,0,1,0,1151.89,4,171097.43,11,0,0,3,True
7581818,333,1,25,3098,266837317,0,0,0,1151.95,8,169945.48,11,4,10,3,True
8082478,266,2,20,3590,266837317,0,0,0,1151.81,3,168793.67,6,3,11,3,True
8376689,792,1,10,6713,266837317,0,0,0,1151.95,6,169945.62,11,6,23,4,True
8628973,834,0,20,5593,266837317,0,0,0,1152.03,5,168793.59,5,3,10,5,True
8751542,1315,0,25,1508,266837317,0,0,0,1151.78,8,167641.81,5,1,12,5,True
8856211,1108,1,10,9371,266837317,0,0,0,1151.99,0,168793.8,0,1,20,6,True
8910314,1429,0,451,5593,266837317,0,0,0,1151.75,7,167642.05,24,5,0,6,True
9014218,1315,0,25,6713,266837317,0,0,0,1151.84,8,166490.21,5,0,19,7,True
9028658,1215,3,25,1218,266837317,0,0,0,1151.86,8,165338.35,24,6,17,8,True
9075589,41,2,-1,7886,266837317,0,1,0,1151.87,4,165338.35,11,1,23,8,True
9423675,333,1,-1,8820,266837317,0,2,0,1151.91,4,165338.35,11,3,4,10,True
9664122,1215,3,25,3955,266837317,0,0,0,1152.18,8,164186.17,24,3,12,10,False
1459657,1388,1,25,5023,343352047,1,0,0,977.6,8,79166.4,24,0,19,1,True
1488337,1349,3,25,5380,343352047,1,0,0,978.08,8,78188.32,24,0,11,1,True
1531626,297,0,10,8945,343352047,1,0,0,978.11,6,79166.43,4,3,21,3,True
1667420,1058,4,30,1067,343352047,1,0,0,977.95,8,78188.48,11,4,12,6,True
1760864,117,1,10,9307,343352047,1,0,0,977.94,6,79166.42,18,2,16,6,True
1946547,814,4,30,6953,343352047,1,0,0,978.12,8,78188.3,18,2,1,6,True
2076265,446,1,10,8804,343352047,1,0,0,977.99,6,79166.29,13,0,3,8,True
2099712,814,4,-1,2900,343352047,1,1,0,978.1,4,79166.29,18,2,16,8,True
2269792,1280,3,-1,7787,343352047,1,2,0,978.1,1,79166.29,24,5,16,8,True
2375224,1349,3,25,2900,343352047,1,0,0,978.08,8,78188.21,24,2,20,9,True
2381888,1349,3,30,8945,343352047,1,0,0,977.73,8,77210.48,24,5,18,9,True
2528050,729,0,20,9263,343352047,1,0,0,978.14,5,76232.34,11,6,18,10,True
2773369,297,0,20,8945,343352047,1,0,0,977.96,3,75254.38,4,2,20,10,True
2833993,1250,1,10,5644,343352047,1,0,0,978.04,6,76232.42,23,3,1,10,True
2968675,1159,0,10,8804,343352047,1,0,0,977.82,6,77210.24,15,5,3,10,True
2994042,373,1,10,1830,343352047,1,0,0,978.09,0,78188.33,25,1,20,10,True
3420324,1388,1,-1,6953,343352047,1,1,0,977.94,4,78188.33,24,3,23,1,True
3451077,1349,3,451,8804,343352047,1,0,0,978.08,7,77210.25,24,5,17,1,True
3797949,1349,3,30,1067,343352047,1,0,0,977.91,8,76232.34,24,5,0,2,True
3948979,1144,2,20,8945,343352047,1,0,0,978.53,3,75253.81,15,4,12,2,True
4014882,1058,4,451,5023,343352047,1,0,0,977.98,7,74275.83,11,0,0,4,True
4814023,1315,0,10,8984,343352047,1,0,0,978.12,6,75253.95,5,0,14,4,True
4982381,653,1,-1,5380,343352047,1,1,0,978.04,4,75253.95,24,4,22,5,True
5121812,1124,0,30,1830,343352047,1,0,0,978.06,8,74275.89,24,2,13,5,True
5683215,1280,3,25,6953,343352047,1,0,0,977.83,8,73298.06,24,0,5,6,True
5768139,814,4,-1,1431,343352047,1,1,0,977.85,1,73298.06,18,1,23,7,True
6077728,1089,0,10,8076,343352047,1,0,0,977.87,6,74275.93,18,3,1,7,True
6132738,1388,1,30,7787,343352047,1,0,0,978.28,8,73297.65,24,4,6,8,True
6727267,1388,1,25,7787,343352047,1,0,0,977.78,8,72319.87,24,6,20,8,True
7069799,1058,4,30,1830,343352047,1,0,0,977.93,8,71341.94,11,3,13,9,True
7096360,1349,3,25,5023,343352047,1,0,0,978.12,8,70363.82,24,4,20,9,True
7254465,814,4,25,9348,343352047,1,0,0,978.03,8,69385.79,18,3,22,9,True
7301082,1435,2,20,5023,343352047,1,0,0,977.92,5,68407.87,24,2,2,10,True
7498481,814,4,30,9348,343352047,1,0,0,978.0,8,67429.87,18,0,20,11,True
7585585,807,0,10,8984,343352047,1,0,0,978.04,6,68407.91,11,4,6,12,True
7952653,1124,0,25,9348,343352047,1,0,0,977.99,8,67429.92,24,2,13,12,True
8284884,1169,0,10,2900,343352047,1,0,0,978.0,6,68407.92,24,1,1,1,True
8315594,1260,0,10,9263,343352047,1,0,0,978.17,6,69386.09,23,4,11,1,True
8480401,818,1,10,5023,343352047,1,0,0,977.86,6,70363.95,18,6,14,2,True
8484261,1015,0,10,5380,343352047,1,0,0,977.99,6,71341.94,26,6,23,3,True
8642639,1388,1,451,8945,343352047,1,0,0,977.97,7,70363.97,24,5,11,4,True
8673931,1364,0,10,8076,343352047,1,0,0,978.04,6,71342.01,16,6,8,4,True
8906754,1093,0,451,1830,343352047,1,0,0,977.95,7,70364.06,18,6,13,4,True
9132934,1345,2,20,8804,343352047,1,0,0,977.9,3,69386.16,24,1,8,5,True
9453713,814,4,25,1431,343352047,1,0,0,977.67,8,68408.49,18,1,4,5,True
9508730,814,4,25,4489,343352047,1,0,0,978.07,8,67430.42,18,5,23,6,True
9634302,1058,4,-1,8945,343352047,1,1,0,978.07,4,67430.42,11,6,1,6,True
9661167,630,0,20,7787,343352047,1,0,0,977.96,5,66452.46,11,3,16,6,True
9684605,1058,4,30,7787,343352047,1,0,0,978.09,8,65474.37,11,2,16,8,True
9705085,1076,1,10,9307,343352047,1,0,0,978.23,6,66452.6,18,5,4,9,True
9792417,653,1,30,1067,343352047,1,0,0,978.2,8,65474.4,24,1,8,10,False
9907564,814,4,25,8945,343352047,1,0,0,977.82,8,64496.58,18,3,7,10,True
9985070,1146,2,20,4247,343352047,1,0,0,977.98,3,63518.6,15,6,14,10,True
1070648,962,0,-1,6489,287387513,1,1,0,548.93,1,583045.0,13,2,14,4,True
1148722,1289,1,10,7874,287387513,1,0,0,548.87,6,583593.87,24,2,0,5,False
1380517,1435,2,25,6489,287387513,1,0,0,549.19,8,583044.68,24,1,9,5,True
1958173,599,0,10,7782,287387513,1,0,0,548.79,6,583593.47,24,5,18,6,True
2027941,233,4,30,3449,287387513,1,0,0,549.03,8,583044.44,26,2,23,6,True
2085487,783,0,10,6489,287387513,1,0,0,549.07,6,583593.51,14,3,10,6,True
2155745,362,0,20,6720,287387513,1,0,0,548.93,5,583044.58,24,0,17,7,True
2585828,233,4,-1,5076,287387513,1,1,0,548.88,1,583044.58,26,6,14,9,True
2686693,1050,4,451,6489,287387513,1,0,0,548.95,7,582495.63,11,2,16,10,True
2700321,1435,2,-1,3449,287387513,1,1,0,548.9,4,582495.63,24,2,17,10,True
3255829,287,0,10,6809,287387513,1,0,0,549.08,6,583044.71,24,3,0,10,True
3660989,809,3,451,2699,287387513,1,0,0,548.91,7,582495.8,11,4,4,10,True
3951200,1435,2,30,4290,287387513,1,0,0,549.24,8,581946.56,24,1,11,1,True
3962131,1169,0,10,6931,287387513,1,0,0,549.21,0,582495.77,24,3,23,3,True
4098505,809,3,30,7263,287387513,1,0,0,548.94,8,581946.83,11,1,15,3,True
4213642,962,0,25,3328,287387513,1,0,0,549.17,8,581397.66,13,3,5,4,True
4521260,233,4,30,3108,287387513,1,0,0,548.98,8,580848.68,26,4,11,4,True
5082799,1164,0,20,2699,287387513,1,0,0,548.83,3,580299.85,24,5,11,5,True
5118869,1435,2,451,6931,287387513,1,0,0,548.94,7,579750.91,24,6,4,5,True
5287752,809,3,25,2699,287387513,1,0,0,549.15,8,579201.76,11,6,4,6,True
5342559,809,3,451,6931,287387513,1,0,0,548.93,7,578652.83,11,0,11,6,True
5462494,303,0,20,6720,287387513,1,0,0,549.04,5,578103.79,4,0,1,7,True
5950448,809,3,25,3449,287387513,1,0,0,549.03,8,577554.76,11,4,6,8,True
6012258,962,0,-1,5647,287387513,1,1,0,548.98,4,577554.76,13,4,15,9,True
6188948,1050,4,25,4290,287387513,1,0,0,548.96,8,577005.8,11,6,6,10,True
6366808,233,4,451,7782,287387513,1,0,0,548.94,7,576456.86,26,0,2,11,True
6511648,522,0,10,2699,287387513,1,0,0,548.77,6,577005.63,18,0,4,11,True
6648414,233,4,30,3108,287387513,1,0,0,548.91,8,576456.72,26,1,18,11,True
6869118,962,0,-1,1219,287387513,1,1,0,548.63,4,576456.72,13,4,18,12,True
7074475,962,0,-1,7782,287387513,1,2,0,549.14,1,576456.72,13,6,13,1,True
7328344,809,3,30,4007,287387513,1,0,0,549.01,8,575907.71,11,0,18,1,True
7797565,747,1,10,6489,287387513,1,0,0,548.95,6,576456.66,24,3,9,1,True
7828543,68,0,10,3449,287387513,1,0,0,549.21,6,577005.87,20,4,4,1,True
8120894,1050,4,451,8279,287387513,1,0,0,548.77,7,576457.1,11,6,20,1,True
8171835,809,3,30,5647,287387513,1,0,0,549.19,8,575907.91,11,4,19,1,True
8244052,1050,4,30,1219,287387513,1,0,0,548.55,8,575359.36,11,5,1,1,True
8275188,1485,0,10,7874,287387513,1,0,0,548.94,0,575908.3,24,4,11,2,True
8359554,858,1,10,7782,287387513,1,0,0,549.1,6,576457.4,24,2,12,3,True
8406430,312,0,20,5647,287387513,1,0,0,549.01,3,575908.39,4,5,20,4,True
8671166,1435,2,25,3449,287387513,1,0,0,548.84,8,575359.55,24,4,2,4,True
8722070,681,2,20,2677,287387513,1,0,0,548.81,3,574810.74,24,6,2,5,True
8941765,809,3,30,1158,287387513,1,0,0,548.79,8,574261.95,11,4,14,5,True
9050815,1359,2,20,5076,287387513,1,0,0,548.89,3,573713.06,24,0,5,6,True
9055363,1072,0,10,6489,287387513,1,0,0,549.02,6,574262.08,18,5,9,6,True
9226603,393,1,10,6489,287387513,1,0,0,548.82,6,574810.9,10,0,3,6,True
9268019,438,1,10,6931,287387513,1,0,0,548.85,6,575359.75,24,3,8,7,True
9277335,1050,4,30,5076,287387513,1,0,0,549.3,8,574810.45,11,5,7,7,True
9429296,1050,4,30,3108,287387513,1,0,0,549.09,8,574261.36,11,3,22,9,True
9475813,1435,2,451,7874,287387513,1,0,0,548.62,7,573712.74,24,3,22,10,True
9616746,233,4,-1,1158,287387513,1,1,0,549.1,4,573712.74,26,1,23,11,True
9705580,53,0,10,5076,287387513,1,0,0,549.02,0,574261.76,20,3,11,11,True
1108981,1044,0,10,9452,559074906,1,0,0,1084.28,0,965954.28,11,3,12,2,True
1442571,111,3,-1,5902,559074906,1,1,0,1084.15,4,965954.28,3,6,1,3,True
1603385,645,0,20,4255,559074906,1,0,0,1083.8,3,964870.48,24,3,5,3,True
1621006,1074,4,-1,2631,559074906,1,1,0,1084.08,4,964870.48,18,4,3,4,True
2001087,1376,3,451,9452,559074906,1,0,0,1083.71,7,963786.77,16,1,15,4,True
2651150,551,0,20,6543,559074906,1,0,0,1084.06,5,962702.71,17,5,6,4,True
2716493,281,1,-1,4255,559074906,1,1,0,1083.82,1,962702.71,24,6,0,6,True
2755463,257,1,30,6280,559074906,1,0,0,1083.95,8,961618.76,6,6,15,6,True
2819666,1118,4,451,4129,559074906,1,0,0,1084.26,7,960534.5,24,5,5,7,True
2900659,111,3,451,2208,559074906,1,0,0,1083.95,7,959450.55,3,5,3,8,True
2928611,989,1,10,5801,559074906,1,0,0,1083.97,6,960534.52,22,6,15,8,True
2944679,147,0,10,1435,559074906,1,0,0,1083.88,6,961618.4,18,5,14,8,True
3314242,1118,4,451,5722,559074906,1,0,0,1083.95,7,960534.45,24,0,0,9,True
3617052,129,0,10,2669,559074906,1,0,0,1083.92,6,961618.37,18,3,18,9,True
3753770,111,3,30,9452,559074906,1,0,0,1083.89,8,960534.48,3,4,13,9,True
3894200,281,1,451,4129,559074906,1,0,0,1083.87,7,959450.61,24,5,1,10,True
3960967,257,1,-1,5801,559074906,1,1,0,1083.84,1,959450.61,6,0,22,11,True
4515884,111,3,451,4960,559074906,1,0,0,1083.85,7,958366.76,3,1,9,11,True
4769903,1118,4,-1,6543,559074906,1,1,0,1084.1,4,958366.76,24,5,10,1,True
5341731,304,0,10,2631,559074906,1,0,0,1084.11,6,959450.87,4,5,1,1,True
5388121,1118,4,25,6543,559074906,1,0,0,1084.02,8,958366.85,24,5,7,1,True
5536525,1074,4,451,1478,559074906,1,0,0,1084.16,7,957282.69,18,3,7,2,True
5631364,1118,4,451,4446,559074906,1,0,0,1083.85,7,956198.84,24,0,2,2,True
5809361,929,0,20,6543,559074906,1,0,0,1084.07,3,955114.77,18,2,23,2,True
5971371,1074,4,-1,5902,559074906,1,1,0,1084.14,4,955114.77,18,3,21,2,True
5978848,715,0,10,6982,559074906,1,0,0,1084.34,6,956199.11,18,0,4,6,True
5991840,1376,3,25,1478,559074906,1,0,0,1083.65,8,955115.46,16,5,23,6,True
6009760,111,3,451,4255,559074906,1,0,0,1083.59,7,954031.87,3,2,20,6,True
6114355,1074,4,451,4434,559074906,1,0,0,1083.96,7,952947.91,18,4,5,6,True
6230392,257,1,451,6543,559074906,1,0,0,1084.01,7,951863.9,6,0,2,7,True
6532075,111,3,-1,1478,559074906,1,1,0,1084.07,4,951863.9,3,3,14,7,True
6556908,281,1,451,2669,559074906,1,0,0,1084.13,7,950779.77,24,6,2,8,True
6758518,1118,4,451,6982,559074906,1,0,0,1083.95,7,949695.82,24,1,5,8,True
6851982,281,1,25,6280,559074906,1,0,0,1084.12,8,948611.7,24,2,23,9,True
7243549,111,3,30,4446,559074906,1,0,0,1083.79,8,947527.91,3,3,0,10,True
7532356,1074,4,25,5801,559074906,1,0,0,1083.78,8,946444.13,18,2,5,11,True
7551146,1376,3,-1,6543,559074906,1,1,0,1083.89,4,946444.13,16,3,2,11,True
7713393,956,1,10,2208,559074906,1,0,0,1084.12,6,947528.25,13,2,11,1,True
8003342,1074,4,30,5821,559074906,1,0,0,1084.15,8,946444.1,18,0,15,1,True
8206111,1012,0,20,2631,559074906,1,0,0,1084.17,3,945359.93,26,0,16,2,True
8220764,257,1,30,4960,559074906,1,0,0,1083.94,8,944275.99,6,1,8,4,True
8239214,630,0,20,5722,559074906,1,0,0,1084.0,3,943191.99,11,3,6,4,True
8244124,1074,4,-1,5902,559074906,1,1,0,1083.82,1,943191.99,18,4,15,5,True
8603826,111,3,451,4960,559074906,1,0,0,1083.83,7,942108.16,3,6,14,5,True
8709947,183,1,10,2208,559074906,1,0,0,1083.91,6,943192.07,18,1,3,6,True
8826331,281,1,30,5722,559074906,1,0,0,1084.09,8,942107.98,24,3,20,6,True
8903456,587,2,20,2669,559074906,1,0,0,1083.83,3,941024.15,24,5,21,7,True
8904245,1227,0,20,6982,559074906,1,0,0,1083.92,5,939940.23,18,5,2,7,True
9203131,257,1,25,6543,559074906,1,0,0,1084.13,8,938856.1,6,3,11,9,True
9475600,1118,4,-1,8095,559074906,1,1,0,1084.1,4,938856.1,24,5,5,9,True
9612969,281,1,451,4446,559074906,1,0,0,1084.12,7,937771.98,24,5,13,10,True
9673124,1376,3,30,2669,559074906,1,0,0,1083.8,8,936688.18,16,2,19,11,True
9921170,1118,4,-1,6982,559074906,1,1,0,1083.83,4,936688.18,24,1,18,11,True
9984770,1376,3,25,8095,559074906,1,0,0,1084.01,8,935604.17,16,3,21,11,True
1276670,567,1,-1,1906,969547546,1,1,0,996.14,4,952621.0,11,5,20,5,True
1328933,567,1,-1,8456,969547546,1,2,0,996.36,4,952621.0,11,4,21,6,True
1641507,874,4,-1,2773,969547546,1,3,1,995.78,4,952621.0,24,4,21,9,True
1084230,800,0,10,1956,919161352,1,0,0,274.63,6,250144.63,11,3,5,1,True
1315579,417,3,-1,4563,919161352,1,1,0,274.85,4,250144.63,18,4,11,2,True
1409480,53,0,10,9568,919161352,1,0,0,274.89,6,250419.52,20,3,7,3,True
1449016,1140,0,451,7594,919161352,1,0,0,275.04,7,250144.48,15,3,18,3,False
1595528,645,0,10,7011,919161352,1,0,0,274.99,6,250419.47,24,0,2,3,True
1620985,417,3,451,4359,919161352,1,0,0,274.88,7,250144.59,18,3,10,3,True
1794860,696,2,20,3730,919161352,1,0,0,275.15,3,249869.44,24,3,19,4,True
1828380,339,4,25,9119,919161352,1,0,0,274.98,8,249594.46,11,3,19,5,True
2021572,376,0,20,9508,919161352,1,0,0,275.01,5,249319.45,25,6,6,5,True
2369965,509,0,20,4135,919161352,1,0,0,274.91,5,249044.54,12,1,23,6,True
2397239,339,4,451,4359,919161352,1,0,0,274.99,7,248769.55,11,3,20,7,True
2426988,1242,4,-1,5997,919161352,1,1,0,275.5,4,248769.55,18,2,5,7,True
2488674,1140,0,25,9971,919161352,1,0,0,275.12,8,248494.43,15,3,15,8,True
2711174,1242,4,30,3730,919161352,1,0,0,275.18,8,248219.25,18,6,2,8,True
2911828,1140,0,451,3779,919161352,1,0,0,274.69,7,247944.56,15,6,20,9,False
3108749,339,4,30,3061,919161352,1,0,0,275.05,8,247669.51,11,5,3,10,True
3400524,918,2,20,9810,919161352,1,0,0,275.08,5,247394.43,18,4,2,10,True
3515830,1242,4,-1,3779,919161352,1,1,0,275.14,1,247394.43,18,4,20,10,True
3541381,339,4,451,7594,919161352,1,0,0,275.17,7,247119.26,11,1,13,10,True
3735716,339,4,451,3287,919161352,1,0,0,275.11,7,246844.15,11,5,10,10,True
4197764,417,3,25,9568,919161352,1,0,0,275.06,8,246569.09,18,2,23,11,True
4385576,339,4,451,5176,919161352,1,0,0,274.88,7,246294.21,11,0,1,11,True
4403290,816,0,20,5176,919161352,1,0,0,275.07,3,246019.14,18,2,2,2,True
4787309,123,0,451,6009,919161352,1,0,0,274.81,7,245744.33,18,2,2,3,True
5098141,123,0,-1,4983,919161352,1,1,0,274.77,1,245744.33,18,1,21,3,True
5250040,417,3,-1,5176,919161352,1,2,0,275.06,4,245744.33,18,6,18,3,True
5250512,1242,4,30,9810,919161352,1,0,0,275.17,8,245469.16,18,2,19,3,True
5280360,123,0,-1,3465,919161352,1,1,0,274.95,4,245469.16,18,6,1,5,True
5292014,1140,0,451,9810,919161352,1,0,0,274.72,7,245194.44,15,0,0,6,True
5351594,748,1,10,9568,919161352,1,0,0,275.03,0,245469.47,24,3,19,6,True
5408351,123,0,451,4135,919161352,1,0,0,274.91,7,245194.56,18,5,8,6,False
5413280,562,1,10,9508,919161352,1,0,0,275.01,6,245469.57,17,5,23,6,False
5564229,1140,0,30,5778,919161352,1,0,0,275.08,8,245194.49,15,3,18,7,True
5712450,123,0,451,4737,919161352,1,0,0,275.0,7,244919.49,18,4,4,7,True
6157705,1140,0,451,6318,919161352,1,0,0,274.95,7,244644.54,15,1,6,8,True
6181793,123,0,451,9810,919161352,1,0,0,275.03,7,244369.51,18,0,22,9,False
6246117,123,0,30,9810,919161352,1,0,0,274.94,8,244094.57,18,1,8,9,True
6316856,1242,4,25,4135,919161352,1,0,0,275.01,8,243819.56,18,4,11,9,True
6561554,1140,0,-1,4820,919161352,1,1,0,275.25,1,243819.56,15,0,20,10,True
6678642,1242,4,451,9810,919161352,1,0,0,274.98,7,243544.58,18,0,16,10,True
6720136,1140,0,30,4737,919161352,1,0,0,275.06,8,243269.52,15,1,14,11,True
6797276,858,1,10,4820,919161352,1,0,0,275.03,6,243544.55,24,2,19,12,True
7049505,373,1,10,9403,919161352,1,0,0,275.2,0,243819.75,25,4,6,2,True
7439207,123,0,451,9403,919161352,1,0,0,275.01,7,243544.74,18,2,2,2,True
7763932,339,4,30,4983,919161352,1,0,0,275.11,8,243269.63,11,6,21,3,True
7895332,339,4,25,1482,919161352,1,0,0,275.22,8,242994.41,11,5,10,4,True
8055858,123,0,30,5778,919161352,1,0,0,274.98,8,242719.43,18,0,9,7,True
8340579,339,4,451,9403,919161352,1,0,0,275.12,7,242444.31,11,0,3,9,True
8375538,123,0,30,6009,919161352,1,0,0,274.73,8,242169.58,18,1,3,9,True
8585157,1242,4,30,5495,919161352,1,0,0,274.77,8,241894.81,18,5,20,9,True
8950818,339,4,451,1482,919161352,1,0,0,274.95,7,241619.86,11,6,5,9,True
9367258,123,0,-1,4563,919161352,1,1,0,274.84,1,241619.86,18,4,14,10,True
9503965,123,0,451,4820,919161352,1,0,0,274.9,7,241344.96,18,5,12,11,True
9561299,1140,0,25,2790,919161352,1,0,0,275.01,8,241069.95,15,3,20,11,True
9821938,1140,0,30,3730,919161352,1,0,0,274.72,8,240795.23,15,5,12,11,True
9958724,339,4,-1,4983,919161352,1,1,0,275.19,1,240795.23,11,1,9,11,True
1213662,1400,3,-1,2811,457913045,0,1,0,806.06,4,358015.0,24,6,11,1,True
1473955,586,4,30,5015,457913045,0,0,0,806.17,8,357208.83,24,2,22,1,True
1625489,1140,0,30,8526,457913045,0,0,0,806.18,8,356402.65,15,3,19,1,True
2070387,1065,0,10,5015,457913045,0,0,0,806.09,6,357208.74,11,1,9,3,True
2259120,112,4,25,8163,457913045,0,0,0,806.2,8,356402.54,3,1,4,3,True
2325821,112,4,451,4194,457913045,0,0,0,805.69,7,355596.85,3,5,13,4,True
2475975,279,2,20,2811,457913045,0,0,0,806.03,5,354790.82,24,5,14,4,True
2491545,586,4,-1,4194,457913045,0,1,0,806.07,4,354790.82,24,3,23,6,True
2686112,111,3,451,8278,457913045,0,0,0,806.11,7,353984.71,3,1,1,6,True
2810435,1140,0,30,2811,457913045,0,0,0,806.02,8,353178.69,15,6,15,7,True
2923219,1436,0,20,2811,457913045,0,0,0,806.0,3,352372.69,24,5,7,8,True
2953622,112,4,-1,8526,457913045,0,1,0,806.34,4,352372.69,3,1,13,9,True
3453897,366,0,20,3575,457913045,0,0,0,805.96,5,351566.73,25,1,11,10,True
3539852,111,3,-1,4194,457913045,0,1,0,806.11,4,351566.73,3,2,4,10,True
3636221,399,2,20,2660,457913045,0,0,0,805.93,5,350760.8,10,1,11,11,True
3833956,470,1,451,4194,457913045,0,0,0,805.77,7,349955.03,5,1,23,11,True
3938701,630,0,10,2514,457913045,0,0,0,805.89,6,350760.92,11,5,17,1,True
4022949,470,1,30,2478,457913045,0,0,0,806.06,8,349954.86,5,1,16,1,True
4042462,470,1,-1,3575,457913045,0,1,0,806.2,4,349954.86,5,3,1,2,True
4117378,111,3,30,8278,457913045,0,0,0,806.18,8,349148.68,3,1,17,3,True
4139855,1156,1,10,2811,457913045,0,0,0,806.06,6,349954.74,15,6,2,3,True
4399852,111,3,451,7879,457913045,0,0,0,805.96,7,349148.78,3,6,1,5,True
4403279,1140,0,30,5015,457913045,0,0,0,806.15,8,348342.63,15,3,18,5,True
4507934,586,4,451,8163,457913045,0,0,0,806.29,7,347536.34,24,6,1,5,True
4590071,130,0,10,7879,457913045,0,0,0,805.98,6,348342.32,18,6,4,5,True
4696915,1400,3,-1,5015,457913045,0,1,0,806.04,4,348342.32,24,1,7,6,True
4899731,192,2,20,2514,457913045,0,0,0,805.99,5,347536.33,18,5,10,6,False
4915536,586,4,451,7879,457913045,0,0,0,806.02,7,346730.31,24,1,14,7,True
5349214,1400,3,25,3575,457913045,0,0,0,805.94,8,345924.37,24,5,17,7,True
5377604,470,1,25,4194,457913045,0,0,0,805.93,8,345118.44,5,3,19,7,True
5811298,995,1,10,2514,457913045,0,0,0,805.64,6,345924.08,22,4,18,8,True
6043417,1140,0,451,7611,457913045,0,0,0,806.05,7,345118.03,15,5,4,10,True
6091383,1140,0,451,7611,457913045,0,0,0,806.15,7,344311.88,15,5,21,11,True
6125925,1044,0,20,8278,457913045,0,0,0,806.02,5,343505.86,11,0,5,11,True
6232253,479,2,20,2363,457913045,0,0,0,806.01,3,342699.85,5,2,22,11,True
6258761,586,4,-1,8278,457913045,0,1,0,806.23,1,342699.85,24,5,12,11,True
6575882,470,1,451,3575,457913045,0,0,0,805.98,7,341893.87,5,0,20,11,True
6772906,675,2,20,8163,457913045,0,0,0,806.26,3,341087.61,24,6,0,12,True
6789015,800,0,10,3575,457913045,0,0,0,806.0,6,341893.61,11,0,1,1,True
6939338,182,1,10,2478,457913045,0,0,0,805.88,6,342699.49,18,0,19,1,True
7177924,470,1,451,7611,457913045,0,0,0,805.8,7,341893.69,5,4,12,1,True
7757460,1311,2,20,2514,457913045,0,0,0,806.38,3,341087.31,5,3,12,6,True
7878608,1140,0,30,2660,457913045,0,0,0,806.04,8,340281.27,15,0,14,6,True
8267401,279,2,20,1051,457913045,0,0,0,806.29,5,339474.98,24,2,17,7,True
8479610,470,1,451,8924,457913045,0,0,0,806.12,7,338668.86,5,6,2,7,True
8699223,586,4,30,8526,457913045,0,0,0,805.93,8,337862.93,24,0,7,7,True
8844771,1400,3,25,5015,457913045,0,0,0,806.05,8,337056.88,24,5,8,7,True
8877515,76,0,10,2811,457913045,0,0,0,806.11,6,337862.99,20,1,2,7,True
9197194,111,3,451,4194,457913045,0,0,0,806.26,7,337056.73,3,2,8,8,True
9215464,1400,3,30,2514,457913045,0,0,0,806.01,8,336250.72,24,2,17,8,True
9614676,586,4,-1,7611,457913045,0,1,0,805.88,1,336250.72,24,5,8,10,True
9816344,1140,0,451,8526,457913045,0,0,0,806.14,7,335444.58,15,1,20,10,True
1136867,86,4,25,1277,257075370,0,0,0,105.93,8,863901.07,1,0,2,1,True
1327244,279,2,451,8834,257075370,0,0,0,106.28,7,863794.79,24,4,12,1,True
1361387,149,2,451,8541,257075370,0,0,0,106.04,7,863688.75,18,4,0,2,True
1585722,279,2,25,9778,257075370,0,0,0,105.89,8,863582.86,24,3,5,3,True
1645657,1015,0,20,4981,257075370,0,0,0,106.03,3,863476.83,26,1,0,4,True
1657963,1044,0,20,2509,257075370,0,0,0,106.04,3,863370.79,11,1,16,4,True
2025247,989,1,451,1864,257075370,0,0,0,105.98,7,863264.81,22,6,11,4,True
2189342,234,0,20,2166,257075370,0,0,0,106.12,5,863158.69,26,1,12,5,True
2215478,1266,4,30,6807,257075370,0,0,0,106.08,8,863052.61,23,4,2,5,False
2263218,279,2,30,8541,257075370,0,0,0,106.21,8,862946.4,24,5,0,6,True
2306704,1159,0,20,3602,257075370,0,0,0,105.94,3,862840.46,15,1,12,7,True
2679410,599,0,10,6807,257075370,0,0,0,105.97,6,862946.43,24,3,13,7,True
2711775,989,1,451,2908,257075370,0,0,0,106.23,7,862840.2,22,5,5,7,False
2731199,86,4,25,2908,257075370,0,0,0,106.13,8,862734.07,1,1,0,7,False
2951418,1036,1,10,4981,257075370,0,0,0,106.16,6,862840.23,11,6,21,7,True
3125825,279,2,30,9778,257075370,0,0,0,106.12,8,862734.11,24,2,15,8,True
3157232,149,2,30,1597,257075370,0,0,0,106.25,8,862627.86,18,5,23,8,True
3684270,989,1,-1,7297,257075370,0,1,0,106.03,4,862627.86,22,0,16,8,True
3926512,1111,0,10,4142,257075370,0,0,0,105.95,6,862733.81,0,4,17,9,False
4628371,1179,0,20,4142,257075370,0,0,0,106.16,3,862627.65,24,0,21,9,True
4695762,989,1,-1,7297,257075370,0,1,0,105.96,4,862627.65,22,6,20,10,True
4822378,86,4,25,2509,257075370,0,0,0,105.99,8,862521.66,1,0,13,10,True
4922381,989,1,25,2166,257075370,0,0,0,105.97,8,862415.69,22,1,9,10,True
4973777,802,2,20,1864,257075370,0,0,0,105.98,5,862309.71,11,6,16,11,True
5198488,989,1,25,2166,257075370,0,0,0,106.07,8,862203.64,22,1,13,11,True
5236552,1000,0,20,8839,257075370,0,0,0,106.0,5,862097.64,26,0,16,11,True
5334404,642,0,10,8834,257075370,0,0,0,105.57,0,862203.21,24,5,6,12,True
5424436,123,0,20,1864,257075370,0,0,0,105.96,3,862097.25,18,1,23,2,True
5976677,279,2,30,4645,257075370,0,0,0,106.21,8,861991.04,24,0,1,3,True
5981962,149,2,25,3602,257075370,0,0,0,106.1,8,861884.94,18,3,4,3,True
6086592,86,4,30,4981,257075370,0,0,0,105.98,8,861778.96,1,6,18,3,True
6425183,794,2,20,7297,257075370,0,0,0,106.1,5,861672.86,11,1,0,5,True
6580756,149,2,30,4142,257075370,0,0,0,106.11,8,861566.75,18,6,0,5,True
6662789,858,1,10,4142,257075370,0,0,0,105.99,0,861672.74,24,0,15,5,True
6867021,86,4,451,4981,257075370,0,0,0,105.94,7,861566.8,1,6,0,6,True
6996291,149,2,30,7003,257075370,0,0,0,106.0,8,861460.8,18,1,12,6,True
7090350,1266,4,451,8839,257075370,0,0,0,106.02,7,861354.78,23,0,11,6,True
7224715,86,4,-1,4142,257075370,0,1,0,106.08,4,861354.78,1,4,16,7,True
7348831,149,2,25,2908,257075370,0,0,0,106.08,8,861248.7,18,3,12,9,True
7756823,989,1,25,4981,257075370,0,0,0,105.94,8,861142.76,22,3,11,10,True
8090704,1266,4,30,6807,257075370,0,0,0,106.08,8,861036.68,23,2,1,10,True
8286220,989,1,451,8541,257075370,0,0,0,106.18,7,860930.5,22,0,21,10,True
8310867,1266,4,451,8834,257075370,0,0,0,106.13,7,860824.37,23,6,23,11,True
8354074,86,4,30,1864,257075370,0,0,0,105.82,8,860718.55,1,5,2,11,True
8513650,1266,4,451,6807,257075370,0,0,0,105.97,7,860612.58,23,1,17,12,True
8624237,279,2,25,1383,257075370,0,0,0,105.91,8,860506.67,24,0,23,1,True
8710875,1266,4,-1,2908,257075370,0,1,0,105.94,1,860506.67,23,6,5,2,True
8976406,607,2,20,3602,257075370,0,0,0,105.97,5,860400.7,24,2,18,3,True
9274411,688,0,20,1383,257075370,0,0,0,105.77,5,860294.93,24,4,18,3,True
9371153,86,4,451,2725,257075370,0,0,0,105.98,7,860188.95,1,1,11,4,True
9603640,86,4,30,7297,257075370,0,0,0,106.07,8,860082.88,1,0,8,4,True
9629185,627,0,20,9778,257075370,0,0,0,105.99,3,859976.89,11,2,16,6,True
9666454,279,2,-1,2166,257075370,0,1,0,105.83,4,859976.89,24,1,14,7,True
9691865,551,0,20,8834,257075370,0,0,0,106.12,5,859870.77,17,5,22,7,True
9701405,1205,0,20,3602,257075370,0,0,0,105.97,5,859764.8,24,3,19,7,True
9854838,279,2,25,8839,257075370,0,0,0,106.02,8,859658.78,24,1,11,10,True
9892857,149,2,451,1864,257075370,0,0,0,106.12,7,859552.66,18,3,22,10,True
9921766,989,1,30,8834,257075370,0,0,0,105.98,8,859446.68,22,5,8,11,True
1357382,1235,1,30,5285,505495095,1,0,0,891.85,8,980583.15,18,3,9,1,True
1469828,859,2,451,2321,505495095,1,0,0,892.19,7,979690.96,24,4,23,1,True
1675928,304,0,451,4848,505495095,1,0,0,891.96,7,978799.0,4,6,10,1,True
2040837,1461,0,451,7909,505495095,1,0,0,891.72,7,977907.28,11,0,5,2,True
2088808,287,0,25,3695,505495095,1,0,0,891.79,8,977015.49,24,1,1,2,True
2106483,115,2,20,4840,505495095,1,0,0,891.94,5,976123.55,3,0,3,3,True
2141523,1175,2,30,9112,505495095,1,0,0,891.84,8,975231.71,24,5,22,3,True
2960056,304,0,30,7291,505495095,1,0,0,891.96,8,974339.75,4,5,23,3,True
3083615,287,0,-1,5285,505495095,1,1,0,892.08,4,974339.75,24,6,16,4,True
3098469,1235,1,25,4305,505495095,1,0,0,892.09,8,973447.66,18,5,5,5,True
3442153,962,0,10,4905,505495095,1,0,0,891.95,0,974339.61,13,0,5,6,True
3869388,576,2,20,9112,505495095,1,0,0,892.08,3,973447.53,11,5,4,7,True
4184501,1477,2,20,6724,505495095,1,0,0,892.05,3,972555.48,24,4,21,7,True
4232270,1235,1,451,8662,505495095,1,0,0,891.95,7,971663.53,18,3,8,8,True
4526558,1461,0,30,4231,505495095,1,0,0,891.83,8,970771.7,11,1,5,9,True
4639308,1110,0,20,4208,505495095,1,0,0,892.04,5,969879.66,0,6,22,9,True
4659779,287,0,451,8620,505495095,1,0,0,892.11,7,968987.55,24,0,2,10,True
4664055,537,0,10,2321,505495095,1,0,0,891.84,6,969879.39,18,2,0,10,True
4760672,1235,1,-1,5897,505495095,1,1,0,892.38,4,969879.39,18,1,6,11,True
4803603,1363,0,451,3695,505495095,1,0,0,892.1,7,968987.29,16,1,12,11,False
4963851,1235,1,451,4002,505495095,1,0,0,891.83,7,968095.46,18,5,20,11,True
4969325,398,0,20,8596,505495095,1,0,0,891.93,5,967203.53,10,1,5,12,True
4988621,1029,0,20,4231,505495095,1,0,0,891.81,5,966311.72,11,5,6,1,True
5377599,712,0,20,2778,505495095,1,0,0,892.16,3,965419.56,18,1,6,1,True
5472747,304,0,451,4840,505495095,1,0,0,892.07,7,964527.49,4,2,11,2,True
5492684,1235,1,451,3830,505495095,1,0,0,892.21,7,963635.28,18,2,6,2,True
5841771,1461,0,30,3359,505495095,1,0,0,892.24,8,962743.04,11,6,0,2,False
5883103,1363,0,30,4305,505495095,1,0,0,891.86,8,961851.18,16,0,12,3,True
5936023,859,2,451,8620,505495095,1,0,0,892.15,7,960959.03,24,0,8,4,True
6151641,304,0,-1,6724,505495095,1,1,0,891.95,4,960959.03,4,2,2,4,True
6190087,859,2,25,2498,505495095,1,0,0,891.95,8,960067.08,24,4,16,4,True
6259786,1235,1,25,4305,505495095,1,0,0,891.87,8,959175.21,18,2,12,4,True
6310023,687,0,20,7291,505495095,1,0,0,891.98,5,958283.23,24,0,3,4,True
6321768,1377,0,10,5285,505495095,1,0,0,891.91,6,959175.14,16,1,20,5,True
7177912,1235,1,25,3359,505495095,1,0,0,892.34,8,958282.8,18,6,1,7,True
7622918,1363,0,-1,2089,505495095,1,1,0,891.85,4,958282.8,16,2,3,8,True
7729899,1363,0,25,5285,505495095,1,0,0,892.0,8,957390.8,16,3,10,9,True
7825238,1235,1,451,6627,505495095,1,0,0,891.74,7,956499.06,18,6,4,10,True
7839431,312,0,10,9541,505495095,1,0,0,891.93,0,957390.99,4,4,13,10,True
7908018,1175,2,25,3830,505495095,1,0,0,891.86,8,956499.13,24,6,6,11,True
7950116,427,2,20,2498,505495095,1,0,0,891.91,3,955607.22,18,6,10,12,True
8049565,403,0,10,8862,505495095,1,0,0,891.94,0,956499.16,10,0,12,12,True
8099103,287,0,-1,2089,505495095,1,1,0,892.53,1,956499.16,24,3,4,12,True
8323021,1175,2,451,2321,505495095,1,0,0,892.05,7,955607.11,24,0,1,2,True
8486087,1363,0,30,8596,505495095,1,0,0,891.9,8,954715.21,16,1,19,2,True
8849518,1363,0,25,3271,505495095,1,0,0,891.89,8,953823.32,16,2,18,2,True
8972227,1445,2,20,7137,505495095,1,0,0,892.1,5,952931.22,24,5,8,2,True
9033039,1175,2,30,6724,505495095,1,0,0,891.99,8,952039.23,24,2,4,3,True
9044907,287,0,30,3271,505495095,1,0,0,891.89,8,951147.34,24,5,4,5,True
9275132,1363,0,451,7909,505495095,1,0,0,892.27,7,950255.07,16,4,1,6,True
9339765,1461,0,10,4905,505495095,1,0,0,892.23,6,951147.3,11,4,22,6,True
9541134,1363,0,25,7909,505495095,1,0,0,891.99,8,950255.31,16,0,9,6,True
9548185,1175,2,451,4848,505495095,1,0,0,891.73,7,949363.58,24,5,22,8,True
9863627,1304,0,20,4305,505495095,1,0,0,892.14,5,948471.44,5,0,16,10,True
9911383,1461,0,451,9541,505495095,1,0,0,891.91,7,947579.53,11,0,6,10,True
9915278,1363,0,25,9056,505495095,1,0,0,892.3,8,946687.23,16,0,11,10,True
1177114,894,3,30,5872,108006203,0,0,0,1178.22,8,456603.78,24,1,20,1,True
1195752,1281,3,451,5394,108006203,0,0,0,1177.79,7,455425.99,24,6,6,4,True
1279191,1377,0,20,1276,108006203,0,0,0,1177.82,5,454248.17,16,2,11,4,True
1799520,977,4,25,1276,108006203,0,0,0,1177.87,8,453070.3,22,3,13,4,True
1959164,135,2,20,9131,108006203,0,0,0,1177.91,5,451892.39,18,6,13,5,True
1961678,224,3,451,3377,108006203,0,0,0,1178.11,7,450714.28,26,4,15,6,True
2060121,224,3,25,5394,108006203,0,0,0,1178.16,8,449536.12,26,1,0,6,False
2738123,977,4,451,1582,108006203,0,0,0,1178.1,7,448358.02,22,4,18,7,True
2807420,977,4,451,1163,108006203,0,0,0,1177.76,7,447180.26,22,5,22,7,True
2890280,224,3,30,3377,108006203,0,0,0,1177.79,8,446002.47,26,2,11,7,True
2947968,894,3,451,1455,108006203,0,0,0,1177.93,7,444824.54,24,1,16,8,True
3287604,1399,0,20,4887,108006203,0,0,0,1177.82,5,443646.72,24,1,0,8,False
3668744,651,4,30,8448,108006203,0,0,0,1178.08,8,442468.64,24,4,2,9,True
3894134,398,0,10,4887,108006203,0,0,0,1178.02,0,443646.66,10,5,13,9,False
3910409,651,4,25,4475,108006203,0,0,0,1178.11,8,442468.55,24,6,16,10,True
3981574,977,4,451,6761,108006203,0,0,0,1178.09,7,441290.46,22,1,20,10,False
4174837,224,3,451,9716,108006203,0,0,0,1178.09,7,440112.37,26,2,12,11,True
4261026,1319,1,10,5872,108006203,0,0,0,1178.03,6,441290.4,18,4,1,12,True
4313429,824,2,20,3610,108006203,0,0,0,1177.84,5,440112.56,18,6,4,4,True
4832768,424,1,25,3822,108006203,0,0,0,1178.23,8,438934.33,18,3,20,4,True
5257771,894,3,30,9131,108006203,0,0,0,1177.91,8,437756.42,24,4,4,5,False
5433594,275,0,10,1163,108006203,0,0,0,1177.94,6,438934.36,24,0,15,6,True
5456966,424,1,25,1969,108006203,0,0,0,1178.01,8,437756.35,18,0,5,7,True
5558187,621,2,20,9716,108006203,0,0,0,1177.8,3,436578.55,11,2,5,7,False
5659556,755,3,451,3377,108006203,0,0,0,1177.88,7,435400.67,24,4,0,8,True
5807329,224,3,-1,7532,108006203,0,1,0,1178.0,1,435400.67,26,1,16,8,True
6081065,1281,3,25,6794,108006203,0,0,0,1178.01,8,434222.66,24,4,1,10,True
6249999,1233,0,10,3248,108006203,0,0,0,1178.07,6,435400.73,18,6,20,10,True
6353717,610,0,10,7815,108006203,0,0,0,1178.11,0,436578.84,11,2,18,11,True
6362855,894,3,25,1276,108006203,0,0,0,1177.91,8,435400.93,24,0,20,11,True
6434753,977,4,451,5872,108006203,0,0,0,1178.15,7,434222.78,22,4,23,12,True
6495992,224,3,451,4887,108006203,0,0,0,1178.01,7,433044.77,26,1,3,12,True
6744056,894,3,-1,6932,108006203,0,1,0,1178.0,4,433044.77,24,1,19,12,True
7398521,68,0,20,1276,108006203,0,0,0,1177.91,3,431866.86,20,0,1,1,True
7619044,424,1,30,4887,108006203,0,0,0,1177.85,8,430689.01,18,4,7,2,True
7752701,471,0,20,4454,108006203,0,0,0,1178.04,3,429510.97,5,5,23,2,True
7975002,894,3,30,6379,108006203,0,0,0,1177.85,8,428333.12,24,4,9,2,True
8037541,755,3,451,4454,108006203,0,0,0,1178.42,7,427154.7,24,5,19,2,True
8348653,424,1,-1,6794,108006203,0,1,0,1178.07,4,427154.7,18,5,10,4,True
8380310,651,4,-1,1276,108006203,0,2,0,1177.89,1,427154.7,24,5,8,5,True
8470765,651,4,25,1455,108006203,0,0,0,1178.05,8,425976.65,24,5,13,5,True
8713942,1281,3,25,3377,108006203,0,0,0,1177.93,8,424798.72,24,2,20,9,True
8790408,224,3,25,2876,108006203,0,0,0,1178.03,8,423620.69,26,3,17,10,True
8985628,224,3,-1,5394,108006203,0,1,0,1178.07,1,423620.69,26,4,22,10,True
9047738,977,4,-1,6379,108006203,0,2,0,1177.94,4,423620.69,22,6,23,10,True
9201365,894,3,-1,7210,108006203,0,3,1,1178.01,4,0.0,24,3,11,11,True
1327469,951,0,30,7735,959013235,1,0,0,1159.94,8,187805.06,24,4,7,1,True
1456425,1289,1,10,7735,959013235,1,0,0,1160.13,6,188965.19,24,4,19,1,True
1555767,895,0,10,5145,959013235,1,0,0,1160.31,6,190125.5,24,5,5,1,True
1604560,558,0,25,9593,959013235,1,0,0,1159.93,8,188965.57,17,4,21,1,True
1803757,193,1,10,6532,959013235,1,0,0,1160.05,6,190125.62,18,4,7,2,True
1945226,641,0,451,7160,959013235,1,0,0,1159.91,7,188965.71,24,0,7,2,True
2044060,715,0,20,7735,959013235,1,0,0,1160.19,5,187805.52,18,6,21,3,True
2199676,1451,1,25,4483,959013235,1,0,0,1159.94,8,186645.58,11,0,15,3,True
2247012,641,0,451,6736,959013235,1,0,0,1160.11,7,185485.47,24,6,11,4,True
2737885,1219,1,451,7161,959013235,1,0,0,1160.14,7,184325.33,24,6,2,5,True
2984363,558,0,30,3598,959013235,1,0,0,1159.94,8,183165.39,17,0,3,5,True
3151554,1144,2,20,8030,959013235,1,0,0,1160.04,3,182005.35,15,3,2,7,True
3221838,553,1,10,6532,959013235,1,0,0,1160.21,6,183165.56,17,4,17,7,True
3316334,1120,4,-1,8030,959013235,1,1,0,1160.32,4,183165.56,24,3,18,7,True
3813906,558,0,451,7088,959013235,1,0,0,1160.11,7,182005.45,17,1,21,9,True
3944646,950,0,30,7735,959013235,1,0,0,1160.02,8,180845.43,24,2,7,10,True
4041588,1019,0,10,7160,959013235,1,0,0,1159.99,6,182005.42,26,4,13,10,True
4079735,599,0,20,5372,959013235,1,0,0,1159.97,5,180845.45,24,6,17,11,True
4107375,1120,4,30,5145,959013235,1,0,0,1160.07,8,179685.38,24,5,18,11,True
4696042,951,0,451,6976,959013235,1,0,0,1160.0,7,178525.38,24,2,10,11,True
4721383,1120,4,30,9593,959013235,1,0,0,1159.99,8,177365.39,24,6,20,1,True
5074471,182,1,10,4483,959013235,1,0,0,1160.27,6,178525.66,18,6,10,2,True
5245582,558,0,-1,5372,959013235,1,1,0,1160.08,1,178525.66,17,5,23,2,True
5339392,1219,1,451,6249,959013235,1,0,0,1160.04,7,177365.62,24,5,17,2,True
5394400,1451,1,25,7735,959013235,1,0,0,1159.96,8,176205.66,11,1,17,4,True
5783948,194,1,10,5145,959013235,1,0,0,1160.11,6,177365.77,18,4,6,4,True
6134254,1219,1,30,6736,959013235,1,0,0,1159.88,8,176205.89,24,6,15,6,True
6461713,950,0,451,8424,959013235,1,0,0,1159.82,7,175046.07,24,2,4,6,True
6621344,1425,0,20,3819,959013235,1,0,0,1159.96,5,173886.11,24,5,15,6,True
6741329,950,0,-1,8424,959013235,1,1,0,1159.75,1,173886.11,24,1,14,7,False
6760881,394,0,20,6532,959013235,1,0,0,1160.06,5,172726.05,10,3,1,7,True
6780703,97,0,10,7161,959013235,1,0,0,1160.05,6,173886.1,3,4,12,7,True
7043918,1120,4,451,5227,959013235,1,0,0,1160.14,7,172725.96,24,4,4,8,True
7168830,1120,4,451,9855,959013235,1,0,0,1159.91,7,171566.05,24,5,12,9,True
7184274,641,0,25,7161,959013235,1,0,0,1159.74,8,170406.31,24,4,10,9,True
7195490,1451,1,-1,7735,959013235,1,1,0,1160.18,4,170406.31,11,6,5,10,True
7206659,950,0,451,6976,959013235,1,0,0,1159.86,7,169246.45,24,1,8,11,True
7319418,1451,1,-1,6736,959013235,1,1,0,1159.89,1,169246.45,11,2,9,12,True
7341015,641,0,451,7735,959013235,1,0,0,1160.13,7,168086.32,24,3,16,12,True
7587678,1140,0,10,5227,959013235,1,0,0,1159.84,0,169246.16,15,5,11,12,True
7688268,951,0,451,8424,959013235,1,0,0,1160.05,7,168086.11,24,3,1,2,True
7875842,1120,4,-1,5145,959013235,1,1,0,1160.05,4,168086.11,24,2,10,2,True
8156004,951,0,30,9593,959013235,1,0,0,1159.75,8,166926.36,24,2,21,2,True
8440423,951,0,451,9593,959013235,1,0,0,1159.84,7,165766.52,24,5,11,2,True
8482864,1451,1,30,6736,959013235,1,0,0,1160.15,8,164606.37,11,6,11,4,True
8553173,951,0,30,8030,959013235,1,0,0,1159.98,8,163446.39,24,5,14,5,True
8581708,1120,4,451,7735,959013235,1,0,0,1159.95,7,162286.44,24,0,8,5,True
8957403,1036,1,10,6532,959013235,1,0,0,1159.91,0,163446.35,11,2,6,6,True
8991333,599,0,10,8424,959013235,1,0,0,1160.12,6,164606.47,24,4,10,6,True
9016298,950,0,451,6249,959013235,1,0,0,1160.26,7,163446.21,24,0,7,7,True
9225757,951,0,25,6994,959013235,1,0,0,1160.09,8,162286.12,24,1,6,7,True
9287248,558,0,451,6976,959013235,1,0,0,1159.93,7,161126.19,17,1,21,7,True
9320244,1219,1,451,4483,959013235,1,0,0,1160.04,7,159966.15,24,0,22,7,True
9415034,950,0,30,7160,959013235,1,0,0,1160.24,8,158805.91,24,1,5,8,True
9720156,558,0,451,7161,959013235,1,0,0,1160.02,7,157645.89,17,4,14,9,True
9764488,579,0,20,5227,959013235,1,0,0,1159.72,5,156486.17,11,4,4,11,True
9805782,950,0,451,7160,959013235,1,0,0,1159.93,7,155326.24,24,3,11,11,True
1162365,1025,1,25,4432,564897163,1,0,0,1164.18,8,444187.82,11,5,22,1,True
1505956,645,0,30,1101,564897163,1,0,0,1164.16,8,443023.66,24,3,13,1,False
1573298,637,4,25,4432,564897163,1,0,0,1164.31,8,441859.35,24,4,8,1,True
2026043,384,3,25,6798,564897163,1,0,0,1164.0,8,440695.35,25,4,5,2,True
2149322,1210,0,20,1648,564897163,1,0,0,1164.36,3,439530.99,24,5,17,2,True
2180638,129,0,451,3173,564897163,1,0,0,1163.91,7,438367.08,18,1,18,3,True
2415384,550,0,30,8447,564897163,1,0,0,1163.87,8,437203.21,17,5,11,4,True
2456262,763,3,451,7648,564897163,1,0,0,1163.86,7,436039.35,14,6,9,4,True
2477947,547,4,451,6798,564897163,1,0,0,1164.19,7,434875.16,17,5,8,4,True
2709179,916,0,451,5164,564897163,1,0,0,1163.88,7,433711.28,18,4,21,4,True
2724216,129,0,25,1648,564897163,1,0,0,1163.77,8,432547.51,18,5,2,5,True
2795698,916,0,30,7986,564897163,1,0,0,1163.85,8,431383.66,18,2,1,6,True
3015127,550,0,451,6798,564897163,1,0,0,1163.86,7,430219.8,17,6,1,7,True
3179692,384,3,451,6379,564897163,1,0,0,1163.96,7,429055.84,25,5,9,7,True
3337575,550,0,451,6549,564897163,1,0,0,1164.23,7,427891.61,17,0,23,8,True
3832167,637,4,25,6549,564897163,1,0,0,1163.78,8,426727.83,24,4,7,8,True
3971868,547,4,25,5164,564897163,1,0,0,1164.3,8,425563.53,17,3,19,9,True
4111760,384,3,30,3658,564897163,1,0,0,1164.16,8,424399.37,25,1,10,10,True
4251796,916,0,451,5164,564897163,1,0,0,1164.12,7,423235.25,18,1,4,10,False
4352492,547,4,451,2030,564897163,1,0,0,1163.97,7,422071.28,17,1,23,10,True
4424576,637,4,30,6379,564897163,1,0,0,1164.06,8,420907.22,24,5,5,12,True
4625663,318,0,10,3797,564897163,1,0,0,1164.03,6,422071.25,11,1,12,12,True
4689004,1025,1,30,9956,564897163,1,0,0,1164.13,8,420907.12,11,4,14,12,True
4718654,287,0,10,9396,564897163,1,0,0,1163.89,6,422071.01,24,6,17,1,True
5018005,41,2,20,9956,564897163,1,0,0,1164.06,3,420906.95,11,4,4,3,True
5284670,1017,2,20,4860,564897163,1,0,0,1163.9,5,419743.05,26,5,17,4,True
5415417,547,4,451,6006,564897163,1,0,0,1164.3,7,418578.75,17,0,16,4,True
5904826,547,4,30,7986,564897163,1,0,0,1163.83,8,417414.92,17,0,17,4,True
6036254,1052,0,10,6798,564897163,1,0,0,1164.0,0,418578.92,11,1,7,5,True
6100187,645,0,25,6006,564897163,1,0,0,1164.0,8,417414.92,24,4,19,5,True
6157937,550,0,25,2018,564897163,1,0,0,1163.94,8,416250.98,17,0,10,5,True
6367725,1025,1,-1,8807,564897163,1,1,0,1164.09,1,416250.98,11,6,8,5,True
6557043,1039,1,10,6549,564897163,1,0,0,1164.32,0,417415.3,11,1,13,5,True
6601541,286,1,10,5164,564897163,1,0,0,1164.13,6,418579.43,24,1,2,6,True
6773834,763,3,-1,9801,564897163,1,1,0,1163.98,4,418579.43,14,4,7,6,True
6890625,1025,1,30,6798,564897163,1,0,0,1164.19,8,417415.24,11,2,18,6,True
7045501,319,0,20,8447,564897163,1,0,0,1163.8,5,416251.44,11,5,13,6,True
7133788,637,4,451,8979,564897163,1,0,0,1164.0,7,415087.44,24,4,8,6,True
7271237,550,0,-1,4860,564897163,1,1,0,1164.13,4,415087.44,17,0,11,8,True
7444345,763,3,25,2018,564897163,1,0,0,1164.14,8,413923.3,14,4,21,9,True
7529072,567,1,10,8807,564897163,1,0,0,1164.17,0,415087.47,11,1,12,10,True
7587476,550,0,451,6379,564897163,1,0,0,1164.21,7,413923.26,17,4,0,10,False
8041160,763,3,25,3658,564897163,1,0,0,1164.2,8,412759.06,14,3,16,10,True
8138243,763,3,451,8807,564897163,1,0,0,1164.04,7,411595.02,14,6,7,10,True
8168655,1025,1,451,4860,564897163,1,0,0,1164.04,7,410430.98,11,1,22,11,True
8239664,1025,1,451,8627,564897163,1,0,0,1163.93,7,409267.05,11,0,20,12,True
8527407,129,0,451,6549,564897163,1,0,0,1164.15,7,408102.9,18,1,17,12,True
8718278,130,0,10,8807,564897163,1,0,0,1164.16,0,409267.06,18,4,19,2,True
8853400,550,0,30,3797,564897163,1,0,0,1163.87,8,408103.19,17,6,22,3,True
8936618,1246,0,10,7648,564897163,1,0,0,1164.01,0,409267.2,23,1,21,5,True
8963899,547,4,30,4432,564897163,1,0,0,1164.09,8,408103.11,17,1,7,7,True
9048121,644,0,20,1579,564897163,1,0,0,1163.7,5,406939.41,24,0,18,7,True
9057580,129,0,451,5164,564897163,1,0,0,1163.89,7,405775.52,18,6,21,8,True
9156382,276,0,10,4860,564897163,1,0,0,1163.9,6,406939.42,24,6,20,8,True
9357259,1239,1,10,8627,564897163,1,0,0,1164.02,6,408103.44,18,1,7,9,True
9644579,403,0,20,3797,564897163,1,0,0,1163.85,5,406939.59,10,6,17,10,True
9953575,907,0,10,6798,564897163,1,0,0,1164.2,6,408103.79,2,2,13,11,True
1095568,1022,4,25,4671,598547133,0,0,0,595.18,8,326971.82,11,1,3,2,True
1382658,131,4,30,3114,598547133,0,0,0,594.99,8,326376.83,18,0,17,8,True
1678045,947,2,20,6286,598547133,0,0,0,595.08,3,325781.75,24,2,15,3,True
1705349,20,0,20,9909,598547133,0,0,0,595.06,5,325186.69,24,6,12,4,True
1771210,1483,0,-1,4745,598547133,0,1,0,595.16,1,325186.69,24,2,2,4,True
1801096,1022,4,-1,2780,598547133,0,2,0,594.8,4,325186.69,11,5,3,5,True
2123143,1311,2,20,4488,598547133,0,0,0,594.79,5,324591.9,5,2,3,7,True
2481244,1072,0,20,9058,598547133,0,0,0,595.04,5,323996.86,18,2,10,8,True
2504277,131,4,30,5785,598547133,0,0,0,594.85,8,323402.01,18,3,10,9,True
2555788,131,4,451,2247,598547133,0,0,0,595.24,7,322806.77,18,1,5,2,True
2572241,1483,0,-1,4037,598547133,0,1,0,595.14,4,322806.77,24,4,11,5,True
2601412,524,1,10,9058,598547133,0,0,0,595.25,6,323402.02,18,1,5,5,True
2812329,630,0,10,1476,598547133,0,0,0,594.84,0,323996.86,11,6,7,6,True
2854247,131,4,-1,6590,598547133,0,1,0,595.11,1,323996.86,18,3,10,8,True
2964908,1483,0,-1,4249,598547133,0,2,0,594.73,1,323996.86,24,6,11,8,True
3178080,71,1,-1,4671,598547133,0,3,1,594.91,1,0.0,20,0,7,10,True
1186876,178,4,451,3999,324841078,0,0,0,394.15,7,858795.85,24,6,11,2,True
1563887,1061,2,-1,3999,324841078,0,1,0,393.98,4,858795.85,11,0,3,4,True
1964519,448,0,-1,7965,324841078,0,2,0,394.11,1,858795.85,13,5,21,4,True
2047413,935,1,25,7965,324841078,0,0,0,394.15,8,858401.7,24,2,15,6,False
2121203,1052,0,10,5498,324841078,0,0,0,394.23,0,858795.93,11,3,10,9,True
2471319,1061,2,-1,3494,324841078,0,1,0,393.96,4,858795.93,11,0,11,9,True
2718886,841,1,10,3999,324841078,0,0,0,393.85,6,859189.78,5,3,16,10,True
2757937,935,1,451,2748,324841078,0,0,0,394.04,7,858795.74,24,1,12,11,True
2917068,1277,2,20,8521,324841078,0,0,0,394.12,5,858401.62,24,5,6,11,True
3154880,1061,2,30,8521,324841078,0,0,0,394.2,8,858007.42,11,3,22,12,True
3245337,1061,2,30,2000,324841078,0,0,0,394.04,8,857613.38,11,3,3,12,True
3253329,1305,2,20,1754,324841078,0,0,0,393.99,3,857219.39,5,1,0,1,True
3320931,178,4,-1,9939,324841078,0,1,0,393.91,4,857219.39,24,1,6,2,True
3364811,1232,1,10,8521,324841078,0,0,0,394.12,6,857613.51,18,4,1,2,True
3374300,916,0,20,9183,324841078,0,0,0,394.01,5,857219.5,18,4,14,3,True
3707268,1061,2,451,4827,324841078,0,0,0,394.17,7,856825.33,11,2,13,3,True
3922339,1061,2,30,7965,324841078,0,0,0,394.16,8,856431.17,11,3,0,3,True
4051673,1061,2,-1,7965,324841078,0,1,0,394.09,4,856431.17,11,0,22,5,True
4168836,787,0,20,3999,324841078,0,0,0,393.81,3,856037.36,14,4,8,6,True
4274758,448,0,30,9939,324841078,0,0,0,394.05,8,855643.31,13,4,15,6,True
4437419,1061,2,30,8521,324841078,0,0,0,393.97,8,855249.34,11,3,6,7,True
4499669,255,2,451,7965,324841078,0,0,0,393.92,7,854855.42,6,4,12,7,True
4559801,448,0,451,6831,324841078,0,0,0,393.73,7,854461.69,13,4,11,7,True
4691252,935,1,-1,8521,324841078,0,1,0,393.94,4,854461.69,24,0,7,7,True
4726245,448,0,30,9183,324841078,0,0,0,394.08,8,854067.61,13,3,2,8,True
4864647,713,0,20,2748,324841078,0,0,0,393.89,5,853673.72,18,2,8,10,True
5147845,448,0,451,5498,324841078,0,0,0,393.95,7,853279.77,13,2,4,10,True
5656678,183,1,10,6831,324841078,0,0,0,393.96,0,853673.73,18,3,19,11,True
5790747,935,1,451,7965,324841078,0,0,0,394.2,7,853279.53,24,4,3,11,True
5809772,1488,0,10,3494,324841078,0,0,0,393.73,6,853673.26,24,2,19,12,True
6324253,255,2,451,2752,324841078,0,0,0,393.97,7,853279.29,6,1,9,12,True
6377779,1061,2,30,3494,324841078,0,0,0,393.95,8,852885.34,11,5,6,12,True
6405730,448,0,25,5498,324841078,0,0,0,394.04,8,852491.3,13,3,3,2,False
6414465,255,2,25,2000,324841078,0,0,0,394.14,8,852097.16,6,2,16,2,True
6474548,448,0,25,4827,324841078,0,0,0,394.01,8,851703.15,13,6,5,3,True
6683970,178,4,-1,6831,324841078,0,1,0,393.9,4,851703.15,24,0,1,3,True
7087275,158,2,20,9939,324841078,0,0,0,393.89,3,851309.26,24,6,3,3,True
7146760,935,1,30,1754,324841078,0,0,0,394.01,8,850915.25,24,0,11,3,True
7525996,1041,0,20,9183,324841078,0,0,0,393.74,5,850521.51,11,6,10,3,True
7577673,579,0,10,1754,324841078,0,0,0,393.83,6,850915.34,11,5,4,4,True
7687385,1061,2,30,6831,324841078,0,0,0,394.25,8,850521.09,11,6,6,4,True
8330083,448,0,451,9939,324841078,0,0,0,394.06,7,850127.03,13,0,14,4,True
8446984,1061,2,-1,5891,324841078,0,1,0,394.1,1,850127.03,11,5,10,5,True
8499937,448,0,30,9939,324841078,0,0,0,393.74,8,849733.29,13,0,20,5,True
8727802,255,2,-1,2000,324841078,0,1,0,393.99,4,849733.29,6,3,3,5,True
8819232,448,0,30,9183,324841078,0,0,0,394.1,8,849339.19,13,3,7,6,True
8881075,178,4,-1,4930,324841078,0,1,0,394.04,4,849339.19,24,4,18,6,True
9019370,314,0,10,2000,324841078,0,0,0,393.99,6,849733.18,4,5,16,7,True
9378441,524,1,10,3494,324841078,0,0,0,394.02,6,850127.2,18,4,5,7,True
9496842,1247,0,10,2748,324841078,0,0,0,394.07,0,850521.27,23,0,15,9,True
9735646,1061,2,25,2748,324841078,0,0,0,393.91,8,850127.36,11,1,22,9,True
9917278,594,0,10,8521,324841078,0,0,0,393.88,6,850521.24,24,2,2,10,True
9929519,935,1,25,9939,324841078,0,0,0,393.56,8,850127.68,24,5,5,11,True
9969129,1061,2,451,7965,324841078,0,0,0,394.09,7,849733.59,11,2,7,11,True
1145259,118,2,451,9022,397640070,0,0,0,816.89,7,711905.11,18,4,1,2,True
1358672,714,2,20,3920,397640070,0,0,0,816.72,5,711088.39,18,1,2,3,True
1408635,824,2,25,7192,397640070,0,0,0,816.99,8,710271.4,18,6,10,3,True
1504926,796,2,451,8083,397640070,0,0,0,817.46,7,709453.94,11,6,7,3,True
1729567,465,0,-1,9931,397640070,0,1,0,816.73,1,709453.94,13,5,5,4,True
2142894,796,2,25,7192,397640070,0,0,0,816.85,8,708637.09,11,1,4,5,True
2227206,1425,0,20,7668,397640070,0,0,0,816.94,5,707820.15,24,2,5,5,True
2335834,988,3,30,1611,397640070,0,0,0,816.99,8,707003.16,22,5,21,6,True
2431532,118,2,451,3413,397640070,0,0,0,817.04,7,706186.12,18,3,7,6,True
2624597,137,2,20,1149,397640070,0,0,0,817.12,5,705369.0,18,6,12,7,True
2752114,118,2,30,3413,397640070,0,0,0,817.1,8,704551.9,18,0,2,8,True
2935482,316,2,20,8748,397640070,0,0,0,817.05,5,703734.85,4,0,21,12,False
3028742,610,0,20,5059,397640070,0,0,0,817.08,3,702917.77,11,1,23,12,True
3202214,841,1,10,9931,397640070,0,0,0,816.85,6,703734.62,5,2,12,1,True
3269050,1312,0,10,8083,397640070,0,0,0,817.26,6,704551.88,5,6,6,1,True
3590657,824,2,451,9931,397640070,0,0,0,817.16,7,703734.72,18,0,20,1,True
3807428,18,4,25,9022,397640070,0,0,0,816.72,8,702918.0,24,1,6,2,True
3829860,824,2,30,3920,397640070,0,0,0,816.92,8,702101.08,18,3,21,2,True
3858118,1155,0,10,2919,397640070,0,0,0,817.19,6,702918.27,15,1,18,3,True
3884859,1116,0,10,3920,397640070,0,0,0,817.05,0,703735.32,24,2,15,3,True
4282369,988,3,451,9931,397640070,0,0,0,816.92,7,702918.4,22,3,22,3,True
4337820,818,1,10,5654,397640070,0,0,0,816.96,0,703735.36,18,1,19,4,True
4402426,465,0,30,2919,397640070,0,0,0,817.02,8,702918.34,13,5,21,4,True
4603448,796,2,30,8666,397640070,0,0,0,817.15,8,702101.19,11,3,5,5,True
5015893,796,2,451,8666,397640070,0,0,0,816.97,7,701284.22,11,2,22,5,True
5108360,180,0,10,7192,397640070,0,0,0,816.93,6,702101.15,18,3,23,6,True
5170941,465,0,30,8666,397640070,0,0,0,816.79,8,701284.36,13,0,13,7,True
5407011,465,0,451,9931,397640070,0,0,0,817.13,7,700467.23,13,5,14,8,True
5542201,465,0,451,7192,397640070,0,0,0,817.12,7,699650.11,13,6,18,9,True
5651276,824,2,-1,1149,397640070,0,1,0,817.04,1,699650.11,18,0,12,9,True
5727629,988,3,25,8748,397640070,0,0,0,817.19,8,698832.92,22,0,22,9,True
5772106,1094,0,10,7192,397640070,0,0,0,817.02,0,699649.94,0,2,5,9,True
5973714,1463,2,20,3920,397640070,0,0,0,817.03,3,698832.91,11,2,19,10,True
5983436,465,0,30,8083,397640070,0,0,0,817.35,8,698015.56,13,6,3,12,True
6050561,27,0,20,7192,397640070,0,0,0,816.99,5,697198.57,11,2,13,1,True
6061289,18,4,30,9931,397640070,0,0,0,817.09,8,696381.48,24,6,15,1,True
6117283,129,0,20,5059,397640070,0,0,0,816.93,3,695564.55,18,3,0,2,True
6225871,824,2,30,8666,397640070,0,0,0,816.84,8,694747.71,18,5,9,3,True
6270639,796,2,30,2919,397640070,0,0,0,817.15,8,693930.56,11,5,14,3,True
6315520,988,3,30,1149,397640070,0,0,0,816.95,8,693113.61,22,3,22,4,True
6657531,123,0,10,7288,397640070,0,0,0,817.04,6,693930.65,18,0,10,4,True
6680716,907,0,10,9931,397640070,0,0,0,816.91,0,694747.56,2,3,13,4,True
7251787,253,2,20,3920,397640070,0,0,0,816.96,5,693930.6,6,1,4,4,True
7267809,988,3,25,7288,397640070,0,0,0,816.85,8,693113.75,22,2,7,5,True
7828686,1307,0,20,1149,397640070,0,0,0,817.07,5,692296.68,5,3,18,5,True
8198208,824,2,451,3413,397640070,0,0,0,817.11,7,691479.57,18,1,8,6,True
8430095,796,2,30,1611,397640070,0,0,0,816.92,8,690662.65,11,0,16,6,True
8505176,18,4,-1,7668,397640070,0,1,0,817.0,1,690662.65,24,0,20,7,True
8713461,824,2,25,5125,397640070,0,0,0,816.92,8,689845.73,18,0,12,9,True
8818850,824,2,25,8083,397640070,0,0,0,816.86,8,689028.87,18,4,16,9,True
8950026,988,3,451,5125,397640070,0,0,0,816.83,7,688212.04,22,4,22,9,True
9491933,796,2,451,8083,397640070,0,0,0,817.05,7,687394.99,11,3,20,9,True
9496997,465,0,451,2919,397640070,0,0,0,816.99,7,686578.0,13,3,23,10,True
9551567,118,2,25,3413,397640070,0,0,0,816.95,8,685761.05,18,5,8,10,True
9861613,824,2,451,9022,397640070,0,0,0,816.91,7,684944.14,18,3,21,11,True
1096600,1367,4,25,1652,227934684,1,0,0,802.1,8,357599.9,16,2,13,1,True
1176033,774,2,25,1061,227934684,1,0,0,801.78,8,356798.12,14,6,16,2,True
1341675,278,1,10,3574,227934684,1,0,0,802.0,0,357600.12,24,0,22,3,True
1705833,732,0,451,6267,227934684,1,0,0,801.94,7,356798.18,11,1,22,3,False
1788588,1367,4,30,4919,227934684,1,0,0,801.87,8,355996.31,16,4,6,3,True
1851423,882,0,20,4982,227934684,1,0,0,802.08,5,355194.23,27,1,12,3,True
1986963,1089,0,10,3574,227934684,1,0,0,802.26,0,355996.49,18,1,21,4,True
2073033,1144,2,20,7663,227934684,1,0,0,801.8,3,355194.69,15,6,5,4,True
2122261,759,0,20,3574,227934684,1,0,0,802.11,3,354392.58,24,0,9,4,True
2407824,1028,4,-1,7663,227934684,1,1,0,801.76,1,354392.58,11,1,0,5,True
2660429,774,2,30,7663,227934684,1,0,0,801.94,8,353590.64,14,5,8,5,True
2667769,774,2,25,1061,227934684,1,0,0,801.96,8,352788.68,14,1,3,6,True
2712576,1152,0,20,6267,227934684,1,0,0,801.76,5,351986.92,15,0,23,8,True
2818467,787,0,10,1495,227934684,1,0,0,802.09,6,352789.01,14,6,4,9,True
3009463,774,2,451,6267,227934684,1,0,0,801.98,7,351987.03,14,0,10,9,True
3120401,774,2,-1,6267,227934684,1,1,0,802.05,4,351987.03,14,4,20,9,True
3120782,774,2,-1,4919,227934684,1,2,0,801.98,1,351987.03,14,0,20,9,True
3637021,774,2,30,1495,227934684,1,0,0,801.62,8,351185.41,14,3,5,12,True
3683344,774,2,451,4346,227934684,1,0,0,801.81,7,350383.6,14,3,8,12,True
3797579,1367,4,-1,4982,227934684,1,1,0,801.98,4,350383.6,16,6,23,1,True
3872102,266,2,20,1061,227934684,1,0,0,802.06,5,349581.54,6,5,16,3,True
4321717,143,4,-1,4960,227934684,1,1,0,801.73,4,349581.54,18,6,19,3,True
4578643,1367,4,25,4346,227934684,1,0,0,802.17,8,348779.37,16,4,2,3,True
4674835,774,2,25,1652,227934684,1,0,0,802.09,8,347977.28,14,1,18,5,True
4759151,792,1,30,4960,227934684,1,0,0,802.3,8,347174.98,11,4,7,6,True
4834537,1076,1,10,7663,227934684,1,0,0,801.99,6,347976.97,18,3,13,6,True
4899204,792,1,30,3574,227934684,1,0,0,802.31,8,347174.66,11,5,19,8,True
4993997,1367,4,25,8684,227934684,1,0,0,802.02,8,346372.64,16,4,23,8,True
5036655,240,4,25,1652,227934684,1,0,0,801.9,8,345570.74,26,2,21,8,True
5193180,792,1,25,9304,227934684,1,0,0,802.23,8,344768.51,11,5,19,9,True
5229766,792,1,-1,1495,227934684,1,1,0,801.98,4,344768.51,11,0,8,9,True
5243013,732,0,451,4346,227934684,1,0,0,802.2,7,343966.31,11,1,16,9,True
5277440,1028,4,-1,1652,227934684,1,1,0,801.92,4,343966.31,11,4,10,9,True
5431875,774,2,451,4661,227934684,1,0,0,802.22,7,343164.09,14,6,20,11,True
5864616,774,2,30,2834,227934684,1,0,0,801.92,8,342362.17,14,3,0,12,True
5989464,732,0,451,8684,227934684,1,0,0,801.95,7,341560.22,11,0,18,12,True
6181322,672,4,30,2490,227934684,1,0,0,802.1,8,340758.12,18,1,15,1,True
6275148,240,4,25,8684,227934684,1,0,0,802.06,8,339956.06,26,2,15,1,True
6742262,143,4,30,1061,227934684,1,0,0,802.0,8,339154.06,18,5,17,2,True
6962683,774,2,451,1652,227934684,1,0,0,801.94,7,338352.12,14,1,16,3,True
6993679,1367,4,451,4982,227934684,1,0,0,802.21,7,337549.91,16,6,13,4,True
7967345,1028,4,-1,4661,227934684,1,1,0,801.91,1,337549.91,11,2,7,6,True
8063789,143,4,25,9304,227934684,1,0,0,802.17,8,336747.74,18,2,6,6,True
8469417,1367,4,451,4919,227934684,1,0,0,802.41,7,335945.33,16,2,0,6,True
9033803,143,4,451,4346,227934684,1,0,0,801.88,7,335143.45,18,4,4,6,True
9098911,1034,1,10,1061,227934684,1,0,0,802.19,0,335945.64,11,1,8,6,False
9134601,240,4,30,2834,227934684,1,0,0,801.86,8,335143.78,26,0,21,7,True
9536498,240,4,451,1160,227934684,1,0,0,801.86,7,334341.92,26,6,16,8,True
9671809,732,0,-1,9304,227934684,1,1,0,801.96,4,334341.92,11,0,17,10,True
9763172,523,2,20,4982,227934684,1,0,0,801.79,3,333540.13,18,3,11,10,True
9988414,342,0,10,6267,227934684,1,0,0,802.06,6,334342.19,24,3,15,10,True
1170792,1143,4,30,4403,957443108,0,0,0,1006.82,8,125220.18,15,0,3,3,True
1769469,716,0,-1,4197,957443108,0,1,0,1006.89,1,125220.18,18,1,3,3,True
1846714,332,4,-1,4256,957443108,0,2,0,1006.82,4,125220.18,11,1,21,3,True
2031408,741,3,451,9292,957443108,0,0,0,1007.21,7,124212.97,24,3,15,4,True
2114009,306,4,25,7959,957443108,0,0,0,1006.71,8,123206.26,4,6,6,5,True
2634461,332,4,451,5035,957443108,0,0,0,1007.22,7,122199.04,11,4,13,8,False
2659892,741,3,451,3516,957443108,0,0,0,1006.97,7,121192.07,24,6,23,9,True
2660002,306,4,-1,3448,957443108,0,1,0,1007.11,4,121192.07,4,6,13,11,False
2712844,332,4,30,3195,957443108,0,0,0,1007.09,8,120184.98,11,0,13,11,True
2714066,306,4,-1,2263,957443108,0,1,0,1007.1,4,120184.98,4,2,14,2,True
2753839,332,4,451,2263,957443108,0,0,0,1006.91,7,119178.07,11,5,0,3,True
2777648,287,0,20,3448,957443108,0,0,0,1007.33,3,118170.74,24,4,2,3,True
2942039,65,3,-1,3448,957443108,0,1,0,1007.17,4,118170.74,20,2,19,3,True
3004121,306,4,451,2345,957443108,0,0,0,1007.05,7,117163.69,4,4,9,4,True
3034244,1471,0,20,7959,957443108,0,0,0,1006.86,5,116156.83,24,2,0,4,True
3160267,618,3,30,4256,957443108,0,0,0,1006.98,8,115149.85,11,2,8,5,True
3477275,741,3,451,1683,957443108,0,0,0,1006.93,7,114142.92,24,2,18,5,True
3652634,306,4,30,3169,957443108,0,0,0,1006.97,8,113135.95,4,5,4,10,True
3936859,618,3,25,1308,957443108,0,0,0,1006.8,8,112129.15,11,1,3,11,False
4160227,65,3,30,7046,957443108,0,0,0,1007.08,8,111122.07,20,4,1,11,True
4287976,332,4,451,3448,957443108,0,0,0,1007.0,7,110115.07,11,0,17,2,True
4659560,741,3,25,3902,957443108,0,0,0,1006.88,8,109108.19,24,6,10,4,False
4835954,716,0,451,4598,957443108,0,0,0,1007.08,7,108101.11,18,4,13,7,False
5174491,716,0,451,5674,957443108,0,0,0,1007.25,7,107093.86,18,6,4,7,True
5651343,618,3,-1,5862,957443108,0,1,0,1006.93,4,107093.86,11,6,17,9,True
5936626,1143,4,451,6548,957443108,0,0,0,1006.83,7,106087.03,15,3,6,9,True
6081517,716,0,-1,3903,957443108,0,1,0,1006.9,1,106087.03,18,4,5,9,True
6271704,618,3,-1,5577,957443108,0,2,0,1007.06,1,106087.03,11,5,16,9,True
6277887,65,3,-1,1736,957443108,0,3,1,1006.89,4,0.0,20,2,17,10,True
1175081,75,3,25,8117,295598601,1,0,0,1178.88,8,884963.12,20,1,12,1,True
1400717,644,0,25,6525,295598601,1,0,0,1179.07,8,883784.05,24,0,18,1,True
1517561,530,0,10,5258,295598601,1,0,0,1178.99,6,884963.04,18,3,2,3,True
1535565,497,0,451,9672,295598601,1,0,0,1178.99,7,883784.05,12,6,15,3,True
1563363,669,2,451,7743,295598601,1,0,0,1179.02,7,882605.03,18,0,8,3,True
1714650,950,0,451,7225,295598601,1,0,0,1178.86,7,881426.17,24,2,12,3,True
1876267,353,1,10,9183,295598601,1,0,0,1179.2,6,882605.37,24,6,14,4,True
2019777,1429,0,20,2974,295598601,1,0,0,1178.9,5,881426.47,24,0,21,4,True
2426089,362,0,20,5206,295598601,1,0,0,1178.96,5,880247.51,24,0,5,6,True
2436418,950,0,451,7743,295598601,1,0,0,1179.08,7,879068.43,24,2,6,7,True
2465154,669,2,-1,8117,295598601,1,1,0,1179.06,4,879068.43,18,5,6,7,True
2779444,1000,0,10,6658,295598601,1,0,0,1179.01,6,880247.44,26,1,15,8,True
2898536,644,0,30,8117,295598601,1,0,0,1178.98,8,879068.46,24,5,12,8,True
3132515,1318,0,10,1035,295598601,1,0,0,1179.12,6,880247.58,18,3,20,9,True
3261944,644,0,451,9915,295598601,1,0,0,1179.14,7,879068.44,24,5,22,10,True
3546727,669,2,30,3305,295598601,1,0,0,1178.69,8,877889.75,18,1,8,11,True
3673136,644,0,451,6804,295598601,1,0,0,1179.16,7,876710.59,24,5,0,12,True
3698582,950,0,451,9672,295598601,1,0,0,1178.98,7,875531.61,24,6,7,1,True
3718150,644,0,451,7225,295598601,1,0,0,1178.58,7,874353.03,24,5,0,3,True
3789988,1089,0,20,2974,295598601,1,0,0,1179.15,5,873173.88,18,5,14,3,True
3970822,644,0,30,7456,295598601,1,0,0,1178.94,8,871994.94,24,1,7,3,True
4104147,669,2,25,7456,295598601,1,0,0,1179.0,8,870815.94,18,1,16,4,True
4140366,669,2,30,3175,295598601,1,0,0,1179.12,8,869636.82,18,5,18,4,False
4346442,223,2,451,9963,295598601,1,0,0,1179.01,7,868457.81,26,2,7,4,True
4351066,75,3,-1,7732,295598601,1,1,0,1179.15,4,868457.81,20,3,5,4,True
4518573,223,2,-1,3305,295598601,1,2,0,1178.96,4,868457.81,26,3,0,5,True
5528054,208,0,20,8117,295598601,1,0,0,1178.94,5,867278.87,9,0,18,5,False
5596893,497,0,-1,3175,295598601,1,1,0,1179.0,4,867278.87,12,0,20,5,True
5695687,780,0,10,7456,295598601,1,0,0,1178.9,0,868457.77,14,0,5,5,True
5771192,223,2,25,1035,295598601,1,0,0,1178.86,8,867278.91,26,1,22,6,True
5773606,497,0,451,6525,295598601,1,0,0,1178.92,7,866099.99,12,2,21,8,True
6091754,644,0,451,6658,295598601,1,0,0,1179.02,7,864920.97,24,4,13,8,True
6136187,1404,2,20,3573,295598601,1,0,0,1179.09,5,863741.88,24,1,14,8,True
6470600,223,2,451,5206,295598601,1,0,0,1178.97,7,862562.91,26,5,11,9,True
6837533,223,2,25,1590,295598601,1,0,0,1179.09,8,861383.82,26,5,7,10,True
6908685,669,2,451,6525,295598601,1,0,0,1178.99,7,860204.83,18,0,18,10,True
7035395,497,0,-1,5258,295598601,1,1,0,1178.81,4,860204.83,12,5,1,10,True
7097765,644,0,451,3573,295598601,1,0,0,1179.03,7,859025.8,24,6,16,11,True
7099024,1304,0,20,7456,295598601,1,0,0,1178.93,5,857846.87,5,6,18,12,True
7216806,665,2,20,6525,295598601,1,0,0,1178.99,5,856667.88,18,5,16,1,True
7320804,223,2,30,5258,295598601,1,0,0,1179.18,8,855488.7,26,5,21,1,True
7984309,497,0,451,2974,295598601,1,0,0,1178.62,7,854310.08,12,4,17,2,True
7988653,223,2,451,9963,295598601,1,0,0,1179.15,7,853130.93,26,0,20,3,True
8154943,669,2,25,9836,295598601,1,0,0,1178.98,8,851951.95,18,3,5,4,True
8303027,950,0,30,7590,295598601,1,0,0,1178.82,8,850773.13,24,1,9,5,False
8510965,75,3,30,3305,295598601,1,0,0,1179.36,8,849593.77,20,4,9,8,True
8586583,149,2,20,1640,295598601,1,0,0,1179.05,5,848414.72,18,3,23,9,True
8962610,1434,0,10,7732,295598601,1,0,0,1178.66,6,849593.38,24,4,8,9,True
9006751,644,0,451,7732,295598601,1,0,0,1178.83,7,848414.55,24,2,5,10,True
9071675,75,3,451,8983,295598601,1,0,0,1179.05,7,847235.5,20,0,18,10,False
9513044,497,0,451,9836,295598601,1,0,0,1179.3,7,846056.2,12,0,15,10,True
9538094,950,0,30,1590,295598601,1,0,0,1179.04,8,844877.16,24,2,1,10,True
9573052,644,0,451,9183,295598601,1,0,0,1178.85,7,843698.31,24,6,3,10,True
9577437,644,0,451,9963,295598601,1,0,0,1178.91,7,842519.4,24,1,18,10,True
9594283,644,0,451,2974,295598601,1,0,0,1178.95,7,841340.45,24,2,18,10,True
9641400,427,2,20,7456,295598601,1,0,0,1178.84,5,840161.61,18,4,23,11,True
9791782,75,3,30,2091,295598601,1,0,0,1178.98,8,838982.63,20,5,10,11,True
1293243,1156,1,-1,1022,365018790,0,1,0,506.98,4,529710.0,15,2,17,1,True
1314442,1429,0,10,9664,365018790,0,0,0,506.99,0,530216.99,24,4,11,1,True
1597572,462,4,30,5049,365018790,0,0,0,507.24,8,529709.75,13,3,17,1,True
1604089,464,1,451,5304,365018790,0,0,0,507.14,7,529202.61,13,5,20,2,True
1612427,603,0,-1,9726,365018790,0,1,0,506.99,1,529202.61,24,1,16,3,True
1623912,421,3,-1,7745,365018790,0,2,0,507.16,1,529202.61,18,4,23,3,True
2141096,464,1,25,9726,365018790,0,0,0,507.18,8,528695.43,13,0,10,3,True
2316114,98,0,20,3353,365018790,0,0,0,506.93,5,528188.5,3,0,5,4,True
2740436,533,2,20,7731,365018790,0,0,0,506.93,5,527681.57,18,0,17,4,True
2874064,464,1,-1,1876,365018790,0,1,0,507.08,1,527681.57,13,3,22,5,True
3204229,603,0,-1,5331,365018790,0,2,0,507.12,1,527681.57,24,5,10,6,True
3445093,670,0,20,1876,365018790,0,0,0,506.81,5,527174.76,18,1,4,6,True
3964851,464,1,451,7745,365018790,0,0,0,507.06,7,526667.7,13,2,8,6,True
3982809,81,0,20,7745,365018790,0,0,0,506.74,5,526160.96,1,4,12,8,True
4161077,462,4,25,4008,365018790,0,0,0,507.09,8,525653.87,13,2,6,10,True
4376656,783,0,10,4945,365018790,0,0,0,507.14,0,526161.01,14,4,23,10,True
4696485,603,0,25,9664,365018790,0,0,0,506.81,8,525654.2,24,3,0,11,True
4803941,929,0,20,9287,365018790,0,0,0,506.92,3,525147.28,18,1,19,11,True
5044771,462,4,-1,5331,365018790,0,1,0,506.85,4,525147.28,13,4,21,12,False
5294264,603,0,-1,8638,365018790,0,2,0,507.32,4,525147.28,24,2,4,1,True
5303846,603,0,25,9295,365018790,0,0,0,506.79,8,524640.49,24,0,22,1,False
5392580,1108,1,30,5331,365018790,0,0,0,507.0,8,524133.49,0,3,15,1,True
5498669,689,0,20,7698,365018790,0,0,0,507.26,5,523626.23,24,2,16,3,True
5510416,1407,4,30,8638,365018790,0,0,0,507.16,8,523119.07,24,1,15,4,True
5680142,603,0,30,5049,365018790,0,0,0,506.96,8,522612.11,24,0,6,4,True
6186372,309,0,20,2074,365018790,0,0,0,506.78,5,522105.33,4,6,23,5,True
6507792,1156,1,30,8638,365018790,0,0,0,507.06,8,521598.27,15,4,17,5,True
6720955,577,0,451,3729,365018790,0,0,0,506.86,7,521091.41,11,0,15,5,False
6743334,812,0,10,2074,365018790,0,0,0,506.79,6,521598.2,18,2,22,5,True
6904036,464,1,25,2518,365018790,0,0,0,507.2,8,521091.0,13,3,10,6,True
7080625,1361,2,20,9664,365018790,0,0,0,506.93,5,520584.07,16,5,20,7,True
7169200,1156,1,25,2518,365018790,0,0,0,506.65,8,520077.42,15,1,4,8,True
7177934,464,1,25,2518,365018790,0,0,0,506.9,8,519570.52,13,0,8,9,True
7583641,577,0,451,1876,365018790,0,0,0,506.93,7,519063.59,11,4,4,9,True
7727075,1407,4,30,1876,365018790,0,0,0,506.95,8,518556.64,24,3,5,11,True
8316326,1156,1,30,4663,365018790,0,0,0,506.96,8,518049.68,15,0,4,11,True
8508392,1108,1,451,8638,365018790,0,0,0,506.57,7,517543.11,0,2,10,12,True
8567208,462,4,25,7745,365018790,0,0,0,506.91,8,517036.2,13,4,23,12,True
8664055,1407,4,451,2074,365018790,0,0,0,507.09,7,516529.11,24,1,9,12,True
8677163,1407,4,-1,7698,365018790,0,1,0,507.16,4,516529.11,24,2,4,1,True
8841319,144,1,10,7698,365018790,0,0,0,506.78,6,517035.89,18,3,2,2,True
8856797,464,1,30,1289,365018790,0,0,0,506.72,8,516529.17,13,6,0,2,True
8949381,98,0,10,9295,365018790,0,0,0,507.1,0,517036.27,3,3,5,2,True
9046872,681,2,20,4663,365018790,0,0,0,507.24,3,516529.03,24,1,23,4,True
9102483,1108,1,30,7698,365018790,0,0,0,507.18,8,516021.85,0,2,17,7,True
9200326,135,2,20,9287,365018790,0,0,0,506.94,3,515514.91,18,2,10,8,True
9200603,603,0,25,5049,365018790,0,0,0,507.03,8,515007.88,24,1,15,10,True
9204948,1116,0,20,2074,365018790,0,0,0,506.83,5,514501.05,24,1,1,11,True
9252818,871,0,20,2074,365018790,0,0,0,506.78,5,513994.27,24,3,4,11,True
9424411,1108,1,-1,4945,365018790,0,1,0,507.05,1,513994.27,0,6,7,11,True
9614696,421,3,-1,1531,365018790,0,2,0,506.93,4,513994.27,18,3,1,11,True
9673317,1108,1,451,9287,365018790,0,0,0,507.07,7,513487.2,0,4,2,11,True
1035083,701,2,451,6339,675319524,0,0,0,220.23,7,975909.77,18,5,2,1,True
1487446,616,1,-1,7714,675319524,0,1,0,220.18,1,975909.77,11,2,19,1,True
1904701,656,2,451,6265,675319524,0,0,0,220.22,7,975689.55,18,4,0,2,True
1908285,1298,0,10,9095,675319524,0,0,0,220.12,0,975909.67,5,0,7,2,True
2103303,865,0,451,4864,675319524,0,0,0,220.12,7,975689.55,24,6,15,3,True
2153588,796,2,20,1924,675319524,0,0,0,219.7,5,975469.85,11,4,14,3,True
2207141,470,1,-1,1924,675319524,0,1,0,219.8,1,975469.85,5,6,11,4,True
2210835,812,0,10,6540,675319524,0,0,0,220.11,6,975689.96,18,5,15,5,True
3415250,97,0,-1,1924,675319524,0,1,0,219.9,4,975689.96,3,2,10,5,True
3424173,97,0,25,9095,675319524,0,0,0,219.97,8,975469.99,3,6,4,7,True
3707455,403,0,10,7714,675319524,0,0,0,219.89,6,975689.88,10,2,22,8,True
3913390,1079,4,-1,1582,675319524,0,1,0,219.8,4,975689.88,18,6,16,8,True
4005506,1128,2,20,4256,675319524,0,0,0,219.94,5,975469.94,24,0,17,8,True
4157022,616,1,451,4277,675319524,0,0,0,219.86,7,975250.08,11,0,20,9,True
4304194,1156,1,10,7755,675319524,0,0,0,220.13,0,975470.21,15,2,4,9,True
4639342,1195,1,10,4256,675319524,0,0,0,219.95,6,975690.16,24,4,1,9,True
4758835,656,2,451,1657,675319524,0,0,0,220.06,7,975470.1,18,4,21,9,True
5066989,97,0,25,9325,675319524,0,0,0,220.08,8,975250.02,3,3,15,10,True
5079131,679,0,451,4096,675319524,0,0,0,219.89,7,975030.13,24,4,0,10,True
5171782,656,2,30,4864,675319524,0,0,0,219.97,8,974810.16,18,2,20,10,True
5356906,679,0,25,1793,675319524,0,0,0,219.98,8,974590.18,24,5,13,12,True
5377502,97,0,25,5889,675319524,0,0,0,219.99,8,974370.19,3,3,21,12,True
5401912,1079,4,25,5338,675319524,0,0,0,220.02,8,974150.17,18,3,6,1,True
5654755,656,2,451,6540,675319524,0,0,0,220.32,7,973929.85,18,4,0,1,False
5684440,97,0,451,5889,675319524,0,0,0,219.95,7,973709.9,3,5,12,1,True
5786428,584,0,20,1657,675319524,0,0,0,220.28,5,973489.62,11,1,14,1,True
5882813,679,0,30,7755,675319524,0,0,0,219.77,8,973269.85,24,3,9,2,True
5892098,1179,0,20,9325,675319524,0,0,0,220.19,5,973049.66,24,6,3,2,True
5905006,1079,4,30,5338,675319524,0,0,0,220.09,8,972829.57,18,3,2,2,True
6227162,470,1,451,5826,675319524,0,0,0,220.15,7,972609.42,5,6,7,3,True
6425970,656,2,30,6265,675319524,0,0,0,219.87,8,972389.55,18,2,2,3,True
6798371,182,1,10,9325,675319524,0,0,0,219.99,6,972609.54,18,0,23,5,True
6857096,470,1,-1,5889,675319524,0,1,0,220.01,1,972609.54,5,0,0,6,True
6915647,97,0,25,6339,675319524,0,0,0,220.04,8,972389.5,3,0,14,6,True
7228889,1205,0,10,6540,675319524,0,0,0,220.17,6,972609.67,24,4,10,7,True
7281771,739,1,10,4256,675319524,0,0,0,220.07,0,972829.74,24,5,0,8,True
7562506,679,0,30,7755,675319524,0,0,0,219.78,8,972609.96,24,1,22,9,True
7675539,865,0,25,4096,675319524,0,0,0,220.02,8,972389.94,24,4,2,9,True
7762635,470,1,451,1793,675319524,0,0,0,219.95,7,972169.99,5,0,6,10,True
7942743,46,1,25,5586,675319524,0,0,0,220.02,8,971949.97,24,4,10,1,True
8683277,46,1,30,4864,675319524,0,0,0,219.98,8,971729.99,24,6,0,1,True
9020442,616,1,451,6265,675319524,0,0,0,220.12,7,971509.87,11,1,4,2,True
9026247,656,2,451,1582,675319524,0,0,0,219.98,7,971289.89,18,3,10,2,True
9098403,851,1,10,9095,675319524,0,0,0,219.92,6,971509.81,5,3,15,3,True
9215290,1079,4,451,4277,675319524,0,0,0,220.01,7,971289.8,18,4,9,4,True
9494483,1247,0,20,7714,675319524,0,0,0,220.0,3,971069.8,23,1,5,5,True
9504865,616,1,30,6339,675319524,0,0,0,219.93,8,970849.87,11,5,13,5,True
9519954,1160,0,20,9325,675319524,0,0,0,219.91,5,970629.96,15,6,1,5,True
9582244,1079,4,451,5889,675319524,0,0,0,220.08,7,970409.88,18,6,15,8,True
9659471,1206,0,20,6339,675319524,0,0,0,220.11,3,970189.77,24,4,13,8,True
9788182,701,2,30,7714,675319524,0,0,0,220.1,8,969969.67,18,5,23,8,True
9800337,879,1,10,4864,675319524,0,0,0,219.91,6,970189.58,27,0,22,9,True
9888720,155,1,10,4096,675319524,0,0,0,220.24,6,970409.82,18,4,12,11,False
1332803,594,0,20,9307,363376202,1,0,0,241.65,5,484299.35,24,4,5,1,True
1458131,549,1,451,5540,363376202,1,0,0,242.1,7,484057.25,17,5,19,2,True
1580110,187,4,30,7599,363376202,1,0,0,241.76,8,483815.49,18,6,16,2,True
2080422,187,4,25,8035,363376202,1,0,0,242.02,8,483573.47,18,4,18,5,True
2413244,1429,0,10,3936,363376202,1,0,0,241.9,6,483815.37,24,1,19,7,True
2746020,187,4,30,1841,363376202,1,0,0,241.91,8,483573.46,18,4,1,8,True
2794165,705,1,10,8410,363376202,1,0,0,241.8,0,483815.26,18,5,18,8,True
3025478,461,4,451,8252,363376202,1,0,0,241.94,7,483573.32,13,5,9,9,True
3136885,1132,0,20,9434,363376202,1,0,0,241.99,5,483331.33,24,5,20,9,True
3261243,259,4,30,3936,363376202,1,0,0,241.91,8,483089.42,6,2,16,9,True
3495559,846,3,451,2932,363376202,1,0,0,241.9,7,482847.52,5,2,17,9,True
3530177,461,4,30,1841,363376202,1,0,0,241.96,8,482605.56,13,6,2,10,True
3731639,461,4,25,7809,363376202,1,0,0,241.79,8,482363.77,13,5,21,11,True
3883777,461,4,451,9563,363376202,1,0,0,242.17,7,482121.6,13,6,22,11,True
4228904,259,4,25,5486,363376202,1,0,0,241.9,8,481879.7,6,6,17,12,True
4286125,549,1,25,3412,363376202,1,0,0,242.07,8,481637.63,17,6,23,1,True
4325697,461,4,30,5540,363376202,1,0,0,241.91,8,481395.72,13,6,0,1,True
4460316,1173,1,10,6806,363376202,1,0,0,242.17,0,481637.89,24,3,2,1,True
4529697,259,4,25,3616,363376202,1,0,0,242.11,8,481395.78,6,2,22,3,True
4662239,688,0,20,8410,363376202,1,0,0,242.21,3,481153.57,24,0,5,3,True
4755953,461,4,25,3412,363376202,1,0,0,241.75,8,480911.82,13,1,8,4,True
4844575,846,3,30,2886,363376202,1,0,0,242.05,8,480669.77,5,2,12,5,True
4993450,259,4,30,9434,363376202,1,0,0,242.31,8,480427.46,6,0,15,6,True
5162930,846,3,451,3616,363376202,1,0,0,241.99,7,480185.47,5,3,18,6,True
5345854,259,4,30,5486,363376202,1,0,0,241.78,8,479943.69,6,4,6,6,True
5422945,846,3,-1,2886,363376202,1,1,0,241.73,4,479943.69,5,6,12,7,False
5471666,259,4,451,8410,363376202,1,0,0,242.19,7,479701.5,6,1,8,7,True
5563231,461,4,25,5627,363376202,1,0,0,241.87,8,479459.63,13,2,9,7,True
5851348,259,4,25,3342,363376202,1,0,0,242.07,8,479217.56,6,2,15,9,True
5886953,1272,0,20,8410,363376202,1,0,0,241.84,5,478975.72,24,6,0,11,True
5974875,846,3,451,9307,363376202,1,0,0,242.08,7,478733.64,5,1,3,11,True
6321417,1035,0,10,6806,363376202,1,0,0,241.95,6,478975.59,11,5,13,11,True
6477844,187,4,-1,4761,363376202,1,1,0,242.24,1,478975.59,18,3,6,11,True
6819876,1212,0,10,1841,363376202,1,0,0,242.15,6,479217.74,24,4,15,12,True
6945908,549,1,25,3936,363376202,1,0,0,242.06,8,478975.68,17,6,15,12,True
7359021,259,4,30,5500,363376202,1,0,0,242.25,8,478733.43,6,4,0,12,True
7444619,687,0,20,3616,363376202,1,0,0,242.1,5,478491.33,24,0,5,1,True
7455416,187,4,-1,5627,363376202,1,1,0,242.14,4,478491.33,18,1,19,1,True
7703421,260,0,10,6874,363376202,1,0,0,242.26,6,478733.59,6,3,0,1,True
7802281,259,4,-1,3616,363376202,1,1,0,241.94,4,478733.59,6,6,4,1,True
7819400,259,4,30,4320,363376202,1,0,0,242.05,8,478491.54,6,1,19,2,True
7854145,259,4,25,8252,363376202,1,0,0,241.82,8,478249.72,6,3,5,2,False
8242220,461,4,451,1841,363376202,1,0,0,241.74,7,478007.98,13,5,10,2,True
8360894,846,3,-1,6806,363376202,1,1,0,241.88,4,478007.98,5,6,4,2,True
8666250,846,3,25,9434,363376202,1,0,0,241.79,8,477766.19,5,5,14,6,True
8701053,461,4,451,8252,363376202,1,0,0,242.11,7,477524.08,13,1,0,8,True
8814628,461,4,25,6703,363376202,1,0,0,242.14,8,477281.94,13,3,20,8,True
8835482,276,0,10,6052,363376202,1,0,0,241.7,6,477523.64,24,3,14,9,False
8937213,259,4,30,3342,363376202,1,0,0,241.81,8,477281.83,6,1,5,9,True
9391695,416,2,20,9434,363376202,1,0,0,242.09,5,477039.74,18,6,16,11,True
9942497,871,0,20,8035,363376202,1,0,0,241.98,5,476797.76,24,4,18,11,True
1186579,128,0,10,4764,489160099,0,0,0,1098.21,6,552549.21,18,1,19,1,True
1232196,724,3,25,6694,489160099,0,0,0,1097.84,8,551451.37,11,3,20,1,True
1286277,1220,3,30,2632,489160099,0,0,0,1097.78,8,550353.59,24,2,20,2,True
1801586,1220,3,25,2037,489160099,0,0,0,1098.08,8,549255.51,24,3,23,3,True
1997302,413,4,-1,5990,489160099,0,1,0,1097.64,1,549255.51,18,6,19,4,True
2081074,1303,0,10,7952,489160099,0,0,0,1097.94,6,550353.45,5,5,5,4,True
2093603,1065,0,25,2037,489160099,0,0,0,1098.05,8,549255.4,11,4,4,5,True
2255489,1220,3,30,2037,489160099,0,0,0,1097.8,8,548157.6,24,1,18,8,True
2288460,1220,3,451,5990,489160099,0,0,0,1097.71,7,547059.89,24,6,16,8,True
2359803,1201,0,10,6694,489160099,0,0,0,1098.25,0,548158.14,24,6,1,8,True
2407187,1065,0,25,3928,489160099,0,0,0,1097.96,8,547060.18,11,1,20,9,True
2455316,1483,0,10,2632,489160099,0,0,0,1098.05,6,548158.23,24,5,17,9,True
2513281,894,3,30,5990,489160099,0,0,0,1097.94,8,547060.29,24,1,15,9,True
2663921,724,3,451,7549,489160099,0,0,0,1097.92,7,545962.37,11,6,16,10,True
2734684,894,3,25,5069,489160099,0,0,0,1097.82,8,544864.55,24,2,23,10,True
2889189,894,3,25,3928,489160099,0,0,0,1097.78,8,543766.77,24,5,9,10,True
2901463,1220,3,-1,5990,489160099,0,1,0,1098.18,4,543766.77,24,3,8,11,True
2928104,1206,0,451,5748,489160099,0,0,0,1098.2,7,542668.57,24,3,21,2,True
3106383,585,2,20,4233,489160099,0,0,0,1098.17,3,541570.4,11,2,21,3,True
3438905,413,4,25,2037,489160099,0,0,0,1097.88,8,540472.52,18,0,21,3,True
3452331,1206,0,30,2139,489160099,0,0,0,1097.95,8,539374.57,24,4,12,3,True
3491903,894,3,25,7549,489160099,0,0,0,1097.97,8,538276.6,24,0,23,3,True
3812115,953,4,30,4764,489160099,0,0,0,1097.95,8,537178.65,13,5,11,4,True
3929286,953,4,25,3928,489160099,0,0,0,1098.13,8,536080.52,13,1,3,4,True
4118383,1206,0,30,2037,489160099,0,0,0,1097.87,8,534982.65,24,3,6,5,True
4156458,413,4,-1,6694,489160099,0,1,0,1098.18,4,534982.65,18,0,8,5,True
4180188,1065,0,-1,2139,489160099,0,2,0,1097.65,4,534982.65,11,2,10,5,True
4884095,46,1,10,6694,489160099,0,0,0,1097.92,0,536080.57,24,5,9,6,True
5005157,603,0,10,2632,489160099,0,0,0,1097.95,6,537178.52,24,6,18,7,True
5142297,894,3,25,5990,489160099,0,0,0,1097.96,8,536080.56,24,3,10,7,True
5232713,1065,0,451,7771,489160099,0,0,0,1097.88,7,534982.68,11,5,17,7,True
5464885,1206,0,25,5748,489160099,0,0,0,1098.22,8,533884.46,24,6,22,7,True
5509030,724,3,25,5069,489160099,0,0,0,1098.01,8,532786.45,11,0,7,8,True
5711162,1065,0,451,7771,489160099,0,0,0,1097.77,7,531688.68,11,1,2,11,True
6165379,1065,0,30,5541,489160099,0,0,0,1097.95,8,530590.73,11,4,10,12,True
6417354,894,3,30,2632,489160099,0,0,0,1098.1,8,529492.63,24,6,0,1,True
6418237,413,4,25,7771,489160099,0,0,0,1097.84,8,528394.79,18,3,14,2,True
6776966,1065,0,20,9961,489160099,0,0,0,1098.13,3,527296.66,11,0,13,2,True
6791989,1065,0,25,2139,489160099,0,0,0,1097.7,8,526198.96,11,0,15,2,True
7177756,816,0,10,5069,489160099,0,0,0,1097.99,6,527296.95,18,0,11,2,True
7425705,1206,0,451,4233,489160099,0,0,0,1098.02,7,526198.93,24,1,23,3,True
7575066,184,0,10,2037,489160099,0,0,0,1097.83,6,527296.76,18,3,20,3,True
7659287,729,0,20,5069,489160099,0,0,0,1098.11,5,526198.65,11,1,17,4,True
8061492,894,3,451,9961,489160099,0,0,0,1097.81,7,525100.84,24,3,22,4,True
8200002,1105,2,-1,3928,489160099,0,1,0,1097.97,1,525100.84,0,2,6,5,True
8242339,1220,3,451,4764,489160099,0,0,0,1098.12,7,524002.72,24,2,8,5,True
8461291,1124,0,10,2632,489160099,0,0,0,1098.32,6,525101.04,24,4,21,6,True
8752080,724,3,451,5748,489160099,0,0,0,1097.94,7,524003.1,11,0,11,6,True
8958516,664,2,20,5541,489160099,0,0,0,1098.23,5,522904.87,18,2,20,6,True
9141026,1220,3,451,7952,489160099,0,0,0,1097.87,7,521807.0,24,5,17,7,True
9347310,1065,0,30,2139,489160099,0,0,0,1098.16,8,520708.84,11,5,5,8,True
9388517,1220,3,-1,2037,489160099,0,1,0,1098.13,1,520708.84,24,5,17,9,True
9602490,424,1,10,7549,489160099,0,0,0,1097.96,6,521806.8,18,6,14,10,True
9694770,953,4,451,4233,489160099,0,0,0,1097.82,7,520708.98,13,0,14,10,True
1317828,1000,0,451,9516,477564302,1,0,0,740.14,7,800800.86,26,3,4,1,True
1407251,1093,0,10,7780,477564302,1,0,0,740.11,0,801540.97,18,5,0,1,False
1449020,724,3,451,1872,477564302,1,0,0,739.95,7,800801.02,11,2,5,2,True
1473685,724,3,451,9726,477564302,1,0,0,739.99,7,800061.03,11,4,12,2,True
1480624,1012,0,30,4796,477564302,1,0,0,740.42,8,799320.61,26,6,15,3,True
1597160,1408,1,30,1720,477564302,1,0,0,740.16,8,798580.45,24,4,8,4,True
1683460,1012,0,451,8350,477564302,1,0,0,740.1,7,797840.35,26,3,12,4,True
1888982,1012,0,-1,7890,477564302,1,1,0,740.06,4,797840.35,26,5,18,4,True
1903280,416,2,30,2900,477564302,1,0,0,740.26,8,797100.09,18,0,19,4,True
2026991,428,0,-1,4346,477564302,1,1,0,740.1,4,797100.09,18,2,21,6,True
2065955,724,3,451,9726,477564302,1,0,0,740.2,7,796359.89,11,4,15,7,True
2186813,1012,0,30,9924,477564302,1,0,0,740.0,8,795619.89,26,1,4,7,True
2308013,1407,4,25,9184,477564302,1,0,0,739.91,8,794879.98,24,0,18,8,True
2327081,1408,1,25,9184,477564302,1,0,0,739.96,8,794140.02,24,0,18,8,True
2426718,1377,0,10,5787,477564302,1,0,0,739.94,6,794879.96,16,5,0,9,True
2823967,1407,4,451,6158,477564302,1,0,0,739.87,7,794140.09,24,2,16,9,True
2829002,1408,1,30,8162,477564302,1,0,0,740.03,8,793400.06,24,4,1,9,True
2855053,1012,0,-1,9516,477564302,1,1,0,739.95,4,793400.06,26,3,2,10,True
3142016,1408,1,25,4796,477564302,1,0,0,739.93,8,792660.13,24,6,14,10,True
3844733,1408,1,451,8162,477564302,1,0,0,740.26,7,791919.87,24,1,21,11,True
3972538,366,0,10,4796,477564302,1,0,0,739.89,6,792659.76,25,5,20,12,True
4047851,105,3,-1,6350,477564302,1,1,0,739.91,4,792659.76,3,2,19,2,True
4540120,1354,0,20,2595,477564302,1,0,0,739.7,5,791920.06,24,1,9,2,True
4601414,1408,1,30,7780,477564302,1,0,0,739.99,8,791180.07,24,0,17,4,True
4870368,428,0,451,8452,477564302,1,0,0,740.03,7,790440.04,18,3,12,4,True
5004478,275,0,10,5219,477564302,1,0,0,740.17,0,791180.21,24,3,7,4,True
5221865,826,1,10,8350,477564302,1,0,0,739.99,0,791920.2,18,4,5,5,True
5512337,1000,0,451,9202,477564302,1,0,0,739.91,7,791180.29,26,6,8,5,True
5612570,428,0,25,6158,477564302,1,0,0,740.05,8,790440.24,18,4,20,5,True
5739512,1000,0,25,5196,477564302,1,0,0,740.17,8,789700.07,26,6,12,6,False
5773919,1069,1,10,9726,477564302,1,0,0,740.22,6,790440.29,18,1,17,7,True
5800364,1000,0,30,4861,477564302,1,0,0,739.9,8,789700.39,26,3,5,10,True
5958170,724,3,25,6350,477564302,1,0,0,740.16,8,788960.23,11,4,2,10,True
6069882,1000,0,-1,9924,477564302,1,1,0,740.15,1,788960.23,26,3,17,11,True
6097365,366,0,10,9202,477564302,1,0,0,740.22,0,789700.45,25,2,1,11,True
6114243,1407,4,451,4990,477564302,1,0,0,739.78,7,788960.67,24,4,12,11,True
6195593,770,4,-1,6350,477564302,1,1,0,739.9,4,788960.67,14,5,16,12,True
6265285,1408,1,25,1872,477564302,1,0,0,740.07,8,788220.6,24,5,3,12,True
6310214,724,3,451,8410,477564302,1,0,0,739.96,7,787480.64,11,0,6,12,True
6329559,770,4,451,4990,477564302,1,0,0,740.0,7,786740.64,14,2,15,1,True
6336217,223,2,20,9861,477564302,1,0,0,740.07,5,786000.57,26,6,0,1,True
6885716,770,4,25,2595,477564302,1,0,0,739.96,8,785260.61,14,1,3,1,True
7278102,1408,1,-1,9861,477564302,1,1,0,739.93,4,785260.61,24,5,13,1,True
7341445,770,4,30,4825,477564302,1,0,0,740.16,8,784520.45,14,6,15,2,True
7359472,428,0,30,1872,477564302,1,0,0,739.87,8,783780.58,18,0,4,2,True
7430690,428,0,25,1872,477564302,1,0,0,739.88,8,783040.7,18,0,11,3,True
7703360,260,0,20,9202,477564302,1,0,0,740.15,5,782300.55,6,3,5,3,True
7808179,724,3,-1,8350,477564302,1,1,0,739.96,1,782300.55,11,6,17,4,True
8099026,1408,1,-1,9726,477564302,1,2,0,739.93,4,782300.55,24,4,12,5,True
8136877,98,0,20,4346,477564302,1,0,0,739.67,5,781560.88,3,6,19,5,True
8515136,1408,1,451,4346,477564302,1,0,0,740.14,7,780820.74,24,2,22,5,True
8660995,105,3,451,8452,477564302,1,0,0,739.9,7,780080.84,3,3,11,5,True
8711967,105,3,-1,1720,477564302,1,1,0,739.85,4,780080.84,3,4,1,6,True
8865442,770,4,30,4861,477564302,1,0,0,740.12,8,779340.72,14,3,12,8,True
9343204,416,2,30,9184,477564302,1,0,0,739.88,8,778600.84,18,3,19,9,True
9353297,1012,0,30,8162,477564302,1,0,0,740.09,8,777860.75,26,6,20,10,True
9416465,1311,2,20,5787,477564302,1,0,0,739.92,5,777120.83,5,0,0,10,True
9456257,1408,1,30,9184,477564302,1,0,0,739.98,8,776380.85,24,1,12,11,True
9670040,416,2,30,4825,477564302,1,0,0,739.99,8,775640.86,18,1,10,11,True
1145799,642,0,20,6997,891226415,1,0,0,778.02,5,468454.98,24,5,3,2,False
1306678,1044,0,451,4498,891226415,1,0,0,778.07,7,467676.91,11,5,18,2,False
1329854,1231,2,-1,2828,891226415,1,1,0,778.01,1,467676.91,18,6,21,2,True
1716795,840,3,451,4715,891226415,1,0,0,777.99,7,466898.92,5,6,11,3,True
2114847,840,3,30,8241,891226415,1,0,0,778.13,8,466120.79,5,0,7,3,True
2387290,832,3,30,6692,891226415,1,0,0,778.31,8,465342.48,5,1,5,4,True
2900771,355,1,10,2991,891226415,1,0,0,778.38,6,466120.86,24,3,13,4,True
2928008,840,3,-1,8210,891226415,1,1,0,778.19,4,466120.86,5,3,11,5,True
2981507,840,3,451,9317,891226415,1,0,0,778.11,7,465342.75,5,6,4,5,True
3134567,533,2,25,2991,891226415,1,0,0,778.07,8,464564.68,18,1,23,7,True
3169082,1044,0,451,4472,891226415,1,0,0,778.01,7,463786.67,11,0,21,7,True
3223564,1347,4,451,5779,891226415,1,0,0,777.96,7,463008.71,24,4,12,8,True
3554247,32,3,30,5565,891226415,1,0,0,777.64,8,462231.07,11,0,0,8,True
3582847,1461,0,20,1927,891226415,1,0,0,777.97,3,461453.1,11,4,2,9,True
3990751,32,3,451,4715,891226415,1,0,0,778.01,7,460675.09,11,5,6,9,True
4078805,533,2,30,5401,891226415,1,0,0,778.11,8,459896.98,18,3,14,10,True
4130080,572,0,20,8743,891226415,1,0,0,777.89,5,459119.09,11,4,12,11,True
4326463,840,3,451,6997,891226415,1,0,0,778.01,7,458341.08,5,4,15,12,True
4694802,1044,0,25,2609,891226415,1,0,0,777.88,8,457563.2,11,0,21,1,True
4757459,353,1,10,3075,891226415,1,0,0,778.29,6,458341.49,24,2,23,1,True
5205601,1044,0,451,2828,891226415,1,0,0,777.89,7,457563.6,11,6,11,2,True
5501078,807,0,20,1927,891226415,1,0,0,777.9,5,456785.7,11,3,17,3,True
5535574,652,0,10,4587,891226415,1,0,0,778.04,6,457563.74,24,5,2,4,True
5582650,32,3,451,4472,891226415,1,0,0,778.0,7,456785.74,11,4,19,5,True
5671604,551,0,20,2439,891226415,1,0,0,777.87,5,456007.87,17,2,18,6,True
5750100,1300,4,451,6661,891226415,1,0,0,778.04,7,455229.83,5,2,3,6,True
6066416,832,3,-1,2828,891226415,1,1,0,777.85,1,455229.83,5,5,20,6,False
6145688,1347,4,30,5779,891226415,1,0,0,777.88,8,454451.95,24,4,11,6,True
6554168,533,2,30,8743,891226415,1,0,0,777.88,8,453674.07,18,1,5,7,True
6722352,51,0,10,5779,891226415,1,0,0,778.15,6,454452.22,20,2,17,7,True
6731137,32,3,451,8743,891226415,1,0,0,777.94,7,453674.28,11,2,1,7,True
6770786,832,3,30,2991,891226415,1,0,0,777.94,8,452896.34,5,5,11,8,True
6796514,1231,2,-1,4498,891226415,1,1,0,777.96,4,452896.34,18,2,7,9,True
6807846,448,0,10,2108,891226415,1,0,0,778.24,6,453674.58,13,3,12,11,True
6867872,1289,1,10,6306,891226415,1,0,0,777.85,6,454452.43,24,6,16,12,True
6980181,840,3,451,4336,891226415,1,0,0,778.32,7,453674.11,5,0,9,12,True
6980389,979,0,20,2991,891226415,1,0,0,777.91,5,452896.2,22,2,10,12,True
7115646,1175,2,20,4506,891226415,1,0,0,778.19,5,452118.01,24,6,11,12,True
7215573,533,2,451,4336,891226415,1,0,0,778.06,7,451339.95,18,1,8,1,True
7373972,542,0,10,5097,891226415,1,0,0,777.93,0,452117.88,17,2,19,1,True
7534189,1445,2,20,2439,891226415,1,0,0,777.87,5,451340.01,24,4,5,2,True
7553749,32,3,-1,8743,891226415,1,1,0,778.14,1,451340.01,11,2,8,2,True
7896967,219,0,20,8743,891226415,1,0,0,777.86,5,450562.15,9,5,19,2,True
7959203,1231,2,30,4793,891226415,1,0,0,778.04,8,449784.11,18,3,17,2,True
8171111,840,3,-1,7543,891226415,1,1,0,777.78,4,449784.11,5,0,1,4,True
8172301,1034,1,10,7011,891226415,1,0,0,777.86,6,450561.97,11,1,6,4,True
8479175,533,2,451,4793,891226415,1,0,0,778.17,7,449783.8,18,4,10,6,True
8530124,424,1,10,7543,891226415,1,0,0,777.97,0,450561.77,18,1,11,7,True
8704485,1347,4,-1,4715,891226415,1,1,0,778.07,4,450561.77,24,2,19,7,False
8851669,531,0,10,5401,891226415,1,0,0,777.97,0,451339.74,18,3,2,7,True
8868959,1300,4,451,4472,891226415,1,0,0,778.17,7,450561.57,5,3,8,9,True
8909166,1044,0,25,5401,891226415,1,0,0,778.0,8,449783.57,11,1,0,10,True
9247066,1231,2,451,2828,891226415,1,0,0,778.22,7,449005.35,18,4,7,11,True
9708587,812,0,10,8330,891226415,1,0,0,777.96,6,449783.31,18,6,6,11,True
9727080,203,0,20,5077,891226415,1,0,0,777.89,5,449005.42,9,0,20,11,True
9898597,1044,0,25,4587,891226415,1,0,0,777.78,8,448227.64,11,3,10,11,True
9915636,1347,4,451,5077,891226415,1,0,0,778.01,7,447449.63,24,4,12,11,True
1279577,609,3,25,8789,441191378,0,0,0,209.12,8,441836.88,24,1,6,1,True
1340413,900,1,451,9219,441191378,0,0,0,209.03,7,441627.85,24,2,7,2,False
1535343,309,0,10,3642,441191378,0,0,0,208.94,6,441836.79,4,3,1,3,True
1617483,609,3,-1,6989,441191378,0,1,0,208.84,4,441836.79,24,3,12,3,True
1627326,375,4,451,7993,441191378,0,0,0,209.17,7,441627.62,25,6,4,3,True
1924338,609,3,451,8243,441191378,0,0,0,209.35,7,441418.27,24,1,6,5,True
2052445,900,1,451,6874,441191378,0,0,0,208.72,7,441209.55,24,6,18,5,True
2112568,951,0,10,9219,441191378,0,0,0,209.07,0,441418.62,24,3,8,6,True
2197038,781,1,10,8243,441191378,0,0,0,208.68,6,441627.3,14,6,1,6,True
2233519,937,0,10,8789,441191378,0,0,0,208.78,6,441836.08,24,3,15,6,True
2505116,476,1,10,7993,441191378,0,0,0,208.98,0,442045.06,5,2,14,7,True
2760945,609,3,451,2299,441191378,0,0,0,209.03,7,441836.03,24,2,16,7,True
2765329,749,4,451,3642,441191378,0,0,0,209.01,7,441627.02,24,2,12,8,True
2786953,375,4,-1,6874,441191378,0,1,0,208.95,4,441627.02,25,3,15,8,True
2894272,900,1,25,6989,441191378,0,0,0,209.12,8,441417.9,24,4,9,9,True
2926481,900,1,-1,3819,441191378,0,1,0,209.15,4,441417.9,24,0,1,11,True
2972080,375,4,25,3115,441191378,0,0,0,208.85,8,441209.05,25,0,6,11,True
3071361,234,0,25,8243,441191378,0,0,0,209.08,8,440999.97,26,5,15,12,True
3367185,1029,0,10,3578,441191378,0,0,0,209.16,6,441209.13,11,6,3,12,True
3491566,609,3,451,6989,441191378,0,0,0,208.98,7,441000.15,24,0,5,12,True
3707383,375,4,-1,6874,441191378,0,1,0,209.11,1,441000.15,25,6,6,2,True
3724525,900,1,451,9112,441191378,0,0,0,208.93,7,440791.22,24,2,19,2,True
4002091,428,0,10,6989,441191378,0,0,0,209.08,6,441000.3,18,1,1,3,True
4140365,316,2,20,9219,441191378,0,0,0,209.01,3,440791.29,4,3,6,3,True
4164728,302,1,10,8243,441191378,0,0,0,209.1,6,441000.39,4,0,11,4,True
4242605,234,0,30,2214,441191378,0,0,0,208.92,8,440791.47,26,0,14,5,True
4330124,900,1,25,9112,441191378,0,0,0,208.95,8,440582.52,24,2,8,5,True
4495251,900,1,451,3115,441191378,0,0,0,209.12,7,440373.4,24,6,2,5,True
4499924,503,0,10,3115,441191378,0,0,0,209.1,6,440582.5,12,1,13,5,True
4545027,900,1,30,2214,441191378,0,0,0,208.9,8,440373.6,24,5,8,6,True
4597313,609,3,25,6989,441191378,0,0,0,209.07,8,440164.53,24,5,16,6,True
4627803,749,4,451,3115,441191378,0,0,0,209.03,7,439955.5,24,4,13,6,True
5156858,802,2,20,6874,441191378,0,0,0,209.18,3,439746.32,11,4,20,7,True
5293430,609,3,25,2214,441191378,0,0,0,209.13,8,439537.19,24,5,5,7,True
5350756,480,0,20,8789,441191378,0,0,0,209.22,5,439327.97,5,3,12,8,True
5355167,749,4,25,2214,441191378,0,0,0,208.94,8,439119.03,24,3,19,8,True
5699840,375,4,451,3642,441191378,0,0,0,208.66,7,438910.37,25,1,4,9,True
5751904,609,3,25,3819,441191378,0,0,0,208.93,8,438701.44,24,4,2,9,True
6096904,991,1,10,2299,441191378,0,0,0,208.79,0,438910.23,22,4,2,9,True
6169374,609,3,451,6874,441191378,0,0,0,208.78,7,438701.45,24,2,7,9,True
6238687,155,1,10,8243,441191378,0,0,0,208.77,6,438910.22,18,3,4,10,True
6245188,1388,1,10,3578,441191378,0,0,0,209.01,6,439119.23,24,6,11,10,True
6253113,609,3,-1,8789,441191378,0,1,0,208.91,4,439119.23,24,0,20,10,True
6539062,234,0,451,9112,441191378,0,0,0,208.92,7,438910.31,26,6,6,11,False
6623898,609,3,30,3392,441191378,0,0,0,208.91,8,438701.4,24,4,13,2,True
6878666,234,0,451,2299,441191378,0,0,0,209.18,7,438492.22,26,6,16,3,True
6940173,900,1,25,2299,441191378,0,0,0,208.72,8,438283.5,24,6,0,3,True
7674054,1162,2,20,2459,441191378,0,0,0,208.94,3,438074.56,24,2,12,4,True
7912859,609,3,25,3115,441191378,0,0,0,209.07,8,437865.49,24,6,17,4,True
8377970,234,0,451,8243,441191378,0,0,0,208.95,7,437656.54,26,3,23,7,True
8979790,609,3,25,3642,441191378,0,0,0,209.12,8,437447.42,24,5,20,7,True
9019010,900,1,-1,3392,441191378,0,1,0,208.76,1,437447.42,24,5,7,8,True
9055473,1094,0,10,6874,441191378,0,0,0,209.07,6,437656.49,0,6,13,9,True
9118966,1352,1,10,7993,441191378,0,0,0,208.83,6,437865.32,24,0,16,9,True
9725055,594,0,20,2299,441191378,0,0,0,208.94,3,437656.38,24,2,10,9,True
9732550,81,0,20,3392,441191378,0,0,0,209.0,5,437447.38,1,0,6,10,True
9772711,749,4,25,3115,441191378,0,0,0,208.88,8,437238.5,24,3,9,10,True
1170494,1316,3,30,2552,328643463,1,0,0,1103.83,8,365384.17,5,4,4,2,True
1466932,155,1,-1,5650,328643463,1,1,0,1104.02,4,365384.17,18,6,13,2,True
1679149,743,4,451,1579,328643463,1,0,0,1104.05,7,364280.12,24,1,2,4,True
1991631,990,0,20,1611,328643463,1,0,0,1104.16,3,363175.96,22,5,19,4,True
2293039,689,0,10,4064,328643463,1,0,0,1103.92,6,364279.88,24,0,22,4,True
2434980,231,4,451,9707,328643463,1,0,0,1103.93,7,363175.95,26,0,18,6,True
2766976,155,1,-1,2445,328643463,1,1,0,1104.13,1,363175.95,18,3,10,9,True
3271134,592,4,-1,3488,328643463,1,2,0,1104.05,4,363175.95,24,1,14,10,True
3316751,1152,0,20,6146,328643463,1,0,0,1103.95,5,362072.0,15,4,10,1,True
3631772,155,1,30,1352,328643463,1,0,0,1104.02,8,360967.98,18,1,9,2,True
3998480,592,4,451,2513,328643463,1,0,0,1104.04,7,359863.94,24,5,18,3,True
4333301,155,1,25,4301,328643463,1,0,0,1104.13,8,358759.81,18,1,22,4,True
4495239,1068,2,20,7817,328643463,1,0,0,1103.73,5,357656.08,18,6,18,8,True
4499990,231,4,-1,1611,328643463,1,1,0,1104.02,4,357656.08,26,2,2,8,True
4726355,592,4,30,2552,328643463,1,0,0,1104.42,8,356551.66,24,2,18,11,True
4755927,910,0,10,7314,328643463,1,0,0,1104.08,6,357655.74,18,5,3,2,True
4973806,592,4,25,7817,328643463,1,0,0,1104.19,8,356551.55,24,6,9,5,True
5115818,1316,3,-1,3555,328643463,1,1,0,1103.9,4,356551.55,5,3,15,6,True
5564939,231,4,-1,1611,328643463,1,2,0,1104.13,1,356551.55,26,0,21,7,True
5589526,1316,3,-1,2325,328643463,1,3,1,1103.71,4,356551.55,5,2,21,9,True
1022567,1409,1,30,3161,921374419,1,0,0,138.08,8,438917.92,24,4,7,2,True
1306262,1409,1,30,4646,921374419,1,0,0,138.25,8,438779.67,24,1,11,2,True
1591724,320,1,10,6684,921374419,1,0,0,138.09,6,438917.76,11,5,15,3,True
1633732,300,0,20,5130,921374419,1,0,0,138.21,5,438779.55,4,2,6,3,True
1902922,184,0,451,4157,921374419,1,0,0,137.89,7,438641.66,18,0,13,5,True
2059290,730,4,25,2241,921374419,1,0,0,137.89,8,438503.77,11,2,22,5,True
2130657,398,0,10,4157,921374419,1,0,0,137.83,0,438641.6,10,3,9,5,True
2160752,1467,0,25,4157,921374419,1,0,0,138.24,8,438503.36,11,2,19,6,True
2643756,1036,1,10,3303,921374419,1,0,0,138.08,6,438641.44,11,2,3,6,True
3015927,681,2,25,6684,921374419,1,0,0,138.04,8,438503.4,24,2,5,7,True
3498183,1409,1,451,2700,921374419,1,0,0,138.08,7,438365.32,24,4,22,8,True
3563451,1108,1,10,6141,921374419,1,0,0,138.15,6,438503.47,0,2,14,8,False
3568081,184,0,30,2700,921374419,1,0,0,137.88,8,438365.59,18,1,2,9,True
3760543,1409,1,451,3025,921374419,1,0,0,138.04,7,438227.55,24,4,11,10,False
4093914,576,2,20,6684,921374419,1,0,0,138.06,5,438089.49,11,4,18,1,True
4163687,1361,2,30,5528,921374419,1,0,0,138.11,8,437951.38,16,6,18,2,True
4180457,231,4,451,4157,921374419,1,0,0,138.06,7,437813.32,26,0,2,2,True
4397688,184,0,451,1897,921374419,1,0,0,137.98,7,437675.34,18,3,1,3,True
4411143,730,4,451,5180,921374419,1,0,0,138.02,7,437537.32,11,0,3,3,True
4493435,730,4,25,7796,921374419,1,0,0,137.87,8,437399.45,11,4,19,3,True
4658835,1361,2,-1,3161,921374419,1,1,0,137.98,1,437399.45,16,5,16,4,True
4695334,184,0,25,3303,921374419,1,0,0,138.02,8,437261.43,18,2,15,4,True
4961543,1467,0,25,4157,921374419,1,0,0,137.75,8,437123.68,11,1,16,8,True
4963321,1361,2,451,4646,921374419,1,0,0,137.94,7,436985.74,16,0,16,10,True
5062928,730,4,451,2581,921374419,1,0,0,138.17,7,436847.57,11,3,13,10,True
5339393,1124,0,10,4294,921374419,1,0,0,137.79,6,436985.36,24,3,4,10,True
5614917,482,1,10,3453,921374419,1,0,0,138.07,6,437123.43,5,2,4,11,True
5780644,231,4,451,1897,921374419,1,0,0,138.18,7,436985.25,26,2,13,12,True
6095552,231,4,30,1045,921374419,1,0,0,138.29,8,436846.96,26,3,22,12,True
6103493,727,0,10,4294,921374419,1,0,0,137.91,6,436984.87,11,3,14,12,True
6115104,542,0,20,5180,921374419,1,0,0,137.98,5,436846.89,17,4,9,12,True
6221403,1409,1,451,5180,921374419,1,0,0,138.16,7,436708.73,24,1,21,1,True
6340905,1467,0,-1,3292,921374419,1,1,0,137.89,4,436708.73,11,3,10,1,True
6515804,1217,0,10,1897,921374419,1,0,0,138.11,6,436846.84,24,5,15,2,True
6541895,1273,0,10,1045,921374419,1,0,0,138.12,0,436984.96,24,1,9,3,True
7039366,1409,1,25,5130,921374419,1,0,0,138.09,8,436846.87,24,2,10,3,True
7391586,681,2,451,1045,921374419,1,0,0,138.11,7,436708.76,24,4,10,3,True
7492806,231,4,-1,6141,921374419,1,1,0,138.05,4,436708.76,26,2,18,4,True
7665354,1220,3,30,3453,921374419,1,0,0,138.21,8,436570.55,24,2,7,6,True
7753727,1232,1,10,5180,921374419,1,0,0,137.89,0,436708.44,18,4,23,6,True
7905830,1361,2,30,3303,921374419,1,0,0,137.91,8,436570.53,16,3,16,7,True
8118074,730,4,451,5180,921374419,1,0,0,137.85,7,436432.68,11,6,10,7,True
8145865,1361,2,451,4294,921374419,1,0,0,138.15,7,436294.53,16,0,1,8,True
8181150,585,2,20,1897,921374419,1,0,0,138.26,5,436156.27,11,6,13,8,True
8302442,1220,3,451,6141,921374419,1,0,0,138.02,7,436018.25,24,6,11,9,True
8568931,1361,2,30,2241,921374419,1,0,0,137.76,8,435880.49,16,6,20,9,True
8769135,1467,0,-1,1457,921374419,1,1,0,137.94,4,435880.49,11,4,12,9,True
8810919,403,0,10,3303,921374419,1,0,0,137.71,6,436018.2,10,2,2,9,True
8942134,730,4,-1,3025,921374419,1,1,0,137.9,1,436018.2,11,4,5,10,True
8969529,730,4,451,3453,921374419,1,0,0,137.95,7,435880.25,11,6,2,10,True
9291455,1409,1,451,3453,921374419,1,0,0,138.0,7,435742.25,24,4,20,11,True
9608686,118,2,20,2241,921374419,1,0,0,138.03,3,435604.22,18,6,5,11,True
9934361,1390,0,10,3161,921374419,1,0,0,138.02,0,435742.24,24,2,11,11,True
1014429,979,0,451,5569,295185826,0,0,0,954.93,7,848120.07,22,1,7,1,True
1693391,979,0,451,6079,295185826,0,0,0,954.87,7,847165.2,22,0,20,1,True
1872972,1082,3,451,3819,295185826,0,0,0,954.88,7,846210.32,18,1,13,1,True
1906837,800,0,20,3982,295185826,0,0,0,954.91,3,845255.41,11,6,0,1,True
2022086,367,1,10,3930,295185826,0,0,0,955.14,0,846210.55,25,4,14,1,True
2100732,344,3,451,4163,295185826,0,0,0,955.06,7,845255.49,24,1,1,2,True
2156779,854,0,30,4163,295185826,0,0,0,955.23,8,844300.26,24,1,8,2,True
2315675,1227,0,10,7971,295185826,0,0,0,954.9,6,845255.16,18,5,9,3,True
2324652,35,2,20,7971,295185826,0,0,0,955.08,3,844300.08,11,0,20,4,True
2372739,854,0,30,1211,295185826,0,0,0,954.97,8,843345.11,24,5,7,4,True
2755149,1443,4,-1,6734,295185826,0,1,0,954.93,1,843345.11,24,6,1,4,True
2878370,344,3,-1,6734,295185826,0,2,0,955.25,1,843345.11,24,3,8,5,False
2999661,854,0,25,6142,295185826,0,0,0,954.93,8,842390.18,24,2,4,6,True
3084109,349,2,20,4163,295185826,0,0,0,955.2,5,841434.98,24,3,8,7,True
3344088,854,0,30,4873,295185826,0,0,0,955.13,8,840479.85,24,4,12,7,True
3362221,1122,1,10,2122,295185826,0,0,0,954.96,0,841434.81,24,2,7,7,False
3571406,1443,4,30,7275,295185826,0,0,0,954.99,8,840479.82,24,2,22,7,True
3731513,931,0,10,3930,295185826,0,0,0,955.17,6,841434.99,24,4,22,8,True
3740695,677,0,10,4993,295185826,0,0,0,955.09,0,842390.08,24,5,1,8,True
3780242,854,0,451,1211,295185826,0,0,0,955.12,7,841434.96,24,5,5,8,True
4033655,1443,4,451,7275,295185826,0,0,0,954.97,7,840479.99,24,1,0,10,True
4150372,979,0,-1,2122,295185826,0,1,0,955.19,4,840479.99,22,1,2,10,True
4215195,854,0,451,7632,295185826,0,0,0,955.03,7,839524.96,24,5,8,10,True
4772463,344,3,25,9637,295185826,0,0,0,954.9,8,838570.06,24,4,14,11,True
4820128,344,3,451,9637,295185826,0,0,0,954.94,7,837615.12,24,6,6,11,True
5318923,1082,3,30,9637,295185826,0,0,0,955.03,8,836660.09,18,3,22,12,True
5421409,979,0,451,1211,295185826,0,0,0,954.92,7,835705.17,22,4,5,12,True
5534497,1443,4,25,7275,295185826,0,0,0,955.2,8,834749.97,24,5,1,12,True
5582694,1443,4,-1,2122,295185826,0,1,0,955.18,4,834749.97,24,1,9,1,True
6166411,1443,4,25,3752,295185826,0,0,0,954.88,8,833795.09,24,3,17,2,True
6483807,979,0,30,1211,295185826,0,0,0,955.16,8,832839.93,22,0,17,2,True
6983468,344,3,451,6142,295185826,0,0,0,954.64,7,831885.29,24,0,8,4,True
6993399,344,3,30,6142,295185826,0,0,0,955.05,8,830930.24,24,5,21,4,True
7131136,1072,0,10,6142,295185826,0,0,0,955.13,6,831885.37,18,4,1,5,True
7132666,854,0,-1,1567,295185826,0,1,0,954.93,1,831885.37,24,4,6,7,True
7198362,1443,4,451,6079,295185826,0,0,0,954.77,7,830930.6,24,4,12,9,True
7343864,787,0,10,1211,295185826,0,0,0,955.13,6,831885.73,14,2,17,11,True
7504951,1155,0,20,3982,295185826,0,0,0,954.84,5,830930.89,15,3,7,11,True
7727709,854,0,451,4873,295185826,0,0,0,955.03,7,829975.86,24,5,6,12,True
7903952,649,0,10,1567,295185826,0,0,0,955.08,6,830930.94,24,1,12,1,True
7978897,979,0,-1,4993,295185826,0,1,0,954.86,1,830930.94,22,5,2,2,True
8184325,344,3,25,3982,295185826,0,0,0,955.16,8,829975.78,24,6,16,4,True
8241710,800,0,10,3930,295185826,0,0,0,955.15,6,830930.93,11,3,7,5,True
8604903,344,3,451,5569,295185826,0,0,0,954.91,7,829976.02,24,4,7,6,True
8605064,1053,1,10,3674,295185826,0,0,0,955.13,0,830931.15,11,4,14,6,True
8781516,1443,4,25,7375,295185826,0,0,0,954.91,8,829976.24,24,6,0,8,False
8890537,854,0,-1,7275,295185826,0,1,0,955.07,4,829976.24,24,5,7,9,True
9092553,344,3,30,1573,295185826,0,0,0,954.95,8,829021.29,24,6,14,9,True
9096527,1443,4,451,7275,295185826,0,0,0,954.8,7,828066.49,24,0,0,9,True
9219281,854,0,30,6142,295185826,0,0,0,955.21,8,827111.28,24,2,2,10,True
9357122,979,0,25,3674,295185826,0,0,0,954.83,8,826156.45,22,5,6,10,True
9429261,1037,0,20,3674,295185826,0,0,0,954.85,3,825201.6,11,5,19,10,True
9556831,1443,4,25,2122,295185826,0,0,0,954.95,8,824246.65,24,0,8,11,True
9807920,344,3,25,1211,295185826,0,0,0,954.8,8,823291.85,24,3,23,11,True
1130654,952,0,10,8774,188078162,1,0,0,204.95,6,482536.95,13,0,4,1,True
1156682,452,4,-1,3721,188078162,1,1,0,204.72,4,482536.95,13,3,2,2,True
1212481,132,2,451,1920,188078162,1,0,0,204.86,7,482332.09,18,0,10,3,True
1527356,1156,1,10,7313,188078162,1,0,0,205.09,6,482537.18,15,2,19,3,False
1762311,1445,2,451,3134,188078162,1,0,0,204.81,7,482332.37,24,2,3,4,True
1762348,865,0,-1,6520,188078162,1,1,0,204.93,1,482332.37,24,6,16,4,True
2477717,1388,1,451,2848,188078162,1,0,0,205.08,7,482127.29,24,1,18,5,True
2768936,782,4,-1,4944,188078162,1,1,0,205.07,4,482127.29,14,4,20,5,True
3123784,594,0,10,4035,188078162,1,0,0,205.24,0,482332.53,24,0,5,5,True
3169598,1445,2,-1,5723,188078162,1,1,0,204.92,4,482332.53,24,6,3,5,True
3228683,1125,1,10,4705,188078162,1,0,0,205.29,6,482537.82,24,2,18,6,True
3399228,132,2,30,4746,188078162,1,0,0,204.87,8,482332.95,18,4,14,6,True
3570931,782,4,451,7313,188078162,1,0,0,205.04,7,482127.91,14,4,8,7,True
3743085,1445,2,25,1920,188078162,1,0,0,204.97,8,481922.94,24,6,8,7,True
3749475,1101,2,20,4944,188078162,1,0,0,205.2,5,481717.74,0,5,5,8,True
3923167,1366,4,30,6027,188078162,1,0,0,205.21,8,481512.53,16,3,2,8,True
4053496,452,4,451,5347,188078162,1,0,0,205.04,7,481307.49,13,3,19,8,True
4127704,452,4,451,4149,188078162,1,0,0,205.03,7,481102.46,13,2,7,8,True
4326077,97,0,10,5999,188078162,1,0,0,204.96,6,481307.42,3,2,20,9,False
4462749,1366,4,451,4035,188078162,1,0,0,205.24,7,481102.18,16,5,14,9,True
4813412,782,4,25,4944,188078162,1,0,0,205.05,8,480897.13,14,2,17,11,True
4815235,1388,1,451,5999,188078162,1,0,0,205.21,7,480691.92,24,5,21,11,True
5067823,342,0,20,7313,188078162,1,0,0,204.79,5,480487.13,24,2,12,12,True
5118445,1388,1,30,3120,188078162,1,0,0,205.04,8,480282.09,24,2,11,2,True
5149536,865,0,25,4989,188078162,1,0,0,205.12,8,480076.97,24,2,9,3,True
5167503,1445,2,-1,4434,188078162,1,1,0,205.04,4,480076.97,24,5,12,5,True
5216567,782,4,30,5999,188078162,1,0,0,205.23,8,479871.74,14,5,3,6,True
5334246,816,0,25,3991,188078162,1,0,0,205.03,8,479666.71,18,1,8,6,True
5355608,816,0,-1,5723,188078162,1,1,0,204.99,4,479666.71,18,0,12,8,True
5862682,1388,1,451,4303,188078162,1,0,0,205.06,7,479461.65,24,3,12,8,True
5943027,616,1,10,5342,188078162,1,0,0,205.09,0,479666.74,11,5,2,8,False
6328454,132,2,30,2241,188078162,1,0,0,204.87,8,479461.87,18,5,13,9,True
6714192,1455,2,-1,2848,188078162,1,1,0,205.17,4,479461.87,11,2,13,10,True
6870188,1445,2,25,2241,188078162,1,0,0,205.01,8,479256.86,24,5,6,11,True
6941144,1249,2,20,4989,188078162,1,0,0,204.76,5,479052.1,23,6,3,12,True
7073019,406,1,10,4746,188078162,1,0,0,205.09,6,479257.19,10,5,3,1,True
7368264,1388,1,30,4303,188078162,1,0,0,204.68,8,479052.51,24,0,20,1,True
7373878,816,0,451,3134,188078162,1,0,0,204.88,7,478847.63,18,2,9,2,True
7498146,1366,4,451,4434,188078162,1,0,0,205.07,7,478642.56,16,3,22,2,True
7550364,1455,2,451,5342,188078162,1,0,0,204.87,7,478437.69,11,5,12,3,True
7647507,701,2,20,4746,188078162,1,0,0,205.14,5,478232.55,18,3,19,4,True
7920542,452,4,30,3196,188078162,1,0,0,204.68,8,478027.87,13,0,7,5,True
8216661,1010,0,20,7313,188078162,1,0,0,205.1,5,477822.77,26,0,8,5,True
8295554,1366,4,30,1398,188078162,1,0,0,205.13,8,477617.64,16,3,6,5,True
8362454,782,4,30,7313,188078162,1,0,0,205.12,8,477412.52,14,3,8,6,True
8373520,132,2,451,4746,188078162,1,0,0,205.01,7,477207.51,18,4,7,6,True
8401979,1132,0,10,3721,188078162,1,0,0,205.21,6,477412.72,24,1,22,7,True
8453221,1210,0,20,3196,188078162,1,0,0,205.01,3,477207.71,24,0,10,7,True
8948043,1366,4,451,3120,188078162,1,0,0,204.96,7,477002.75,16,2,1,8,True
9077398,509,0,10,2848,188078162,1,0,0,205.22,0,477207.97,12,5,0,9,True
9744266,605,0,10,4746,188078162,1,0,0,204.88,6,477412.85,24,1,13,9,True
9805925,1366,4,25,3721,188078162,1,0,0,204.86,8,477207.99,16,2,18,10,True
9842725,782,4,30,4944,188078162,1,0,0,205.09,8,477002.9,14,1,11,11,True
9867179,132,2,451,4149,188078162,1,0,0,204.83,7,476798.07,18,5,5,11,True
1057825,716,0,10,6016,830172112,0,0,0,613.07,6,974678.07,18,5,21,2,True
1082106,1252,4,25,8003,830172112,0,0,0,613.05,8,974065.02,23,6,5,5,True
1109541,560,2,30,6119,830172112,0,0,0,612.94,8,973452.08,17,2,9,5,True
1202291,1454,1,10,4690,830172112,0,0,0,613.1,6,974065.18,11,3,5,5,True
1229640,1076,1,10,7073,830172112,0,0,0,613.17,0,974678.35,18,4,18,5,True
1356627,947,2,25,6431,830172112,0,0,0,612.74,8,974065.61,24,2,16,5,True
1490464,824,2,451,6545,830172112,0,0,0,613.11,7,973452.5,18,1,22,8,True
1709056,560,2,451,6545,830172112,0,0,0,613.07,7,972839.43,17,2,16,8,True
1746332,200,0,20,6016,830172112,0,0,0,613.14,5,972226.29,9,3,6,8,True
1868666,414,4,25,2149,830172112,0,0,0,613.09,8,971613.2,18,0,4,9,True
1935662,557,1,10,4690,830172112,0,0,0,612.72,6,972225.92,17,1,16,9,True
2151042,817,4,451,7690,830172112,0,0,0,613.19,7,971612.73,18,6,11,9,False
2405786,947,2,451,3261,830172112,0,0,0,613.07,7,970999.66,24,4,1,10,True
2448274,1009,0,10,9213,830172112,0,0,0,612.77,0,971612.43,26,1,20,11,True
2575799,1419,1,10,9896,830172112,0,0,0,613.21,6,972225.64,24,1,15,11,True
2606585,1435,2,20,8003,830172112,0,0,0,613.18,5,971612.46,24,3,20,12,True
2806846,1252,4,25,9385,830172112,0,0,0,613.01,8,970999.45,23,6,14,12,True
2966541,1134,1,451,7350,830172112,0,0,0,613.14,7,970386.31,24,2,15,1,True
3001341,817,4,-1,2946,830172112,0,1,0,612.81,4,970386.31,18,4,4,2,True
3036912,211,0,20,2946,830172112,0,0,0,613.06,5,969773.25,9,0,7,2,True
3561267,414,4,451,6016,830172112,0,0,0,613.05,7,969160.2,18,3,1,3,True
3721906,414,4,451,7350,830172112,0,0,0,613.2,7,968547.0,18,5,6,3,True
3841232,414,4,30,4690,830172112,0,0,0,613.32,8,967933.68,18,0,15,3,True
3909994,1134,1,30,5052,830172112,0,0,0,613.34,8,967320.34,24,6,3,5,True
4047966,300,0,10,9705,830172112,0,0,0,612.9,6,967933.24,4,0,15,6,True
4393614,1411,0,20,6498,830172112,0,0,0,612.92,3,967320.32,24,3,20,6,True
4529793,1134,1,451,3365,830172112,0,0,0,613.07,7,966707.25,24,2,2,7,True
4591674,824,2,451,2149,830172112,0,0,0,612.94,7,966094.31,18,5,0,7,True
4719130,560,2,-1,9896,830172112,0,1,0,612.77,1,966094.31,17,5,22,7,True
4885125,414,4,25,6119,830172112,0,0,0,613.16,8,965481.15,18,2,1,8,True
5036618,817,4,451,3061,830172112,0,0,0,612.69,7,964868.46,18,3,20,8,True
5110921,560,2,-1,8885,830172112,0,1,0,612.95,4,964868.46,17,5,8,12,True
5151009,168,0,30,4690,830172112,0,0,0,613.02,8,964255.44,24,4,21,2,True
5161620,947,2,451,8003,830172112,0,0,0,612.85,7,963642.59,24,5,16,3,True
5294613,360,0,20,5052,830172112,0,0,0,612.64,5,963029.95,24,1,21,3,True
5386383,1255,0,10,9213,830172112,0,0,0,612.99,6,963642.94,23,0,13,4,True
5421677,168,0,-1,6431,830172112,0,1,0,613.37,1,963642.94,24,0,2,5,True
5490573,824,2,30,7073,830172112,0,0,0,612.95,8,963029.99,18,2,9,5,True
5781136,560,2,451,2149,830172112,0,0,0,613.02,7,962416.97,17,6,11,5,True
5952973,621,2,20,2101,830172112,0,0,0,612.89,3,961804.08,11,3,7,6,True
5986666,414,4,30,6119,830172112,0,0,0,612.98,8,961191.1,18,6,11,6,True
6173003,168,0,30,7350,830172112,0,0,0,613.19,8,960577.91,24,2,4,6,True
6839657,360,0,20,2101,830172112,0,0,0,612.95,5,959964.96,24,6,13,6,True
7066558,1060,1,10,2101,830172112,0,0,0,613.13,6,960578.09,11,3,19,7,True
7146340,947,2,451,2946,830172112,0,0,0,612.96,7,959965.13,24,1,17,7,True
7647126,1434,0,20,2101,830172112,0,0,0,613.05,3,959352.08,24,3,15,8,True
8715431,947,2,451,1172,830172112,0,0,0,612.92,7,958739.16,24,3,0,8,True
9085843,824,2,30,1172,830172112,0,0,0,612.94,8,958126.22,18,4,20,8,True
9360936,995,1,10,6431,830172112,0,0,0,613.04,6,958739.26,22,4,14,8,True
9401493,1134,1,451,1172,830172112,0,0,0,612.82,7,958126.44,24,3,4,9,True
9512162,350,0,20,5052,830172112,0,0,0,613.3,3,957513.14,24,0,6,9,True
9790134,696,2,20,9213,830172112,0,0,0,613.29,5,956899.85,24,1,22,10,True
9918158,817,4,30,5052,830172112,0,0,0,612.93,8,956286.92,18,1,2,10,True
9950646,269,0,20,1802,830172112,0,0,0,613.23,5,955673.69,24,2,14,10,True
1029257,410,4,25,1048,615571717,0,0,0,599.78,8,903481.22,18,2,5,1,True
1079761,847,3,30,4935,615571717,0,0,0,600.22,8,902881.0,5,3,13,1,True
1265322,1113,1,10,1048,615571717,0,0,0,600.06,6,903481.06,0,3,23,2,True
1332826,438,1,10,8038,615571717,0,0,0,599.58,6,904080.64,24,5,11,2,True
1350109,664,2,20,2825,615571717,0,0,0,600.01,3,903480.63,18,0,4,2,False
1386911,1019,0,25,2201,615571717,0,0,0,600.12,8,902880.51,26,4,6,3,True
1427814,1361,2,20,9654,615571717,0,0,0,600.25,5,902280.26,16,5,4,3,True
1526713,404,1,10,5918,615571717,0,0,0,600.02,6,902880.28,10,5,23,3,True
1542780,1463,2,20,5741,615571717,0,0,0,600.19,5,902280.09,11,6,9,3,True
1880909,880,1,10,3171,615571717,0,0,0,600.11,6,902880.2,27,3,23,4,True
2060166,732,0,20,3828,615571717,0,0,0,600.1,5,902280.1,11,0,2,6,True
2207952,1224,4,25,9820,615571717,0,0,0,600.16,8,901679.94,24,5,17,7,False
2560178,850,1,10,3828,615571717,0,0,0,599.89,0,902279.83,5,1,19,7,True
2687858,316,2,25,2825,615571717,0,0,0,600.12,8,901679.71,4,6,14,7,True
2688317,747,1,10,1048,615571717,0,0,0,600.2,0,902279.91,24,6,21,9,True
2933942,1019,0,451,3171,615571717,0,0,0,600.0,7,901679.91,26,5,0,9,True
3264720,996,0,10,3171,615571717,0,0,0,600.36,6,902280.27,26,6,20,9,True
3417841,1317,4,-1,8038,615571717,0,1,0,600.0,4,902280.27,18,1,2,10,True
3587925,1323,4,451,5918,615571717,0,0,0,599.93,7,901680.34,18,4,16,10,True
3751622,538,0,10,4459,615571717,0,0,0,599.89,6,902280.23,18,6,2,11,True
3815309,427,2,25,2825,615571717,0,0,0,600.09,8,901680.14,18,3,3,11,True
4014285,410,4,451,9654,615571717,0,0,0,600.15,7,901079.99,18,0,21,11,True
4196763,847,3,-1,9654,615571717,0,1,0,600.13,1,901079.99,5,0,10,1,True
4209213,739,1,10,8038,615571717,0,0,0,600.14,6,901680.13,24,3,1,1,True
4411478,1224,4,30,2201,615571717,0,0,0,599.98,8,901080.15,24,0,15,2,True
4412803,427,2,451,9654,615571717,0,0,0,600.21,7,900479.94,18,4,8,3,True
4474599,1123,2,20,5368,615571717,0,0,0,600.04,5,899879.9,24,5,2,4,True
4475940,1323,4,30,2825,615571717,0,0,0,600.27,8,899279.63,18,2,23,5,True
4882780,1317,4,-1,4935,615571717,0,1,0,600.03,1,899279.63,18,3,6,7,True
4884322,1224,4,30,2825,615571717,0,0,0,600.19,8,898679.44,24,0,20,7,True
5147680,1323,4,25,9654,615571717,0,0,0,599.75,8,898079.69,18,2,11,7,True
5180240,1019,0,25,5918,615571717,0,0,0,599.87,8,897479.82,26,3,7,7,True
5226198,316,2,30,2201,615571717,0,0,0,600.07,8,896879.75,4,4,23,7,True
5251273,316,2,-1,4935,615571717,0,1,0,600.15,4,896879.75,4,5,7,7,True
5472627,1317,4,25,2201,615571717,0,0,0,600.04,8,896279.71,18,1,1,8,True
5961437,199,0,20,3695,615571717,0,0,0,599.88,5,895679.83,18,1,11,8,True
6503450,427,2,451,5918,615571717,0,0,0,600.1,7,895079.73,18,1,22,8,True
6582139,847,3,-1,5918,615571717,0,1,0,600.14,1,895079.73,5,6,20,9,True
6818120,410,4,30,4935,615571717,0,0,0,599.88,8,894479.85,18,5,21,9,True
6823836,1224,4,-1,4459,615571717,0,1,0,599.89,1,894479.85,24,4,17,11,True
7477420,316,2,-1,2825,615571717,0,2,0,600.16,4,894479.85,4,5,15,11,True
7483899,739,1,30,9820,615571717,0,0,0,599.97,8,893879.88,24,3,15,11,True
7496910,1224,4,30,2825,615571717,0,0,0,600.08,8,893279.8,24,3,1,1,True
7682185,316,2,30,4935,615571717,0,0,0,600.18,8,892679.62,4,0,6,1,True
7690105,427,2,-1,1048,615571717,0,1,0,599.99,1,892679.62,18,1,21,2,True
8205957,847,3,-1,3695,615571717,0,2,0,600.21,4,892679.62,5,1,18,4,True
8431335,757,0,20,9654,615571717,0,0,0,599.94,5,892079.68,24,2,9,5,True
8621586,739,1,30,7927,615571717,0,0,0,600.05,8,891479.63,24,5,21,5,True
8663305,739,1,451,5918,615571717,0,0,0,600.0,7,890879.63,24,5,13,5,True
8995326,410,4,451,5741,615571717,0,0,0,599.96,7,890279.67,18,5,11,6,True
9130009,847,3,30,4935,615571717,0,0,0,600.04,8,889679.63,5,0,12,6,True
9253526,410,4,25,7927,615571717,0,0,0,600.05,8,889079.58,18,5,0,7,True
9284569,427,2,25,2201,615571717,0,0,0,600.09,8,888479.49,18,2,22,7,True
9358862,1323,4,30,3828,615571717,0,0,0,599.9,8,887879.59,18,0,23,7,True
9602273,1317,4,451,4459,615571717,0,0,0,599.93,7,887279.66,18,6,7,10,True
9620819,1288,0,10,9820,615571717,0,0,0,600.13,6,887879.79,24,4,16,10,True
9719660,427,2,30,9820,615571717,0,0,0,600.15,8,887279.64,18,6,10,11,True
9975454,1119,0,10,4935,615571717,0,0,0,600.09,0,887879.73,24,2,9,11,True
1005120,736,1,-1,8015,882201495,0,1,0,646.89,4,566804.0,11,6,8,1,True
1063934,736,1,451,9705,882201495,0,0,0,647.0,7,566157.0,11,1,0,1,True
1070919,1012,0,10,1617,882201495,0,0,0,646.94,6,566803.94,26,5,19,2,True
1115286,139,4,451,3331,882201495,0,0,0,647.04,7,566156.9,18,5,14,2,True
1697516,993,0,30,9063,882201495,0,0,0,646.89,8,565510.01,22,2,6,3,True
1787300,1307,0,10,9130,882201495,0,0,0,647.06,6,566157.07,5,1,9,3,True
1791478,703,0,-1,4967,882201495,0,1,0,646.75,1,566157.07,18,4,11,5,True
2068135,649,0,20,9704,882201495,0,0,0,647.19,3,565509.88,24,6,20,5,True
2234738,703,0,-1,8654,882201495,0,1,0,646.96,4,565509.88,18,6,13,6,True
2536281,334,0,20,5413,882201495,0,0,0,647.07,5,564862.81,11,2,1,7,True
2865356,225,3,30,1902,882201495,0,0,0,647.13,8,564215.68,26,6,6,7,False
2899225,40,4,30,6663,882201495,0,0,0,647.16,8,563568.52,11,4,22,8,True
2908988,1380,0,20,8479,882201495,0,0,0,647.14,3,562921.38,16,6,0,8,True
2918867,139,4,451,3331,882201495,0,0,0,646.94,7,562274.44,18,1,7,9,True
3179767,40,4,-1,5413,882201495,0,1,0,647.1,4,562274.44,11,2,2,10,True
3419557,267,0,20,1617,882201495,0,0,0,647.13,5,561627.31,6,5,14,10,True
3477083,703,0,451,3596,882201495,0,0,0,647.13,7,560980.18,18,2,7,10,True
3507977,694,2,20,9063,882201495,0,0,0,647.03,3,560333.15,24,4,0,10,True
3569377,225,3,451,3240,882201495,0,0,0,647.1,7,559686.05,26,0,9,10,True
3609183,736,1,-1,5406,882201495,0,1,0,647.01,4,559686.05,11,2,21,11,True
3635548,989,1,10,5888,882201495,0,0,0,646.94,6,560332.99,22,3,15,12,True
3785539,787,0,20,5406,882201495,0,0,0,647.08,3,559685.91,14,3,19,12,True
3827566,40,4,451,6345,882201495,0,0,0,647.03,7,559038.88,11,5,8,1,True
3935436,703,0,-1,3596,882201495,0,1,0,646.84,1,559038.88,18,6,17,2,True
3995505,703,0,451,4757,882201495,0,0,0,646.95,7,558391.93,18,3,16,3,True
4057246,225,3,30,6551,882201495,0,0,0,646.8,8,557745.13,26,4,13,3,True
4348929,993,0,-1,9705,882201495,0,1,0,647.16,4,557745.13,22,2,23,3,True
4353255,736,1,30,7159,882201495,0,0,0,647.03,8,557098.1,11,2,22,4,True
4558430,225,3,30,3596,882201495,0,0,0,647.26,8,556450.84,26,0,23,5,True
5200968,703,0,25,8654,882201495,0,0,0,646.77,8,555804.07,18,1,20,5,True
5234998,40,4,-1,1902,882201495,0,1,0,647.0,4,555804.07,11,0,7,6,True
5411703,703,0,25,8654,882201495,0,0,0,647.11,8,555156.96,18,4,20,6,True
5822829,755,3,30,8015,882201495,0,0,0,646.78,8,554510.18,24,5,5,7,True
5859192,139,4,25,7159,882201495,0,0,0,646.87,8,553863.31,18,1,11,7,True
5870998,736,1,-1,9130,882201495,0,1,0,646.93,4,553863.31,11,1,10,9,True
6384488,139,4,451,6663,882201495,0,0,0,647.15,7,553216.16,18,1,21,9,True
6627303,225,3,-1,4967,882201495,0,1,0,646.78,4,553216.16,26,2,3,9,True
6820248,879,1,10,6551,882201495,0,0,0,647.11,6,553863.27,27,5,16,9,True
6821865,29,0,20,2561,882201495,0,0,0,646.8,5,553216.47,11,1,0,10,True
7110325,703,0,-1,9063,882201495,0,1,0,647.19,4,553216.47,18,4,14,11,True
7140672,1355,4,30,2919,882201495,0,0,0,647.05,8,552569.42,24,6,17,12,True
7168430,1217,0,10,8654,882201495,0,0,0,646.8,6,553216.22,24,1,10,12,True
7287799,755,3,25,4757,882201495,0,0,0,646.86,8,552569.36,24,0,12,12,True
7393261,755,3,25,1902,882201495,0,0,0,647.18,8,551922.18,24,4,6,12,True
7865693,736,1,451,9704,882201495,0,0,0,646.98,7,551275.2,11,1,19,1,True
7978406,1355,4,451,1617,882201495,0,0,0,646.93,7,550628.27,24,3,12,2,True
8120668,225,3,30,5406,882201495,0,0,0,646.94,8,549981.33,26,2,23,3,True
8530141,225,3,451,8654,882201495,0,0,0,647.15,7,549334.18,26,4,13,4,True
8952361,1355,4,25,2919,882201495,0,0,0,647.13,8,548687.05,24,6,23,4,True
9027465,755,3,30,7159,882201495,0,0,0,646.97,8,548040.08,24,5,14,5,True
9393639,568,1,10,2512,882201495,0,0,0,646.75,0,548686.83,11,0,18,7,True
9552862,225,3,25,5031,882201495,0,0,0,646.87,8,548039.96,26,6,7,8,True
9643066,208,0,10,6551,882201495,0,0,0,647.17,6,548687.13,9,4,2,9,True
9947998,1355,4,451,9704,882201495,0,0,0,646.98,7,548040.15,24,0,10,11,True
1139553,549,1,10,8844,711156544,0,0,0,539.87,6,729557.87,17,2,9,1,False
1145153,472,4,30,2107,711156544,0,0,0,540.53,8,729017.34,5,2,22,1,True
1430540,283,4,451,5885,711156544,0,0,0,540.15,7,728477.19,24,6,15,1,True
1756358,331,4,25,9327,711156544,0,0,0,539.87,8,727937.32,11,5,17,1,True
2110057,863,4,451,9604,711156544,0,0,0,540.05,7,727397.27,24,6,23,2,True
2532273,1198,4,30,9487,711156544,0,0,0,539.79,8,726857.48,24,3,5,3,True
2659746,1198,4,30,8675,711156544,0,0,0,540.03,8,726317.45,24,4,10,5,True
2697585,318,0,20,9604,711156544,0,0,0,540.01,3,725777.44,11,4,9,6,True
2875525,472,4,-1,7210,711156544,0,1,0,539.65,1,725777.44,5,3,8,6,True
2886659,863,4,25,7945,711156544,0,0,0,539.83,8,725237.61,24,4,20,6,True
2975703,603,0,20,5538,711156544,0,0,0,539.78,3,724697.83,24,1,9,6,True
3084755,283,4,25,2107,711156544,0,0,0,539.94,8,724157.89,24,2,20,7,True
3154804,472,4,30,6208,711156544,0,0,0,540.32,8,723617.57,5,4,16,7,False
3162993,283,4,451,5538,711156544,0,0,0,540.18,7,723077.39,24,6,5,9,True
3204019,863,4,-1,7685,711156544,0,1,0,540.22,4,723077.39,24,0,3,11,True
3445308,331,4,30,6208,711156544,0,0,0,540.01,8,722537.38,11,5,12,12,True
3650794,1181,2,30,6771,711156544,0,0,0,540.0,8,721997.38,24,6,16,1,True
3709606,1181,2,451,7945,711156544,0,0,0,539.85,7,721457.53,24,3,18,2,True
3718812,1181,2,30,9327,711156544,0,0,0,540.02,8,720917.51,24,4,18,2,True
4026367,1468,1,10,9952,711156544,0,0,0,539.9,6,721457.41,11,6,0,2,True
4416948,522,0,10,9327,711156544,0,0,0,539.92,6,721997.33,18,3,6,3,True
4647911,283,4,451,8675,711156544,0,0,0,539.9,7,721457.43,24,4,21,5,True
4680697,485,1,10,5885,711156544,0,0,0,540.17,0,721997.6,5,6,21,5,True
4797593,1482,3,25,1054,711156544,0,0,0,539.92,8,721457.68,24,2,10,5,True
4923904,283,4,25,9604,711156544,0,0,0,540.21,8,720917.47,24,0,3,7,True
5075265,331,4,451,6137,711156544,0,0,0,539.81,7,720377.66,11,3,22,7,True
5261813,649,0,10,9952,711156544,0,0,0,540.13,6,720917.79,24,6,17,7,True
5365958,1482,3,25,7945,711156544,0,0,0,540.07,8,720377.72,24,3,3,7,True
5447883,863,4,-1,2107,711156544,0,1,0,539.96,1,720377.72,24,3,2,8,True
5631977,1181,2,30,9327,711156544,0,0,0,539.98,8,719837.74,24,4,11,8,True
6155840,656,2,20,8675,711156544,0,0,0,539.94,3,719297.8,18,0,11,8,True
6977938,889,0,10,1054,711156544,0,0,0,539.88,0,719837.68,27,6,21,9,True
7021002,1181,2,-1,9843,711156544,0,1,0,540.06,4,719837.68,24,6,11,10,True
7234518,472,4,30,5538,711156544,0,0,0,540.14,8,719297.54,5,0,2,10,True
7275077,459,1,10,3669,711156544,0,0,0,540.07,6,719837.61,13,1,17,11,True
7492106,1482,3,25,2107,711156544,0,0,0,540.09,8,719297.52,24,4,22,11,True
7734499,331,4,451,9952,711156544,0,0,0,540.15,7,718757.37,11,0,4,11,True
7741277,283,4,451,8611,711156544,0,0,0,540.15,7,718217.22,24,0,19,1,True
7983046,331,4,30,9487,711156544,0,0,0,539.66,8,717677.56,11,1,6,2,True
8059596,1482,3,451,6440,711156544,0,0,0,539.78,7,717137.78,24,4,5,3,True
8630750,1482,3,451,6208,711156544,0,0,0,540.05,7,716597.73,24,4,0,3,True
8682314,1140,0,10,6208,711156544,0,0,0,540.25,6,717137.98,15,3,1,3,True
8759398,1482,3,451,8675,711156544,0,0,0,539.75,7,716598.23,24,6,21,3,True
9084415,283,4,25,4717,711156544,0,0,0,540.08,8,716058.15,24,0,13,4,True
9143530,687,0,20,9327,711156544,0,0,0,540.0,5,715518.15,24,5,11,5,True
9227396,472,4,30,5885,711156544,0,0,0,539.46,8,714978.69,5,6,17,8,True
9527388,787,0,20,9327,711156544,0,0,0,540.05,5,714438.64,14,6,11,9,True
9850345,1181,2,-1,8675,711156544,0,1,0,539.81,4,714438.64,24,1,19,9,True
9852851,1388,1,10,5538,711156544,0,0,0,540.16,6,714978.8,24,1,4,9,True
9858892,1198,4,30,4455,711156544,0,0,0,539.92,8,714438.88,24,5,8,10,True
9964454,1181,2,451,8611,711156544,0,0,0,539.98,7,713898.9,24,1,6,11,True
1098088,1315,0,10,8549,413349313,0,0,0,1053.87,0,87827.87,5,1,4,1,True
1103878,652,0,20,3035,413349313,0,0,0,1054.14,5,86773.73,24,1,18,2,True
1269910,1483,0,10,6565,413349313,0,0,0,1053.84,0,87827.57,24,6,23,2,True
1477934,151,4,30,9469,413349313,0,0,0,1053.71,8,86773.86,18,1,11,2,True
1486577,220,0,-1,4472,413349313,0,1,0,1054.06,1,86773.86,26,6,17,3,False
1797482,715,0,-1,2631,413349313,0,2,0,1054.06,1,86773.86,18,2,23,3,True
1932958,715,0,25,6565,413349313,0,0,0,1054.03,8,85719.83,18,6,4,4,False
1971125,106,4,30,6565,413349313,0,0,0,1054.03,8,84665.8,3,4,19,4,True
2121500,106,4,25,4904,413349313,0,0,0,1053.93,8,83611.87,3,0,12,4,True
2339659,282,2,20,7474,413349313,0,0,0,1053.93,3,82557.94,24,2,16,4,True
2699258,151,4,30,8263,413349313,0,0,0,1053.99,8,81503.95,18,4,23,4,True
2797025,220,0,451,8263,413349313,0,0,0,1054.25,7,80449.7,26,4,13,6,True
3127859,1201,0,25,3304,413349313,0,0,0,1054.0,8,79395.7,24,4,2,6,True
3147884,831,1,10,3035,413349313,0,0,0,1054.18,6,80449.88,5,3,23,7,True
3184275,106,4,30,6487,413349313,0,0,0,1054.11,8,79395.77,3,2,15,7,True
3350956,199,0,20,8306,413349313,0,0,0,1053.96,5,78341.81,18,0,17,7,True
3380341,423,3,451,6487,413349313,0,0,0,1053.95,7,77287.86,18,6,2,9,True
3503287,423,3,30,4115,413349313,0,0,0,1053.85,8,76234.01,18,6,1,10,True
3590990,220,0,30,7474,413349313,0,0,0,1054.06,8,75179.95,26,1,13,11,False
3892875,996,0,20,7483,413349313,0,0,0,1053.7,5,74126.25,26,1,4,11,True
4027919,423,3,451,7474,413349313,0,0,0,1053.94,7,73072.31,18,5,9,12,True
4047051,715,0,-1,9058,413349313,0,1,0,1053.87,4,73072.31,18,3,8,1,False
4134140,1201,0,30,6274,413349313,0,0,0,1054.11,8,72018.2,24,5,18,1,False
4504993,106,4,-1,4472,413349313,0,1,0,1054.07,1,72018.2,3,2,11,1,False
4645170,220,0,25,6427,413349313,0,0,0,1053.82,8,70964.38,26,0,14,1,True
4663269,715,0,30,3304,413349313,0,0,0,1053.85,8,69910.53,18,6,17,1,True
4808671,715,0,25,1453,413349313,0,0,0,1054.32,8,68856.21,18,0,2,1,True
4847529,728,1,10,3304,413349313,0,0,0,1053.93,6,69910.14,11,0,23,2,True
4885341,378,0,20,6733,413349313,0,0,0,1053.86,3,68856.28,25,3,16,3,True
5373126,1101,2,20,3413,413349313,0,0,0,1053.97,5,67802.31,0,0,22,3,True
5847400,106,4,25,9469,413349313,0,0,0,1054.17,8,66748.14,3,1,20,3,True
5928704,1137,1,10,2261,413349313,0,0,0,1054.06,6,67802.2,24,4,13,4,True
6180843,1364,0,20,6487,413349313,0,0,0,1053.94,5,66748.26,16,4,14,5,True
6207554,151,4,25,8549,413349313,0,0,0,1054.0,8,65694.26,18,2,19,5,True
6259829,951,0,10,2261,413349313,0,0,0,1053.91,6,66748.17,24,2,4,6,True
6291022,220,0,25,6427,413349313,0,0,0,1054.09,8,65694.08,26,1,16,7,True
6454079,151,4,451,6565,413349313,0,0,0,1053.89,7,64640.19,18,3,5,8,True
6603522,106,4,25,2752,413349313,0,0,0,1053.95,8,63586.24,3,1,22,9,True
6858711,1201,0,30,8263,413349313,0,0,0,1053.8,8,62532.44,24,5,3,9,True
6873263,1112,1,10,3035,413349313,0,0,0,1054.07,0,63586.51,0,4,14,10,True
7123877,1201,0,30,4115,413349313,0,0,0,1053.79,8,62532.72,24,0,8,1,True
7161143,715,0,-1,9469,413349313,0,1,0,1054.03,4,62532.72,18,5,17,1,True
7320469,220,0,-1,6427,413349313,0,2,0,1054.05,4,62532.72,26,2,11,1,True
7425582,584,0,20,4667,413349313,0,0,0,1053.94,3,61478.78,11,0,3,2,True
7476317,423,3,30,4904,413349313,0,0,0,1054.18,8,60424.6,18,1,19,3,True
7545202,917,0,20,2631,413349313,0,0,0,1053.78,5,59370.82,18,2,16,3,True
7671993,1201,0,25,9058,413349313,0,0,0,1053.84,8,58316.98,24,5,12,3,True
7775264,423,3,30,4667,413349313,0,0,0,1053.91,8,57263.07,18,5,14,3,True
7811736,423,3,-1,6427,413349313,0,1,0,1054.09,4,57263.07,18,4,15,5,True
7839012,151,4,-1,6487,413349313,0,2,0,1054.1,1,57263.07,18,2,8,6,True
7930586,1201,0,451,3035,413349313,0,0,0,1054.19,7,56208.88,24,1,7,10,True
8193028,457,0,20,4472,413349313,0,0,0,1053.8,5,55155.08,13,2,10,10,True
8327397,580,0,20,4115,413349313,0,0,0,1054.21,5,54100.87,11,5,17,10,True
8715727,220,0,-1,7474,413349313,0,1,0,1054.11,4,54100.87,26,3,3,10,True
8720053,445,0,20,4472,413349313,0,0,0,1053.87,3,53047.0,13,6,21,11,True
9648218,715,0,30,4115,413349313,0,0,0,1053.87,8,51993.13,18,6,17,11,True
9943831,423,3,25,8549,413349313,0,0,0,1054.14,8,50938.99,18,5,2,11,True
1056720,1380,0,-1,9881,738565035,0,1,0,279.65,4,145989.0,16,5,22,1,True
1084993,603,0,25,4251,738565035,0,0,0,279.9,8,145709.1,24,4,4,1,True
1163852,59,0,10,6495,738565035,0,0,0,280.26,6,145989.36,20,4,11,1,True
1327529,371,3,451,2715,738565035,0,0,0,280.35,7,145709.01,25,3,9,1,True
1707983,1376,3,451,2715,738565035,0,0,0,280.06,7,145428.95,16,0,15,1,True
1985955,371,3,30,1800,738565035,0,0,0,280.06,8,145148.89,25,6,10,3,True
2163253,443,2,20,6730,738565035,0,0,0,279.94,3,144868.95,24,1,23,4,True
2169956,603,0,25,9679,738565035,0,0,0,280.08,8,144588.87,24,0,7,5,True
2277205,371,3,25,8634,738565035,0,0,0,280.0,8,144308.87,25,1,19,5,True
2303117,670,0,10,6730,738565035,0,0,0,279.97,0,144588.84,18,2,3,5,True
2321676,542,0,10,5448,738565035,0,0,0,280.1,6,144868.94,17,6,0,5,True
2388572,371,3,-1,8985,738565035,0,1,0,280.05,4,144868.94,25,1,19,5,True
2402357,371,3,451,1269,738565035,0,0,0,280.05,7,144588.89,25,5,6,7,True
2528359,371,3,451,9679,738565035,0,0,0,279.69,7,144309.2,25,2,5,8,True
2721736,371,3,451,9881,738565035,0,0,0,280.19,7,144029.01,25,1,1,9,True
2966266,1376,3,30,9679,738565035,0,0,0,279.94,8,143749.07,16,6,9,11,True
3008535,484,0,20,8985,738565035,0,0,0,280.04,5,143469.03,5,1,15,12,True
3033269,371,3,451,3804,738565035,0,0,0,280.04,7,143188.99,25,0,5,1,True
3054814,603,0,25,3804,738565035,0,0,0,280.15,8,142908.84,24,3,12,1,True
3310325,1376,3,-1,2865,738565035,0,1,0,280.26,1,142908.84,16,3,18,1,True
3461680,1376,3,451,3050,738565035,0,0,0,280.09,7,142628.75,16,2,3,3,True
4047203,1376,3,451,2715,738565035,0,0,0,280.08,7,142348.67,16,3,4,3,True
4268003,1463,2,20,5448,738565035,0,0,0,279.8,5,142068.87,11,3,17,3,True
4428453,262,2,20,6730,738565035,0,0,0,279.91,3,141788.96,6,3,20,4,True
4853120,1380,0,451,8493,738565035,0,0,0,280.12,7,141508.84,16,0,10,5,True
5130993,302,1,10,2865,738565035,0,0,0,279.82,6,141788.66,4,4,18,5,True
5429126,1376,3,25,8985,738565035,0,0,0,280.01,8,141508.65,16,1,18,6,False
5454335,1303,0,30,8634,738565035,0,0,0,279.89,8,141228.76,5,0,10,7,True
5638501,1376,3,30,5564,738565035,0,0,0,280.01,8,140948.75,16,3,3,7,True
5682195,1376,3,451,5564,738565035,0,0,0,279.97,7,140668.78,16,2,19,7,True
5715307,1303,0,25,5448,738565035,0,0,0,280.14,8,140388.64,5,3,4,8,True
5732870,1315,0,20,5564,738565035,0,0,0,280.26,5,140108.38,5,0,14,8,True
6013203,1271,0,10,1757,738565035,0,0,0,280.11,6,140388.49,23,3,21,9,True
6034949,1303,0,451,9881,738565035,0,0,0,279.96,7,140108.53,5,3,10,10,True
6144966,1303,0,25,5304,738565035,0,0,0,279.99,8,139828.54,5,1,14,11,True
6168698,1303,0,451,2715,738565035,0,0,0,280.01,7,139548.53,5,2,2,11,True
6196793,1303,0,30,2210,738565035,0,0,0,280.09,8,139268.44,5,4,4,11,True
6226291,1380,0,451,8985,738565035,0,0,0,279.89,7,138988.55,16,2,5,12,True
6642802,1061,2,20,9050,738565035,0,0,0,279.76,5,138708.79,11,2,10,12,True
6761265,123,0,20,8493,738565035,0,0,0,279.78,3,138429.01,18,5,21,1,True
6857527,1376,3,25,2865,738565035,0,0,0,279.98,8,138149.03,16,5,3,1,True
7064399,1380,0,451,8985,738565035,0,0,0,279.84,7,137869.19,16,0,20,1,True
7243641,1486,2,20,2856,738565035,0,0,0,280.3,5,137588.89,24,2,15,1,True
7390818,512,0,10,9050,738565035,0,0,0,279.89,6,137868.78,12,4,13,3,True
7483967,1303,0,451,2715,738565035,0,0,0,279.94,7,137588.84,5,4,3,4,True
8158626,1380,0,451,5304,738565035,0,0,0,280.02,7,137308.82,16,3,11,5,True
8336409,371,3,30,9050,738565035,0,0,0,279.71,8,137029.11,25,6,18,5,True
8746942,1231,2,20,4251,738565035,0,0,0,279.88,3,136749.23,18,2,2,5,True
8818138,1380,0,451,3066,738565035,0,0,0,280.01,7,136469.22,16,5,23,6,True
8937778,594,0,10,1800,738565035,0,0,0,280.07,0,136749.29,24,3,18,7,True
9235707,371,3,451,9881,738565035,0,0,0,280.09,7,136469.2,25,4,10,7,True
9277208,804,0,20,5304,738565035,0,0,0,279.79,3,136189.41,11,2,18,7,True
9336113,603,0,30,6412,738565035,0,0,0,280.24,8,135909.17,24,3,21,8,True
9593081,887,2,20,9679,738565035,0,0,0,279.69,5,135629.48,27,0,6,8,False
9607514,887,2,20,7710,738565035,0,0,0,279.84,5,135349.64,27,4,17,8,True
9652428,1303,0,30,5448,738565035,0,0,0,279.99,8,135069.65,5,1,11,9,True
9767519,603,0,-1,8493,738565035,0,1,0,279.69,4,135069.65,24,6,10,9,True
9879784,371,3,30,5564,738565035,0,0,0,279.95,8,134789.7,25,0,1,11,True
1053226,279,2,-1,7338,829987627,1,1,0,548.0,1,189136.0,24,5,13,1,True
1099289,790,0,20,9739,829987627,1,0,0,547.8,5,188588.2,11,3,23,2,True
1113995,1067,4,451,3554,829987627,1,0,0,548.07,7,188040.13,11,6,4,2,True
1243223,687,0,-1,2566,829987627,1,1,0,548.02,4,188040.13,24,3,17,2,True
1276755,1192,2,451,7160,829987627,1,0,0,548.05,7,187492.08,24,1,12,3,True
1292798,630,0,10,6521,829987627,1,0,0,547.77,0,188039.85,11,5,1,4,True
1619710,687,0,451,6234,829987627,1,0,0,548.01,7,187491.84,24,2,16,5,True
1730678,1232,1,10,2860,829987627,1,0,0,548.08,6,188039.92,18,3,5,5,True
1772587,1192,2,451,7371,829987627,1,0,0,547.99,7,187491.93,24,2,14,6,True
1869579,279,2,451,5945,829987627,1,0,0,548.15,7,186943.78,24,5,17,7,True
2127419,1067,4,30,7066,829987627,1,0,0,547.98,8,186395.8,11,0,15,7,True
2147639,1192,2,451,7066,829987627,1,0,0,548.08,7,185847.72,24,4,9,8,True
3336691,525,0,10,5663,829987627,1,0,0,547.76,6,186395.48,18,1,22,9,True
3410561,1192,2,25,3403,829987627,1,0,0,548.04,8,185847.44,24,3,5,10,True
3645158,1192,2,-1,5945,829987627,1,1,0,548.09,4,185847.44,24,5,3,11,True
3690684,897,0,10,3403,829987627,1,0,0,548.04,6,186395.48,24,2,23,11,True
3988155,816,0,10,5945,829987627,1,0,0,548.3,0,186943.78,18,5,11,12,True
4418438,279,2,-1,7160,829987627,1,1,0,548.07,4,186943.78,24,2,20,1,True
4672093,513,4,30,5607,829987627,1,0,0,548.11,8,186395.67,12,5,3,2,True
4681919,1067,4,25,9119,829987627,1,0,0,548.03,8,185847.64,11,5,12,2,True
4693711,1067,4,451,7160,829987627,1,0,0,547.8,7,185299.84,11,2,20,2,True
4776455,279,2,30,9934,829987627,1,0,0,548.08,8,184751.76,24,5,5,3,True
5048289,1192,2,451,4404,829987627,1,0,0,547.99,7,184203.77,24,1,13,3,True
5094884,249,0,10,6330,829987627,1,0,0,548.09,6,184751.86,6,3,22,3,False
5469571,1192,2,-1,8857,829987627,1,1,0,547.82,4,184751.86,24,2,5,3,True
5634169,687,0,30,2046,829987627,1,0,0,547.89,8,184203.97,24,5,3,4,True
5762172,1192,2,25,5607,829987627,1,0,0,548.18,8,183655.79,24,0,1,5,True
5816985,1067,4,30,3554,829987627,1,0,0,548.08,8,183107.71,11,6,8,8,True
5858566,1067,4,-1,4783,829987627,1,1,0,547.57,4,183107.71,11,0,13,8,True
5962515,513,4,-1,9988,829987627,1,2,0,548.05,1,183107.71,12,5,12,8,True
5998866,1192,2,451,5663,829987627,1,0,0,547.97,7,182559.74,24,6,17,10,True
6082527,47,1,10,7013,829987627,1,0,0,547.97,6,183107.71,24,6,22,10,True
6140955,1192,2,-1,5663,829987627,1,1,0,548.11,4,183107.71,24,3,13,10,True
6184344,1192,2,451,5607,829987627,1,0,0,548.1,7,182559.61,24,5,14,10,True
6343316,729,0,10,6521,829987627,1,0,0,548.15,0,183107.76,11,0,23,11,True
6386716,802,2,20,2860,829987627,1,0,0,548.04,5,182559.72,11,5,16,11,True
6440944,279,2,25,4803,829987627,1,0,0,547.75,8,182011.97,24,2,20,12,True
6736662,327,0,20,3554,829987627,1,0,0,548.28,3,181463.69,11,3,6,12,True
6845314,687,0,451,5607,829987627,1,0,0,547.79,7,180915.9,24,5,23,1,True
7027739,687,0,30,9934,829987627,1,0,0,548.04,8,180367.86,24,4,2,1,True
7061970,687,0,30,4659,829987627,1,0,0,548.08,8,179819.78,24,5,8,2,True
7523317,254,0,20,7338,829987627,1,0,0,548.01,3,179271.77,6,4,16,2,True
7733584,303,0,20,3921,829987627,1,0,0,548.19,5,178723.58,4,3,2,3,True
7880881,1067,4,25,9655,829987627,1,0,0,548.09,8,178175.49,11,4,20,4,True
8034943,21,0,10,6234,829987627,1,0,0,548.06,6,178723.55,11,2,1,5,True
8068937,513,4,-1,7160,829987627,1,1,0,547.92,4,178723.55,12,6,11,5,True
8167250,687,0,451,9655,829987627,1,0,0,548.26,7,178175.29,24,0,3,5,True
8203568,811,0,20,4659,829987627,1,0,0,548.08,5,177627.21,18,6,14,6,True
8355123,576,2,20,8857,829987627,1,0,0,548.09,5,177079.12,11,2,4,6,True
8410748,279,2,25,4659,829987627,1,0,0,547.69,8,176531.43,24,1,20,7,True
8589322,916,0,10,3554,829987627,1,0,0,547.98,6,177079.41,18,6,9,7,True
8591533,279,2,25,2046,829987627,1,0,0,547.86,8,176531.55,24,3,6,8,True
8821610,687,0,451,2046,829987627,1,0,0,547.85,7,175983.7,24,6,16,8,True
9033622,1162,2,20,2860,829987627,1,0,0,547.86,5,175435.84,24,1,9,10,True
9443676,1067,4,-1,2860,829987627,1,1,0,548.15,1,175435.84,11,1,19,11,True
1000097,377,4,451,6658,717565716,1,0,0,1072.06,7,519686.94,25,3,10,2,True
1171453,761,2,451,7296,717565716,1,0,0,1071.9,7,518615.04,24,3,15,2,True
1212335,1477,2,20,3671,717565716,1,0,0,1072.44,5,517542.6,24,6,9,2,True
1283455,1142,2,25,3671,717565716,1,0,0,1071.93,8,516470.67,15,1,16,3,True
1292431,999,4,25,5111,717565716,1,0,0,1071.98,8,515398.69,26,3,8,4,True
1294821,85,2,-1,9781,717565716,1,1,0,1071.82,1,515398.69,1,6,7,6,True
1611910,761,2,30,4611,717565716,1,0,0,1071.83,8,514326.86,24,0,12,6,True
1629313,999,4,-1,9781,717565716,1,1,0,1072.1,1,514326.86,26,1,17,7,True
2743736,1411,0,20,2430,717565716,1,0,0,1072.14,5,513254.72,24,6,23,7,True
2967714,30,4,30,5881,717565716,1,0,0,1072.33,8,512182.39,11,2,2,7,True
3075493,999,4,-1,5881,717565716,1,1,0,1071.78,4,512182.39,26,6,2,9,True
3097179,377,4,25,4061,717565716,1,0,0,1071.89,8,511110.5,25,2,5,10,True
3361234,85,2,451,9140,717565716,1,0,0,1071.91,7,510038.59,1,1,17,11,True
3550828,761,2,25,9781,717565716,1,0,0,1071.93,8,508966.66,24,4,2,11,True
3694866,1142,2,25,6658,717565716,1,0,0,1072.02,8,507894.64,15,4,0,1,True
3954970,584,0,20,6658,717565716,1,0,0,1071.9,5,506822.74,11,6,4,3,True
4336124,471,0,10,5111,717565716,1,0,0,1071.94,6,507894.68,5,1,12,3,True
4844776,85,2,451,6420,717565716,1,0,0,1072.2,7,506822.48,1,4,19,4,True
4927911,377,4,25,5111,717565716,1,0,0,1072.16,8,505750.32,25,4,15,5,True
5441611,761,2,30,2844,717565716,1,0,0,1072.13,8,504678.19,24,4,18,5,True
5509945,761,2,30,4488,717565716,1,0,0,1072.09,8,503606.1,24,6,1,6,True
5635526,85,2,-1,8537,717565716,1,1,0,1072.11,1,503606.1,1,6,0,6,True
5704174,999,4,30,4061,717565716,1,0,0,1072.07,8,502534.03,26,1,13,6,True
5770260,1142,2,25,3671,717565716,1,0,0,1072.18,8,501461.85,15,2,15,7,True
6070262,30,4,451,8209,717565716,1,0,0,1071.94,7,500389.91,11,3,13,7,True
6768490,30,4,-1,6658,717565716,1,1,0,1071.81,4,500389.91,11,4,18,9,True
6832733,1227,0,20,1935,717565716,1,0,0,1071.98,5,499317.93,18,1,7,11,True
6894199,761,2,30,2218,717565716,1,0,0,1071.95,8,498245.98,24,2,1,11,True
6899560,790,0,10,6567,717565716,1,0,0,1072.03,6,499318.01,11,2,8,12,True
7035707,85,2,25,1937,717565716,1,0,0,1071.92,8,498246.09,1,3,12,12,True
7110435,1476,0,10,4504,717565716,1,0,0,1071.97,6,499318.06,24,2,22,12,True
7124860,96,0,25,3671,717565716,1,0,0,1071.88,8,498246.18,1,4,6,2,True
7156471,96,0,451,4611,717565716,1,0,0,1071.87,7,497174.31,1,0,12,2,True
7234953,761,2,30,9781,717565716,1,0,0,1071.98,8,496102.33,24,1,20,3,True
7294148,30,4,451,9140,717565716,1,0,0,1071.87,7,495030.46,11,1,5,3,True
7499498,1388,1,10,8156,717565716,1,0,0,1072.1,0,496102.56,24,5,8,4,True
7732997,761,2,30,6658,717565716,1,0,0,1072.15,8,495030.41,24,6,4,4,True
8342648,999,4,451,4757,717565716,1,0,0,1071.78,7,493958.63,26,5,2,5,True
8504376,85,2,451,5111,717565716,1,0,0,1071.92,7,492886.71,1,6,1,5,False
8587530,30,4,451,6754,717565716,1,0,0,1071.92,7,491814.79,11,5,15,6,True
8694000,377,4,451,4504,717565716,1,0,0,1071.97,7,490742.82,25,4,12,7,True
8820558,96,0,451,5881,717565716,1,0,0,1072.37,7,489670.45,1,5,7,7,True
8924832,96,0,25,2430,717565716,1,0,0,1072.14,8,488598.31,1,6,22,7,True
9132444,377,4,25,1935,717565716,1,0,0,1071.95,8,487526.36,25,2,17,7,True
9447105,1142,2,25,4725,717565716,1,0,0,1071.98,8,486454.38,15,1,8,8,True
9562243,377,4,-1,6754,717565716,1,1,0,1072.28,1,486454.38,25,2,10,8,True
9643020,484,0,10,6567,717565716,1,0,0,1071.99,0,487526.37,5,5,2,8,True
9662639,999,4,30,3671,717565716,1,0,0,1072.02,8,486454.35,26,0,1,9,True
9880361,999,4,25,3179,717565716,1,0,0,1072.06,8,485382.29,26,0,15,9,True
9908445,687,0,20,6754,717565716,1,0,0,1071.9,5,484310.39,24,2,19,9,True
9910349,761,2,451,3692,717565716,1,0,0,1071.98,7,483238.41,24,3,12,9,True
9928497,377,4,25,6567,717565716,1,0,0,1072.17,8,482166.24,25,6,20,10,True
1281771,1217,0,10,5168,970026543,0,0,0,715.14,6,701801.14,24,1,0,1,True
1374026,785,0,451,8929,970026543,0,0,0,715.15,7,701085.99,14,0,16,1,True
1501033,935,1,10,9438,970026543,0,0,0,715.05,0,701801.04,24,0,14,2,True
1532192,427,2,25,2423,970026543,0,0,0,715.04,8,701086.0,18,0,2,2,True
1571925,1406,0,-1,2485,970026543,0,1,0,714.74,1,701086.0,24,6,9,3,True
1603370,1325,0,10,9438,970026543,0,0,0,715.08,0,701801.08,18,4,9,3,True
1824351,503,0,10,2596,970026543,0,0,0,714.96,6,702516.04,12,4,17,3,True
1903936,1406,0,30,2596,970026543,0,0,0,714.94,8,701801.1,24,1,18,3,True
1910714,254,0,10,5971,970026543,0,0,0,715.24,6,702516.34,6,2,12,4,True
2102783,1101,2,451,5977,970026543,0,0,0,715.25,7,701801.09,0,0,5,6,True
2147903,1127,0,20,1855,970026543,0,0,0,714.91,5,701086.18,24,6,1,6,True
2216962,785,0,25,9003,970026543,0,0,0,715.34,8,700370.84,14,1,8,7,True
2513385,1101,2,451,2596,970026543,0,0,0,714.7,7,699656.14,0,1,5,9,True
2614428,560,2,20,2596,970026543,0,0,0,714.8,5,698941.34,17,3,18,10,True
2634495,524,1,10,2041,970026543,0,0,0,715.33,6,699656.67,18,6,21,10,False
2816287,1101,2,-1,3512,970026543,0,1,0,715.02,4,699656.67,0,3,1,12,True
3385755,1406,0,25,9438,970026543,0,0,0,714.95,8,698941.72,24,4,4,1,True
3588221,1255,0,10,8798,970026543,0,0,0,715.01,0,699656.73,23,1,16,1,True
3719230,427,2,-1,2410,970026543,0,1,0,714.92,4,699656.73,18,3,5,3,True
3929734,976,4,451,3716,970026543,0,0,0,714.86,7,698941.87,22,5,13,4,False
3974261,785,0,451,3716,970026543,0,0,0,715.26,7,698226.61,14,2,19,4,True
4700107,1356,2,20,8798,970026543,0,0,0,714.83,3,697511.78,24,4,15,4,True
4708641,158,2,30,2410,970026543,0,0,0,715.25,8,696796.53,24,3,13,5,True
4715442,976,4,451,5237,970026543,0,0,0,715.07,7,696081.46,22,4,13,6,True
4800856,1406,0,-1,9438,970026543,0,1,0,715.03,4,696081.46,24,5,1,7,True
5043494,158,2,451,9438,970026543,0,0,0,715.0,7,695366.46,24,5,18,7,True
5183404,1123,2,20,2173,970026543,0,0,0,715.04,3,694651.42,24,1,23,7,True
5545911,158,2,-1,8648,970026543,0,1,0,714.85,4,694651.42,24,4,17,8,False
5611987,348,0,10,2410,970026543,0,0,0,714.71,6,695366.13,24,1,12,8,True
5708513,1101,2,-1,2410,970026543,0,1,0,715.08,4,695366.13,0,4,15,8,True
5885779,1406,0,30,2041,970026543,0,0,0,714.9,8,694651.23,24,6,14,9,True
5889430,158,2,30,2410,970026543,0,0,0,715.22,8,693936.01,24,1,17,10,True
6003961,427,2,25,3716,970026543,0,0,0,714.86,8,693221.15,18,2,8,10,True
6218060,1101,2,451,5168,970026543,0,0,0,715.13,7,692506.02,0,5,6,10,True
6255373,785,0,30,2596,970026543,0,0,0,715.06,8,691790.96,14,1,13,10,True
6481131,567,1,10,2423,970026543,0,0,0,714.97,6,692505.93,11,5,8,12,True
6678048,1210,0,10,5154,970026543,0,0,0,715.04,6,693220.97,24,2,19,1,True
6797544,759,0,20,5168,970026543,0,0,0,715.02,3,692505.95,24,4,21,1,True
7009448,1012,0,451,5168,970026543,0,0,0,714.78,7,691791.17,26,2,6,2,True
7113860,1012,0,25,2041,970026543,0,0,0,714.96,8,691076.21,26,0,6,2,True
7150382,1012,0,30,5971,970026543,0,0,0,714.73,8,690361.48,26,2,4,3,True
7270893,1012,0,25,2423,970026543,0,0,0,714.8,8,689646.68,26,2,1,4,True
7739036,1406,0,-1,3716,970026543,0,1,0,714.81,4,689646.68,24,2,6,4,True
7816599,238,0,20,7694,970026543,0,0,0,715.16,5,688931.52,26,5,2,5,True
7964021,918,2,20,9950,970026543,0,0,0,715.1,3,688216.42,18,0,3,5,True
8067835,427,2,30,9003,970026543,0,0,0,714.94,8,687501.48,18,4,16,5,True
8494455,785,0,451,4096,970026543,0,0,0,714.63,7,686786.85,14,4,16,6,True
8712972,457,0,10,5971,970026543,0,0,0,715.09,0,687501.94,13,4,19,6,True
8766176,976,4,25,9950,970026543,0,0,0,715.1,8,686786.84,22,0,9,6,True
8826161,1101,2,30,8929,970026543,0,0,0,714.84,8,686072.0,0,6,9,7,False
9279938,796,2,20,8798,970026543,0,0,0,714.97,5,685357.03,11,4,14,8,True
9305374,1406,0,451,9003,970026543,0,0,0,715.2,7,684641.83,24,0,20,8,True
9322992,538,0,10,4096,970026543,0,0,0,714.83,0,685356.66,18,0,9,9,True
9406643,35,2,20,3512,970026543,0,0,0,715.0,5,684641.66,11,3,22,9,True
9749408,427,2,451,5168,970026543,0,0,0,714.86,7,683926.8,18,3,19,9,True
9822572,1406,0,30,5168,970026543,0,0,0,715.01,8,683211.79,24,3,18,10,True
9827481,427,2,451,8929,970026543,0,0,0,715.21,7,682496.58,18,5,23,10,True
9880127,333,1,10,5154,970026543,0,0,0,715.03,0,683211.61,11,1,19,11,True
1191189,1009,0,30,5860,497681935,0,0,0,138.89,8,806544.11,26,0,7,1,True
1352749,203,0,451,8346,497681935,0,0,0,138.99,7,806405.12,9,2,1,2,True
1761385,79,4,451,8346,497681935,0,0,0,138.91,7,806266.21,1,2,6,2,False
2223051,715,0,20,8497,497681935,0,0,0,138.8,3,806127.41,18,1,19,3,True
2353850,726,0,20,1144,497681935,0,0,0,139.06,5,805988.35,11,3,10,4,True
2389671,211,0,10,8672,497681935,0,0,0,138.93,6,806127.28,9,6,17,9,True
2665951,579,0,30,6880,497681935,0,0,0,139.17,8,805988.11,11,0,1,9,True
2817842,1201,0,10,2756,497681935,0,0,0,139.08,6,806127.19,24,1,1,9,True
2918348,79,4,30,8345,497681935,0,0,0,139.14,8,805988.05,1,2,0,9,True
2935109,876,4,25,7900,497681935,0,0,0,139.02,8,805849.03,24,2,20,11,True
2996157,711,2,25,1903,497681935,0,0,0,139.13,8,805709.9,18,4,6,11,True
3240324,376,0,-1,6953,497681935,0,1,0,138.84,1,805709.9,25,5,1,12,True
3250385,203,0,451,7900,497681935,0,0,0,139.22,7,805570.68,9,6,5,12,True
3254442,563,4,25,8672,497681935,0,0,0,139.08,8,805431.6,17,4,14,12,True
3374885,1009,0,451,8657,497681935,0,0,0,138.98,7,805292.62,26,2,23,1,True
3502209,95,2,20,8265,497681935,0,0,0,138.85,5,805153.77,1,3,6,1,True
3773190,376,0,30,1502,497681935,0,0,0,139.13,8,805014.64,25,2,5,2,True
3869786,1249,2,30,8265,497681935,0,0,0,138.86,8,804875.78,23,3,20,2,True
4318799,1037,0,20,8657,497681935,0,0,0,139.12,3,804736.66,11,0,21,3,True
4329243,203,0,30,7988,497681935,0,0,0,139.07,8,804597.59,9,4,14,6,True
4453380,79,4,451,1031,497681935,0,0,0,138.83,7,804458.76,1,0,14,7,True
4519922,579,0,25,7492,497681935,0,0,0,138.96,8,804319.8,11,4,23,7,True
4682067,563,4,25,5090,497681935,0,0,0,139.16,8,804180.64,17,4,22,8,True
4695568,204,0,20,5860,497681935,0,0,0,138.95,5,804041.69,9,0,19,8,True
4888408,579,0,-1,7988,497681935,0,1,0,139.16,4,804041.69,11,0,12,8,True
4890587,734,0,10,1144,497681935,0,0,0,139.02,6,804180.71,11,6,0,9,True
5122720,522,0,20,6315,497681935,0,0,0,139.25,5,804041.46,18,0,0,10,True
5399386,1315,0,20,5860,497681935,0,0,0,139.18,3,803902.28,5,6,23,10,True
5430840,711,2,25,4352,497681935,0,0,0,138.73,8,803763.55,18,4,9,11,True
5434446,1217,0,10,8346,497681935,0,0,0,139.25,6,803902.8,24,6,13,12,True
5466106,876,4,25,8345,497681935,0,0,0,138.68,8,803764.12,24,5,5,12,True
5705728,711,2,30,1144,497681935,0,0,0,139.09,8,803625.03,18,1,13,12,True
5981458,806,1,10,2859,497681935,0,0,0,138.86,0,803763.89,11,3,8,12,True
6081035,1142,2,20,8657,497681935,0,0,0,139.0,5,803624.89,15,5,4,2,True
6154646,1009,0,451,7492,497681935,0,0,0,139.14,7,803485.75,26,0,16,2,True
6290517,1249,2,451,6953,497681935,0,0,0,139.05,7,803346.7,23,2,8,2,False
6292424,579,0,25,3568,497681935,0,0,0,139.19,8,803207.51,11,2,13,3,True
6454821,787,0,10,8346,497681935,0,0,0,138.96,6,803346.47,14,3,22,4,True
6654420,1123,2,20,1144,497681935,0,0,0,139.24,5,803207.23,24,4,2,4,True
6711860,1009,0,451,8497,497681935,0,0,0,138.81,7,803068.42,26,5,9,4,True
6767136,563,4,451,8265,497681935,0,0,0,138.9,7,802929.52,17,0,5,4,True
7081735,579,0,451,5860,497681935,0,0,0,139.31,7,802790.21,11,6,9,5,True
7088244,312,0,20,1031,497681935,0,0,0,139.03,3,802651.18,4,5,10,5,True
7299144,1245,1,10,2756,497681935,0,0,0,138.9,6,802790.08,18,1,10,8,True
7515734,376,0,25,6315,497681935,0,0,0,138.89,8,802651.19,25,2,9,8,True
7598669,1009,0,25,6880,497681935,0,0,0,138.94,8,802512.25,26,5,10,8,True
8032931,203,0,451,1031,497681935,0,0,0,139.07,7,802373.18,9,0,7,9,True
8726044,1262,0,20,1144,497681935,0,0,0,139.07,5,802234.11,23,1,9,9,True
9297532,1249,2,30,8265,497681935,0,0,0,139.13,8,802094.98,23,6,13,10,True
9301861,579,0,451,3568,497681935,0,0,0,138.8,7,801956.18,11,2,11,10,True
9427615,79,4,451,8497,497681935,0,0,0,139.31,7,801816.87,1,0,16,11,True
9748267,203,0,-1,6880,497681935,0,1,0,138.75,4,801816.87,9,2,19,11,True
9876447,711,2,451,2859,497681935,0,0,0,138.93,7,801677.94,18,6,12,11,True
1084710,487,4,-1,6597,260369955,1,1,0,209.79,4,523903.0,12,5,13,1,True
1275720,329,1,10,2752,260369955,1,0,0,210.02,6,524113.02,11,1,10,1,True
1488421,459,1,30,4158,260369955,1,0,0,209.91,8,523903.11,13,3,18,2,True
1591822,459,1,451,6558,260369955,1,0,0,209.91,7,523693.2,13,4,22,4,True
2192070,122,3,30,5498,260369955,1,0,0,209.96,8,523483.24,18,4,13,4,True
2369634,239,1,10,4190,260369955,1,0,0,210.08,6,523693.32,26,6,11,5,True
2506061,650,3,451,7053,260369955,1,0,0,209.83,7,523483.49,24,3,18,6,True
2591638,459,1,-1,2662,260369955,1,1,0,210.03,4,523483.49,13,6,10,6,True
2727493,487,4,451,8699,260369955,1,0,0,209.99,7,523273.5,12,0,20,6,True
3763784,1280,3,25,5378,260369955,1,0,0,209.86,8,523063.64,24,2,21,8,True
3954696,1280,3,30,4190,260369955,1,0,0,209.9,8,522853.74,24,0,6,8,True
3963758,650,3,451,7707,260369955,1,0,0,210.11,7,522643.63,24,0,18,8,True
4090564,122,3,25,2752,260369955,1,0,0,209.99,8,522433.64,18,2,9,8,True
4149356,650,3,451,5401,260369955,1,0,0,210.1,7,522223.54,24,4,10,9,True
4308288,549,1,10,4190,260369955,1,0,0,209.97,6,522433.51,17,0,23,9,True
4487443,1280,3,25,9963,260369955,1,0,0,210.13,8,522223.38,24,5,9,9,True
4796896,459,1,25,6558,260369955,1,0,0,210.03,8,522013.35,13,5,17,10,True
4824543,1044,0,20,7109,260369955,1,0,0,210.12,5,521803.23,11,0,16,10,True
4942498,487,4,25,1603,260369955,1,0,0,210.02,8,521593.21,12,4,12,11,True
5078083,933,4,30,5378,260369955,1,0,0,210.02,8,521383.19,24,2,10,1,True
5427316,1355,4,30,4586,260369955,1,0,0,209.7,8,521173.49,24,2,22,2,True
5465720,1355,4,451,7053,260369955,1,0,0,210.06,7,520963.43,24,4,17,2,True
5518414,1260,0,451,7109,260369955,1,0,0,210.31,7,520753.12,23,6,0,3,True
5725802,933,4,25,9418,260369955,1,0,0,210.34,8,520542.78,24,5,5,4,True
5827966,487,4,25,4158,260369955,1,0,0,209.93,8,520332.85,12,1,7,5,True
5986368,933,4,451,2662,260369955,1,0,0,209.89,7,520122.96,24,4,1,6,True
6373832,1260,0,30,5986,260369955,1,0,0,210.0,8,519912.96,23,4,4,6,True
6410776,218,0,20,5498,260369955,1,0,0,209.95,5,519703.01,9,4,9,6,True
6587009,933,4,451,5378,260369955,1,0,0,210.23,7,519492.78,24,2,7,7,True
6719444,1260,0,30,7053,260369955,1,0,0,210.05,8,519282.73,23,4,2,8,True
6732417,933,4,451,8699,260369955,1,0,0,210.11,7,519072.62,24,5,14,9,True
7067627,487,4,-1,7053,260369955,1,1,0,210.11,1,519072.62,12,4,14,10,True
7253463,1419,1,10,4640,260369955,1,0,0,210.27,6,519282.89,24,1,11,10,True
7258139,650,3,25,4586,260369955,1,0,0,209.82,8,519073.07,24,2,14,10,True
7301119,650,3,-1,7053,260369955,1,1,0,209.97,1,519073.07,24,2,22,11,True
7474136,577,0,10,4159,260369955,1,0,0,210.19,0,519283.26,11,5,10,11,True
7830423,1280,3,-1,8699,260369955,1,1,0,210.38,1,519283.26,24,1,22,11,True
7911301,1409,1,10,4190,260369955,1,0,0,210.3,6,519493.56,24,2,2,11,True
7930993,933,4,-1,5986,260369955,1,1,0,209.92,4,519493.56,24,3,8,1,True
7942919,650,3,451,9418,260369955,1,0,0,210.2,7,519283.36,24,1,12,2,True
8424607,1425,0,20,9430,260369955,1,0,0,209.93,3,519073.43,24,3,1,2,True
8734693,487,4,451,4190,260369955,1,0,0,209.84,7,518863.59,12,1,15,3,True
8936391,1260,0,451,4640,260369955,1,0,0,210.23,7,518653.36,23,0,3,4,True
8960087,1280,3,30,7707,260369955,1,0,0,209.95,8,518443.41,24,4,5,5,True
9071299,641,0,10,4190,260369955,1,0,0,210.07,6,518653.48,24,4,3,8,True
9190199,584,0,10,4377,260369955,1,0,0,210.07,6,518863.55,11,5,5,8,True
9256383,1280,3,451,7707,260369955,1,0,0,210.03,7,518653.52,24,4,4,9,True
9682742,459,1,451,7707,260369955,1,0,0,210.13,7,518443.39,13,3,5,10,True
9822175,1355,4,30,7053,260369955,1,0,0,210.01,8,518233.38,24,0,6,10,True
9858188,933,4,25,6597,260369955,1,0,0,210.04,8,518023.34,24,2,19,11,True
9903370,304,0,20,4377,260369955,1,0,0,209.96,5,517813.38,4,2,12,11,True
1114212,457,0,20,5503,708399354,0,0,0,551.08,5,399725.92,13,2,17,2,True
1235089,914,2,451,2928,708399354,0,0,0,551.02,7,399174.9,18,3,18,2,True
1403671,537,0,20,6448,708399354,0,0,0,551.25,5,398623.65,18,4,11,2,True
1562648,275,0,10,1002,708399354,0,0,0,550.98,6,399174.63,24,1,19,2,True
2204924,833,4,30,1345,708399354,0,0,0,550.9,8,398623.73,5,6,7,3,True
2437833,106,4,30,8899,708399354,0,0,0,551.18,8,398072.55,3,3,14,3,True
2472361,833,4,-1,1795,708399354,0,1,0,550.99,4,398072.55,5,4,23,5,True
2674011,833,4,451,5693,708399354,0,0,0,550.93,7,397521.62,5,0,22,5,True
2766227,1151,4,451,2928,708399354,0,0,0,550.96,7,396970.66,15,1,21,7,True
3091155,1137,1,10,1002,708399354,0,0,0,551.22,6,397521.88,24,4,14,7,True
3285282,1058,4,451,2870,708399354,0,0,0,550.88,7,396971.0,11,0,16,8,True
3383360,106,4,30,2928,708399354,0,0,0,550.9,8,396420.1,3,3,23,9,True
3403310,1151,4,25,2870,708399354,0,0,0,550.71,8,395869.39,15,1,4,9,True
3721268,914,2,30,8899,708399354,0,0,0,550.97,8,395318.42,18,0,19,10,True
3951136,867,0,20,1002,708399354,0,0,0,550.98,5,394767.44,24,1,15,12,True
3957135,1424,4,30,6448,708399354,0,0,0,550.75,8,394216.69,24,2,20,2,True
4001921,833,4,30,6448,708399354,0,0,0,551.08,8,393665.61,5,0,7,2,True
4357659,1151,4,451,2204,708399354,0,0,0,551.14,7,393114.47,15,4,11,3,True
4460287,1151,4,451,7042,708399354,0,0,0,551.2,7,392563.27,15,2,5,4,True
4590995,914,2,-1,4078,708399354,0,1,0,551.1,4,392563.27,18,6,9,5,True
4798474,1424,4,451,4893,708399354,0,0,0,550.75,7,392012.52,24,6,11,5,True
5060937,1219,1,10,1588,708399354,0,0,0,551.11,6,392563.63,24,6,23,7,True
5252748,106,4,25,8198,708399354,0,0,0,550.97,8,392012.66,3,1,1,8,True
5290301,106,4,25,2870,708399354,0,0,0,551.04,8,391461.62,3,1,10,8,True
5415725,914,2,25,3701,708399354,0,0,0,551.01,8,390910.61,18,6,11,9,True
5475478,1151,4,451,3113,708399354,0,0,0,550.84,7,390359.77,15,4,8,9,False
5744808,800,0,20,7042,708399354,0,0,0,550.98,3,389808.79,11,2,14,9,True
5943322,1424,4,25,6448,708399354,0,0,0,550.98,8,389257.81,24,3,5,9,True
6027494,914,2,451,4078,708399354,0,0,0,550.7,7,388707.11,18,1,20,10,False
6057683,833,4,451,2204,708399354,0,0,0,551.13,7,388155.98,5,5,14,11,True
6116772,833,4,25,3701,708399354,0,0,0,550.97,8,387605.01,5,2,2,11,True
6223680,1014,1,10,4893,708399354,0,0,0,551.13,6,388156.14,26,1,4,12,True
6238443,208,0,20,1671,708399354,0,0,0,551.06,5,387605.08,9,2,8,12,True
6420953,914,2,30,1588,708399354,0,0,0,551.22,8,387053.86,18,4,22,1,True
6510260,914,2,451,2870,708399354,0,0,0,550.65,7,386503.21,18,0,13,1,True
6819578,1151,4,25,1002,708399354,0,0,0,550.92,8,385952.29,15,3,23,1,True
6879496,833,4,-1,8198,708399354,0,1,0,551.12,1,385952.29,5,5,14,1,True
6983520,833,4,-1,4893,708399354,0,2,0,550.98,4,385952.29,5,2,8,1,False
7387989,1058,4,25,1671,708399354,0,0,0,551.01,8,385401.28,11,6,2,2,True
7445524,833,4,30,8198,708399354,0,0,0,551.03,8,384850.25,5,2,17,2,True
7614287,1151,4,451,8198,708399354,0,0,0,551.07,7,384299.18,15,3,1,3,True
7863596,649,0,20,6448,708399354,0,0,0,551.19,3,383747.99,24,2,13,4,True
7876478,833,4,25,2870,708399354,0,0,0,550.86,8,383197.13,5,3,19,4,True
8320599,1175,2,20,6448,708399354,0,0,0,550.97,3,382646.16,24,3,7,4,True
8390056,1151,4,30,1520,708399354,0,0,0,550.96,8,382095.2,15,2,16,4,True
8876833,1058,4,30,5693,708399354,0,0,0,550.95,8,381544.25,11,0,11,4,True
9098052,106,4,451,2139,708399354,0,0,0,551.05,7,380993.2,3,3,9,5,False
9105929,1144,2,20,2139,708399354,0,0,0,551.12,5,380442.08,15,0,21,5,True
9158134,106,4,-1,1520,708399354,0,1,0,550.99,1,380442.08,3,6,1,6,False
9187169,1424,4,25,2139,708399354,0,0,0,550.9,8,379891.18,24,6,23,6,True
9436650,1058,4,451,1588,708399354,0,0,0,551.02,7,379340.16,11,6,12,8,True
9520882,914,2,25,2928,708399354,0,0,0,551.12,8,378789.04,18,1,15,8,True
9722622,1424,4,-1,1520,708399354,0,1,0,550.79,4,378789.04,24,6,5,8,True
9742789,1058,4,451,2204,708399354,0,0,0,551.16,7,378237.88,11,4,11,10,True
9845844,833,4,30,3701,708399354,0,0,0,550.95,8,377686.93,5,5,19,10,True
9855246,641,0,10,7042,708399354,0,0,0,551.1,6,378238.03,24,0,0,11,True
1048934,404,1,-1,9175,530567562,1,1,0,479.7,1,403388.0,10,6,11,1,True
1088388,1172,3,451,1535,530567562,1,0,0,480.04,7,402907.96,24,1,12,1,True
1192346,461,4,30,5696,530567562,1,0,0,479.69,8,402428.27,13,3,7,1,True
1242343,461,4,-1,6259,530567562,1,1,0,479.68,4,402428.27,13,3,13,1,True
1259064,404,1,-1,8902,530567562,1,2,0,479.92,4,402428.27,10,2,1,3,True
1307199,404,1,25,4565,530567562,1,0,0,479.94,8,401948.33,10,4,21,4,True
1312751,930,3,-1,6316,530567562,1,1,0,480.11,1,401948.33,18,6,7,5,True
1518825,792,1,10,6943,530567562,1,0,0,479.99,0,402428.32,11,3,0,5,True
1845695,404,1,451,5696,530567562,1,0,0,479.89,7,401948.43,10,4,10,5,True
2151711,538,0,451,6259,530567562,1,0,0,480.11,7,401468.32,18,5,6,6,True
2299483,1399,0,25,9175,530567562,1,0,0,480.07,8,400988.25,24,5,16,8,True
2317718,1421,0,10,1535,530567562,1,0,0,479.94,6,401468.19,24,3,8,9,True
2338257,930,3,-1,1797,530567562,1,1,0,479.9,4,401468.19,18,1,5,9,True
2565399,461,4,451,5055,530567562,1,0,0,479.73,7,400988.46,13,0,1,10,True
2620301,930,3,451,2196,530567562,1,0,0,480.15,7,400508.31,18,3,18,11,True
2957298,929,0,20,3455,530567562,1,0,0,479.74,5,400028.57,18,0,1,11,True
3118894,930,3,451,5786,530567562,1,0,0,479.96,7,399548.61,18,0,15,11,True
3184720,538,0,30,6316,530567562,1,0,0,480.03,8,399068.58,18,5,15,12,True
3373550,767,0,20,9175,530567562,1,0,0,480.16,5,398588.42,14,3,12,12,True
3443104,461,4,30,1549,530567562,1,0,0,479.97,8,398108.45,13,6,9,12,True
3580886,538,0,451,5055,530567562,1,0,0,479.93,7,397628.52,18,0,10,12,True
3933447,461,4,30,2168,530567562,1,0,0,480.01,8,397148.51,13,3,8,3,True
3940269,538,0,451,6943,530567562,1,0,0,480.16,7,396668.35,18,0,11,3,True
4304319,53,0,20,8851,530567562,1,0,0,479.9,5,396188.45,20,5,13,3,True
4361932,404,1,-1,5696,530567562,1,1,0,479.76,4,396188.45,10,0,0,5,True
4555082,132,2,451,8902,530567562,1,0,0,480.23,7,395708.22,18,1,17,5,True
4630447,627,0,20,1549,530567562,1,0,0,480.17,5,395228.05,11,0,7,6,True
5135743,930,3,30,7693,530567562,1,0,0,479.76,8,394748.29,18,3,7,7,True
5235406,950,0,10,7693,530567562,1,0,0,480.08,6,395228.37,24,1,23,8,True
5267642,1399,0,30,1797,530567562,1,0,0,480.0,8,394748.37,24,3,2,8,True
5500250,404,1,451,1535,530567562,1,0,0,480.2,7,394268.17,10,2,5,9,True
5611229,461,4,451,2553,530567562,1,0,0,479.7,7,393788.47,13,4,12,9,True
6023638,461,4,30,1797,530567562,1,0,0,480.12,8,393308.35,13,5,4,10,True
6053896,1471,0,20,4565,530567562,1,0,0,479.99,5,392828.36,24,1,18,10,True
6107009,1354,0,20,5696,530567562,1,0,0,480.13,3,392348.23,24,2,15,11,True
6251586,930,3,30,7693,530567562,1,0,0,479.99,8,391868.24,18,1,3,11,True
6320553,1455,2,20,8902,530567562,1,0,0,479.8,3,391388.44,11,2,19,11,True
6366131,538,0,-1,2168,530567562,1,1,0,479.91,4,391388.44,18,0,23,12,True
6609387,538,0,451,6943,530567562,1,0,0,480.2,7,390908.24,18,2,4,12,True
6694691,461,4,30,6943,530567562,1,0,0,479.93,8,390428.31,13,3,8,1,True
6702499,1172,3,30,2168,530567562,1,0,0,479.82,8,389948.49,24,3,13,1,True
6953436,132,2,-1,6051,530567562,1,1,0,479.94,4,389948.49,18,0,11,2,True
7048711,1105,2,20,6051,530567562,1,0,0,479.87,3,389468.62,0,2,20,2,True
7182585,930,3,-1,7693,530567562,1,1,0,479.95,4,389468.62,18,6,19,3,True
7289913,688,0,20,6259,530567562,1,0,0,479.97,5,388988.65,24,3,20,3,True
7692187,538,0,30,5786,530567562,1,0,0,480.08,8,388508.57,18,5,21,3,True
7766393,1172,3,451,8902,530567562,1,0,0,479.82,7,388028.75,24,5,5,4,True
7807567,132,2,30,6051,530567562,1,0,0,480.01,8,387548.74,18,1,12,4,True
8689110,897,0,10,3229,530567562,1,0,0,480.08,6,388028.82,24,5,22,7,False
8736969,461,4,30,2553,530567562,1,0,0,479.86,8,387548.96,13,1,5,7,True
8771626,930,3,30,1535,530567562,1,0,0,479.98,8,387068.98,18,2,22,8,True
8990588,1471,0,20,1797,530567562,1,0,0,480.0,5,386588.98,24,5,3,8,True
9116874,1363,0,20,5696,530567562,1,0,0,480.14,5,386108.84,16,1,19,9,True
9128721,537,0,10,4565,530567562,1,0,0,480.2,0,386589.04,18,5,23,9,True
9262647,1180,1,10,6943,530567562,1,0,0,479.83,6,387068.87,24,6,2,10,True
9578917,694,2,20,6943,530567562,1,0,0,479.85,5,386589.02,24,0,9,10,True
9746511,930,3,-1,3229,530567562,1,1,0,479.75,1,386589.02,18,3,0,10,True
1197781,641,0,25,9944,683729410,1,0,0,973.87,8,730465.13,24,0,10,1,True
1213626,358,4,25,9513,683729410,1,0,0,973.88,8,729491.25,24,4,22,1,True
1498158,1127,0,10,3409,683729410,1,0,0,974.26,0,730465.51,24,2,10,2,True
1853606,641,0,-1,3409,683729410,1,1,0,974.18,4,730465.51,24,5,18,2,True
2003425,942,0,10,8550,683729410,1,0,0,974.06,6,731439.57,24,6,4,2,True
2054658,358,4,25,6132,683729410,1,0,0,973.99,8,730465.58,24,5,2,2,True
2206132,796,2,-1,1771,683729410,1,1,0,974.19,4,730465.58,11,2,19,2,False
2271634,1076,1,451,9944,683729410,1,0,0,973.93,7,729491.65,18,6,22,3,True
2283493,358,4,25,3409,683729410,1,0,0,973.99,8,728517.66,24,3,10,3,True
2308219,1163,4,451,8550,683729410,1,0,0,973.91,7,727543.75,24,6,15,4,True
2617870,1076,1,451,6966,683729410,1,0,0,973.95,7,726569.8,18,5,16,4,True
2996754,1399,0,10,9485,683729410,1,0,0,973.93,6,727543.73,24,6,7,4,True
3298676,1163,4,25,9174,683729410,1,0,0,974.12,8,726569.61,24,5,5,5,True
3446662,1163,4,451,4823,683729410,1,0,0,974.32,7,725595.29,24,3,5,6,True
3606591,931,0,20,4823,683729410,1,0,0,974.24,3,724621.05,24,6,12,6,True
3834221,1076,1,30,4823,683729410,1,0,0,973.85,8,723647.2,18,4,23,9,True
3852869,796,2,30,5863,683729410,1,0,0,974.18,8,722673.02,11,4,10,9,True
3915162,796,2,451,9950,683729410,1,0,0,974.11,7,721698.91,11,1,4,11,True
4110640,641,0,451,6132,683729410,1,0,0,974.06,7,720724.85,24,6,21,3,True
4203215,1076,1,30,5863,683729410,1,0,0,973.94,8,719750.91,18,1,14,4,True
4204440,1163,4,-1,9513,683729410,1,1,0,973.92,1,719750.91,24,4,20,4,True
4249321,358,4,25,9485,683729410,1,0,0,974.26,8,718776.65,24,4,13,4,True
4763268,358,4,30,5863,683729410,1,0,0,974.06,8,717802.59,24,2,2,5,True
4802889,550,0,20,9485,683729410,1,0,0,973.91,5,716828.68,17,3,13,5,True
4882731,1232,1,10,8550,683729410,1,0,0,974.13,6,717802.81,18,2,11,6,True
5280940,937,0,10,9950,683729410,1,0,0,973.92,0,718776.73,24,5,16,8,True
5418795,358,4,30,9950,683729410,1,0,0,974.02,8,717802.71,24,1,5,9,True
5434888,1076,1,451,9513,683729410,1,0,0,973.95,7,716828.76,18,6,0,10,True
5456262,641,0,25,9389,683729410,1,0,0,974.44,8,715854.32,24,1,4,10,True
5656418,1076,1,451,6889,683729410,1,0,0,973.92,7,714880.4,18,2,0,10,True
5725200,1163,4,25,9944,683729410,1,0,0,973.84,8,713906.56,24,3,9,11,True
5959916,358,4,-1,6132,683729410,1,1,0,973.93,1,713906.56,24,6,10,11,True
6516853,916,0,20,6889,683729410,1,0,0,974.01,5,712932.55,18,2,16,11,True
6781216,1076,1,25,9950,683729410,1,0,0,973.84,8,711958.71,18,3,2,11,True
7062359,444,2,20,3298,683729410,1,0,0,974.12,5,710984.59,24,0,23,11,True
7179424,1163,4,451,9950,683729410,1,0,0,973.64,7,710010.95,24,6,19,11,True
7200747,1163,4,-1,1232,683729410,1,1,0,973.98,1,710010.95,24,4,21,12,True
7221911,27,0,10,5863,683729410,1,0,0,973.96,6,710984.91,11,2,21,12,True
7316473,641,0,30,9174,683729410,1,0,0,974.15,8,710010.76,24,5,7,2,True
7887357,889,0,20,9944,683729410,1,0,0,974.1,3,709036.66,27,4,20,2,True
8000569,1163,4,-1,3409,683729410,1,1,0,974.02,4,709036.66,24,5,2,5,True
8131728,641,0,451,8550,683729410,1,0,0,974.0,7,708062.66,24,6,19,5,True
8322173,1134,1,10,9389,683729410,1,0,0,974.14,6,709036.8,24,4,20,6,True
8641091,796,2,451,9174,683729410,1,0,0,973.99,7,708062.81,11,4,19,6,True
9116588,796,2,451,6966,683729410,1,0,0,974.24,7,707088.57,11,5,11,6,False
9359588,641,0,30,9174,683729410,1,0,0,973.73,8,706114.84,24,2,4,8,False
9736282,796,2,25,8716,683729410,1,0,0,974.05,8,705140.79,11,4,0,8,True
9844808,735,1,10,5863,683729410,1,0,0,974.29,0,706115.08,11,1,10,8,True
9929108,796,2,30,4823,683729410,1,0,0,973.86,8,705141.22,11,1,3,10,True
9956859,1485,0,20,9174,683729410,1,0,0,973.92,5,704167.3,24,3,9,11,True
1755919,205,0,20,7812,282627895,1,0,0,533.87,5,269743.13,9,2,3,1,True
1889706,152,4,30,6989,282627895,1,0,0,533.71,8,269209.42,18,5,11,3,True
1895660,132,2,451,1632,282627895,1,0,0,534.06,7,268675.36,18,3,9,3,True
2138534,152,4,451,3828,282627895,1,0,0,534.12,7,268141.24,18,4,20,3,True
2258496,1436,0,25,3188,282627895,1,0,0,534.01,8,267607.23,24,1,16,4,True
2591473,1436,0,30,3188,282627895,1,0,0,533.65,8,267073.58,24,4,15,4,True
2650863,152,4,451,1574,282627895,1,0,0,533.86,7,266539.72,18,4,11,5,True
2681769,152,4,451,9157,282627895,1,0,0,533.97,7,266005.75,18,2,13,6,True
2718363,130,0,20,1020,282627895,1,0,0,534.31,3,265471.44,18,5,5,6,True
2941613,910,0,10,2231,282627895,1,0,0,533.85,0,266005.29,18,0,22,7,True
3019298,152,4,451,3344,282627895,1,0,0,534.04,7,265471.25,18,3,12,7,True
3227734,132,2,-1,7857,282627895,1,1,0,533.98,4,265471.25,18,0,16,8,False
3397086,1285,1,10,4430,282627895,1,0,0,534.12,6,266005.37,24,1,6,9,True
3641375,152,4,451,7812,282627895,1,0,0,534.15,7,265471.22,18,3,2,9,True
3746308,1436,0,25,5972,282627895,1,0,0,533.96,8,264937.26,24,4,11,9,True
3841079,152,4,25,4322,282627895,1,0,0,534.11,8,264403.15,18,4,17,10,True
3895789,1399,0,10,7612,282627895,1,0,0,533.78,6,264936.93,24,1,9,11,True
3953488,859,2,20,7086,282627895,1,0,0,534.11,3,264402.82,24,5,10,11,True
4015533,1325,0,20,1574,282627895,1,0,0,533.94,5,263868.88,18,4,4,12,True
4069838,289,4,451,3828,282627895,1,0,0,534.32,7,263334.56,24,2,15,12,True
4641491,132,2,451,4396,282627895,1,0,0,533.95,7,262800.61,18,1,11,1,True
4792268,726,0,451,9157,282627895,1,0,0,533.92,7,262266.69,11,3,16,1,True
4965278,1217,0,10,7812,282627895,1,0,0,534.2,0,262800.89,24,2,6,1,True
5003675,289,4,451,3828,282627895,1,0,0,534.02,7,262266.87,24,3,3,2,True
5060557,132,2,-1,3188,282627895,1,1,0,534.09,1,262266.87,18,5,10,2,True
5094801,726,0,30,7812,282627895,1,0,0,533.84,8,261733.03,11,5,3,3,True
5116533,132,2,30,2994,282627895,1,0,0,534.06,8,261198.97,18,1,16,3,True
5189254,64,0,10,2994,282627895,1,0,0,534.07,0,261733.04,20,2,17,3,True
5240118,132,2,25,6582,282627895,1,0,0,533.95,8,261199.09,18,5,2,3,True
5378735,132,2,451,1574,282627895,1,0,0,534.08,7,260665.01,18,3,15,4,True
5488966,305,1,10,5814,282627895,1,0,0,533.95,0,261198.96,4,2,14,4,True
6052266,1339,2,20,3828,282627895,1,0,0,534.16,5,260664.8,18,4,4,5,True
6135677,289,4,25,4430,282627895,1,0,0,534.24,8,260130.56,24,6,12,6,True
6412757,1014,1,10,3828,282627895,1,0,0,534.12,6,260664.68,26,1,6,7,False
6441862,289,4,30,3188,282627895,1,0,0,534.06,8,260130.62,24,5,19,8,True
6481540,599,0,10,6383,282627895,1,0,0,533.97,0,260664.59,24,4,23,8,True
6519044,360,0,10,2231,282627895,1,0,0,533.59,6,261198.18,24,3,20,9,False
6960038,289,4,-1,1574,282627895,1,1,0,533.99,4,261198.18,24,0,9,11,True
6960059,353,1,10,7512,282627895,1,0,0,533.97,6,261732.15,24,2,23,12,True
7241720,132,2,25,7612,282627895,1,0,0,533.98,8,261198.17,18,4,9,12,True
7449222,1436,0,30,4396,282627895,1,0,0,534.21,8,260663.96,24,2,10,1,True
7498003,1436,0,451,4322,282627895,1,0,0,534.04,7,260129.92,24,6,11,1,True
7556652,132,2,451,4396,282627895,1,0,0,533.78,7,259596.14,18,3,1,1,True
7720102,289,4,30,5814,282627895,1,0,0,533.74,8,259062.4,24,6,13,2,True
7787810,1436,0,25,9158,282627895,1,0,0,534.07,8,258528.33,24,2,21,2,True
7944436,132,2,25,9158,282627895,1,0,0,533.96,8,257994.37,18,4,13,3,True
7954805,289,4,451,7857,282627895,1,0,0,534.12,7,257460.25,24,2,16,4,True
8236307,289,4,-1,4322,282627895,1,1,0,534.0,4,257460.25,24,6,14,4,True
8397152,616,1,10,4322,282627895,1,0,0,534.04,6,257994.29,11,2,2,5,True
8659941,438,1,10,9701,282627895,1,0,0,534.1,6,258528.39,24,0,13,5,True
8703399,152,4,451,3097,282627895,1,0,0,534.03,7,257994.36,18,3,9,6,True
8709930,1436,0,30,7857,282627895,1,0,0,534.04,8,257460.32,24,3,18,6,True
9406491,289,4,25,5814,282627895,1,0,0,534.09,8,256926.23,24,0,2,7,True
9468309,1445,2,20,6989,282627895,1,0,0,534.1,5,256392.13,24,2,6,7,True
9557504,1273,0,10,2231,282627895,1,0,0,533.95,6,256926.08,24,0,0,7,True
9866652,726,0,25,6989,282627895,1,0,0,534.16,8,256391.92,11,1,21,8,True
9872961,1425,0,10,5472,282627895,1,0,0,534.06,6,256925.98,24,1,4,8,True
9882301,1436,0,20,5972,282627895,1,0,0,533.99,3,256391.99,24,0,14,10,True
9896464,132,2,-1,4322,282627895,1,1,0,534.02,4,256391.99,18,0,20,11,False
1017303,1434,0,20,6094,646562552,1,0,0,587.09,5,979804.91,24,6,12,1,True
1067971,1121,3,451,8149,646562552,1,0,0,587.04,7,979217.87,24,0,8,1,True
1134736,149,2,30,4519,646562552,1,0,0,586.82,8,978631.05,18,3,20,1,True
1721698,831,1,30,4519,646562552,1,0,0,586.9,8,978044.15,5,2,9,2,True
1914833,1380,0,25,2863,646562552,1,0,0,586.76,8,977457.39,16,2,22,2,True
2144570,831,1,30,9139,646562552,1,0,0,587.01,8,976870.38,5,0,14,2,True
2436336,1380,0,451,7577,646562552,1,0,0,586.86,7,976283.52,16,5,22,4,True
2475984,1121,3,30,1003,646562552,1,0,0,587.24,8,975696.28,24,6,23,4,True
2833228,1037,0,20,5790,646562552,1,0,0,586.7,3,975109.58,11,6,3,5,True
3145884,1179,0,25,9139,646562552,1,0,0,586.99,8,974522.59,24,6,20,5,True
3167409,1380,0,25,3536,646562552,1,0,0,586.92,8,973935.67,16,0,8,5,True
3177141,1127,0,20,2863,646562552,1,0,0,586.73,5,973348.94,24,5,3,7,True
3283640,149,2,30,1872,646562552,1,0,0,587.44,8,972761.5,18,5,5,7,True
3332674,1035,0,10,8149,646562552,1,0,0,586.72,6,973348.22,11,6,3,8,True
3439668,831,1,25,8341,646562552,1,0,0,587.08,8,972761.14,5,3,11,9,True
3443907,1179,0,30,1643,646562552,1,0,0,587.07,8,972174.07,24,5,23,9,True
3469120,831,1,451,8262,646562552,1,0,0,587.04,7,971587.03,5,0,6,10,True
3696902,1179,0,-1,1003,646562552,1,1,0,586.94,4,971587.03,24,6,14,10,True
3995432,149,2,25,9934,646562552,1,0,0,587.14,8,970999.89,18,0,20,10,True
4043715,910,0,10,7993,646562552,1,0,0,586.78,0,971586.67,18,6,14,11,True
4356439,1380,0,451,7993,646562552,1,0,0,587.04,7,970999.63,16,1,2,12,True
4669614,910,0,10,2221,646562552,1,0,0,587.05,0,971586.68,18,2,22,12,True
4694019,1179,0,-1,4519,646562552,1,1,0,587.08,4,971586.68,24,1,11,1,True
4782545,831,1,-1,8341,646562552,1,2,0,586.98,4,971586.68,5,6,22,2,True
4888027,1179,0,451,3746,646562552,1,0,0,586.81,7,970999.87,24,2,11,2,True
5036982,1179,0,25,3536,646562552,1,0,0,587.07,8,970412.8,24,3,4,3,True
5177583,812,0,10,4931,646562552,1,0,0,587.02,0,970999.82,18,1,14,3,False
5595075,831,1,451,2863,646562552,1,0,0,587.06,7,970412.76,5,2,17,3,True
5902138,1179,0,30,8341,646562552,1,0,0,587.23,8,969825.53,24,2,1,3,True
6222402,1121,3,451,9139,646562552,1,0,0,586.98,7,969238.55,24,2,17,3,True
6265512,1121,3,30,4043,646562552,1,0,0,587.09,8,968651.46,24,6,22,4,True
6395724,831,1,25,4043,646562552,1,0,0,587.07,8,968064.39,5,5,6,4,True
6444358,1179,0,25,7993,646562552,1,0,0,586.81,8,967477.58,24,4,1,5,True
6885493,1179,0,451,2221,646562552,1,0,0,586.98,7,966890.6,24,4,10,5,True
6984749,1121,3,25,5790,646562552,1,0,0,587.16,8,966303.44,24,2,2,5,True
7062205,149,2,-1,3536,646562552,1,1,0,586.88,4,966303.44,18,1,4,5,True
7119670,1121,3,25,7993,646562552,1,0,0,587.24,8,965716.2,24,3,17,6,True
7124744,1164,0,20,1872,646562552,1,0,0,586.96,5,965129.24,24,1,10,6,True
7131375,1179,0,25,8635,646562552,1,0,0,587.05,8,964542.19,24,5,21,7,True
7391474,1052,0,10,9934,646562552,1,0,0,586.97,6,965129.16,11,0,21,7,True
7596396,149,2,451,2863,646562552,1,0,0,586.84,7,964542.32,18,4,18,8,False
7645358,1179,0,451,8262,646562552,1,0,0,587.11,7,963955.21,24,1,22,11,False
7653347,916,0,20,3746,646562552,1,0,0,586.86,5,963368.35,18,4,8,12,True
7885504,1380,0,451,4043,646562552,1,0,0,586.72,7,962781.63,16,3,6,12,True
8136558,1410,1,10,8149,646562552,1,0,0,586.96,0,963368.59,24,4,16,1,False
8150470,831,1,30,4931,646562552,1,0,0,586.91,8,962781.68,5,5,9,1,False
8203975,1315,0,10,8020,646562552,1,0,0,587.13,6,963368.81,5,6,19,4,False
8212302,1179,0,25,7577,646562552,1,0,0,587.08,8,962781.73,24,1,0,5,True
8388339,1179,0,-1,3536,646562552,1,1,0,586.89,1,962781.73,24,3,23,5,True
8512314,135,2,20,7993,646562552,1,0,0,587.06,5,962194.67,18,6,18,6,True
8633900,1380,0,451,4043,646562552,1,0,0,586.97,7,961607.7,16,4,18,6,True
8706209,1121,3,451,1439,646562552,1,0,0,587.02,7,961020.68,24,5,22,6,True
9024289,1179,0,-1,1643,646562552,1,1,0,587.09,4,961020.68,24,2,12,7,True
9315571,1380,0,25,2863,646562552,1,0,0,586.75,8,960433.93,16,5,7,8,True
9335781,183,1,10,9139,646562552,1,0,0,587.01,6,961020.94,18,3,4,8,True
9452684,918,2,20,8341,646562552,1,0,0,586.96,5,960433.98,18,2,16,9,True
9654931,587,2,20,7577,646562552,1,0,0,586.92,3,959847.06,24,5,12,10,True
9738689,831,1,30,7577,646562552,1,0,0,586.77,8,959260.29,5,6,18,10,True
9831433,228,0,10,3064,646562552,1,0,0,586.8,6,959847.09,26,5,8,11,True
1147748,1017,2,451,9736,616728081,1,0,0,851.05,7,119881.95,26,6,1,1,True
1567176,535,0,30,3666,616728081,1,0,0,851.15,8,119030.8,18,3,14,1,True
2103485,1304,0,30,4887,616728081,1,0,0,851.12,8,118179.68,5,5,11,2,True
2395170,812,0,30,8462,616728081,1,0,0,851.01,8,117328.67,18,6,11,2,True
2500836,953,4,25,5799,616728081,1,0,0,850.93,8,116477.74,13,0,18,5,True
2611716,1017,2,451,9736,616728081,1,0,0,851.03,7,115626.71,26,4,17,7,True
3108582,535,0,25,4888,616728081,1,0,0,851.31,8,114775.4,18,0,18,8,True
3211239,953,4,451,4888,616728081,1,0,0,850.82,7,113924.58,13,2,22,8,True
3412324,59,0,30,6512,616728081,1,0,0,851.29,8,113073.29,20,2,9,8,True
3520345,1017,2,451,5799,616728081,1,0,0,850.9,7,112222.39,26,6,18,9,True
3622706,780,0,20,1962,616728081,1,0,0,850.97,5,111371.42,14,5,16,9,True
3795365,1017,2,-1,4406,616728081,1,1,0,851.15,4,111371.42,26,3,12,11,True
3804648,537,0,20,3463,616728081,1,0,0,850.9,5,110520.52,18,3,15,11,True
3971552,564,0,20,2312,616728081,1,0,0,850.85,5,109669.67,17,2,14,11,True
3984355,59,0,25,1445,616728081,1,0,0,850.88,8,108818.79,20,0,2,12,True
4043911,1304,0,451,7852,616728081,1,0,0,851.06,7,107967.73,5,6,3,12,True
4391195,1304,0,451,2077,616728081,1,0,0,850.96,7,107116.77,5,5,18,1,True
4710873,1017,2,30,4887,616728081,1,0,0,850.95,8,106265.82,26,2,17,1,True
4828477,208,0,20,1962,616728081,1,0,0,850.9,3,105414.92,9,2,23,1,True
4855148,953,4,-1,4039,616728081,1,1,0,851.1,4,105414.92,13,5,23,2,True
4888256,1304,0,30,4606,616728081,1,0,0,851.13,8,104563.79,5,0,10,2,True
5414031,373,1,10,4887,616728081,1,0,0,851.01,6,105414.8,25,2,14,3,True
5594321,1304,0,25,2077,616728081,1,0,0,851.19,8,104563.61,5,1,19,3,True
5604877,333,1,-1,4039,616728081,1,1,0,850.94,1,104563.61,11,2,4,3,True
5782454,1304,0,451,8462,616728081,1,0,0,850.79,7,103712.82,5,0,4,3,True
5823147,812,0,30,4895,616728081,1,0,0,851.08,8,102861.74,18,1,21,3,True
5925725,333,1,25,4887,616728081,1,0,0,851.17,8,102010.57,11,6,12,4,True
6055210,953,4,30,3364,616728081,1,0,0,851.25,8,101159.32,13,3,7,4,True
6218107,1304,0,-1,3083,616728081,1,1,0,851.1,4,101159.32,5,4,10,4,True
6303046,1007,2,20,4888,616728081,1,0,0,851.07,3,100308.25,26,5,21,4,True
6382721,931,0,20,4568,616728081,1,0,0,851.25,3,99457.0,24,6,12,6,True
6453434,448,0,10,3364,616728081,1,0,0,850.95,6,100307.95,13,2,6,6,True
6759844,333,1,25,3666,616728081,1,0,0,851.13,8,99456.82,11,2,16,6,True
6760588,1017,2,30,1445,616728081,1,0,0,851.15,8,98605.67,26,6,20,10,True
6871579,333,1,25,6512,616728081,1,0,0,850.93,8,97754.74,11,6,20,11,True
7166460,1304,0,451,8751,616728081,1,0,0,851.0,7,96903.74,5,1,17,11,True
7205770,59,0,25,3666,616728081,1,0,0,850.91,8,96052.83,20,3,11,12,True
7415864,76,0,20,7852,616728081,1,0,0,851.28,3,95201.55,20,6,12,12,True
7595544,628,0,20,1962,616728081,1,0,0,851.08,5,94350.47,11,1,0,1,True
7785174,114,0,10,1962,616728081,1,0,0,850.81,0,95201.28,3,1,18,2,True
7925912,953,4,451,2077,616728081,1,0,0,851.19,7,94350.09,13,2,18,3,True
8212011,535,0,30,3364,616728081,1,0,0,851.06,8,93499.03,18,4,22,5,True
8419236,535,0,-1,4039,616728081,1,1,0,850.87,4,93499.03,18,4,3,6,True
8526073,812,0,30,3364,616728081,1,0,0,851.31,8,92647.72,18,3,23,7,True
8587977,204,0,20,3083,616728081,1,0,0,851.03,5,91796.69,9,3,2,8,True
8624371,535,0,30,4064,616728081,1,0,0,851.19,8,90945.5,18,5,13,8,True
8864805,673,0,10,2312,616728081,1,0,0,850.93,6,91796.43,18,0,17,9,True
8919754,59,0,30,4888,616728081,1,0,0,851.05,8,90945.38,20,6,1,9,True
9047889,535,0,25,1445,616728081,1,0,0,850.95,8,90094.43,18,2,11,9,True
9265503,812,0,-1,4895,616728081,1,1,0,850.96,1,90094.43,18,5,10,10,True
9639042,333,1,-1,8751,616728081,1,2,0,850.86,4,90094.43,11,2,4,11,True
1217198,841,1,-1,9783,466665529,1,1,0,822.95,4,672241.0,5,5,12,1,True
1224828,1167,4,451,9783,466665529,1,0,0,822.85,7,671418.15,24,4,23,1,True
1338943,1090,0,20,9665,466665529,1,0,0,823.06,3,670595.09,18,6,13,3,True
1448293,841,1,25,3293,466665529,1,0,0,823.07,8,669772.02,5,3,0,4,True
1558109,20,0,10,2764,466665529,1,0,0,822.8,0,670594.82,24,6,21,5,True
1733384,605,0,30,4320,466665529,1,0,0,822.8,8,669772.02,24,3,5,6,True
1912703,662,1,30,9024,466665529,1,0,0,823.27,8,668948.75,18,5,21,6,True
2009519,662,1,-1,7691,466665529,1,1,0,823.12,4,668948.75,18,3,17,7,True
2061947,658,4,451,6332,466665529,1,0,0,823.09,7,668125.66,18,1,2,7,True
2107114,459,1,10,3806,466665529,1,0,0,823.05,6,668948.71,13,2,6,7,True
2490429,662,1,451,1953,466665529,1,0,0,823.03,7,668125.68,18,1,18,8,True
2503326,1167,4,451,3549,466665529,1,0,0,822.94,7,667302.74,24,2,23,8,True
2516802,1167,4,25,3550,466665529,1,0,0,823.09,8,666479.65,24,2,11,8,True
2574571,1167,4,-1,7691,466665529,1,1,0,823.4,1,666479.65,24,2,19,9,True
2791954,956,1,10,4192,466665529,1,0,0,823.17,0,667302.82,13,4,8,9,True
2792353,1262,0,451,4228,466665529,1,0,0,822.75,7,666480.07,23,0,10,10,True
2860429,1088,4,451,2764,466665529,1,0,0,822.76,7,665657.31,18,5,21,11,True
3528422,662,1,30,4192,466665529,1,0,0,822.86,8,664834.45,18,1,19,12,True
3671890,1167,4,30,4320,466665529,1,0,0,823.16,8,664011.29,24,1,23,1,True
4284139,85,2,20,4320,466665529,1,0,0,822.99,3,663188.3,1,5,18,4,True
4454145,605,0,-1,2532,466665529,1,1,0,823.07,1,663188.3,24,2,7,4,True
4731150,605,0,30,4576,466665529,1,0,0,823.0,8,662365.3,24,3,6,4,True
5004817,658,4,25,3806,466665529,1,0,0,823.06,8,661542.24,18,2,23,5,True
5009481,662,1,25,7418,466665529,1,0,0,823.03,8,660719.21,18,1,7,5,True
5086044,1167,4,30,2896,466665529,1,0,0,823.2,8,659896.01,24,1,9,5,True
5196636,1255,0,20,3549,466665529,1,0,0,822.92,3,659073.09,23,5,16,7,True
5247939,605,0,30,1791,466665529,1,0,0,823.09,8,658250.0,24,3,16,7,True
5597438,114,0,20,9024,466665529,1,0,0,823.1,3,657426.9,3,4,10,8,True
5803911,662,1,25,6902,466665529,1,0,0,822.85,8,656604.05,18,3,23,8,True
6341027,1262,0,25,2915,466665529,1,0,0,823.11,8,655780.94,23,4,8,8,True
6434255,658,4,-1,2532,466665529,1,1,0,823.07,4,655780.94,18,2,0,10,True
6531370,445,0,20,9665,466665529,1,0,0,823.2,5,654957.74,13,1,1,11,True
6613825,605,0,451,6332,466665529,1,0,0,823.02,7,654134.72,24,3,14,12,True
6875226,1262,0,30,3806,466665529,1,0,0,823.22,8,653311.5,23,2,3,12,True
6960572,658,4,25,4996,466665529,1,0,0,823.03,8,652488.47,18,6,1,1,True
7497687,1173,1,10,6332,466665529,1,0,0,822.76,6,653311.23,24,1,9,2,True
7549380,658,4,451,3806,466665529,1,0,0,823.16,7,652488.07,18,6,23,2,True
7597454,605,0,30,6755,466665529,1,0,0,823.02,8,651665.05,24,2,9,2,False
8566639,841,1,25,6902,466665529,1,0,0,823.07,8,650841.98,5,6,9,3,True
8600457,1262,0,25,7691,466665529,1,0,0,822.98,8,650019.0,23,2,16,4,True
8649498,658,4,451,4949,466665529,1,0,0,822.87,7,649196.13,18,1,6,4,True
8655387,713,0,10,4576,466665529,1,0,0,823.1,6,650019.23,18,4,18,5,True
8823238,1088,4,25,7418,466665529,1,0,0,823.12,8,649196.11,18,3,0,5,True
9161420,658,4,25,5730,466665529,1,0,0,823.13,8,648372.98,18,4,8,5,True
9460303,1167,4,30,4192,466665529,1,0,0,822.93,8,647550.05,24,2,23,6,True
9471610,359,2,20,3806,466665529,1,0,0,822.74,3,646727.31,24,1,11,6,False
9481486,605,0,-1,2233,466665529,1,1,0,823.01,4,646727.31,24,4,3,6,True
9512029,662,1,451,4320,466665529,1,0,0,822.86,7,645904.45,18,5,11,8,True
9517610,1446,1,10,7556,466665529,1,0,0,822.72,6,646727.17,24,6,23,8,True
9627584,1262,0,30,2233,466665529,1,0,0,822.96,8,645904.21,23,2,12,9,True
9655715,96,0,20,7418,466665529,1,0,0,822.71,5,645081.5,1,0,20,9,True
9690446,841,1,30,4192,466665529,1,0,0,822.87,8,644258.63,5,1,4,9,True
9744406,1088,4,25,3516,466665529,1,0,0,822.83,8,643435.8,18,2,21,10,True
9844162,841,1,30,2532,466665529,1,0,0,823.05,8,642612.75,5,6,21,10,True
9851008,1088,4,30,3293,466665529,1,0,0,822.96,8,641789.79,18,5,10,11,True
9925271,605,0,30,6902,466665529,1,0,0,823.04,8,640966.75,24,0,23,11,True
9935390,662,1,30,6332,466665529,1,0,0,822.96,8,640143.79,18,4,9,11,True
1247364,1088,4,451,1796,673985502,0,0,0,1188.95,7,111641.05,18,2,2,1,True
1642208,1145,4,-1,6229,673985502,0,1,0,1189.13,4,111641.05,15,6,10,1,True
1829614,121,4,451,4875,673985502,0,0,0,1189.03,7,110452.02,18,6,12,1,True
1856787,1019,0,20,1956,673985502,0,0,0,1188.82,5,109263.2,26,4,23,2,True
1964234,1088,4,-1,8324,673985502,0,1,0,1189.25,1,109263.2,18,4,2,2,False
2170095,1144,2,451,9652,673985502,0,0,0,1189.16,7,108074.04,15,5,23,3,True
2272394,1145,4,451,6229,673985502,0,0,0,1188.82,7,106885.22,15,6,21,4,True
2742491,1144,2,451,9665,673985502,0,0,0,1188.96,7,105696.26,15,0,19,5,True
2845601,977,4,-1,3551,673985502,0,1,0,1188.78,1,105696.26,22,4,13,5,True
2890529,1388,1,10,3231,673985502,0,0,0,1188.96,0,106885.22,24,1,19,6,True
2920895,116,0,20,3873,673985502,0,0,0,1189.06,5,105696.16,3,2,7,8,True
3023915,121,4,451,9652,673985502,0,0,0,1189.13,7,104507.03,18,5,20,8,True
3273021,1088,4,25,6126,673985502,0,0,0,1189.06,8,103317.97,18,0,6,8,True
3437078,627,0,20,3015,673985502,0,0,0,1189.11,3,102128.86,11,6,4,9,True
3579540,121,4,25,2724,673985502,0,0,0,1189.01,8,100939.85,18,6,22,10,True
3700107,1156,1,10,2662,673985502,0,0,0,1188.87,0,102128.72,15,6,4,12,True
3880647,1145,4,30,4700,673985502,0,0,0,1188.86,8,100939.86,15,6,15,12,True
3958787,977,4,-1,7911,673985502,0,1,0,1188.71,4,100939.86,22,6,6,2,True
3984568,980,1,10,1895,673985502,0,0,0,1188.89,6,102128.75,22,3,4,3,True
4000807,1145,4,-1,1956,673985502,0,1,0,1188.88,1,102128.75,15,5,18,3,True
4206562,977,4,30,6126,673985502,0,0,0,1189.1,8,100939.65,22,2,4,3,True
4259686,1162,2,20,3778,673985502,0,0,0,1188.67,3,99750.98,24,5,7,4,True
4260502,714,2,20,1895,673985502,0,0,0,1188.9,3,98562.08,18,6,17,5,True
4302295,1144,2,30,3990,673985502,0,0,0,1189.22,8,97372.86,15,4,17,7,True
4562349,1015,0,10,1796,673985502,0,0,0,1188.91,6,98561.77,26,2,23,7,True
4706348,1201,0,20,6229,673985502,0,0,0,1188.93,5,97372.84,24,0,13,8,True
4782440,977,4,30,8205,673985502,0,0,0,1188.97,8,96183.87,22,1,22,8,True
4824333,1145,4,-1,9665,673985502,0,1,0,1188.92,4,96183.87,15,6,7,8,False
5378663,1144,2,-1,6368,673985502,0,2,0,1189.32,1,96183.87,15,1,20,9,True
5472294,121,4,451,3015,673985502,0,0,0,1189.11,7,94994.76,18,3,21,9,True
5797943,1145,4,25,2662,673985502,0,0,0,1188.95,8,93805.81,15,1,22,9,True
6041029,781,1,10,6126,673985502,0,0,0,1188.87,0,94994.68,14,2,15,9,True
6041691,628,0,10,2662,673985502,0,0,0,1188.87,6,96183.55,11,5,3,10,False
6137211,723,1,30,4897,673985502,0,0,0,1189.2,8,94994.35,11,1,18,10,True
6235827,1314,2,20,6101,673985502,0,0,0,1189.11,5,93805.24,5,4,11,11,False
6389687,1145,4,-1,2610,673985502,0,1,0,1189.01,4,93805.24,15,0,1,11,True
6737034,1088,4,-1,3845,673985502,0,2,0,1189.06,4,93805.24,18,0,10,12,True
6925837,1145,4,30,6368,673985502,0,0,0,1188.85,8,92616.39,15,4,9,12,True
7058729,1088,4,-1,1564,673985502,0,1,0,1188.85,4,92616.39,18,3,21,2,True
7510573,1144,2,30,6617,673985502,0,0,0,1188.85,8,91427.54,15,0,2,3,True
7657085,121,4,-1,2662,673985502,0,1,0,1188.87,4,91427.54,18,0,17,3,True
7788290,1069,1,10,4897,673985502,0,0,0,1188.97,6,92616.51,18,1,17,4,True
7796183,1088,4,-1,3231,673985502,0,1,0,1188.9,4,92616.51,18,5,6,5,True
7884053,842,2,20,3551,673985502,0,0,0,1188.89,3,91427.62,5,3,21,8,True
7898721,1303,0,10,4048,673985502,0,0,0,1189.01,6,92616.63,5,2,1,8,True
7939007,1145,4,-1,3845,673985502,0,1,0,1189.22,1,92616.63,15,2,13,9,True
8194048,512,0,20,4700,673985502,0,0,0,1188.91,5,91427.72,12,3,14,9,True
8250317,121,4,451,4875,673985502,0,0,0,1189.13,7,90238.59,18,3,20,9,True
8532019,977,4,451,1956,673985502,0,0,0,1189.08,7,89049.51,22,6,10,9,True
9014265,121,4,-1,9665,673985502,0,1,0,1189.08,4,89049.51,18,1,1,9,False
9547553,723,1,451,2662,673985502,0,0,0,1189.31,7,87860.2,11,0,6,9,True
9626082,1212,0,10,4875,673985502,0,0,0,1188.94,6,89049.14,24,4,19,10,True
9716987,977,4,30,8205,673985502,0,0,0,1188.99,8,87860.15,22,3,15,10,True
9836753,723,1,30,6126,673985502,0,0,0,1189.15,8,86671.0,11,5,7,10,True
9854444,1088,4,25,3778,673985502,0,0,0,1189.03,8,85481.97,18,0,18,11,True
9895668,1145,4,30,6126,673985502,0,0,0,1188.83,8,84293.14,15,1,6,11,True
1098267,83,4,-1,1746,866915784,0,1,0,887.01,4,266889.0,1,6,13,1,True
1112726,702,4,30,7166,866915784,0,0,0,887.03,8,266001.97,18,3,6,1,True
1640106,702,4,30,1363,866915784,0,0,0,886.86,8,265115.11,18,4,8,1,True
1847982,887,2,451,1545,866915784,0,0,0,886.96,7,264228.15,27,4,21,4,True
1850081,1094,0,30,1363,866915784,0,0,0,887.09,8,263341.06,0,5,0,4,True
1935773,702,4,451,7166,866915784,0,0,0,887.08,7,262453.98,18,1,15,5,True
1990356,71,1,451,1363,866915784,0,0,0,886.82,7,261567.16,20,4,12,6,True
2132999,48,4,25,1340,866915784,0,0,0,886.93,8,260680.23,24,6,8,7,True
2256237,1488,0,10,1746,866915784,0,0,0,887.23,6,261567.46,24,6,12,8,True
2355282,631,3,451,3915,866915784,0,0,0,887.06,7,260680.4,11,5,5,8,True
2502504,1124,0,10,3392,866915784,0,0,0,886.95,6,261567.35,24,2,11,9,True
2527009,631,3,-1,5930,866915784,0,1,0,886.79,4,261567.35,11,1,5,9,True
2584643,806,1,10,6753,866915784,0,0,0,886.8,6,262454.15,11,4,16,11,True
3021585,673,0,10,1417,866915784,0,0,0,887.2,0,263341.35,18,1,22,11,True
3297727,1041,0,10,2332,866915784,0,0,0,886.97,6,264228.32,11,1,1,12,True
3366560,48,4,25,1363,866915784,0,0,0,886.96,8,263341.36,24,1,21,12,True
3514420,83,4,451,5732,866915784,0,0,0,886.96,7,262454.4,1,5,12,12,True
3732570,71,1,-1,3915,866915784,0,1,0,887.13,4,262454.4,20,0,11,12,True
4176006,1094,0,25,8542,866915784,0,0,0,887.11,8,261567.29,0,0,22,1,True
4540463,83,4,451,5569,866915784,0,0,0,886.86,7,260680.43,1,2,7,1,True
4582137,631,3,-1,5597,866915784,0,1,0,886.86,4,260680.43,11,1,6,3,True
4821614,1232,1,10,6793,866915784,0,0,0,886.94,6,261567.37,18,6,18,4,True
5155650,887,2,-1,1746,866915784,0,1,0,887.29,1,261567.37,27,0,2,5,True
5600157,1094,0,451,6793,866915784,0,0,0,886.89,7,260680.48,0,3,0,7,True
6034451,631,3,451,9978,866915784,0,0,0,886.82,7,259793.66,11,2,16,8,True
6325539,631,3,30,8542,866915784,0,0,0,887.07,8,258906.59,11,6,8,10,True
6658935,1094,0,30,1363,866915784,0,0,0,886.94,8,258019.65,0,2,11,11,True
6751808,1226,2,20,9369,866915784,0,0,0,887.01,5,257132.64,18,3,9,12,True
6753151,887,2,-1,1545,866915784,0,1,0,886.74,4,257132.64,27,2,20,12,True
6821824,702,4,451,1417,866915784,0,0,0,887.06,7,256245.58,18,5,4,2,True
6912254,234,0,10,2732,866915784,0,0,0,886.93,6,257132.51,26,2,9,2,True
7009228,1094,0,451,9119,866915784,0,0,0,887.08,7,256245.43,0,5,1,3,True
7419243,503,0,20,2732,866915784,0,0,0,887.05,3,255358.38,12,2,8,3,True
7630073,83,4,-1,2655,866915784,0,1,0,887.0,1,255358.38,1,5,7,3,True
7637455,48,4,30,5930,866915784,0,0,0,887.14,8,254471.24,24,5,1,5,True
7804743,562,1,10,2732,866915784,0,0,0,886.9,6,255358.14,17,4,13,5,True
7884184,702,4,25,5569,866915784,0,0,0,887.26,8,254470.88,18,6,13,5,True
8184885,887,2,451,2655,866915784,0,0,0,887.28,7,253583.6,27,3,6,5,True
8284098,887,2,451,6753,866915784,0,0,0,887.44,7,252696.16,27,3,19,6,True
8604245,48,4,25,5569,866915784,0,0,0,886.89,8,251809.27,24,2,14,6,True
8667415,1410,1,10,1746,866915784,0,0,0,886.56,0,252695.83,24,3,6,6,True
8806589,631,3,30,5569,866915784,0,0,0,887.09,8,251808.74,11,2,20,7,False
9173312,887,2,-1,6296,866915784,0,1,0,886.82,4,251808.74,27,5,22,8,True
9463203,702,4,451,2189,866915784,0,0,0,887.17,7,250921.57,18,4,13,9,True
9610723,631,3,451,1417,866915784,0,0,0,887.08,7,250034.49,11,0,3,9,True
9793153,71,1,451,2732,866915784,0,0,0,887.15,7,249147.34,20,0,10,10,True
9887571,702,4,-1,6753,866915784,0,1,0,886.91,1,249147.34,18,2,1,10,True
9937313,393,1,10,9978,866915784,0,0,0,887.14,0,250034.48,10,6,10,10,True
9938112,438,1,10,3915,866915784,0,0,0,887.36,6,250921.84,24,3,10,10,True
9946304,1451,1,10,9978,866915784,0,0,0,886.99,6,251808.83,11,0,10,11,True
1110813,1146,2,451,9731,514952760,0,0,0,553.18,7,582348.82,15,0,8,2,True
1260049,202,4,451,3759,514952760,0,0,0,552.82,7,581796.0,9,3,16,3,True
1370927,1377,0,20,9731,514952760,0,0,0,553.03,3,581242.97,16,6,10,4,True
1405886,1235,1,-1,9820,514952760,0,1,0,553.36,1,581242.97,18,4,4,4,True
1467172,744,4,25,1078,514952760,0,0,0,553.12,8,580689.85,24,5,19,4,True
1557078,744,4,451,9231,514952760,0,0,0,552.88,7,580136.97,24,6,21,4,True
1772168,1146,2,451,6097,514952760,0,0,0,553.03,7,579583.94,15,1,0,5,True
1856430,689,0,10,4746,514952760,0,0,0,553.05,6,580136.99,24,4,23,5,True
2021039,1027,0,10,2895,514952760,0,0,0,553.21,6,580690.2,11,5,17,6,True
2667080,1175,2,20,8689,514952760,0,0,0,552.53,3,580137.67,24,4,14,6,True
2780656,744,4,451,9319,514952760,0,0,0,552.89,7,579584.78,24,3,17,7,True
2955524,1146,2,30,4746,514952760,0,0,0,553.29,8,579031.49,15,6,16,7,True
3048814,744,4,25,6097,514952760,0,0,0,552.93,8,578478.56,24,5,21,9,True
3210224,1235,1,30,1920,514952760,0,0,0,553.2,8,577925.36,18,3,8,9,True
3217094,1146,2,451,9231,514952760,0,0,0,552.98,7,577372.38,15,1,1,9,True
3357115,1235,1,-1,9327,514952760,0,1,0,553.08,4,577372.38,18,5,11,10,True
3375565,744,4,25,1078,514952760,0,0,0,553.29,8,576819.09,24,5,15,10,True
3845601,193,1,10,4940,514952760,0,0,0,553.03,6,577372.12,18,0,1,11,True
3975205,1235,1,25,3557,514952760,0,0,0,553.2,8,576818.92,18,0,3,11,True
4104726,202,4,30,3759,514952760,0,0,0,553.04,8,576265.88,9,5,4,2,True
4830405,1284,2,451,9820,514952760,0,0,0,553.27,7,575712.61,24,5,5,3,True
4855998,1146,2,451,9319,514952760,0,0,0,552.78,7,575159.83,15,1,5,3,True
4879700,1284,2,-1,1078,514952760,0,1,0,552.97,4,575159.83,24,5,1,4,True
5132890,1273,0,20,6097,514952760,0,0,0,552.93,3,574606.9,24,5,4,4,True
5134539,1284,2,-1,1732,514952760,0,1,0,553.03,4,574606.9,24,5,16,4,True
5303421,480,0,20,4135,514952760,0,0,0,552.98,3,574053.92,5,2,19,5,True
5422403,1428,1,10,9731,514952760,0,0,0,552.99,6,574606.91,24,5,8,5,True
5508706,1235,1,-1,9731,514952760,0,1,0,553.03,4,574606.91,18,5,6,6,True
5939973,1146,2,451,6097,514952760,0,0,0,552.79,7,574054.12,15,2,4,6,True
5990068,1146,2,451,1732,514952760,0,0,0,553.11,7,573501.01,15,4,5,6,True
6259210,1127,0,10,4254,514952760,0,0,0,552.92,6,574053.93,24,0,14,6,True
6286804,1284,2,25,8689,514952760,0,0,0,552.95,8,573500.98,24,5,12,9,True
6297215,1318,0,10,8689,514952760,0,0,0,552.89,6,574053.87,18,2,17,9,True
6343591,1235,1,-1,2895,514952760,0,1,0,553.14,1,574053.87,18,3,4,9,True
6711234,202,4,-1,3557,514952760,0,2,0,553.14,4,574053.87,9,0,15,9,True
7266411,998,0,10,2895,514952760,0,0,0,552.85,6,574606.72,26,5,20,10,True
7727804,1284,2,25,7688,514952760,0,0,0,552.97,8,574053.75,24,4,13,11,True
7868941,1146,2,25,1732,514952760,0,0,0,553.2,8,573500.55,15,2,9,12,True
7917126,958,2,20,9319,514952760,0,0,0,553.28,3,572947.27,13,4,1,12,True
8053339,202,4,25,7688,514952760,0,0,0,553.06,8,572394.21,9,2,18,1,True
8081656,202,4,25,9327,514952760,0,0,0,552.83,8,571841.38,9,4,18,1,True
8114645,445,0,20,4254,514952760,0,0,0,552.78,3,571288.6,13,3,15,2,True
8211300,1284,2,451,2895,514952760,0,0,0,552.84,7,570735.76,24,4,0,3,True
8231202,1235,1,25,4746,514952760,0,0,0,552.92,8,570182.84,18,6,6,4,True
8273925,744,4,451,3557,514952760,0,0,0,553.04,7,569629.8,24,4,16,5,True
8310589,1146,2,30,1450,514952760,0,0,0,552.92,8,569076.88,15,5,14,8,True
8650337,1235,1,-1,3759,514952760,0,1,0,552.93,1,569076.88,18,5,4,10,True
9427337,744,4,451,9820,514952760,0,0,0,553.07,7,568523.81,24,2,17,10,True
9544389,1235,1,30,6097,514952760,0,0,0,552.81,8,567971.0,18,6,5,11,True
9684453,64,0,20,6097,514952760,0,0,0,552.93,5,567418.07,20,5,8,11,True
9918241,1146,2,25,3759,514952760,0,0,0,552.95,8,566865.12,15,1,21,11,True
1142374,242,4,-1,9573,931799357,1,1,0,130.14,4,848418.0,26,3,1,5,True
1432839,117,1,451,3479,931799357,1,0,0,129.79,7,848288.21,18,1,11,5,False
1755583,755,3,451,4974,931799357,1,0,0,129.97,7,848158.24,24,2,13,11,True
1794403,755,3,451,9442,931799357,1,0,0,130.36,7,848027.88,24,4,22,12,True
1896799,117,1,30,4472,931799357,1,0,0,129.85,8,847898.03,18,4,11,3,True
2172582,242,4,-1,1632,931799357,1,1,0,129.93,1,847898.03,26,0,17,5,True
2220338,931,0,20,4974,931799357,1,0,0,129.79,3,847768.24,24,1,18,5,True
2333373,1121,3,-1,4472,931799357,1,1,0,130.0,4,847768.24,24,1,20,5,True
2343036,755,3,451,4974,931799357,1,0,0,129.95,7,847638.29,24,1,17,8,True
2343595,1465,4,-1,2791,931799357,1,1,0,130.08,4,847638.29,11,5,12,9,True
2439951,755,3,25,6619,931799357,1,0,0,129.83,8,847508.46,24,2,0,2,True
2642621,117,1,451,4997,931799357,1,0,0,129.97,7,847378.49,18,2,14,3,True
2764502,111,3,30,3479,931799357,1,0,0,129.98,8,847248.51,3,1,2,3,True
2837951,1121,3,-1,5322,931799357,1,1,0,129.98,1,847248.51,24,4,13,7,True
2858823,1121,3,-1,3479,931799357,1,2,0,129.93,1,847248.51,24,0,13,9,True
2892282,755,3,-1,4974,931799357,1,3,1,129.82,1,847248.51,24,4,4,9,True
1235410,129,0,30,1331,837005116,1,0,0,861.01,8,435538.99,18,6,6,1,True
1539178,670,0,20,2099,837005116,1,0,0,861.16,3,434677.83,18,0,12,1,True
1748279,1159,0,10,7033,837005116,1,0,0,861.24,6,435539.07,15,1,15,2,True
1797645,818,1,10,6497,837005116,1,0,0,860.86,6,436399.93,18,0,20,4,True
1910012,712,0,20,3296,837005116,1,0,0,860.89,3,435539.04,18,6,22,4,True
2214465,1445,2,30,3296,837005116,1,0,0,861.02,8,434678.02,24,4,8,4,True
2227011,1090,0,451,4654,837005116,1,0,0,861.07,7,433816.95,18,6,10,5,True
2303908,1445,2,25,7033,837005116,1,0,0,861.15,8,432955.8,24,5,9,7,True
2309185,1090,0,25,8332,837005116,1,0,0,861.16,8,432094.64,18,5,17,7,True
2468406,880,1,10,5901,837005116,1,0,0,861.12,6,432955.76,27,1,9,8,True
2541927,184,0,20,5901,837005116,1,0,0,860.71,5,432095.05,18,3,8,11,True
2843043,1090,0,25,8985,837005116,1,0,0,860.95,8,431234.1,18,6,5,11,True
2897412,1401,1,451,5447,837005116,1,0,0,860.95,7,430373.15,24,3,18,11,True
2992735,1445,2,25,4101,837005116,1,0,0,861.22,8,429511.93,24,4,16,12,True
3020539,919,4,25,3738,837005116,1,0,0,861.08,8,428650.85,18,0,21,1,True
3239029,895,0,20,3409,837005116,1,0,0,861.15,5,427789.7,24,4,15,1,True
3890696,920,4,-1,1331,837005116,1,1,0,860.95,1,427789.7,18,2,2,1,True
3933995,1195,1,10,1308,837005116,1,0,0,860.88,6,428650.58,24,1,11,2,True
4101187,1435,2,451,2099,837005116,1,0,0,860.94,7,427789.64,24,4,0,3,True
4360546,1445,2,30,4654,837005116,1,0,0,860.81,8,426928.83,24,3,14,4,True
4851685,879,1,10,3968,837005116,1,0,0,861.21,0,427790.04,27,2,0,4,True
5043362,1279,4,451,5447,837005116,1,0,0,860.98,7,426929.06,24,0,7,4,True
5100863,1445,2,451,8387,837005116,1,0,0,860.77,7,426068.29,24,1,20,4,True
5132757,97,0,20,3738,837005116,1,0,0,860.84,3,425207.45,3,6,2,5,True
5227379,1090,0,30,7499,837005116,1,0,0,861.03,8,424346.42,18,0,23,5,True
5236802,1090,0,451,3738,837005116,1,0,0,860.84,7,423485.58,18,6,11,6,False
5442206,712,0,20,3296,837005116,1,0,0,861.07,3,422624.51,18,2,3,6,True
5581973,920,4,25,8571,837005116,1,0,0,860.87,8,421763.64,18,6,10,7,True
5679991,1445,2,-1,5197,837005116,1,1,0,861.12,1,421763.64,24,1,8,7,True
5881349,110,4,25,9027,837005116,1,0,0,860.91,8,420902.73,3,4,22,7,True
6108916,530,0,20,8232,837005116,1,0,0,860.98,5,420041.75,18,2,20,8,True
6274949,919,4,451,6418,837005116,1,0,0,861.07,7,419180.68,18,6,23,8,True
6348019,611,0,20,8332,837005116,1,0,0,861.25,5,418319.43,11,1,21,8,True
6452006,1401,1,-1,3968,837005116,1,1,0,860.97,1,418319.43,24,6,14,9,True
6705719,1279,4,451,3968,837005116,1,0,0,860.86,7,417458.57,24,4,6,9,True
7006532,877,2,20,1716,837005116,1,0,0,861.17,5,416597.4,24,4,11,9,True
7159248,1435,2,30,3296,837005116,1,0,0,861.15,8,415736.25,24,1,12,11,True
7202166,110,4,30,1331,837005116,1,0,0,860.86,8,414875.39,3,6,20,1,True
7739963,110,4,451,6418,837005116,1,0,0,860.96,7,414014.43,3,5,5,2,True
7820676,871,0,10,3409,837005116,1,0,0,860.94,6,414875.37,24,6,18,2,False
7922756,1401,1,-1,8571,837005116,1,1,0,860.93,4,414875.37,24,1,17,2,True
8281796,757,0,20,4026,837005116,1,0,0,860.98,5,414014.39,24,6,17,3,True
8480117,605,0,20,3968,837005116,1,0,0,861.06,3,413153.33,24,0,3,3,True
8518111,1401,1,25,8387,837005116,1,0,0,860.82,8,412292.51,24,5,20,4,True
8551866,110,4,451,5447,837005116,1,0,0,861.25,7,411431.26,3,0,13,4,True
8557799,1483,0,20,7586,837005116,1,0,0,860.92,5,410570.34,24,6,16,5,True
8758793,1090,0,25,8232,837005116,1,0,0,860.91,8,409709.43,18,1,6,5,True
8795590,920,4,25,6497,837005116,1,0,0,861.06,8,408848.37,18,5,3,6,False
8812555,944,2,20,8387,837005116,1,0,0,860.93,3,407987.44,24,5,8,6,True
8921699,920,4,-1,7033,837005116,1,1,0,861.29,4,407987.44,18,2,0,7,True
8949331,1445,2,-1,5148,837005116,1,2,0,860.93,1,407987.44,24,5,13,7,True
8996514,920,4,30,3977,837005116,1,0,0,860.99,8,407126.45,18,3,4,8,True
9185623,1445,2,25,3968,837005116,1,0,0,860.98,8,406265.47,24,6,20,8,True
9212425,1279,4,-1,6497,837005116,1,1,0,860.91,4,406265.47,24,4,18,10,True
9286368,673,0,20,5447,837005116,1,0,0,860.62,5,405404.85,18,5,19,10,True
9373927,254,0,10,7586,837005116,1,0,0,860.96,6,406265.81,6,3,3,10,True
9437381,129,0,25,1308,837005116,1,0,0,860.98,8,405404.83,18,2,8,11,True
9475578,1409,1,10,6418,837005116,1,0,0,861.04,0,406265.87,24,6,19,11,True
1004634,1480,4,451,5487,309219333,1,0,0,507.73,7,199574.27,24,0,7,1,True
1097517,948,4,25,2935,309219333,1,0,0,508.37,8,199065.9,24,5,5,1,True
1184368,944,2,451,5528,309219333,1,0,0,507.86,7,198558.04,24,6,22,1,True
1240188,1480,4,-1,5174,309219333,1,1,0,507.87,4,198558.04,24,0,3,2,True
1264344,948,4,25,3504,309219333,1,0,0,507.93,8,198050.11,24,4,7,2,True
1336645,580,0,10,9770,309219333,1,0,0,508.35,6,198558.46,11,6,3,5,True
1662095,1132,0,20,5528,309219333,1,0,0,507.98,5,198050.48,24,3,9,6,True
1775111,944,2,451,3504,309219333,1,0,0,507.76,7,197542.72,24,0,14,6,True
1821423,811,0,20,9770,309219333,1,0,0,508.1,3,197034.62,18,1,22,7,True
2117618,1114,1,451,4291,309219333,1,0,0,508.12,7,196526.5,0,1,7,8,True
2137794,1150,0,10,5174,309219333,1,0,0,508.16,0,197034.66,15,1,6,9,True
2141037,1114,1,25,3504,309219333,1,0,0,507.9,8,196526.76,0,6,16,10,True
2566208,1022,4,451,9489,309219333,1,0,0,508.02,7,196018.74,11,6,17,11,True
2677915,1022,4,30,5174,309219333,1,0,0,507.94,8,195510.8,11,1,0,11,True
2712777,1022,4,451,6484,309219333,1,0,0,507.8,7,195003.0,11,6,20,1,True
3062883,1271,0,20,5847,309219333,1,0,0,507.91,5,194495.09,23,0,6,1,True
3067024,1480,4,-1,2935,309219333,1,1,0,508.19,4,194495.09,24,1,8,1,True
3552152,1022,4,451,4893,309219333,1,0,0,508.06,7,193987.03,11,3,9,1,True
3734980,1012,0,20,4898,309219333,1,0,0,507.93,3,193479.1,26,1,17,2,False
3922254,303,0,10,5487,309219333,1,0,0,507.87,6,193986.97,4,4,12,3,True
3982170,114,0,20,6811,309219333,1,0,0,508.18,5,193478.79,3,4,0,3,True
4504802,1480,4,30,2935,309219333,1,0,0,507.97,8,192970.82,24,2,11,3,True
4665433,948,4,30,2935,309219333,1,0,0,508.15,8,192462.67,24,6,14,5,True
4785202,1022,4,30,6484,309219333,1,0,0,508.02,8,191954.65,11,3,0,5,True
5301333,944,2,-1,6057,309219333,1,1,0,508.11,4,191954.65,24,2,22,6,True
5501275,811,0,10,6811,309219333,1,0,0,508.06,6,192462.71,18,5,7,7,True
5522135,944,2,-1,4893,309219333,1,1,0,508.02,4,192462.71,24,4,21,9,True
5746968,944,2,30,5847,309219333,1,0,0,507.87,8,191954.84,24,2,16,9,True
5846027,570,2,20,5847,309219333,1,0,0,507.91,5,191446.93,11,1,15,10,True
6242633,1142,2,20,6484,309219333,1,0,0,508.03,5,190938.9,15,1,13,12,True
6320267,42,2,20,6447,309219333,1,0,0,507.97,5,190430.93,24,1,17,12,True
6424184,687,0,451,6811,309219333,1,0,0,508.02,7,189922.91,24,1,15,1,True
6598279,1114,1,451,4898,309219333,1,0,0,507.85,7,189415.06,0,4,20,1,True
6776486,1022,4,25,6484,309219333,1,0,0,508.14,8,188906.92,11,5,21,2,True
7073742,562,1,10,4898,309219333,1,0,0,508.02,6,189414.94,17,2,0,2,True
7087678,20,0,20,6484,309219333,1,0,0,508.1,5,188906.84,24,4,15,2,True
7173555,1480,4,451,5528,309219333,1,0,0,507.96,7,188398.88,24,6,11,3,True
7188846,1480,4,-1,5479,309219333,1,1,0,507.74,1,188398.88,24,6,11,3,True
7486450,1022,4,30,5479,309219333,1,0,0,507.99,8,187890.89,11,3,1,4,True
7508143,687,0,451,4898,309219333,1,0,0,508.13,7,187382.76,24,2,1,5,True
7527683,1114,1,451,4898,309219333,1,0,0,507.91,7,186874.85,0,6,6,6,True
7531884,1114,1,451,5487,309219333,1,0,0,508.13,7,186366.72,0,2,14,6,True
7732026,1480,4,25,5487,309219333,1,0,0,508.07,8,185858.65,24,2,6,7,True
8056441,68,0,20,9489,309219333,1,0,0,507.75,3,185350.9,20,6,19,8,True
8118166,1022,4,25,9770,309219333,1,0,0,507.98,8,184842.92,11,6,7,8,True
8328561,948,4,-1,4893,309219333,1,1,0,507.74,4,184842.92,24,5,11,8,True
8447701,1409,1,10,6057,309219333,1,0,0,507.84,6,185350.76,24,2,1,9,True
8616379,687,0,25,4893,309219333,1,0,0,507.9,8,184842.86,24,6,6,9,True
8741276,687,0,-1,4898,309219333,1,1,0,507.89,4,184842.86,24,2,11,10,True
9127041,1125,1,10,5847,309219333,1,0,0,507.89,0,185350.75,24,3,19,10,True
9329062,564,0,20,6057,309219333,1,0,0,507.96,3,184842.79,17,5,10,10,True
9383940,948,4,-1,6811,309219333,1,1,0,507.87,4,184842.79,24,5,23,10,True
9725579,1480,4,-1,4291,309219333,1,2,0,508.09,4,184842.79,24,2,20,11,True
9813229,1094,0,10,4893,309219333,1,0,0,507.99,6,185350.78,0,4,23,11,False
9828667,1022,4,25,5847,309219333,1,0,0,508.24,8,184842.54,11,6,6,11,True
9909781,1022,4,30,6811,309219333,1,0,0,508.13,8,184334.41,11,0,1,11,True
1086058,553,1,25,8418,432545246,1,0,0,245.87,8,634673.13,17,0,16,1,True
1180628,400,4,30,7075,432545246,1,0,0,245.99,8,634427.14,10,2,20,2,True
1308214,553,1,25,9174,432545246,1,0,0,246.24,8,634180.9,17,5,19,2,False
1526238,553,1,-1,4727,432545246,1,1,0,246.29,4,634180.9,17,4,21,2,True
1827392,849,1,451,8864,432545246,1,0,0,245.88,7,633935.02,5,2,14,3,True
1827640,400,4,-1,8864,432545246,1,1,0,246.16,1,633935.02,10,0,21,3,True
1881799,1339,2,20,2430,432545246,1,0,0,245.99,3,633689.03,18,3,12,3,True
2322244,376,0,20,8167,432545246,1,0,0,245.75,5,633443.28,25,1,0,4,True
2389177,1201,0,10,1807,432545246,1,0,0,246.0,6,633689.28,24,1,13,4,True
2520933,400,4,30,8490,432545246,1,0,0,246.06,8,633443.22,10,4,21,4,True
2579617,400,4,30,8490,432545246,1,0,0,245.98,8,633197.24,10,5,21,8,True
2914966,553,1,-1,4359,432545246,1,1,0,246.03,4,633197.24,17,6,0,8,True
3149558,314,0,20,6556,432545246,1,0,0,245.96,5,632951.28,4,1,21,8,True
3488928,849,1,-1,8490,432545246,1,1,0,246.11,4,632951.28,5,3,2,9,True
3804290,550,0,30,1369,432545246,1,0,0,245.88,8,632705.4,17,3,8,9,True
4123061,400,4,451,3459,432545246,1,0,0,245.89,7,632459.51,10,1,18,10,True
4126087,400,4,30,9174,432545246,1,0,0,246.1,8,632213.41,10,1,14,10,True
4130118,849,1,451,7179,432545246,1,0,0,246.02,7,631967.39,5,5,4,11,True
4759141,550,0,25,9962,432545246,1,0,0,245.72,8,631721.67,17,5,9,12,True
4935215,849,1,451,8864,432545246,1,0,0,246.0,7,631475.67,5,5,14,3,True
5178148,550,0,451,7612,432545246,1,0,0,246.27,7,631229.4,17,3,3,3,True
5338495,849,1,-1,8845,432545246,1,1,0,246.0,1,631229.4,5,1,6,3,True
5350727,509,0,10,8670,432545246,1,0,0,246.15,0,631475.55,12,2,2,3,True
5467980,550,0,-1,7350,432545246,1,1,0,245.91,4,631475.55,17,4,14,3,True
5490028,550,0,451,2430,432545246,1,0,0,245.99,7,631229.56,17,5,4,4,True
6103337,738,2,20,7612,432545246,1,0,0,245.94,5,630983.62,11,0,10,6,True
6555500,1142,2,25,8864,432545246,1,0,0,246.26,8,630737.36,15,4,5,6,True
6641864,553,1,-1,6556,432545246,1,1,0,246.29,4,630737.36,17,6,18,7,True
6681804,611,0,20,8845,432545246,1,0,0,245.91,5,630491.45,11,0,7,8,True
6934838,849,1,25,7923,432545246,1,0,0,245.94,8,630245.51,5,3,16,8,True
6962228,553,1,451,1349,432545246,1,0,0,245.97,7,629999.54,17,3,21,8,True
7009431,550,0,30,8418,432545246,1,0,0,245.63,8,629753.91,17,5,4,12,True
7493534,553,1,25,1349,432545246,1,0,0,246.04,8,629507.87,17,2,14,12,True
7735301,553,1,30,8670,432545246,1,0,0,245.96,8,629261.91,17,0,20,1,True
8023616,553,1,30,4359,432545246,1,0,0,246.12,8,629015.79,17,0,7,3,True
8358388,553,1,-1,3459,432545246,1,1,0,245.87,4,629015.79,17,3,2,3,True
8367211,553,1,451,5931,432545246,1,0,0,246.05,7,628769.74,17,6,15,3,True
8444324,1142,2,-1,5931,432545246,1,1,0,246.26,1,628769.74,15,1,2,3,True
8587143,550,0,451,4847,432545246,1,0,0,245.98,7,628523.76,17,5,9,4,True
8617145,304,0,20,8864,432545246,1,0,0,245.96,3,628277.8,4,2,1,4,True
8627460,148,1,10,2359,432545246,1,0,0,246.23,6,628524.03,18,4,11,4,True
8676542,553,1,25,8604,432545246,1,0,0,245.81,8,628278.22,17,5,2,5,True
8754684,1445,2,20,3459,432545246,1,0,0,245.86,3,628032.36,24,3,8,5,True
8776696,1142,2,30,8604,432545246,1,0,0,245.59,8,627786.77,15,2,14,6,True
8890030,1142,2,25,1349,432545246,1,0,0,245.7,8,627541.07,15,2,19,7,True
9078758,550,0,30,7980,432545246,1,0,0,245.92,8,627295.15,17,4,6,7,True
9108595,550,0,451,4727,432545246,1,0,0,246.2,7,627048.95,17,1,20,7,True
9517815,1311,2,20,5931,432545246,1,0,0,246.15,5,626802.8,5,2,12,7,True
9529426,400,4,451,9962,432545246,1,0,0,246.12,7,626556.68,10,5,5,9,True
9653333,249,0,20,7350,432545246,1,0,0,246.0,5,626310.68,6,5,19,10,True
9699507,849,1,25,7920,432545246,1,0,0,246.16,8,626064.52,5,1,15,10,True
9764130,553,1,-1,8845,432545246,1,1,0,246.12,4,626064.52,17,3,1,11,True
9888134,553,1,30,8490,432545246,1,0,0,246.27,8,625818.25,17,3,6,11,True
1089815,995,1,30,4261,248999712,1,0,0,358.0,8,593879.0,22,0,10,1,True
1119734,834,0,10,4824,248999712,1,0,0,358.09,6,594237.09,5,3,10,1,True
1263460,782,4,451,3141,248999712,1,0,0,357.85,7,593879.24,14,3,20,1,True
1413885,1155,0,-1,4341,248999712,1,1,0,358.02,4,593879.24,15,4,17,1,True
1451123,1409,1,10,9658,248999712,1,0,0,357.97,6,594237.21,24,5,13,4,True
1490413,1250,1,30,9186,248999712,1,0,0,358.15,8,593879.06,23,5,7,4,True
1773926,782,4,25,5027,248999712,1,0,0,357.96,8,593521.1,14,0,16,4,True
1801936,974,3,451,4824,248999712,1,0,0,357.9,7,593163.2,22,6,20,5,True
2299813,410,4,25,9891,248999712,1,0,0,358.46,8,592804.74,18,0,10,5,True
2368228,974,3,25,3141,248999712,1,0,0,357.85,8,592446.89,22,2,3,6,True
2675620,1250,1,25,3906,248999712,1,0,0,357.9,8,592088.99,23,4,16,7,True
2844152,974,3,25,4824,248999712,1,0,0,358.01,8,591730.98,22,1,22,7,True
2894019,816,0,451,9271,248999712,1,0,0,357.99,7,591372.99,18,2,1,8,True
2968029,1250,1,451,3906,248999712,1,0,0,358.11,7,591014.88,23,6,0,8,True
3153190,658,4,30,6616,248999712,1,0,0,358.23,8,590656.65,18,2,5,8,True
3233950,995,1,-1,5027,248999712,1,1,0,358.12,4,590656.65,22,3,17,9,True
3340897,1155,0,25,7839,248999712,1,0,0,357.98,8,590298.67,15,4,13,9,True
3540385,1175,2,20,3896,248999712,1,0,0,358.03,5,589940.64,24,5,6,9,True
3681196,411,2,30,5027,248999712,1,0,0,358.13,8,589582.51,18,3,0,10,True
3741164,658,4,451,7839,248999712,1,0,0,357.85,7,589224.66,18,6,10,1,True
3868763,974,3,25,8091,248999712,1,0,0,357.92,8,588866.74,22,6,17,2,True
3907125,1155,0,451,8160,248999712,1,0,0,358.2,7,588508.54,15,4,15,3,True
4068775,373,1,10,5281,248999712,1,0,0,358.03,0,588866.57,25,5,17,3,True
4161344,790,0,20,9891,248999712,1,0,0,358.07,5,588508.5,11,1,12,4,True
4384172,995,1,451,3764,248999712,1,0,0,358.03,7,588150.47,22,6,8,5,True
4582940,130,0,20,3906,248999712,1,0,0,358.16,3,587792.31,18,0,4,5,True
5153783,974,3,451,4341,248999712,1,0,0,357.64,7,587434.67,22,4,9,5,True
5330478,1250,1,25,9271,248999712,1,0,0,358.02,8,587076.65,23,4,13,6,True
5364008,1250,1,30,3906,248999712,1,0,0,357.89,8,586718.76,23,1,12,6,True
5650703,1250,1,30,3262,248999712,1,0,0,358.14,8,586360.62,23,1,15,6,True
5985693,1102,2,20,6616,248999712,1,0,0,358.09,5,586002.53,0,0,14,7,True
6044988,411,2,25,4654,248999712,1,0,0,357.9,8,585644.63,18,5,4,8,False
6290350,1090,0,10,6235,248999712,1,0,0,358.08,6,586002.71,18,5,16,8,True
6503569,1476,0,10,9271,248999712,1,0,0,358.08,0,586360.79,24,0,10,8,True
6692074,525,0,10,4654,248999712,1,0,0,358.15,6,586718.94,18,3,13,9,True
6839785,411,2,30,5027,248999712,1,0,0,358.06,8,586360.88,18,3,7,10,True
7063017,995,1,30,9658,248999712,1,0,0,357.83,8,586003.05,22,3,5,10,True
7071626,411,2,25,8160,248999712,1,0,0,358.18,8,585644.87,18,4,0,12,True
7209981,316,2,20,8418,248999712,1,0,0,357.91,5,585286.96,4,5,7,12,True
7445387,1359,2,20,8418,248999712,1,0,0,358.09,5,584928.87,24,1,6,1,True
7609793,708,2,20,8091,248999712,1,0,0,357.93,5,584570.94,18,3,10,2,True
7664378,782,4,451,3896,248999712,1,0,0,357.83,7,584213.11,14,0,7,3,True
7783699,826,1,10,4341,248999712,1,0,0,357.91,0,584571.02,18,6,20,4,True
7939681,995,1,451,3262,248999712,1,0,0,357.96,7,584213.06,22,1,1,5,True
8351982,410,4,451,9658,248999712,1,0,0,357.72,7,583855.34,18,6,17,6,False
8665111,1454,1,10,4261,248999712,1,0,0,358.02,6,584213.36,11,4,1,7,True
8682455,995,1,30,8418,248999712,1,0,0,358.12,8,583855.24,22,5,9,7,True
8982064,410,4,451,3539,248999712,1,0,0,358.16,7,583497.08,18,3,22,8,True
9223009,1250,1,451,7839,248999712,1,0,0,358.16,7,583138.92,23,5,18,8,True
9292340,378,0,10,9416,248999712,1,0,0,358.11,0,583497.03,25,3,16,9,True
9467929,974,3,25,5281,248999712,1,0,0,358.26,8,583138.77,22,0,10,10,False
9765326,211,0,20,8091,248999712,1,0,0,358.02,3,582780.75,9,3,3,10,False
9915854,658,4,451,3262,248999712,1,0,0,358.09,7,582422.66,18,3,3,10,True
9991256,427,2,20,9891,248999712,1,0,0,357.76,3,582064.9,18,5,6,11,True
1120217,675,2,451,3238,427421458,1,0,0,1151.15,7,119264.85,24,2,6,1,True
1174043,1010,0,10,2742,427421458,1,0,0,1151.13,0,120415.98,26,2,1,2,True
1196627,1481,4,30,9955,427421458,1,0,0,1151.13,8,119264.85,24,1,16,4,True
1562568,796,2,20,9156,427421458,1,0,0,1151.2,5,118113.65,11,0,0,5,True
1690658,46,1,10,9955,427421458,1,0,0,1151.02,0,119264.67,24,0,11,5,True
1828570,1148,4,451,5232,427421458,1,0,0,1150.93,7,118113.74,15,3,12,6,True
2171746,1481,4,-1,9156,427421458,1,1,0,1151.03,4,118113.74,24,0,19,6,True
2396604,812,0,25,5392,427421458,1,0,0,1151.08,8,116962.66,18,4,9,6,True
2482968,890,4,451,7106,427421458,1,0,0,1151.15,7,115811.51,24,5,20,7,True
2611959,675,2,25,8522,427421458,1,0,0,1151.16,8,114660.35,24,3,5,8,True
2617965,1069,1,451,1457,427421458,1,0,0,1151.02,7,113509.33,18,4,18,8,True
2785204,1009,0,20,1457,427421458,1,0,0,1151.17,5,112358.16,26,3,13,8,True
2888666,675,2,25,9594,427421458,1,0,0,1150.92,8,111207.24,24,1,8,8,True
3076518,132,2,451,7106,427421458,1,0,0,1150.9,7,110056.34,18,2,23,8,True
3321908,633,4,451,5392,427421458,1,0,0,1151.09,7,108905.25,11,3,19,9,True
3513831,132,2,451,5232,427421458,1,0,0,1151.05,7,107754.2,18,4,7,10,True
3672318,675,2,451,1457,427421458,1,0,0,1150.9,7,106603.3,24,2,9,10,True
3833100,1148,4,451,5392,427421458,1,0,0,1151.0,7,105452.3,15,0,1,10,True
4336026,890,4,451,3004,427421458,1,0,0,1151.21,7,104301.09,24,2,11,11,True
4422068,967,1,30,8150,427421458,1,0,0,1151.08,8,103150.01,13,1,1,11,True
4852486,1148,4,451,9594,427421458,1,0,0,1150.81,7,101999.2,15,6,23,12,True
5054274,675,2,-1,5392,427421458,1,1,0,1150.85,4,101999.2,24,2,11,12,True
5150437,1217,0,20,2004,427421458,1,0,0,1151.11,5,100848.09,24,5,18,12,True
5154878,967,1,30,5182,427421458,1,0,0,1151.14,8,99696.95,13,3,19,12,True
5305256,1148,4,25,7106,427421458,1,0,0,1150.99,8,98545.96,15,4,17,1,True
5328358,675,2,25,9594,427421458,1,0,0,1151.29,8,97394.67,24,4,6,3,True
5357217,132,2,451,5232,427421458,1,0,0,1151.07,7,96243.6,18,5,15,3,True
5470805,341,0,10,3004,427421458,1,0,0,1150.95,0,97394.55,24,0,7,4,True
5758905,1288,0,20,9594,427421458,1,0,0,1150.91,5,96243.64,24,3,18,4,True
6105903,1270,1,10,5182,427421458,1,0,0,1151.17,6,97394.81,23,1,13,4,True
6305541,1481,4,451,2004,427421458,1,0,0,1151.08,7,96243.73,24,0,18,5,True
6391163,940,1,10,5392,427421458,1,0,0,1151.01,6,97394.74,24,1,13,7,True
6770711,990,0,10,2004,427421458,1,0,0,1151.17,0,98545.91,22,3,6,8,True
6950245,116,0,20,2004,427421458,1,0,0,1150.8,5,97395.11,3,1,16,9,True
7067712,1413,0,10,9594,427421458,1,0,0,1151.12,0,98546.23,24,6,13,11,True
7068339,1069,1,25,2742,427421458,1,0,0,1150.89,8,97395.34,18,4,5,12,True
7299928,1148,4,451,2004,427421458,1,0,0,1150.99,7,96244.35,15,2,15,1,True
7311153,576,2,20,8982,427421458,1,0,0,1150.96,5,95093.39,11,3,3,1,True
7430337,812,0,25,7106,427421458,1,0,0,1150.75,8,93942.64,18,0,20,1,True
7584313,1481,4,451,9594,427421458,1,0,0,1150.89,7,92791.75,24,5,9,2,True
7887753,633,4,451,8522,427421458,1,0,0,1151.15,7,91640.6,11,5,15,3,True
8034716,890,4,25,6744,427421458,1,0,0,1150.93,8,90489.67,24,4,3,3,True
8106553,890,4,451,9594,427421458,1,0,0,1151.02,7,89338.65,24,2,6,4,True
8721971,1471,0,20,9594,427421458,1,0,0,1150.66,5,88187.99,24,3,15,4,True
8952997,995,1,10,5232,427421458,1,0,0,1151.15,0,89339.14,22,6,21,5,True
9160479,890,4,451,9955,427421458,1,0,0,1150.66,7,88188.48,24,0,22,5,False
9389707,812,0,30,3143,427421458,1,0,0,1151.21,8,87037.27,18,1,1,6,True
9576321,812,0,-1,1457,427421458,1,1,0,1151.2,4,87037.27,18,1,5,7,True
9776673,675,2,-1,5392,427421458,1,2,0,1151.11,4,87037.27,24,2,15,8,True
9848613,1014,1,10,6744,427421458,1,0,0,1151.05,6,88188.32,26,5,18,9,True
9870681,812,0,451,5392,427421458,1,0,0,1150.88,7,87037.44,18,5,19,9,True
9922617,1148,4,451,5232,427421458,1,0,0,1151.07,7,85886.37,15,3,1,10,True
1219237,53,0,20,2756,258970827,1,0,0,1086.97,5,698125.03,20,4,14,2,True
1269399,580,0,10,1973,258970827,1,0,0,1086.98,6,699212.01,11,4,9,5,True
1278186,314,0,10,9259,258970827,1,0,0,1087.2,6,700299.21,4,2,8,3,True
1287665,184,0,30,9538,258970827,1,0,0,1086.91,8,699212.3,18,6,23,4,True
1363615,1231,2,451,9538,258970827,1,0,0,1087.11,7,698125.19,18,3,11,10,True
2182326,184,0,-1,2928,258970827,1,1,0,1087.19,4,698125.19,18,3,20,9,True
2247606,1044,0,-1,9538,258970827,1,2,0,1087.03,1,698125.19,11,3,16,10,False
2309790,1231,2,-1,4804,258970827,1,3,1,1086.89,4,698125.19,18,1,22,11,True
1101658,1156,1,30,9882,730138880,1,0,0,582.05,8,355542.95,15,1,18,3,True
1295701,1156,1,25,8631,730138880,1,0,0,581.88,8,354961.07,15,1,3,3,False
1310480,445,0,10,8616,730138880,1,0,0,581.77,6,355542.84,13,0,10,3,True
1558912,1156,1,30,1201,730138880,1,0,0,581.9,8,354960.94,15,0,20,5,True
1708896,1156,1,451,8616,730138880,1,0,0,581.89,7,354379.05,15,3,17,6,True
1881730,417,3,-1,3616,730138880,1,1,0,581.86,4,354379.05,18,3,19,6,True
2218440,611,0,20,9917,730138880,1,0,0,582.16,3,353796.89,11,0,3,6,True
2623222,194,1,10,9882,730138880,1,0,0,582.1,6,354378.99,18,3,8,8,True
2625262,128,0,451,1187,730138880,1,0,0,582.03,7,353796.96,18,0,19,9,True
2761149,128,0,451,1575,730138880,1,0,0,581.84,7,353215.12,18,5,12,10,True
3030334,871,0,451,3634,730138880,1,0,0,581.99,7,352633.13,24,3,18,10,True
3141438,1088,4,-1,1187,730138880,1,1,0,582.11,4,352633.13,18,3,3,10,True
3368069,1156,1,-1,5655,730138880,1,2,0,582.13,1,352633.13,15,3,23,11,True
3452959,128,0,25,7213,730138880,1,0,0,582.04,8,352051.09,18,0,12,12,True
3680414,1156,1,-1,1187,730138880,1,1,0,581.9,4,352051.09,15,6,16,1,True
4148772,1468,1,10,6229,730138880,1,0,0,581.76,0,352632.85,11,1,1,1,True
4227560,112,4,451,9882,730138880,1,0,0,582.09,7,352050.76,3,1,4,1,True
4334763,1150,0,10,6953,730138880,1,0,0,582.01,6,352632.77,15,1,21,1,True
4338829,1399,0,10,1187,730138880,1,0,0,581.97,0,353214.74,24,6,10,2,True
4402614,1156,1,-1,7348,730138880,1,1,0,581.92,4,353214.74,15,2,8,3,True
4508680,1217,0,10,1124,730138880,1,0,0,582.06,6,353796.8,24,5,5,4,True
4515216,1088,4,30,8616,730138880,1,0,0,582.01,8,353214.79,18,1,7,4,True
4843551,128,0,-1,8994,730138880,1,1,0,582.01,1,353214.79,18,6,10,4,True
5118231,1156,1,25,6229,730138880,1,0,0,582.0,8,352632.79,15,1,9,4,True
5314561,417,3,451,8631,730138880,1,0,0,582.01,7,352050.78,18,5,9,4,True
5363822,128,0,30,4832,730138880,1,0,0,581.8,8,351468.98,18,0,20,6,True
5451463,234,0,20,3616,730138880,1,0,0,581.88,5,350887.1,26,3,8,6,True
5486387,871,0,30,4439,730138880,1,0,0,581.76,8,350305.34,24,4,5,6,True
5499744,1382,0,10,3634,730138880,1,0,0,582.23,0,350887.57,16,2,3,8,True
5666211,1156,1,30,6953,730138880,1,0,0,581.92,8,350305.65,15,4,8,10,True
5743302,944,2,20,4439,730138880,1,0,0,581.89,5,349723.76,24,1,0,11,True
5933476,417,3,25,7213,730138880,1,0,0,582.06,8,349141.7,18,6,22,12,True
6239482,235,4,30,1187,730138880,1,0,0,582.01,8,348559.69,26,5,11,12,True
6252977,112,4,451,3634,730138880,1,0,0,582.09,7,347977.6,3,2,18,1,True
6393638,1336,2,20,7213,730138880,1,0,0,581.95,5,347395.65,18,6,10,3,True
6421288,428,0,10,1187,730138880,1,0,0,581.81,6,347977.46,18,4,16,3,True
6482740,128,0,-1,7348,730138880,1,1,0,582.01,1,347977.46,18,5,19,3,True
6695817,417,3,451,3634,730138880,1,0,0,582.17,7,347395.29,18,1,5,3,True
6720399,1169,0,20,9882,730138880,1,0,0,581.79,5,346813.5,24,0,19,3,False
6810309,235,4,30,3616,730138880,1,0,0,582.13,8,346231.37,26,3,20,4,True
7069020,871,0,-1,1854,730138880,1,1,0,582.13,4,346231.37,24,5,12,4,True
7229800,1027,0,20,7213,730138880,1,0,0,581.79,5,345649.58,11,6,14,4,False
7912455,687,0,20,8616,730138880,1,0,0,582.26,5,345067.32,24,3,1,5,True
8101262,42,2,20,3634,730138880,1,0,0,582.13,5,344485.19,24,3,1,6,True
8186464,372,0,20,3616,730138880,1,0,0,581.68,5,343903.51,25,3,16,6,True
8447132,287,0,20,3121,730138880,1,0,0,582.01,3,343321.5,24,5,16,6,True
8783664,1142,2,20,5219,730138880,1,0,0,581.81,3,342739.69,15,6,10,6,True
8814840,297,0,10,1575,730138880,1,0,0,581.96,6,343321.65,4,4,16,7,True
9151546,417,3,451,3616,730138880,1,0,0,581.75,7,342739.9,18,6,7,7,True
9213323,417,3,30,9882,730138880,1,0,0,582.14,8,342157.76,18,3,8,8,True
9424525,235,4,-1,3634,730138880,1,1,0,582.09,4,342157.76,26,2,21,8,True
9740682,1156,1,25,1124,730138880,1,0,0,581.94,8,341575.82,15,0,5,9,True
9753376,1238,0,10,7213,730138880,1,0,0,581.66,6,342157.48,18,3,6,10,True
9831722,337,1,10,9917,730138880,1,0,0,581.9,6,342739.38,11,3,2,10,True
9906246,1088,4,451,1124,730138880,1,0,0,581.98,7,342157.4,18,4,16,11,True
1468825,266,2,20,6751,129656070,0,0,0,291.0,5,434777.0,6,5,6,1,True
1814803,812,0,25,4149,129656070,0,0,0,290.84,8,434486.16,18,0,11,1,True
1887736,1231,2,30,5834,129656070,0,0,0,290.97,8,434195.19,18,5,3,1,True
2054197,327,0,10,2639,129656070,0,0,0,290.93,0,434486.12,11,4,11,3,True
2232341,381,4,25,4575,129656070,0,0,0,291.23,8,434194.89,25,5,20,4,True
2396910,108,2,20,9172,129656070,0,0,0,291.06,5,433903.83,3,3,21,5,True
2412210,950,0,20,6436,129656070,0,0,0,291.13,3,433612.7,24,0,8,5,True
2571625,1041,0,10,7452,129656070,0,0,0,290.97,6,433903.67,11,5,10,5,True
2574610,381,4,451,7318,129656070,0,0,0,290.79,7,433612.88,25,4,19,6,True
2789237,146,4,451,2460,129656070,0,0,0,291.12,7,433321.76,18,4,5,6,True
3058364,663,4,30,5798,129656070,0,0,0,291.04,8,433030.72,18,2,2,6,True
3242539,330,3,451,9172,129656070,0,0,0,290.99,7,432739.73,11,6,19,6,True
3303492,812,0,30,4494,129656070,0,0,0,291.1,8,432448.63,18,1,12,7,False
3649332,663,4,-1,5798,129656070,0,1,0,291.03,1,432448.63,18,1,22,7,True
3924336,330,3,-1,9172,129656070,0,2,0,290.75,4,432448.63,11,4,0,9,True
4050804,146,4,30,8891,129656070,0,0,0,290.78,8,432157.85,18,0,2,9,True
4257197,560,2,451,2564,129656070,0,0,0,291.25,7,431866.6,17,1,18,10,True
4455810,663,4,-1,2639,129656070,0,1,0,290.99,4,431866.6,18,3,4,10,True
4614204,1231,2,451,3114,129656070,0,0,0,291.24,7,431575.36,18,5,3,12,True
5033208,330,3,25,4494,129656070,0,0,0,291.08,8,431284.28,11,6,21,1,True
5082255,1390,0,20,8223,129656070,0,0,0,291.0,5,430993.28,24,0,8,1,True
5272948,616,1,10,5198,129656070,0,0,0,290.8,0,431284.08,11,5,11,2,True
5632355,703,0,10,1581,129656070,0,0,0,291.01,6,431575.09,18,1,20,2,True
5878538,663,4,30,6751,129656070,0,0,0,291.19,8,431283.9,18,5,23,3,True
5983724,403,0,20,9172,129656070,0,0,0,291.25,5,430992.65,10,6,5,3,True
6059543,266,2,20,6491,129656070,0,0,0,291.03,3,430701.62,6,5,6,5,True
6195991,381,4,25,5198,129656070,0,0,0,291.02,8,430410.6,25,1,8,8,False
6312159,1231,2,25,5834,129656070,0,0,0,291.01,8,430119.59,18,0,1,8,True
6640356,812,0,451,4575,129656070,0,0,0,291.29,7,429828.3,18,6,20,9,True
6788188,381,4,451,6830,129656070,0,0,0,290.78,7,429537.52,25,4,4,9,True
6884010,1399,0,20,4575,129656070,0,0,0,291.11,5,429246.41,24,0,17,10,True
7344861,211,0,10,3321,129656070,0,0,0,290.79,6,429537.2,9,1,7,10,True
7592058,931,0,20,6830,129656070,0,0,0,290.87,3,429246.33,24,5,10,12,True
7690096,146,4,451,7036,129656070,0,0,0,290.82,7,428955.51,18,5,0,12,True
7779697,812,0,30,2639,129656070,0,0,0,291.09,8,428664.42,18,3,10,2,True
7833151,381,4,25,2136,129656070,0,0,0,290.96,8,428373.46,25,3,14,4,True
8187368,381,4,-1,9172,129656070,0,1,0,291.07,1,428373.46,25,6,21,4,True
8345796,560,2,25,7318,129656070,0,0,0,291.17,8,428082.29,17,5,20,4,True
8557110,572,0,20,6751,129656070,0,0,0,291.03,5,427791.26,11,1,18,7,True
8793338,373,1,10,6491,129656070,0,0,0,290.93,6,428082.19,25,6,13,7,True
9088748,146,4,25,7318,129656070,0,0,0,290.81,8,427791.38,18,0,5,8,True
9111680,560,2,-1,6837,129656070,0,1,0,291.13,4,427791.38,17,4,23,8,True
9169313,146,4,25,4149,129656070,0,0,0,291.07,8,427500.31,18,5,4,9,True
9203110,146,4,-1,9172,129656070,0,1,0,290.7,4,427500.31,18,4,13,11,True
9315515,1231,2,-1,8223,129656070,0,2,0,291.0,4,427500.31,18,5,4,11,True
9354274,663,4,-1,2564,129656070,0,3,1,290.94,1,0.0,18,3,4,11,True
1105649,618,3,-1,3312,340704103,0,1,0,1148.77,1,842658.0,11,2,0,1,True
1207551,1019,0,-1,4626,340704103,0,2,0,1149.1,1,842658.0,26,5,16,1,True
1223190,1379,3,451,5266,340704103,0,0,0,1149.1,7,841508.9,16,5,18,1,True
1251172,299,1,10,7654,340704103,0,0,0,1149.08,6,842657.98,4,2,4,1,True
1262823,1379,3,25,7536,340704103,0,0,0,1148.67,8,841509.31,16,1,19,4,True
1807777,51,0,10,4867,340704103,0,0,0,1148.81,6,842658.12,20,6,5,6,True
1923628,1199,4,451,4818,340704103,0,0,0,1149.2,7,841508.92,24,1,20,7,False
2052594,962,0,10,7536,340704103,0,0,0,1149.1,0,842658.02,13,3,23,10,True
2420498,1019,0,25,1412,340704103,0,0,0,1148.94,8,841509.08,26,4,4,10,True
2788924,1199,4,451,4818,340704103,0,0,0,1148.88,7,840360.2,24,1,12,10,True
2875096,1380,0,451,1126,340704103,0,0,0,1149.09,7,839211.11,16,3,23,11,True
3040828,627,0,20,7032,340704103,0,0,0,1148.99,5,838062.12,11,5,11,12,True
3262335,1380,0,25,3312,340704103,0,0,0,1149.05,8,836913.07,16,5,14,1,True
3288853,1199,4,451,3312,340704103,0,0,0,1149.21,7,835763.86,24,1,4,1,True
3751166,398,0,10,5740,340704103,0,0,0,1149.23,0,836913.09,10,2,12,2,True
3770128,334,0,20,7296,340704103,0,0,0,1149.13,5,835763.96,11,4,21,4,True
4422487,1019,0,30,4057,340704103,0,0,0,1149.16,8,834614.8,26,2,18,4,True
4781764,1379,3,451,4057,340704103,0,0,0,1149.12,7,833465.68,16,5,0,4,True
4866944,1252,4,30,1801,340704103,0,0,0,1148.85,8,832316.83,23,3,20,5,True
4897352,1105,2,20,4867,340704103,0,0,0,1149.09,5,831167.74,0,5,18,6,True
5073383,292,1,10,4818,340704103,0,0,0,1148.94,0,832316.68,4,1,20,7,True
5164887,580,0,10,5550,340704103,0,0,0,1148.91,6,833465.59,11,2,5,7,True
5402784,1379,3,451,4818,340704103,0,0,0,1149.12,7,832316.47,16,4,8,7,True
5449089,1199,4,451,6441,340704103,0,0,0,1149.0,7,831167.47,24,6,1,8,True
5459497,1380,0,25,5266,340704103,0,0,0,1148.89,8,830018.58,16,6,13,9,True
5461739,1199,4,451,1126,340704103,0,0,0,1149.09,7,828869.49,24,2,0,9,True
5481537,1380,0,25,7654,340704103,0,0,0,1149.16,8,827720.33,16,5,8,9,True
5571180,1379,3,25,4818,340704103,0,0,0,1149.08,8,826571.25,16,2,17,9,True
5647109,618,3,-1,3312,340704103,0,1,0,1148.94,4,826571.25,11,2,15,9,True
5958771,618,3,25,4818,340704103,0,0,0,1148.9,8,825422.35,11,0,10,10,True
5966878,1252,4,25,5266,340704103,0,0,0,1148.96,8,824273.39,23,2,16,11,True
6125782,1075,0,10,7296,340704103,0,0,0,1149.37,6,825422.76,18,1,7,11,True
6256206,1379,3,451,1126,340704103,0,0,0,1149.06,7,824273.7,16,0,10,12,True
6278302,728,1,10,4867,340704103,0,0,0,1149.15,6,825422.85,11,6,12,12,True
6285069,194,1,10,7296,340704103,0,0,0,1148.78,6,826571.63,18,2,2,1,True
6298383,1252,4,451,1412,340704103,0,0,0,1149.05,7,825422.58,23,3,14,1,True
6494102,1019,0,451,1126,340704103,0,0,0,1148.84,7,824273.74,26,0,19,1,True
6850061,1199,4,25,1126,340704103,0,0,0,1148.76,8,823124.98,24,1,13,1,True
7343995,1380,0,-1,5782,340704103,0,1,0,1149.15,4,823124.98,16,0,19,2,True
7736103,1019,0,451,7296,340704103,0,0,0,1148.87,7,821976.11,26,4,18,3,True
7959069,1019,0,-1,3312,340704103,0,1,0,1148.97,4,821976.11,26,0,18,3,True
8181454,155,1,10,6441,340704103,0,0,0,1149.06,6,823125.17,18,3,20,4,True
8320983,1379,3,30,7536,340704103,0,0,0,1149.03,8,821976.14,16,6,15,4,True
8440484,1252,4,25,6369,340704103,0,0,0,1149.11,8,820827.03,23,1,10,4,True
8503425,1379,3,451,1412,340704103,0,0,0,1149.08,7,819677.95,16,1,8,5,True
8545883,995,1,10,5550,340704103,0,0,0,1148.98,6,820826.93,22,5,17,5,True
8573818,1199,4,451,6441,340704103,0,0,0,1148.78,7,819678.15,24,0,2,5,True
8642200,618,3,451,4818,340704103,0,0,0,1149.06,7,818529.09,11,5,21,6,True
8938024,1388,1,10,7296,340704103,0,0,0,1149.13,0,819678.22,24,0,11,6,False
9016399,1231,2,20,4818,340704103,0,0,0,1148.88,5,818529.34,18,0,6,6,True
9045114,1199,4,451,3312,340704103,0,0,0,1148.66,7,817380.68,24,2,5,7,True
9200114,1199,4,30,1126,340704103,0,0,0,1148.72,8,816231.96,24,1,23,7,True
9217046,618,3,-1,4867,340704103,0,1,0,1149.2,1,816231.96,11,6,7,8,True
9363070,300,0,10,4933,340704103,0,0,0,1149.33,6,817381.29,4,6,8,8,False
9387761,1379,3,30,5266,340704103,0,0,0,1149.12,8,816232.17,16,1,3,9,True
9449358,1380,0,30,6441,340704103,0,0,0,1148.72,8,815083.45,16,2,8,9,True
9610741,618,3,30,4057,340704103,0,0,0,1148.77,8,813934.68,11,2,17,11,True
9634138,228,0,10,1412,340704103,0,0,0,1148.93,0,815083.61,26,0,7,11,True
9813621,618,3,25,4867,340704103,0,0,0,1148.99,8,813934.62,11,1,3,11,False
1352515,333,1,30,3088,818436264,1,0,0,985.06,8,597657.94,11,1,2,1,True
1483252,118,2,20,9113,818436264,1,0,0,985.21,3,596672.73,18,2,16,1,True
1633746,30,4,25,9113,818436264,1,0,0,985.01,8,595687.72,11,4,2,2,True
1774176,1137,1,451,5564,818436264,1,0,0,985.08,7,594702.64,24,2,17,3,True
1855502,1470,4,451,8877,818436264,1,0,0,985.1,7,593717.54,11,6,21,5,True
1988557,1470,4,30,9129,818436264,1,0,0,985.11,8,592732.43,11,1,0,8,True
2090754,180,0,20,3088,818436264,1,0,0,984.74,3,591747.69,18,6,8,12,True
2135726,1196,4,451,8735,818436264,1,0,0,985.08,7,590762.61,24,4,11,5,True
2173520,880,1,10,7892,818436264,1,0,0,985.08,0,591747.69,27,1,19,8,True
2415249,1196,4,30,9113,818436264,1,0,0,984.99,8,590762.7,24,0,5,10,True
2548647,30,4,451,3088,818436264,1,0,0,984.97,7,589777.73,11,0,7,1,True
2757608,218,0,20,6654,818436264,1,0,0,984.96,3,588792.77,9,0,7,5,True
3314799,333,1,-1,6654,818436264,1,1,0,984.9,4,588792.77,11,5,10,5,True
3361274,333,1,-1,6654,818436264,1,2,0,985.14,4,588792.77,11,3,11,10,True
3421667,1072,0,-1,3624,818436264,1,3,1,984.77,1,588792.77,18,5,19,10,True
1291959,139,4,-1,9014,696404722,1,1,0,142.19,4,564082.0,18,5,10,1,True
1535151,249,0,25,7338,696404722,1,0,0,142.1,8,563939.9,6,1,13,2,True
1917177,139,4,30,8212,696404722,1,0,0,142.01,8,563797.89,18,0,3,2,True
2010410,1102,2,-1,5158,696404722,1,1,0,141.97,1,563797.89,0,2,14,2,True
2149328,1159,0,10,1822,696404722,1,0,0,142.27,0,563940.16,15,4,7,2,True
2204269,1102,2,25,9993,696404722,1,0,0,142.09,8,563798.07,0,0,5,3,True
2380408,1173,1,10,6376,696404722,1,0,0,142.02,0,563940.09,24,0,10,3,True
2542128,1356,2,20,9993,696404722,1,0,0,141.79,5,563798.3,24,4,15,5,True
2557556,1045,4,30,1684,696404722,1,0,0,142.31,8,563655.99,11,5,18,7,True
2645620,1250,1,10,8094,696404722,1,0,0,142.07,6,563798.06,23,4,18,8,True
2649731,542,0,30,8212,696404722,1,0,0,142.13,8,563655.93,17,0,19,9,True
3029340,542,0,-1,1504,696404722,1,1,0,141.91,4,563655.93,17,3,23,9,True
3217707,716,0,20,2876,696404722,1,0,0,142.2,5,563513.73,18,0,14,10,True
3234723,542,0,451,9710,696404722,1,0,0,142.17,7,563371.56,17,1,6,11,True
3264135,995,1,10,7212,696404722,1,0,0,142.19,0,563513.75,22,5,6,11,True
3335026,1412,2,20,8355,696404722,1,0,0,142.06,5,563371.69,24,3,16,12,True
3400014,249,0,30,1331,696404722,1,0,0,142.1,8,563229.59,6,2,20,12,True
3535305,139,4,25,2876,696404722,1,0,0,142.02,8,563087.57,18,6,11,12,True
4400468,139,4,30,6376,696404722,1,0,0,141.79,8,562945.78,18,2,16,12,True
4419363,542,0,30,7488,696404722,1,0,0,141.75,8,562804.03,17,3,20,12,True
4654906,429,0,20,2876,696404722,1,0,0,142.32,5,562661.71,24,1,7,1,True
4818108,1467,0,20,9993,696404722,1,0,0,142.09,5,562519.62,11,4,20,1,True
4872048,1045,4,30,9710,696404722,1,0,0,141.94,8,562377.68,11,5,18,1,True
4881461,1045,4,-1,9993,696404722,1,1,0,141.92,4,562377.68,11,6,8,2,False
5034173,542,0,30,4375,696404722,1,0,0,141.87,8,562235.81,17,4,18,2,True
5351645,1102,2,-1,8094,696404722,1,1,0,141.73,4,562235.81,0,6,0,2,False
5366621,542,0,-1,6814,696404722,1,2,0,141.83,4,562235.81,17,1,6,2,True
6007512,249,0,20,6069,696404722,1,0,0,141.8,5,562094.01,6,0,3,3,True
6168214,1045,4,451,1331,696404722,1,0,0,141.99,7,561952.02,11,1,8,3,True
6294340,542,0,25,1684,696404722,1,0,0,142.01,8,561810.01,17,6,15,4,True
6323131,139,4,25,5112,696404722,1,0,0,141.87,8,561668.14,18,0,21,4,True
6392890,630,0,20,1684,696404722,1,0,0,141.95,3,561526.19,11,1,4,4,True
6758186,907,0,20,6814,696404722,1,0,0,141.97,5,561384.22,2,2,21,6,True
6786672,139,4,25,8355,696404722,1,0,0,141.98,8,561242.24,18,6,0,7,True
6840015,1045,4,30,5112,696404722,1,0,0,142.15,8,561100.09,11,2,11,8,True
6931040,249,0,25,5126,696404722,1,0,0,142.01,8,560958.08,6,3,9,10,True
7352001,59,0,10,9479,696404722,1,0,0,142.09,6,561100.17,20,2,11,11,True
8000851,1102,2,-1,1684,696404722,1,1,0,141.78,4,561100.17,0,5,15,12,True
8134774,249,0,451,1684,696404722,1,0,0,142.03,7,560958.14,6,1,19,12,True
8135502,542,0,25,1206,696404722,1,0,0,142.18,8,560815.96,17,6,12,12,True
8302449,139,4,451,9478,696404722,1,0,0,142.04,7,560673.92,18,4,4,1,True
8343579,249,0,30,1331,696404722,1,0,0,141.73,8,560532.19,6,5,8,2,True
8355445,249,0,451,7488,696404722,1,0,0,142.2,7,560389.99,6,5,8,3,True
8370600,542,0,-1,6814,696404722,1,1,0,141.94,1,560389.99,17,3,14,4,True
8882876,783,0,20,1504,696404722,1,0,0,142.45,5,560247.54,14,5,13,4,True
9058128,1045,4,-1,1504,696404722,1,1,0,141.91,1,560247.54,11,4,23,5,True
9221176,139,4,25,5126,696404722,1,0,0,142.06,8,560105.48,18,4,6,5,True
9453277,1284,2,20,6376,696404722,1,0,0,141.84,5,559963.64,24,5,14,5,True
9608475,249,0,451,7095,696404722,1,0,0,142.15,7,559821.49,6,0,23,7,True
9761739,542,0,451,2876,696404722,1,0,0,141.79,7,559679.7,17,5,8,8,True
9861339,260,0,20,9710,696404722,1,0,0,142.37,5,559537.33,6,3,1,8,True
1138369,1115,1,10,7835,268836182,1,0,0,301.75,0,496620.75,0,4,18,1,True
1479574,23,0,25,7835,268836182,1,0,0,302.0,8,496318.75,11,2,4,1,True
1538951,1238,0,25,6944,268836182,1,0,0,302.0,8,496016.75,18,5,2,1,True
1649153,366,0,20,3208,268836182,1,0,0,301.92,5,495714.83,25,1,14,2,True
1992424,513,4,30,2899,268836182,1,0,0,301.82,8,495413.01,12,4,9,2,True
1995460,275,0,20,3777,268836182,1,0,0,301.85,5,495111.16,24,0,6,2,True
2148901,23,0,451,2899,268836182,1,0,0,302.12,7,494809.04,11,4,5,4,True
2285484,1383,4,451,3455,268836182,1,0,0,302.04,7,494507.0,16,1,20,5,True
2779344,513,4,30,1101,268836182,1,0,0,301.8,8,494205.2,12,4,2,5,True
2966979,1449,0,30,8533,268836182,1,0,0,301.98,8,493903.22,11,0,12,5,True
3022817,1238,0,30,7078,268836182,1,0,0,302.16,8,493601.06,18,5,18,6,True
3349696,1363,0,20,1101,268836182,1,0,0,301.88,3,493299.18,16,1,18,6,True
3494410,259,4,-1,3455,268836182,1,1,0,302.01,4,493299.18,6,4,10,9,True
3566471,1463,2,20,3650,268836182,1,0,0,302.2,5,492996.98,11,5,19,10,True
4133144,1383,4,451,2713,268836182,1,0,0,301.58,7,492695.4,16,6,15,10,True
4457806,1363,0,10,4588,268836182,1,0,0,302.13,6,492997.53,16,0,0,11,True
4698534,1474,0,10,2975,268836182,1,0,0,301.95,6,493299.48,24,1,3,11,True
4841462,259,4,30,4588,268836182,1,0,0,302.15,8,492997.33,6,6,5,12,True
5041985,1383,4,25,7078,268836182,1,0,0,301.89,8,492695.44,16,1,12,1,True
5240739,1238,0,25,2975,268836182,1,0,0,301.88,8,492393.56,18,2,2,2,True
5442473,23,0,-1,1038,268836182,1,1,0,301.61,1,492393.56,11,3,7,2,True
5544269,1339,2,20,4998,268836182,1,0,0,301.99,5,492091.57,18,5,18,2,True
5830897,513,4,25,9512,268836182,1,0,0,302.19,8,491789.38,12,3,18,3,True
6086761,259,4,25,7042,268836182,1,0,0,302.09,8,491487.29,6,1,2,3,True
6094936,1449,0,30,8141,268836182,1,0,0,302.0,8,491185.29,11,2,19,3,True
6293794,1383,4,-1,8533,268836182,1,1,0,302.02,1,491185.29,16,4,13,4,True
6322168,1156,1,10,7042,268836182,1,0,0,302.07,6,491487.36,15,4,17,5,True
6604692,513,4,30,1038,268836182,1,0,0,301.98,8,491185.38,12,6,19,5,True
6642420,259,4,-1,8533,268836182,1,1,0,301.78,4,491185.38,6,2,19,6,True
6714274,1449,0,451,8533,268836182,1,0,0,302.15,7,490883.23,11,4,2,7,True
6946763,259,4,25,3455,268836182,1,0,0,302.2,8,490581.03,6,3,12,7,True
7039812,1383,4,25,8533,268836182,1,0,0,302.2,8,490278.83,16,1,16,8,True
7234129,259,4,451,3208,268836182,1,0,0,301.88,7,489976.95,6,4,5,8,True
7247234,513,4,30,3455,268836182,1,0,0,301.88,8,489675.07,12,5,13,8,True
7288668,513,4,451,8141,268836182,1,0,0,302.04,7,489373.03,12,1,1,9,True
7404010,343,1,10,1038,268836182,1,0,0,302.07,6,489675.1,24,3,5,9,True
7563157,23,0,25,5568,268836182,1,0,0,302.09,8,489373.01,11,1,9,9,True
7584040,1238,0,30,2713,268836182,1,0,0,301.87,8,489071.14,18,3,18,9,True
7593586,1238,0,-1,2025,268836182,1,1,0,301.81,4,489071.14,18,2,10,10,True
7663698,1383,4,30,8141,268836182,1,0,0,301.9,8,488769.24,16,0,13,10,True
7738293,513,4,30,6466,268836182,1,0,0,302.07,8,488467.17,12,5,21,10,True
7989614,1383,4,30,8533,268836182,1,0,0,302.35,8,488164.82,16,6,15,11,True
7997694,804,0,20,3777,268836182,1,0,0,301.95,5,487862.87,11,1,13,11,True
8066176,1310,4,-1,3208,268836182,1,1,0,302.14,1,487862.87,5,1,1,1,True
8090925,259,4,30,3836,268836182,1,0,0,301.96,8,487560.91,6,2,3,2,True
8472796,1231,2,20,8141,268836182,1,0,0,302.09,5,487258.82,18,2,0,3,True
8588157,1101,2,451,7078,268836182,1,0,0,301.95,7,486956.87,0,4,20,3,True
8737465,824,2,20,3650,268836182,1,0,0,301.86,5,486655.01,18,1,16,4,True
8951607,513,4,25,5568,268836182,1,0,0,301.89,8,486353.12,12,2,0,4,True
9016230,1238,0,25,8533,268836182,1,0,0,302.06,8,486051.06,18,4,5,6,False
9095240,513,4,451,9907,268836182,1,0,0,302.17,7,485748.89,12,2,9,7,False
9266160,259,4,451,3650,268836182,1,0,0,301.89,7,485447.0,6,4,9,7,False
9480313,259,4,25,2713,268836182,1,0,0,301.97,8,485145.03,6,6,0,10,True
9606982,1238,0,451,5568,268836182,1,0,0,301.77,7,484843.26,18,6,20,11,False
9812925,1383,4,25,1101,268836182,1,0,0,302.03,8,484541.23,16,1,12,11,True
1294518,807,0,20,2024,195353791,1,0,0,1102.08,5,452513.92,11,4,0,1,True
1538642,1101,2,451,8918,195353791,1,0,0,1102.06,7,451411.86,0,0,21,1,True
1583410,594,0,451,8376,195353791,1,0,0,1102.06,7,450309.8,24,6,17,1,True
1822385,1192,2,20,9607,195353791,1,0,0,1101.96,5,449207.84,24,4,16,2,True
2365667,1315,0,10,8376,195353791,1,0,0,1101.84,0,450309.68,5,6,16,2,True
2582554,1231,2,25,1189,195353791,1,0,0,1101.98,8,449207.7,18,1,2,3,True
2801348,1212,0,20,6456,195353791,1,0,0,1101.94,5,448105.76,24,1,15,3,True
2894240,435,4,30,3788,195353791,1,0,0,1102.14,8,447003.62,24,5,11,3,True
3059858,249,0,10,6249,195353791,1,0,0,1101.84,6,448105.46,6,4,0,4,True
3345242,435,4,30,8918,195353791,1,0,0,1102.09,8,447003.37,24,1,7,4,True
3487278,995,1,10,6456,195353791,1,0,0,1102.08,6,448105.45,22,3,12,5,True
3988500,594,0,451,7240,195353791,1,0,0,1102.11,7,447003.34,24,1,3,5,True
4041858,435,4,-1,9607,195353791,1,1,0,1102.08,4,447003.34,24,1,20,6,True
4083580,1288,0,10,2492,195353791,1,0,0,1101.79,0,448105.13,24,6,6,6,True
4215279,446,1,10,6456,195353791,1,0,0,1102.09,0,449207.22,13,0,22,7,True
4229426,281,1,-1,6249,195353791,1,1,0,1101.78,4,449207.22,24,1,12,7,True
4479882,435,4,451,3788,195353791,1,0,0,1101.82,7,448105.4,24,5,8,7,True
4494640,1101,2,-1,6456,195353791,1,1,0,1101.97,4,448105.4,0,5,23,8,True
4661736,1419,1,10,4765,195353791,1,0,0,1101.82,0,449207.22,24,1,15,8,True
4851388,937,0,20,9724,195353791,1,0,0,1101.99,5,448105.23,24,2,4,8,True
5020936,435,4,30,8376,195353791,1,0,0,1102.29,8,447002.94,24,6,18,10,True
5404041,738,2,20,2857,195353791,1,0,0,1101.9,3,445901.04,11,6,23,10,True
5745812,1435,2,20,7240,195353791,1,0,0,1101.71,5,444799.33,24,5,23,10,True
5817609,281,1,451,2857,195353791,1,0,0,1102.21,7,443697.12,24,5,16,12,True
5950584,1231,2,25,3788,195353791,1,0,0,1101.89,8,442595.23,18,2,16,2,True
6025150,1101,2,451,6456,195353791,1,0,0,1101.72,7,441493.51,0,6,13,2,True
6198266,761,2,20,2024,195353791,1,0,0,1101.65,5,440391.86,24,6,20,3,True
6432548,1454,1,10,9724,195353791,1,0,0,1102.12,6,441493.98,11,3,14,4,True
6469931,1124,0,20,2857,195353791,1,0,0,1101.87,5,440392.11,24,2,7,7,True
6500647,1231,2,30,1189,195353791,1,0,0,1101.87,8,439290.24,18,5,2,8,True
6672107,794,2,20,4765,195353791,1,0,0,1102.17,5,438188.07,11,5,15,8,True
6686773,435,4,451,8918,195353791,1,0,0,1102.11,7,437085.96,24,6,17,8,True
6729632,594,0,30,4765,195353791,1,0,0,1101.67,8,435984.29,24,1,16,8,True
6790929,281,1,451,2857,195353791,1,0,0,1102.19,7,434882.1,24,4,17,11,True
6855433,594,0,25,3663,195353791,1,0,0,1101.63,8,433780.47,24,0,7,11,True
6914044,1483,0,10,2857,195353791,1,0,0,1102.06,6,434882.53,24,0,21,1,True
6995933,594,0,30,3788,195353791,1,0,0,1101.93,8,433780.6,24,4,20,2,True
7070594,1101,2,451,9607,195353791,1,0,0,1102.22,7,432678.38,0,2,16,3,True
7156306,537,0,20,6456,195353791,1,0,0,1101.76,5,431576.62,18,4,10,4,True
7245932,594,0,-1,2857,195353791,1,1,0,1101.84,1,431576.62,24,5,18,5,True
7358525,1101,2,30,9724,195353791,1,0,0,1102.08,8,430474.54,0,4,22,6,True
7424481,1101,2,30,7240,195353791,1,0,0,1101.87,8,429372.67,0,5,21,6,True
7904776,792,1,10,9724,195353791,1,0,0,1101.9,6,430474.57,11,3,0,6,True
8202073,611,0,10,8918,195353791,1,0,0,1102.12,0,431576.69,11,5,21,9,True
8231805,267,0,20,3663,195353791,1,0,0,1101.98,3,430474.71,6,6,11,9,True
8285684,594,0,-1,7598,195353791,1,1,0,1101.88,4,430474.71,24,2,23,10,True
8335071,594,0,-1,8918,195353791,1,2,0,1102.01,1,430474.71,24,4,9,10,True
8355543,1231,2,-1,6456,195353791,1,3,1,1101.81,4,430474.71,18,6,16,11,True
1029178,887,2,20,1033,621775423,1,0,0,400.97,5,701396.03,27,3,1,1,True
1090915,325,0,-1,2038,621775423,1,1,0,401.03,4,701396.03,11,2,22,1,True
1221470,919,4,25,9575,621775423,1,0,0,400.98,8,700995.05,18,4,11,2,True
1227688,334,0,25,1033,621775423,1,0,0,401.16,8,700593.89,11,0,9,2,True
1487739,998,0,20,1748,621775423,1,0,0,400.82,3,700193.07,26,0,12,3,True
1596102,558,0,30,9714,621775423,1,0,0,400.86,8,699792.21,17,6,23,4,True
1659135,1140,0,10,3220,621775423,1,0,0,401.1,0,700193.31,15,0,3,4,True
1784333,570,2,-1,3966,621775423,1,1,0,400.99,1,700193.31,11,2,0,5,False
2020943,1321,0,20,9714,621775423,1,0,0,401.1,5,699792.21,18,5,9,5,True
2295855,334,0,451,9714,621775423,1,0,0,401.0,7,699391.21,11,4,20,5,True
2591601,325,0,451,5656,621775423,1,0,0,400.91,7,698990.3,11,5,12,7,True
2764960,1179,0,451,6937,621775423,1,0,0,401.01,7,698589.29,24,5,10,7,True
2986368,919,4,-1,4807,621775423,1,1,0,400.96,1,698589.29,18,0,5,8,True
3207344,1377,0,10,3966,621775423,1,0,0,401.06,0,698990.35,16,2,0,8,True
3292576,1179,0,30,6937,621775423,1,0,0,400.96,8,698589.39,24,2,14,9,True
3407030,325,0,451,4807,621775423,1,0,0,401.06,7,698188.33,11,2,17,9,True
3698411,325,0,25,9841,621775423,1,0,0,401.23,8,697787.1,11,5,3,11,True
3798846,558,0,25,3836,621775423,1,0,0,400.76,8,697386.34,17,6,1,11,True
3833315,333,1,10,2038,621775423,1,0,0,401.3,6,697787.64,11,1,21,12,True
3849242,558,0,451,6937,621775423,1,0,0,400.76,7,697386.88,17,2,19,1,True
4379183,325,0,451,6937,621775423,1,0,0,401.02,7,696985.86,11,5,13,1,True
4412803,726,0,20,6300,621775423,1,0,0,400.81,5,696585.05,11,2,14,2,True
4626103,919,4,25,9714,621775423,1,0,0,401.07,8,696183.98,18,0,22,2,True
4840293,454,1,10,4807,621775423,1,0,0,400.86,6,696584.84,13,5,21,3,True
5017647,919,4,30,1748,621775423,1,0,0,400.96,8,696183.88,18,6,0,5,True
5040817,1134,1,10,3966,621775423,1,0,0,401.06,6,696584.94,24,5,12,7,True
5563016,919,4,451,9052,621775423,1,0,0,400.95,7,696183.99,18,4,8,8,True
5670936,919,4,451,3836,621775423,1,0,0,401.02,7,695782.97,18,4,12,9,True
5751840,919,4,30,9482,621775423,1,0,0,401.16,8,695381.81,18,5,7,9,True
6019721,558,0,25,9482,621775423,1,0,0,401.01,8,694980.8,17,6,18,9,True
6027427,1486,2,20,4807,621775423,1,0,0,400.96,5,694579.84,24,2,22,10,True
6114978,1179,0,451,2038,621775423,1,0,0,400.9,7,694178.94,24,4,13,10,True
6254585,1312,0,20,8248,621775423,1,0,0,400.76,5,693778.18,5,0,21,10,True
6294139,558,0,-1,1260,621775423,1,1,0,401.06,4,693778.18,17,1,17,10,True
6443673,675,2,20,8248,621775423,1,0,0,401.06,5,693377.12,24,0,21,11,True
6666634,51,0,20,2038,621775423,1,0,0,400.96,5,692976.16,20,4,6,12,True
6691944,378,0,20,9714,621775423,1,0,0,400.99,3,692575.17,25,6,15,1,True
7097894,1212,0,10,4807,621775423,1,0,0,400.88,6,692976.05,24,2,2,1,True
7170905,325,0,30,9714,621775423,1,0,0,400.82,8,692575.23,11,4,23,1,True
7190878,917,0,10,3836,621775423,1,0,0,400.95,0,692976.18,18,0,14,1,True
7280990,325,0,-1,8748,621775423,1,1,0,400.95,4,692976.18,11,0,21,3,True
7287654,558,0,25,3966,621775423,1,0,0,400.97,8,692575.21,17,0,5,4,True
7313375,570,2,451,1876,621775423,1,0,0,400.88,7,692174.33,11,6,17,4,False
7430693,570,2,-1,9841,621775423,1,1,0,401.05,4,692174.33,11,3,4,5,True
7617465,570,2,-1,8748,621775423,1,2,0,400.89,4,692174.33,11,6,14,5,True
7641404,1321,0,10,8748,621775423,1,0,0,400.77,6,692575.1,18,3,15,5,True
7653304,1179,0,451,9575,621775423,1,0,0,400.87,7,692174.23,24,4,22,5,False
7973189,260,0,20,3220,621775423,1,0,0,401.1,5,691773.13,6,4,8,7,True
8015763,570,2,25,1876,621775423,1,0,0,401.01,8,691372.12,11,2,2,7,True
8073885,355,1,10,9482,621775423,1,0,0,400.99,6,691773.11,24,3,7,8,True
8292440,570,2,25,2038,621775423,1,0,0,400.92,8,691372.19,11,2,20,8,True
8946260,739,1,10,2038,621775423,1,0,0,400.99,6,691773.18,24,1,23,9,True
8968020,531,0,20,9714,621775423,1,0,0,401.14,5,691372.04,18,0,1,10,True
9300744,1179,0,25,6300,621775423,1,0,0,400.95,8,690971.09,24,4,7,10,True
1147736,193,1,10,6364,771218220,0,0,0,545.74,6,793268.74,18,0,4,1,True
1172042,1090,0,451,4559,771218220,0,0,0,546.16,7,792722.58,18,3,13,2,True
1174788,1272,0,20,8806,771218220,0,0,0,546.1,5,792176.48,24,4,18,2,False
1529426,127,1,451,2925,771218220,0,0,0,545.96,7,791630.52,18,6,22,3,True
1704179,1018,4,451,1384,771218220,0,0,0,546.09,7,791084.43,26,1,2,4,True
1746855,1018,4,25,2925,771218220,0,0,0,546.05,8,790538.38,26,3,12,5,False
1925599,1277,2,20,2167,771218220,0,0,0,545.76,3,789992.62,24,1,6,6,True
1950794,275,0,20,1173,771218220,0,0,0,545.86,3,789446.76,24,2,10,6,True
2203615,1090,0,451,2824,771218220,0,0,0,546.23,7,788900.53,18,2,20,7,True
2443202,497,0,10,3692,771218220,0,0,0,546.22,6,789446.75,12,1,21,7,True
2477109,742,4,451,5965,771218220,0,0,0,545.87,7,788900.88,24,3,11,8,True
2481326,479,2,20,2370,771218220,0,0,0,545.9,5,788354.98,5,4,19,8,True
2569094,820,1,10,6031,771218220,0,0,0,546.0,6,788900.98,18,6,3,9,True
2775278,1090,0,25,4559,771218220,0,0,0,545.94,8,788355.04,18,6,11,9,False
2785618,1090,0,25,1672,771218220,0,0,0,546.05,8,787808.99,18,0,23,9,True
2852664,603,0,10,6031,771218220,0,0,0,545.75,6,788354.74,24,1,9,9,True
2870289,127,1,-1,5279,771218220,0,1,0,545.93,4,788354.74,18,3,2,9,True
3600329,1235,1,451,1747,771218220,0,0,0,546.08,7,787808.66,18,1,7,11,True
4052562,1235,1,451,2976,771218220,0,0,0,545.95,7,787262.71,18,1,20,11,True
4560201,742,4,-1,8396,771218220,0,1,0,546.05,1,787262.71,24,0,16,11,True
4961083,867,0,20,4118,771218220,0,0,0,545.96,3,786716.75,24,4,13,12,True
5229429,1090,0,30,6076,771218220,0,0,0,545.84,8,786170.91,18,5,3,1,True
5311872,1090,0,451,2744,771218220,0,0,0,545.58,7,785625.33,18,5,20,1,True
5327344,1127,0,-1,1269,771218220,0,1,0,546.05,4,785625.33,24,4,14,2,True
5345552,1306,4,451,1637,771218220,0,0,0,545.73,7,785079.6,5,1,13,2,False
5513805,1017,2,20,5279,771218220,0,0,0,545.89,3,784533.71,26,3,19,3,True
5615451,742,4,25,8988,771218220,0,0,0,545.99,8,783987.72,24,1,1,4,True
6300554,742,4,30,6334,771218220,0,0,0,545.68,8,783442.04,24,3,20,5,True
6551828,1127,0,-1,2167,771218220,0,1,0,545.83,1,783442.04,24,4,13,5,True
6748970,1090,0,451,2167,771218220,0,0,0,545.86,7,782896.18,18,5,21,7,True
6980184,991,1,10,2370,771218220,0,0,0,546.13,6,783442.31,22,3,0,7,True
7085245,1127,0,451,2824,771218220,0,0,0,545.94,7,782896.37,24,5,17,8,True
7237667,1127,0,451,5965,771218220,0,0,0,546.12,7,782350.25,24,6,3,9,True
7422920,1270,1,451,8483,771218220,0,0,0,545.8,7,781804.45,23,1,23,10,True
7450332,127,1,-1,1672,771218220,0,1,0,546.16,4,781804.45,18,3,10,2,True
7507916,127,1,30,2370,771218220,0,0,0,545.7,8,781258.75,18,0,19,3,True
7582539,1270,1,30,3386,771218220,0,0,0,545.88,8,780712.87,23,6,15,3,True
7778837,1090,0,-1,2925,771218220,0,1,0,545.81,4,780712.87,18,5,10,4,True
7968211,1127,0,-1,3303,771218220,0,2,0,546.03,4,780712.87,24,6,0,4,True
8024425,742,4,30,6173,771218220,0,0,0,545.92,8,780166.95,24,0,18,4,True
8053226,1270,1,30,2744,771218220,0,0,0,546.29,8,779620.66,23,5,10,5,True
8103274,1306,4,30,8806,771218220,0,0,0,546.17,8,779074.49,5,0,19,5,False
8153774,1235,1,451,3386,771218220,0,0,0,545.67,7,778528.82,18,6,10,6,False
8296725,1477,2,20,2167,771218220,0,0,0,546.21,5,777982.61,24,2,11,6,True
8722138,127,1,451,8483,771218220,0,0,0,545.8,7,777436.81,18,4,2,6,True
8847815,1018,4,451,5279,771218220,0,0,0,545.71,7,776891.1,26,1,3,7,True
8853095,1127,0,451,6334,771218220,0,0,0,546.0,7,776345.1,24,5,8,7,True
8939381,1018,4,25,2976,771218220,0,0,0,546.08,8,775799.02,26,6,14,7,True
9000215,184,0,10,9376,771218220,0,0,0,545.98,6,776345.0,18,1,6,9,True
9300801,1090,0,451,5279,771218220,0,0,0,545.95,7,775799.05,18,0,13,9,True
9604795,1270,1,-1,5279,771218220,0,1,0,546.04,4,775799.05,23,2,8,9,True
1270054,693,4,451,8582,362831868,1,0,0,184.11,7,765745.89,24,4,6,1,True
1334060,693,4,25,2057,362831868,1,0,0,183.99,8,765561.9,24,2,20,1,True
1499608,1289,1,451,7173,362831868,1,0,0,183.96,7,765377.94,24,6,18,1,True
1556770,693,4,451,5537,362831868,1,0,0,184.05,7,765193.89,24,2,17,1,True
1566318,693,4,25,2696,362831868,1,0,0,184.01,8,765009.88,24,3,21,2,True
1568244,1289,1,30,1426,362831868,1,0,0,183.88,8,764826.0,24,2,19,3,True
1709192,27,0,20,4652,362831868,1,0,0,184.02,3,764641.98,11,0,5,3,True
2204814,1303,0,20,7616,362831868,1,0,0,183.81,5,764458.17,5,2,10,4,True
2437873,693,4,25,4203,362831868,1,0,0,183.94,8,764274.23,24,1,19,5,True
2496040,939,0,25,5537,362831868,1,0,0,183.87,8,764090.36,24,4,6,6,True
2514811,1364,0,20,3603,362831868,1,0,0,183.75,5,763906.61,16,4,23,6,True
2515046,472,4,25,8060,362831868,1,0,0,183.99,8,763722.62,5,4,17,7,True
2574891,1289,1,25,1426,362831868,1,0,0,183.96,8,763538.66,24,2,20,8,True
2771777,1289,1,451,7616,362831868,1,0,0,184.03,7,763354.63,24,6,19,8,False
2798425,1289,1,25,1426,362831868,1,0,0,184.1,8,763170.53,24,3,15,9,True
2895597,1271,0,10,1426,362831868,1,0,0,184.13,6,763354.66,23,1,21,11,True
3042985,472,4,451,1426,362831868,1,0,0,183.71,7,763170.95,5,1,0,12,True
3598673,1289,1,25,4217,362831868,1,0,0,183.81,8,762987.14,24,2,11,12,True
4069254,342,0,10,3603,362831868,1,0,0,183.86,0,763171.0,24,0,17,1,True
4089261,1289,1,-1,4217,362831868,1,1,0,183.92,4,763171.0,24,4,22,1,True
4354883,1289,1,451,4595,362831868,1,0,0,184.02,7,762986.98,24,6,13,2,True
4518368,693,4,30,5348,362831868,1,0,0,183.87,8,762803.11,24,4,7,2,True
4579724,1039,1,10,4595,362831868,1,0,0,184.1,0,762987.21,11,0,11,3,True
4942201,1289,1,30,7173,362831868,1,0,0,183.96,8,762803.25,24,0,14,3,True
5291786,472,4,451,2844,362831868,1,0,0,184.09,7,762619.16,5,1,9,4,True
5502685,1289,1,25,2185,362831868,1,0,0,183.92,8,762435.24,24,6,20,4,True
5667486,693,4,30,6081,362831868,1,0,0,183.83,8,762251.41,24,2,4,4,True
5963836,939,0,30,5537,362831868,1,0,0,184.06,8,762067.35,24,3,0,4,True
6008822,1258,3,25,1150,362831868,1,0,0,184.26,8,761883.09,23,5,17,4,True
6422416,828,4,30,8788,362831868,1,0,0,184.04,8,761699.05,18,0,22,5,True
6577224,1289,1,-1,8060,362831868,1,1,0,183.88,4,761699.05,24,3,8,6,True
6638662,472,4,25,8788,362831868,1,0,0,183.85,8,761515.2,5,3,17,6,True
6675000,472,4,451,1426,362831868,1,0,0,183.83,7,761331.37,5,5,0,7,True
6746855,939,0,30,2844,362831868,1,0,0,184.16,8,761147.21,24,1,17,7,True
6964878,1258,3,451,2844,362831868,1,0,0,184.13,7,760963.08,23,1,16,8,True
7075179,58,2,20,1150,362831868,1,0,0,184.08,5,760779.0,20,5,11,9,True
7222624,360,0,10,1426,362831868,1,0,0,183.88,6,760962.88,24,1,14,10,True
7355744,472,4,451,7173,362831868,1,0,0,184.12,7,760778.76,5,1,16,10,True
7369555,895,0,20,6081,362831868,1,0,0,183.88,3,760594.88,24,4,21,10,True
7604248,472,4,30,6081,362831868,1,0,0,183.96,8,760410.92,5,0,7,11,True
7609192,459,1,10,8582,362831868,1,0,0,184.09,0,760595.01,13,4,0,11,True
7693887,1258,3,30,7286,362831868,1,0,0,183.82,8,760411.19,23,4,1,11,True
7779797,1110,0,20,6081,362831868,1,0,0,183.98,5,760227.21,0,6,20,3,True
7799386,626,2,20,1150,362831868,1,0,0,183.98,5,760043.23,11,6,14,3,True
8212664,472,4,-1,4217,362831868,1,1,0,183.96,4,760043.23,5,4,19,4,True
8221699,1289,1,10,4203,362831868,1,0,0,183.94,6,760227.17,24,3,10,5,True
8249262,828,4,25,2185,362831868,1,0,0,184.0,8,760043.17,18,4,15,5,True
8596173,828,4,451,6081,362831868,1,0,0,184.07,7,759859.1,18,5,11,5,True
8911907,144,1,10,8582,362831868,1,0,0,184.13,6,760043.23,18,2,14,5,True
8949238,1258,3,451,1426,362831868,1,0,0,184.36,7,759858.87,23,5,13,6,True
8959820,472,4,451,5537,362831868,1,0,0,183.77,7,759675.1,5,4,20,7,True
8982666,334,0,20,8060,362831868,1,0,0,183.98,5,759491.12,11,6,19,9,True
9258622,979,0,10,7173,362831868,1,0,0,184.19,6,759675.31,22,1,21,9,True
9314633,1289,1,-1,7173,362831868,1,1,0,183.73,1,759675.31,24,6,0,10,True
9454875,1258,3,25,4217,362831868,1,0,0,184.04,8,759491.27,23,3,21,10,True
9704918,472,4,451,5537,362831868,1,0,0,183.76,7,759307.51,5,4,5,10,True
9903089,693,4,451,7173,362831868,1,0,0,184.18,7,759123.33,24,4,9,11,True
1352397,835,4,-1,8006,327909007,1,1,0,615.08,4,328468.0,5,5,2,1,True
1378511,1468,1,451,8643,327909007,1,0,0,614.95,7,327853.05,11,3,1,1,True
1486513,1374,4,451,2577,327909007,1,0,0,615.13,7,327237.92,16,3,14,2,True
1652350,1468,1,25,1246,327909007,1,0,0,615.1,8,326622.82,11,3,16,3,True
1702042,525,0,20,6299,327909007,1,0,0,614.95,3,326007.87,18,4,16,4,True
2088027,744,4,30,6079,327909007,1,0,0,615.11,8,325392.76,24,0,7,4,True
2739500,835,4,30,6299,327909007,1,0,0,615.03,8,324777.73,5,6,0,4,True
2830142,1374,4,25,9784,327909007,1,0,0,614.84,8,324162.89,16,3,8,4,True
2885247,427,2,451,6299,327909007,1,0,0,615.04,7,323547.85,18,4,22,4,True
2980330,917,0,451,6079,327909007,1,0,0,614.71,7,322933.14,18,3,4,5,False
2990186,398,0,20,9784,327909007,1,0,0,614.95,5,322318.19,10,5,22,5,True
3072182,467,0,10,6299,327909007,1,0,0,614.79,6,322932.98,5,4,7,6,True
3205329,1127,0,25,3819,327909007,1,0,0,614.94,8,322318.04,24,1,2,6,True
3256676,1307,0,20,6299,327909007,1,0,0,615.25,3,321702.79,5,4,1,7,True
3311790,180,0,20,7361,327909007,1,0,0,615.0,3,321087.79,18,6,8,7,True
3428348,1127,0,30,6377,327909007,1,0,0,614.93,8,320472.86,24,4,12,8,False
3671165,274,1,451,7039,327909007,1,0,0,614.86,7,319858.0,24,0,5,9,True
3701376,1127,0,451,4979,327909007,1,0,0,615.26,7,319242.74,24,5,12,10,True
3821646,917,0,30,6079,327909007,1,0,0,614.8,8,318627.94,18,6,23,10,True
3953697,767,0,20,6079,327909007,1,0,0,615.07,3,318012.87,14,6,9,11,True
4029412,835,4,451,2510,327909007,1,0,0,615.05,7,317397.82,5,0,2,12,False
4370085,1374,4,-1,5318,327909007,1,1,0,615.19,4,317397.82,16,6,0,1,True
4379091,1374,4,25,2577,327909007,1,0,0,615.13,8,316782.69,16,5,5,2,True
4554510,427,2,30,6377,327909007,1,0,0,615.01,8,316167.68,18,6,18,2,True
4865329,1374,4,-1,9784,327909007,1,1,0,614.87,1,316167.68,16,6,20,3,True
4935588,276,0,20,9588,327909007,1,0,0,614.81,5,315552.87,24,5,16,3,True
5258885,835,4,25,9473,327909007,1,0,0,614.88,8,314937.99,5,0,10,3,True
5388130,744,4,30,5318,327909007,1,0,0,615.1,8,314322.89,24,5,17,4,True
5397914,1127,0,451,8624,327909007,1,0,0,615.2,7,313707.69,24,6,9,5,True
5436496,1233,0,10,6079,327909007,1,0,0,614.9,6,314322.59,18,0,3,5,True
5467010,835,4,451,6079,327909007,1,0,0,615.11,7,313707.48,5,0,20,6,True
5621593,274,1,30,6079,327909007,1,0,0,615.18,8,313092.3,24,6,2,8,True
5677362,497,0,20,4979,327909007,1,0,0,614.84,5,312477.46,12,6,17,9,True
5698859,909,2,20,5318,327909007,1,0,0,615.13,5,311862.33,18,2,3,9,True
5727812,218,0,20,8006,327909007,1,0,0,614.94,5,311247.39,9,3,13,9,True
5823218,180,0,10,8624,327909007,1,0,0,615.0,6,311862.39,18,4,3,10,True
5825548,917,0,451,5318,327909007,1,0,0,614.95,7,311247.44,18,5,19,10,True
6224108,1127,0,451,4979,327909007,1,0,0,614.85,7,310632.59,24,3,18,12,True
7136230,274,1,451,8006,327909007,1,0,0,614.94,7,310017.65,24,0,5,1,True
7340857,1215,3,25,7039,327909007,1,0,0,615.19,8,309402.46,24,5,7,1,True
7454985,427,2,451,6299,327909007,1,0,0,614.95,7,308787.51,18,5,21,1,True
7549365,917,0,451,8643,327909007,1,0,0,615.16,7,308172.35,18,5,15,3,True
7956867,1468,1,25,6299,327909007,1,0,0,615.17,8,307557.18,11,6,6,3,True
8573941,529,2,20,1887,327909007,1,0,0,614.89,5,306942.29,18,5,18,3,True
8611812,211,0,20,5571,327909007,1,0,0,615.02,5,306327.27,9,0,16,4,True
8692776,484,0,10,9784,327909007,1,0,0,615.2,6,306942.47,5,5,7,4,True
8816805,274,1,451,6299,327909007,1,0,0,614.99,7,306327.48,24,4,6,5,False
8920465,835,4,30,2510,327909007,1,0,0,615.06,8,305712.42,5,0,6,5,True
9090462,1374,4,451,2577,327909007,1,0,0,614.67,7,305097.75,16,3,12,5,True
9235631,274,1,451,9473,327909007,1,0,0,615.16,7,304482.59,24,0,11,6,True
9426515,1215,3,451,8006,327909007,1,0,0,614.88,7,303867.71,24,4,21,7,True
9467790,274,1,451,8624,327909007,1,0,0,614.84,7,303252.87,24,4,7,7,True
9564967,835,4,30,5571,327909007,1,0,0,615.01,8,302637.86,5,1,6,9,False
9659749,835,4,451,7039,327909007,1,0,0,614.93,7,302022.93,5,1,9,9,True
9728872,1127,0,451,1246,327909007,1,0,0,614.97,7,301407.96,24,6,9,9,True
9743849,274,1,451,2577,327909007,1,0,0,615.06,7,300792.9,24,1,14,10,True
9806525,427,2,30,9784,327909007,1,0,0,615.05,8,300177.85,18,1,3,10,True
9940677,427,2,451,3819,327909007,1,0,0,614.94,7,299562.91,18,3,22,11,True
1258331,1231,2,30,9380,148326112,0,0,0,522.09,8,275658.91,18,4,17,1,True
1282353,256,4,30,3754,148326112,0,0,0,521.99,8,275136.92,6,4,16,2,True
1402337,1231,2,451,7520,148326112,0,0,0,521.98,7,274614.94,18,2,10,2,True
1571560,256,4,25,7766,148326112,0,0,0,521.9,8,274093.04,6,5,12,3,True
1802636,642,0,10,1845,148326112,0,0,0,522.03,6,274615.07,24,6,9,4,True
1889115,1406,0,20,3486,148326112,0,0,0,522.09,3,274092.98,24,3,21,4,True
2359418,738,2,20,2754,148326112,0,0,0,521.9,3,273571.08,11,0,20,5,True
2386043,1449,0,20,3756,148326112,0,0,0,522.24,3,273048.84,11,6,18,5,True
2483034,603,0,20,3756,148326112,0,0,0,522.36,3,272526.48,24,4,5,8,True
2609770,929,0,20,1845,148326112,0,0,0,521.9,3,272004.58,18,5,15,9,True
2655981,1187,4,25,1845,148326112,0,0,0,521.95,8,271482.63,24,3,4,9,False
2679263,1451,1,10,5090,148326112,0,0,0,522.16,0,272004.79,11,5,23,10,True
2747355,1231,2,-1,9380,148326112,0,1,0,521.88,4,272004.79,18,0,13,10,True
3016672,1115,1,25,5338,148326112,0,0,0,522.22,8,271482.57,0,2,12,10,True
3060940,1445,2,451,5090,148326112,0,0,0,522.24,7,270960.33,24,1,8,10,True
3286914,711,2,25,7766,148326112,0,0,0,522.08,8,270438.25,18,5,18,11,True
3450131,184,0,20,5090,148326112,0,0,0,522.01,3,269916.24,18,3,6,11,True
3490643,256,4,30,2897,148326112,0,0,0,521.99,8,269394.25,6,3,18,12,True
3526090,218,0,20,3050,148326112,0,0,0,522.07,5,268872.18,9,6,9,12,True
3671336,1445,2,30,2754,148326112,0,0,0,521.97,8,268350.21,24,5,19,12,True
3974292,1476,0,30,2897,148326112,0,0,0,522.19,8,267828.02,24,1,19,1,True
3976665,670,0,10,9380,148326112,0,0,0,522.05,6,268350.07,18,4,2,2,False
4042896,1090,0,10,3756,148326112,0,0,0,521.82,6,268871.89,18,0,23,2,True
4317683,457,0,10,3050,148326112,0,0,0,521.69,6,269393.58,13,5,2,4,True
4400158,399,2,20,2897,148326112,0,0,0,522.02,3,268871.56,10,4,3,5,True
4479752,256,4,451,2873,148326112,0,0,0,522.03,7,268349.53,6,3,1,5,False
4738334,1134,1,10,3756,148326112,0,0,0,521.95,6,268871.48,24,0,18,5,True
4932235,365,0,10,7520,148326112,0,0,0,521.79,0,269393.27,25,2,8,7,True
4963220,256,4,-1,2754,148326112,0,1,0,522.39,4,269393.27,6,2,10,8,True
5181771,689,0,10,1845,148326112,0,0,0,521.82,6,269915.09,24,4,3,11,True
5245416,1445,2,25,5090,148326112,0,0,0,521.83,8,269393.26,24,0,1,12,True
5653154,711,2,30,9380,148326112,0,0,0,521.81,8,268871.45,18,4,22,12,True
5704384,1231,2,451,5090,148326112,0,0,0,522.1,7,268349.35,18,0,12,1,True
6124868,256,4,30,2754,148326112,0,0,0,522.26,8,267827.09,6,6,21,1,True
6214196,1408,1,10,3486,148326112,0,0,0,521.98,6,268349.07,24,3,20,2,True
6253330,314,0,20,3754,148326112,0,0,0,521.93,5,267827.14,4,4,18,3,True
6270899,1115,1,25,5338,148326112,0,0,0,522.07,8,267305.07,0,1,4,3,True
6625700,1231,2,451,2754,148326112,0,0,0,522.03,7,266783.04,18,0,8,4,True
6691203,256,4,451,2897,148326112,0,0,0,521.92,7,266261.12,6,1,23,4,True
7573678,1270,1,10,3754,148326112,0,0,0,521.71,6,266782.83,23,0,11,5,True
7637081,1115,1,25,5090,148326112,0,0,0,521.99,8,266260.84,0,0,19,5,True
7750168,325,0,20,9380,148326112,0,0,0,522.11,3,265738.73,11,0,9,6,True
7967037,1476,0,25,3050,148326112,0,0,0,521.85,8,265216.88,24,5,11,7,True
8127361,256,4,25,7766,148326112,0,0,0,521.72,8,264695.16,6,5,5,7,True
8150957,942,0,20,3756,148326112,0,0,0,521.9,5,264173.26,24,6,9,7,True
8495595,1231,2,451,3050,148326112,0,0,0,521.99,7,263651.27,18,3,1,8,True
8701565,1445,2,-1,9380,148326112,0,1,0,521.87,1,263651.27,24,3,0,9,True
8897146,736,1,10,5338,148326112,0,0,0,522.08,6,264173.35,11,3,23,10,True
8935222,256,4,451,3486,148326112,0,0,0,521.86,7,263651.49,6,4,11,10,True
9333374,211,0,10,8262,148326112,0,0,0,521.98,6,264173.47,9,4,8,10,True
9413037,1445,2,25,2897,148326112,0,0,0,521.93,8,263651.54,24,5,1,10,True
9649914,1445,2,25,7766,148326112,0,0,0,521.91,8,263129.63,24,5,4,11,True
9890589,400,4,30,1845,148326112,0,0,0,521.9,8,262607.73,10,3,23,11,False
1018341,128,0,25,8442,870737401,1,0,0,482.17,8,878614.83,18,3,15,1,True
1270659,975,4,451,9851,870737401,1,0,0,481.66,7,878133.17,22,5,20,2,True
1322769,704,3,30,8920,870737401,1,0,0,482.14,8,877651.03,18,5,0,3,True
1402138,378,0,451,7324,870737401,1,0,0,481.88,7,877169.15,25,2,0,3,True
1408814,547,4,451,3417,870737401,1,0,0,482.1,7,876687.05,17,1,4,3,False
1428898,704,3,30,8607,870737401,1,0,0,482.31,8,876204.74,18,6,5,5,True
1577943,1195,1,10,4932,870737401,1,0,0,482.15,0,876686.89,24,4,8,5,True
1670254,1191,4,25,5403,870737401,1,0,0,482.05,8,876204.84,24,2,16,6,False
1723376,1296,4,451,3937,870737401,1,0,0,482.05,7,875722.79,5,1,17,8,True
1811037,547,4,451,9139,870737401,1,0,0,481.96,7,875240.83,17,5,23,8,True
1915796,1113,1,10,4263,870737401,1,0,0,482.18,6,875723.01,0,6,8,9,True
1996291,704,3,-1,6241,870737401,1,1,0,481.97,1,875723.01,18,0,15,9,True
2217706,1089,0,20,4932,870737401,1,0,0,481.94,3,875241.07,18,1,16,9,True
2337453,34,1,10,5403,870737401,1,0,0,481.95,6,875723.02,11,1,22,10,True
2738325,200,0,10,8525,870737401,1,0,0,481.71,0,876204.73,9,6,5,11,True
2875315,1164,0,10,8442,870737401,1,0,0,482.07,6,876686.8,24,3,22,11,True
2881114,128,0,451,5223,870737401,1,0,0,481.87,7,876204.93,18,2,17,12,True
2895947,1152,0,10,4071,870737401,1,0,0,482.14,6,876687.07,15,1,21,1,True
2958302,1296,4,451,8383,870737401,1,0,0,482.14,7,876204.93,5,4,14,2,True
3325509,704,3,25,8525,870737401,1,0,0,482.07,8,875722.86,18,3,18,3,True
3421827,799,2,20,1388,870737401,1,0,0,482.03,3,875240.83,11,2,18,3,True
3494856,975,4,451,5863,870737401,1,0,0,481.87,7,874758.96,22,0,8,4,True
4053660,104,4,30,6241,870737401,1,0,0,481.94,8,874277.02,3,5,14,4,False
4184525,104,4,-1,4795,870737401,1,1,0,481.94,1,874277.02,3,6,11,4,True
4221940,378,0,451,9715,870737401,1,0,0,481.93,7,873795.09,25,5,15,4,True
4523677,547,4,451,5863,870737401,1,0,0,481.63,7,873313.46,17,6,0,5,True
4837123,1296,4,451,3417,870737401,1,0,0,481.8,7,872831.66,5,3,18,5,True
4986687,104,4,25,3417,870737401,1,0,0,481.85,8,872349.81,3,0,19,5,True
5088913,687,0,20,8607,870737401,1,0,0,482.21,5,871867.6,24,0,15,6,True
5122996,104,4,30,8525,870737401,1,0,0,482.08,8,871385.52,3,5,0,7,True
5580816,403,0,20,5223,870737401,1,0,0,482.18,5,870903.34,10,3,0,8,True
6020522,128,0,30,3417,870737401,1,0,0,481.85,8,870421.49,18,0,16,8,True
6166247,378,0,30,5934,870737401,1,0,0,481.85,8,869939.64,25,3,3,9,True
6309074,219,0,10,4071,870737401,1,0,0,482.01,6,870421.65,9,6,18,10,True
6464998,1296,4,25,5395,870737401,1,0,0,482.12,8,869939.53,5,2,1,11,True
6567631,128,0,-1,5403,870737401,1,1,0,482.01,1,869939.53,18,4,21,12,True
6924448,378,0,-1,8607,870737401,1,2,0,481.9,1,869939.53,25,5,22,12,True
6949090,1210,0,10,3937,870737401,1,0,0,481.87,6,870421.4,24,5,7,2,True
7011744,704,3,25,1388,870737401,1,0,0,481.91,8,869939.49,18,1,13,2,True
7823175,1191,4,30,9139,870737401,1,0,0,481.95,8,869457.54,24,3,5,2,True
7872081,378,0,30,5934,870737401,1,0,0,481.92,8,868975.62,25,4,16,6,True
7948825,889,0,10,8383,870737401,1,0,0,482.35,6,869457.97,27,0,4,7,True
8017825,975,4,-1,4795,870737401,1,1,0,482.19,4,869457.97,22,2,15,7,True
8162133,530,0,20,3417,870737401,1,0,0,482.03,3,868975.94,18,4,19,8,True
8197135,1173,1,10,6200,870737401,1,0,0,481.95,6,869457.89,24,6,5,8,True
8352011,1191,4,30,1388,870737401,1,0,0,481.79,8,868976.1,24,6,21,9,True
8385857,547,4,-1,9139,870737401,1,1,0,481.95,1,868976.1,17,0,9,9,True
8733181,104,4,451,6200,870737401,1,0,0,481.86,7,868494.24,3,3,21,9,True
8839230,1296,4,451,1388,870737401,1,0,0,481.99,7,868012.25,5,6,4,9,True
8952101,428,0,10,8607,870737401,1,0,0,482.05,6,868494.3,18,6,17,9,True
9007015,704,3,25,8313,870737401,1,0,0,482.2,8,868012.1,18,5,14,10,True
9332487,547,4,451,3417,870737401,1,0,0,482.06,7,867530.04,17,5,9,10,True
9932938,547,4,-1,8920,870737401,1,1,0,481.64,1,867530.04,17,0,12,10,True
9945239,975,4,30,4932,870737401,1,0,0,482.13,8,867047.91,22,2,5,11,True
1087779,1434,0,10,2625,621252145,0,0,0,476.06,6,846818.06,24,6,21,1,True
1530074,1400,3,30,1305,621252145,0,0,0,476.1,8,846341.96,24,2,7,1,True
1619168,681,2,451,4537,621252145,0,0,0,476.03,7,845865.93,24,0,10,2,True
1721608,885,3,451,2625,621252145,0,0,0,475.89,7,845390.04,24,2,9,4,True
1797780,1402,4,30,5810,621252145,0,0,0,476.08,8,844913.96,24,5,12,5,True
1840649,1110,0,10,4199,621252145,0,0,0,476.06,6,845390.02,0,6,0,5,True
2211700,774,2,25,7019,621252145,0,0,0,475.92,8,844914.1,14,6,21,6,True
2237352,314,0,20,5041,621252145,0,0,0,475.95,5,844438.15,4,0,19,7,False
2352625,35,2,20,6450,621252145,0,0,0,475.92,3,843962.23,11,0,14,7,True
2441021,281,1,10,4394,621252145,0,0,0,476.2,6,844438.43,24,3,8,8,True
2592976,885,3,451,8620,621252145,0,0,0,476.13,7,843962.3,24,3,7,9,True
2705740,287,0,20,1798,621252145,0,0,0,476.2,3,843486.1,24,1,14,9,True
2767719,1311,2,20,4392,621252145,0,0,0,476.02,3,843010.08,5,3,8,9,True
2801467,1093,0,451,3729,621252145,0,0,0,475.92,7,842534.16,18,0,11,10,True
2897909,681,2,30,5041,621252145,0,0,0,476.08,8,842058.08,24,6,18,10,True
3292131,607,2,20,4420,621252145,0,0,0,476.05,3,841582.03,24,6,16,10,True
3314157,774,2,-1,5041,621252145,0,1,0,475.98,4,841582.03,14,4,23,12,True
3383484,774,2,451,2026,621252145,0,0,0,476.1,7,841105.93,14,4,1,12,True
3625175,1400,3,451,8268,621252145,0,0,0,475.96,7,840629.97,24,0,17,1,True
3637532,885,3,25,4537,621252145,0,0,0,476.04,8,840153.93,24,0,18,1,True
4008956,681,2,-1,1840,621252145,0,1,0,476.1,4,840153.93,24,2,17,1,True
4291253,1093,0,451,1082,621252145,0,0,0,475.95,7,839677.98,18,6,21,2,True
4621021,1400,3,30,8620,621252145,0,0,0,476.11,8,839201.87,24,3,7,3,True
4770318,1069,1,451,1798,621252145,0,0,0,476.18,7,838725.69,18,3,23,4,True
4831356,219,0,10,2625,621252145,0,0,0,476.19,6,839201.88,9,6,5,4,True
5327120,1400,3,30,8268,621252145,0,0,0,475.98,8,838725.9,24,5,2,4,True
5446740,1402,4,-1,3293,621252145,0,1,0,475.94,4,838725.9,24,1,8,5,True
5507653,1069,1,451,3293,621252145,0,0,0,475.79,7,838250.11,18,3,16,5,True
5569697,267,0,10,4537,621252145,0,0,0,475.81,6,838725.92,6,0,16,5,True
6072399,681,2,25,1435,621252145,0,0,0,475.97,8,838249.95,24,4,20,6,True
6196548,774,2,451,3714,621252145,0,0,0,475.81,7,837774.14,14,5,3,6,True
6693976,1035,0,10,1840,621252145,0,0,0,475.71,6,838249.85,11,4,10,6,True
6806166,1486,2,30,2625,621252145,0,0,0,476.11,8,837773.74,24,1,4,6,True
6887125,885,3,-1,4487,621252145,0,1,0,476.28,4,837773.74,24,6,18,7,True
7307197,630,0,20,1798,621252145,0,0,0,475.89,5,837297.85,11,1,18,8,True
7345893,1400,3,25,7019,621252145,0,0,0,475.95,8,836821.9,24,5,19,8,True
7486493,1093,0,451,9655,621252145,0,0,0,476.0,7,836345.9,18,6,23,9,True
7903166,681,2,-1,8620,621252145,0,1,0,476.04,1,836345.9,24,1,1,11,True
8124957,681,2,451,2026,621252145,0,0,0,476.13,7,835869.77,24,5,7,11,True
8143754,577,0,20,1435,621252145,0,0,0,476.02,5,835393.75,11,0,13,12,True
8427362,1069,1,30,4487,621252145,0,0,0,475.68,8,834918.07,18,1,6,1,True
8430934,681,2,25,1082,621252145,0,0,0,476.08,8,834441.99,24,3,0,2,True
8572899,681,2,451,3729,621252145,0,0,0,475.96,7,833966.03,24,1,5,2,True
8596607,1037,0,10,4487,621252145,0,0,0,476.2,6,834442.23,11,5,22,3,True
8697110,885,3,451,7961,621252145,0,0,0,476.0,7,833966.23,24,3,18,3,True
8958746,774,2,451,8268,621252145,0,0,0,476.17,7,833490.06,14,5,3,3,True
9008727,341,0,20,3714,621252145,0,0,0,476.17,5,833013.89,24,1,18,4,True
9047856,1010,0,10,9270,621252145,0,0,0,476.18,6,833490.07,26,4,7,4,True
9077947,1486,2,451,1305,621252145,0,0,0,475.96,7,833014.11,24,3,1,4,True
9201862,1486,2,451,4394,621252145,0,0,0,476.02,7,832538.09,24,6,15,8,True
9531628,1322,2,20,7961,621252145,0,0,0,475.76,5,832062.33,18,0,5,8,True
9568926,1093,0,451,9066,621252145,0,0,0,476.06,7,831586.27,18,2,12,8,True
9702434,1402,4,25,4420,621252145,0,0,0,475.76,8,831110.51,24,3,12,9,True
9817049,681,2,30,9655,621252145,0,0,0,476.06,8,830634.45,24,0,4,10,True
1292144,46,1,10,7049,201691274,0,0,0,1035.86,6,499850.86,24,2,22,1,True
1476511,343,1,-1,6769,201691274,0,1,0,1036.16,1,499850.86,24,4,5,1,True
1518141,975,4,30,3030,201691274,0,0,0,1036.23,8,498814.63,22,4,6,2,True
1554213,602,4,451,6907,201691274,0,0,0,1035.91,7,497778.72,24,3,11,3,True
1826809,1044,0,25,6382,201691274,0,0,0,1036.02,8,496742.7,11,1,16,4,True
2220462,1044,0,30,3797,201691274,0,0,0,1035.99,8,495706.71,11,1,16,5,True
2269596,564,0,20,9426,201691274,0,0,0,1035.91,5,494670.8,17,3,16,5,False
2601367,935,1,10,4702,201691274,0,0,0,1035.69,6,495706.49,24,5,15,5,True
2733036,975,4,25,6382,201691274,0,0,0,1036.32,8,494670.17,22,0,15,6,True
2751018,214,4,-1,3030,201691274,0,1,0,1035.85,1,494670.17,9,6,1,7,True
2891275,1044,0,451,5261,201691274,0,0,0,1036.1,7,493634.07,11,5,23,9,True
3013404,23,0,10,1916,201691274,0,0,0,1035.95,6,494670.02,11,1,0,10,True
3121491,1284,2,-1,1939,201691274,0,1,0,1036.09,1,494670.02,24,3,5,11,True
3605776,1284,2,30,4702,201691274,0,0,0,1035.95,8,493634.07,24,5,21,11,True
3640229,47,1,10,6907,201691274,0,0,0,1036.09,6,494670.16,24,1,10,12,True
3922407,602,4,-1,1916,201691274,0,1,0,1035.84,4,494670.16,24,2,19,1,True
4157077,1044,0,-1,6907,201691274,0,2,0,1036.07,1,494670.16,11,3,5,1,True
4332180,602,4,25,6382,201691274,0,0,0,1036.08,8,493634.08,24,4,10,2,True
4542120,343,1,30,4702,201691274,0,0,0,1035.91,8,492598.17,24,5,18,2,True
4879781,1044,0,-1,4124,201691274,0,1,0,1035.95,4,492598.17,11,6,22,4,True
5093574,1205,0,20,5188,201691274,0,0,0,1035.94,3,491562.23,24,6,14,5,True
5422308,1284,2,451,5261,201691274,0,0,0,1035.88,7,490526.35,24,3,15,5,True
5452760,1044,0,451,3797,201691274,0,0,0,1036.3,7,489490.05,11,3,15,5,False
6767396,1486,2,30,4124,201691274,0,0,0,1036.23,8,488453.82,24,0,7,6,True
6898576,1044,0,30,1998,201691274,0,0,0,1035.97,8,487417.85,11,4,6,8,True
6944718,214,4,30,6907,201691274,0,0,0,1036.18,8,486381.67,9,0,15,8,True
7131256,234,0,10,3797,201691274,0,0,0,1035.93,0,487417.6,26,6,16,9,True
7281234,1102,2,20,1939,201691274,0,0,0,1035.91,5,486381.69,0,6,2,9,False
7355652,1044,0,451,6907,201691274,0,0,0,1035.81,7,485345.88,11,2,1,9,True
7357215,1044,0,30,3797,201691274,0,0,0,1035.91,8,484309.97,11,3,15,9,False
7497266,602,4,451,7070,201691274,0,0,0,1036.07,7,483273.9,24,4,16,9,True
7637381,748,1,10,3030,201691274,0,0,0,1035.98,6,484309.88,24,2,14,10,True
7641049,1284,2,-1,5261,201691274,0,1,0,1035.68,4,484309.88,24,2,15,11,True
7666725,28,1,10,2225,201691274,0,0,0,1036.03,0,485345.91,11,4,7,11,True
7740429,266,2,20,3030,201691274,0,0,0,1036.09,3,484309.82,6,5,6,11,True
7779279,1284,2,25,1998,201691274,0,0,0,1036.08,8,483273.74,24,5,0,11,True
7902710,602,4,30,9531,201691274,0,0,0,1036.02,8,482237.72,24,5,17,12,True
7952742,1284,2,30,4124,201691274,0,0,0,1035.9,8,481201.82,24,3,13,12,True
8214699,1044,0,-1,7070,201691274,0,1,0,1036.14,4,481201.82,11,3,4,12,True
8423494,254,0,20,6382,201691274,0,0,0,1035.91,5,480165.91,6,3,7,2,True
8429760,343,1,25,4124,201691274,0,0,0,1035.95,8,479129.96,24,0,14,2,True
8430797,1217,0,10,4124,201691274,0,0,0,1035.83,6,480165.79,24,1,1,4,True
8680779,34,1,10,3723,201691274,0,0,0,1035.93,0,481201.72,11,2,2,5,True
8949765,975,4,451,9531,201691274,0,0,0,1035.97,7,480165.75,22,2,2,6,True
8978241,214,4,25,4124,201691274,0,0,0,1035.81,8,479129.94,9,4,2,6,True
9411157,1421,0,20,3723,201691274,0,0,0,1035.9,3,478094.04,24,5,19,7,True
9603909,343,1,30,5188,201691274,0,0,0,1035.86,8,477058.18,24,4,9,8,True
9641353,1278,0,20,7564,201691274,0,0,0,1036.01,5,476022.17,24,5,5,9,True
9646383,1486,2,-1,7564,201691274,0,1,0,1036.04,4,476022.17,24,5,3,10,True
9726122,1486,2,-1,3723,201691274,0,2,0,1035.98,1,476022.17,24,3,6,11,True
1281057,378,0,451,4601,901354850,1,0,0,257.75,7,950687.25,25,5,10,1,True
1350909,378,0,25,7244,901354850,1,0,0,258.12,8,950429.13,25,2,21,2,True
1434375,177,4,451,6162,901354850,1,0,0,257.97,7,950171.16,24,1,16,3,True
1908998,948,4,451,7249,901354850,1,0,0,258.09,7,949913.07,24,6,19,3,True
2019767,177,4,30,3513,901354850,1,0,0,257.87,8,949655.2,24,0,5,4,True
2027303,1416,4,-1,4986,901354850,1,1,0,257.97,1,949655.2,24,0,2,5,True
2699111,1276,4,451,4499,901354850,1,0,0,258.01,7,949397.19,24,2,5,5,True
3180761,177,4,-1,6951,901354850,1,1,0,257.7,4,949397.19,24,3,5,6,True
3261325,378,0,-1,7244,901354850,1,2,0,258.01,1,949397.19,25,4,16,6,True
3300322,851,1,10,4137,901354850,1,0,0,257.97,0,949655.16,5,6,17,6,True
3565492,948,4,30,4499,901354850,1,0,0,258.09,8,949397.07,24,3,18,7,True
3762662,108,2,20,7244,901354850,1,0,0,258.04,5,949139.03,3,1,3,8,True
3818870,948,4,30,4986,901354850,1,0,0,257.94,8,948881.09,24,3,2,8,False
3841295,177,4,451,5350,901354850,1,0,0,258.1,7,948622.99,24,4,1,8,True
3848969,1416,4,451,6162,901354850,1,0,0,258.14,7,948364.85,24,3,23,9,True
3850296,1356,2,20,7249,901354850,1,0,0,257.89,3,948106.96,24,1,23,10,True
4302794,948,4,451,4326,901354850,1,0,0,257.89,7,947849.07,24,2,21,10,True
4310690,177,4,-1,7602,901354850,1,1,0,257.89,4,947849.07,24,0,1,11,True
4452028,378,0,451,4601,901354850,1,0,0,258.01,7,947591.06,25,5,21,12,True
4767616,1146,2,20,9568,901354850,1,0,0,257.94,5,947333.12,15,0,6,1,True
4927972,728,1,10,7685,901354850,1,0,0,258.07,6,947591.19,11,2,18,1,True
4966494,1276,4,30,8707,901354850,1,0,0,257.99,8,947333.2,24,0,5,2,True
5079985,509,0,10,1951,901354850,1,0,0,258.04,6,947591.24,12,0,16,2,True
5368727,937,0,20,8707,901354850,1,0,0,257.96,5,947333.28,24,6,18,3,True
5378118,1201,0,10,4326,901354850,1,0,0,258.08,0,947591.36,24,1,15,3,True
5381920,177,4,451,4499,901354850,1,0,0,258.03,7,947333.33,24,1,6,4,True
5698530,1416,4,451,6635,901354850,1,0,0,257.95,7,947075.38,24,5,7,4,True
5817986,177,4,-1,4986,901354850,1,1,0,258.43,1,947075.38,24,6,5,5,True
5998685,652,0,20,6162,901354850,1,0,0,257.84,5,946817.54,24,3,14,5,True
6050321,497,0,20,8707,901354850,1,0,0,258.0,5,946559.54,12,0,5,6,True
6375849,1307,0,10,6162,901354850,1,0,0,258.08,6,946817.62,5,6,19,8,True
6406872,583,2,20,7249,901354850,1,0,0,258.0,5,946559.62,11,3,0,9,True
6504853,1270,1,10,6635,901354850,1,0,0,258.15,0,946817.77,23,5,20,12,True
6556593,177,4,30,4499,901354850,1,0,0,258.14,8,946559.63,24,0,13,1,True
6570080,177,4,451,7685,901354850,1,0,0,258.11,7,946301.52,24,5,2,2,True
6714091,948,4,451,5059,901354850,1,0,0,258.12,7,946043.4,24,0,14,2,True
6811939,260,0,20,5059,901354850,1,0,0,258.11,5,945785.29,6,3,13,3,True
7247512,177,4,451,6371,901354850,1,0,0,257.88,7,945527.41,24,5,13,3,True
7306204,177,4,451,4601,901354850,1,0,0,257.81,7,945269.6,24,6,13,3,True
7352495,1416,4,30,7685,901354850,1,0,0,257.98,8,945011.62,24,4,14,3,True
7684778,1382,0,10,6951,901354850,1,0,0,257.93,6,945269.55,16,5,14,4,True
7818844,1477,2,20,6635,901354850,1,0,0,257.95,5,945011.6,24,5,12,5,True
8224881,177,4,451,6951,901354850,1,0,0,258.05,7,944753.55,24,6,4,5,True
8238548,948,4,451,4137,901354850,1,0,0,258.05,7,944495.5,24,1,2,6,True
8279023,1304,0,10,8188,901354850,1,0,0,258.05,6,944753.55,5,5,7,6,True
8441260,341,0,10,4601,901354850,1,0,0,258.08,0,945011.63,24,6,15,6,True
8896853,948,4,30,4499,901354850,1,0,0,258.0,8,944753.63,24,3,12,6,True
8941972,1416,4,451,1951,901354850,1,0,0,257.9,7,944495.73,24,3,17,9,True
9022149,177,4,30,7249,901354850,1,0,0,257.8,8,944237.93,24,4,9,9,True
9032167,378,0,-1,6162,901354850,1,1,0,257.98,4,944237.93,25,6,1,9,True
9085354,945,1,10,4601,901354850,1,0,0,258.19,0,944496.12,24,2,15,10,True
9118353,378,0,451,4499,901354850,1,0,0,257.89,7,944238.23,25,4,10,11,True
9470774,948,4,25,5350,901354850,1,0,0,258.18,8,943980.05,24,4,20,11,True
9602115,1416,4,-1,7249,901354850,1,1,0,257.87,4,943980.05,24,2,1,11,True
1175473,995,1,25,6969,680564094,1,0,0,855.13,8,225424.87,22,6,1,1,True
1220814,685,3,30,6150,680564094,1,0,0,854.94,8,224569.93,24,0,2,1,True
1223348,995,1,-1,4256,680564094,1,1,0,854.76,1,224569.93,22,1,19,1,True
1542043,370,4,451,6969,680564094,1,0,0,854.84,7,223715.09,25,0,23,1,True
2244197,995,1,451,6150,680564094,1,0,0,855.12,7,222859.97,22,1,22,2,True
2295867,105,3,-1,4202,680564094,1,1,0,854.74,4,222859.97,3,6,21,2,True
2545325,685,3,451,2329,680564094,1,0,0,855.09,7,222004.88,24,3,2,3,True
2703597,222,2,25,3601,680564094,1,0,0,855.05,8,221149.83,26,0,0,4,True
2727697,118,2,20,2329,680564094,1,0,0,855.1,5,220294.73,18,6,12,4,True
2883657,538,0,451,3762,680564094,1,0,0,855.06,7,219439.67,18,2,22,5,True
2884563,228,0,10,3762,680564094,1,0,0,855.14,0,220294.81,26,2,17,6,False
2977470,320,1,10,6859,680564094,1,0,0,855.3,6,221150.11,11,5,8,6,True
3106053,995,1,451,2329,680564094,1,0,0,854.99,7,220295.12,22,0,6,7,True
3231625,703,0,10,3601,680564094,1,0,0,854.91,6,221150.03,18,4,14,7,True
3280593,105,3,25,4256,680564094,1,0,0,854.92,8,220295.11,3,0,17,11,True
3310710,1298,0,10,3601,680564094,1,0,0,854.74,6,221149.85,5,5,15,11,True
3368800,995,1,-1,6969,680564094,1,1,0,854.58,1,221149.85,22,5,0,12,True
3588200,538,0,-1,2329,680564094,1,2,0,854.94,1,221149.85,18,3,20,12,True
3644246,370,4,451,2329,680564094,1,0,0,854.87,7,220294.98,25,1,4,1,True
3703021,538,0,451,5560,680564094,1,0,0,854.87,7,219440.11,18,4,11,1,True
3936902,370,4,451,3601,680564094,1,0,0,855.03,7,218585.08,25,1,5,1,True
3956234,370,4,-1,2329,680564094,1,1,0,855.09,4,218585.08,25,3,17,1,False
4323789,685,3,25,5969,680564094,1,0,0,855.06,8,217730.02,24,5,4,3,True
4474680,68,0,20,8071,680564094,1,0,0,855.19,3,216874.83,20,5,6,3,True
4628180,538,0,-1,4202,680564094,1,1,0,855.01,4,216874.83,18,3,9,3,True
4656065,995,1,25,3561,680564094,1,0,0,854.75,8,216020.08,22,1,4,4,True
5261735,1433,4,-1,6150,680564094,1,1,0,854.95,4,216020.08,24,0,21,5,True
5757879,995,1,30,8071,680564094,1,0,0,854.95,8,215165.13,22,3,23,5,True
6219654,538,0,25,8071,680564094,1,0,0,855.06,8,214310.07,18,1,2,5,True
6544668,1433,4,30,3601,680564094,1,0,0,854.94,8,213455.13,24,3,6,6,True
6692548,1433,4,451,2329,680564094,1,0,0,855.07,7,212600.06,24,5,2,6,True
6757161,538,0,451,3601,680564094,1,0,0,854.97,7,211745.09,18,3,17,6,True
6799397,685,3,-1,2329,680564094,1,1,0,854.99,4,211745.09,24,6,23,7,True
6816970,790,0,20,3762,680564094,1,0,0,854.77,5,210890.32,11,0,22,8,True
6857573,995,1,451,6150,680564094,1,0,0,855.01,7,210035.31,22,4,11,9,True
6966969,105,3,451,3601,680564094,1,0,0,855.1,7,209180.21,3,5,6,10,True
7053122,995,1,25,6150,680564094,1,0,0,854.82,8,208325.39,22,1,22,10,True
7156095,951,0,10,8071,680564094,1,0,0,855.05,0,209180.44,24,1,3,11,True
7181997,105,3,-1,3601,680564094,1,1,0,854.68,1,209180.44,3,6,5,11,True
7270094,105,3,451,8034,680564094,1,0,0,854.81,7,208325.63,3,4,22,11,True
7294067,370,4,25,4256,680564094,1,0,0,854.95,8,207470.68,25,4,2,1,True
7574126,685,3,-1,4256,680564094,1,1,0,854.84,4,207470.68,24,3,7,1,True
8005469,1433,4,451,6969,680564094,1,0,0,854.73,7,206615.95,24,3,20,2,True
8007849,962,0,10,4256,680564094,1,0,0,855.08,0,207471.03,13,0,20,4,True
8010260,685,3,451,2329,680564094,1,0,0,855.07,7,206615.96,24,5,3,4,True
8106164,222,2,451,5969,680564094,1,0,0,855.03,7,205760.93,26,0,3,4,True
8435977,995,1,451,3561,680564094,1,0,0,855.23,7,204905.7,22,3,14,6,True
8599249,341,0,10,6150,680564094,1,0,0,854.91,6,205760.61,24,4,11,7,True
8802704,255,2,20,3601,680564094,1,0,0,854.9,5,204905.71,6,5,17,7,True
8861053,369,1,10,4202,680564094,1,0,0,854.87,6,205760.58,25,6,6,7,True
8897917,538,0,451,8034,680564094,1,0,0,854.99,7,204905.59,18,1,7,9,True
9157403,995,1,-1,5969,680564094,1,1,0,854.9,1,204905.59,22,0,1,9,True
9472475,995,1,451,2329,680564094,1,0,0,855.11,7,204050.48,22,6,15,9,True
9508580,995,1,30,6859,680564094,1,0,0,855.01,8,203195.47,22,0,18,10,True
9567398,222,2,30,4256,680564094,1,0,0,855.08,8,202340.39,26,0,3,11,True
9864828,685,3,451,3762,680564094,1,0,0,855.07,7,201485.32,24,0,11,11,True
1078432,1476,0,451,9226,405490269,1,0,0,977.24,7,233977.76,24,5,4,2,False
1301904,599,0,25,2859,405490269,1,0,0,976.97,8,233000.79,24,4,13,3,True
1416231,1231,2,-1,7412,405490269,1,1,0,976.89,4,233000.79,18,6,11,3,True
1618434,662,1,10,3596,405490269,1,0,0,976.97,6,233977.76,18,0,7,4,True
1713004,1476,0,451,6188,405490269,1,0,0,976.95,7,233000.81,24,5,3,4,True
1717012,1461,0,451,8512,405490269,1,0,0,976.89,7,232023.92,11,1,4,5,False
2096915,1298,0,20,4870,405490269,1,0,0,976.79,5,231047.13,5,1,4,8,True
2192232,866,0,20,3596,405490269,1,0,0,976.89,3,230070.24,24,6,4,8,True
2276433,1476,0,25,1965,405490269,1,0,0,976.87,8,229093.37,24,3,2,8,True
2292246,1029,0,20,1134,405490269,1,0,0,976.81,5,228116.56,11,6,23,9,True
2415747,550,0,20,1375,405490269,1,0,0,976.92,5,227139.64,17,2,8,9,True
2460236,1231,2,-1,9226,405490269,1,1,0,976.99,1,227139.64,18,1,5,10,True
2872614,599,0,451,7412,405490269,1,0,0,976.81,7,226162.83,24,3,0,10,True
3116004,599,0,451,4500,405490269,1,0,0,977.1,7,225185.73,24,2,5,11,True
3345833,832,3,25,9012,405490269,1,0,0,977.22,8,224208.51,5,4,19,11,True
3515163,1314,2,20,7144,405490269,1,0,0,976.91,3,223231.6,5,6,0,1,True
3707908,599,0,30,6188,405490269,1,0,0,976.93,8,222254.67,24,4,9,2,True
3931936,832,3,451,8512,405490269,1,0,0,977.11,7,221277.56,5,4,4,3,True
4103902,664,2,20,9226,405490269,1,0,0,976.96,5,220300.6,18,2,8,3,True
4126539,1250,1,10,1965,405490269,1,0,0,976.99,6,221277.59,23,0,12,4,True
4655164,1461,0,451,4870,405490269,1,0,0,976.84,7,220300.75,11,5,4,4,True
5146466,1461,0,25,7823,405490269,1,0,0,976.9,8,219323.85,11,0,23,5,True
5259039,832,3,30,7412,405490269,1,0,0,976.72,8,218347.13,5,3,22,6,True
5335081,1277,2,30,1965,405490269,1,0,0,977.38,8,217369.75,24,4,12,6,True
5349983,980,1,10,2888,405490269,1,0,0,976.98,0,218346.73,22,0,4,6,True
5538811,309,0,20,4500,405490269,1,0,0,976.94,5,217369.79,4,6,6,7,True
5620832,1461,0,25,1892,405490269,1,0,0,977.16,8,216392.63,11,2,10,7,True
5755259,1461,0,451,9733,405490269,1,0,0,977.32,7,215415.31,11,5,23,8,True
5878068,1231,2,451,7144,405490269,1,0,0,976.94,7,214438.37,18,3,7,8,True
5973332,1166,2,20,9733,405490269,1,0,0,977.05,5,213461.32,24,4,5,9,True
6096153,832,3,-1,8822,405490269,1,1,0,976.92,4,213461.32,5,6,10,10,True
6363175,1461,0,451,9378,405490269,1,0,0,976.96,7,212484.36,11,5,17,11,True
6727261,1277,2,25,7144,405490269,1,0,0,976.83,8,211507.53,24,5,19,11,True
6790417,1461,0,451,9733,405490269,1,0,0,977.13,7,210530.4,11,0,14,11,True
6809572,1255,0,20,4786,405490269,1,0,0,977.11,5,209553.29,23,6,14,11,True
6837680,599,0,451,9226,405490269,1,0,0,977.06,7,208576.23,24,1,18,1,True
7315045,522,0,20,1892,405490269,1,0,0,976.67,5,207599.56,18,4,10,1,True
7380257,303,0,20,6986,405490269,1,0,0,976.72,5,206622.84,4,4,6,1,True
7659708,832,3,451,9226,405490269,1,0,0,977.12,7,205645.72,5,5,16,1,True
7708048,203,0,10,4087,405490269,1,0,0,977.0,6,206622.72,9,1,22,1,True
7713325,1461,0,451,6188,405490269,1,0,0,976.82,7,205645.9,11,4,3,2,True
7784192,599,0,451,8339,405490269,1,0,0,977.11,7,204668.79,24,4,4,2,True
7942053,1231,2,30,4786,405490269,1,0,0,976.88,8,203691.91,18,4,14,3,True
8059398,832,3,30,2859,405490269,1,0,0,976.87,8,202715.04,5,2,14,4,True
8315324,1041,0,10,6522,405490269,1,0,0,977.03,6,203692.07,11,6,23,5,True
8449409,1476,0,30,1466,405490269,1,0,0,976.72,8,202715.35,24,6,19,6,True
8657226,1111,0,20,4870,405490269,1,0,0,976.99,5,201738.36,0,0,10,7,True
8664681,1461,0,-1,9378,405490269,1,1,0,976.78,1,201738.36,11,0,22,7,True
8960823,599,0,451,4500,405490269,1,0,0,977.1,7,200761.26,24,4,12,8,True
8968485,599,0,25,9012,405490269,1,0,0,976.58,8,199784.68,24,6,1,8,True
9207625,1476,0,25,1375,405490269,1,0,0,977.25,8,198807.43,24,3,4,9,True
9426046,530,0,10,1892,405490269,1,0,0,977.18,6,199784.61,18,1,12,9,True
9943756,644,0,20,1134,405490269,1,0,0,977.05,5,198807.56,24,1,8,9,True
9971932,832,3,25,6522,405490269,1,0,0,977.29,8,197830.27,5,3,23,10,True
9984170,832,3,451,2859,405490269,1,0,0,976.95,7,196853.32,5,5,14,11,True
9998806,199,0,20,7846,405490269,1,0,0,977.0,5,195876.32,18,1,21,11,True
1245084,1140,0,20,7920,424717250,1,0,0,892.07,5,154223.93,15,4,19,2,True
1377738,1352,1,10,3975,424717250,1,0,0,892.14,0,155116.07,24,6,6,2,True
1562312,513,4,-1,9857,424717250,1,1,0,891.86,4,155116.07,12,4,2,3,True
1660731,59,0,20,9831,424717250,1,0,0,892.27,3,154223.8,20,3,2,3,False
1869846,1014,1,30,9857,424717250,1,0,0,892.06,8,153331.74,26,6,7,5,True
1922962,1164,0,10,3097,424717250,1,0,0,891.73,6,154223.47,24,3,21,5,True
2076808,20,0,10,1080,424717250,1,0,0,891.93,6,155115.4,24,4,16,5,True
2348065,655,3,25,1090,424717250,1,0,0,891.82,8,154223.58,18,5,6,5,True
2411538,235,4,30,1090,424717250,1,0,0,891.91,8,153331.67,26,6,18,6,True
2497126,176,3,30,7412,424717250,1,0,0,892.16,8,152439.51,24,6,5,8,True
2507077,956,1,10,3097,424717250,1,0,0,891.87,0,153331.38,13,4,22,8,True
2576375,1014,1,30,3009,424717250,1,0,0,891.85,8,152439.53,26,5,10,9,True
2768129,198,0,10,1090,424717250,1,0,0,891.95,6,153331.48,18,5,14,9,True
2886044,513,4,-1,1090,424717250,1,1,0,891.86,4,153331.48,12,4,5,10,True
2963698,1322,2,20,3715,424717250,1,0,0,892.02,3,152439.46,18,5,5,10,True
2980788,365,0,30,7920,424717250,1,0,0,892.06,8,151547.4,25,3,21,11,True
3029699,365,0,-1,9857,424717250,1,1,0,892.43,4,151547.4,25,5,13,2,True
3062389,538,0,10,1094,424717250,1,0,0,892.03,0,152439.43,18,0,20,2,True
3194540,235,4,451,1660,424717250,1,0,0,891.95,7,151547.48,26,3,15,3,True
3280252,353,1,10,7920,424717250,1,0,0,892.24,0,152439.72,24,4,17,5,True
3483354,655,3,-1,9571,424717250,1,1,0,891.92,4,152439.72,18,4,7,5,True
3494092,513,4,30,1090,424717250,1,0,0,891.96,8,151547.76,12,4,7,6,True
3580193,1090,0,20,3097,424717250,1,0,0,891.9,5,150655.86,18,1,15,8,True
3935738,513,4,-1,1094,424717250,1,1,0,892.28,4,150655.86,12,4,10,8,True
4001179,176,3,451,6196,424717250,1,0,0,891.9,7,149763.96,24,4,6,8,True
4045305,176,3,25,1080,424717250,1,0,0,892.01,8,148871.95,24,1,12,8,True
4408550,349,2,20,5467,424717250,1,0,0,891.98,3,147979.97,24,4,10,9,True
4646013,993,0,10,1660,424717250,1,0,0,892.11,0,148872.08,22,6,14,9,True
4804233,235,4,451,3975,424717250,1,0,0,892.25,7,147979.83,26,6,10,10,True
5156410,694,2,-1,5904,424717250,1,1,0,891.63,4,147979.83,24,3,11,10,True
5376291,389,3,-1,1080,424717250,1,2,0,892.08,4,147979.83,10,4,6,11,True
5407731,655,3,25,6638,424717250,1,0,0,892.2,8,147087.63,18,4,9,11,True
5606160,184,0,10,7920,424717250,1,0,0,891.88,6,147979.51,18,6,6,12,True
6118135,1014,1,30,7920,424717250,1,0,0,891.97,8,147087.54,26,2,19,12,True
6194358,362,0,10,9291,424717250,1,0,0,892.01,0,147979.55,24,1,2,12,True
6462415,176,3,25,3137,424717250,1,0,0,892.01,8,147087.54,24,4,17,12,True
6722533,694,2,451,1080,424717250,1,0,0,892.21,7,146195.33,24,0,11,2,True
6755198,655,3,25,1660,424717250,1,0,0,892.0,8,145303.33,18,0,23,3,True
6822806,694,2,451,6959,424717250,1,0,0,891.98,7,144411.35,24,5,1,3,True
7060496,1014,1,451,3975,424717250,1,0,0,891.93,7,143519.42,26,6,6,3,True
7281144,1014,1,451,1094,424717250,1,0,0,892.15,7,142627.27,26,6,19,3,True
7463942,655,3,30,3975,424717250,1,0,0,892.25,8,141735.02,18,4,1,4,True
8221855,655,3,30,4781,424717250,1,0,0,892.19,8,140842.83,18,4,12,4,True
8397682,176,3,30,6959,424717250,1,0,0,891.91,8,139950.92,24,4,22,5,True
8473116,513,4,25,9831,424717250,1,0,0,892.07,8,139058.85,12,1,11,5,True
8618932,1226,2,20,3137,424717250,1,0,0,892.04,5,138166.81,18,5,14,6,True
8746200,1325,0,20,3715,424717250,1,0,0,891.74,5,137275.07,18,3,5,7,True
9002248,1483,0,20,6638,424717250,1,0,0,891.82,3,136383.25,24,0,12,9,True
9123238,1014,1,30,9831,424717250,1,0,0,891.82,8,135491.43,26,2,9,9,True
9323793,238,0,10,1094,424717250,1,0,0,891.89,0,136383.32,26,5,4,9,True
9439304,655,3,30,1090,424717250,1,0,0,892.12,8,135491.2,18,0,6,9,True
9517898,51,0,10,5467,424717250,1,0,0,891.94,6,136383.14,20,3,19,10,True
9584896,130,0,20,2583,424717250,1,0,0,892.23,5,135490.91,18,0,21,10,True
9758686,176,3,-1,9291,424717250,1,1,0,891.94,1,135490.91,24,5,16,10,True
9766900,694,2,25,6959,424717250,1,0,0,892.06,8,134598.85,24,3,10,10,True
9773362,389,3,451,3097,424717250,1,0,0,892.16,7,133706.69,10,3,14,11,True
9819438,389,3,451,4781,424717250,1,0,0,891.87,7,132814.82,10,0,5,11,True
9853031,1288,0,451,9857,424717250,1,0,0,891.95,7,131922.87,24,1,12,11,True
1130873,512,0,30,8441,488949538,1,0,0,1124.72,8,803684.28,12,6,13,1,True
1582502,199,0,451,2418,488949538,1,0,0,1125.08,7,802559.2,18,5,17,1,True
1954367,512,0,30,8565,488949538,1,0,0,1124.79,8,801434.41,12,5,19,2,True
2036231,156,4,451,1268,488949538,1,0,0,1125.08,7,800309.33,18,4,8,3,True
2209026,1389,4,451,1949,488949538,1,0,0,1124.87,7,799184.46,24,4,5,4,True
2323333,512,0,30,5305,488949538,1,0,0,1124.95,8,798059.51,12,5,12,5,True
2661087,156,4,451,1949,488949538,1,0,0,1125.23,7,796934.28,18,6,22,7,False
2697125,199,0,451,9464,488949538,1,0,0,1124.69,7,795809.59,18,5,3,7,True
2746618,512,0,30,4668,488949538,1,0,0,1125.19,8,794684.4,12,2,9,8,False
2840582,104,4,25,8565,488949538,1,0,0,1124.98,8,793559.42,3,6,11,8,True
3176692,1389,4,451,6426,488949538,1,0,0,1125.1,7,792434.32,24,4,21,8,True
3205004,551,0,10,2418,488949538,1,0,0,1124.85,6,793559.17,17,6,7,8,True
3761940,1262,0,10,2063,488949538,1,0,0,1124.95,6,794684.12,23,5,3,9,True
3830607,200,0,10,6647,488949538,1,0,0,1125.12,0,795809.24,9,5,23,9,True
3882553,199,0,451,8441,488949538,1,0,0,1124.91,7,794684.33,18,4,20,10,True
3987384,104,4,25,3180,488949538,1,0,0,1125.12,8,793559.21,3,6,4,11,True
4043101,156,4,25,6227,488949538,1,0,0,1125.06,8,792434.15,18,6,15,12,True
4219281,998,0,20,2418,488949538,1,0,0,1124.89,5,791309.26,26,1,20,1,True
4412423,219,0,20,6647,488949538,1,0,0,1125.09,3,790184.17,9,3,16,1,True
4551559,1409,1,10,2968,488949538,1,0,0,1125.26,6,791309.43,24,5,11,1,False
4607207,156,4,-1,6647,488949538,1,1,0,1125.08,4,791309.43,18,1,21,1,True
4667706,160,0,20,2158,488949538,1,0,0,1124.66,5,790184.77,24,3,13,2,True
4870435,156,4,25,2158,488949538,1,0,0,1124.97,8,789059.8,18,1,0,2,True
5247178,156,4,30,2063,488949538,1,0,0,1125.0,8,787934.8,18,2,4,3,True
5526452,670,0,20,6249,488949538,1,0,0,1124.78,3,786810.02,18,4,10,3,True
5725789,512,0,451,3180,488949538,1,0,0,1124.9,7,785685.12,12,4,15,3,True
5834143,104,4,451,5305,488949538,1,0,0,1125.0,7,784560.12,3,0,1,4,True
5840416,512,0,451,1949,488949538,1,0,0,1124.89,7,783435.23,12,0,10,4,False
6086051,104,4,451,6249,488949538,1,0,0,1124.83,7,782310.4,3,5,11,5,True
6298182,156,4,451,5305,488949538,1,0,0,1125.11,7,781185.29,18,1,3,5,True
6595442,156,4,30,8441,488949538,1,0,0,1124.94,8,780060.35,18,3,0,6,True
6797993,104,4,451,1903,488949538,1,0,0,1125.16,7,778935.19,3,1,4,6,True
7125586,1364,0,10,6249,488949538,1,0,0,1124.84,6,780060.03,16,2,23,8,True
7156751,806,1,10,1949,488949538,1,0,0,1125.2,6,781185.23,11,4,7,10,True
7302525,512,0,451,4668,488949538,1,0,0,1125.14,7,780060.09,12,5,17,10,True
7313414,104,4,451,2063,488949538,1,0,0,1125.12,7,778934.97,3,4,20,11,True
7625076,104,4,-1,8702,488949538,1,1,0,1124.99,4,778934.97,3,6,0,11,True
7664300,104,4,30,2063,488949538,1,0,0,1125.0,8,777809.97,3,4,19,2,False
7892319,228,0,10,1268,488949538,1,0,0,1125.06,6,778935.03,26,6,16,3,True
7900963,512,0,25,4668,488949538,1,0,0,1124.79,8,777810.24,12,5,14,3,True
7927875,199,0,451,7378,488949538,1,0,0,1124.92,7,776685.32,18,6,11,3,True
8179917,1175,2,20,6647,488949538,1,0,0,1125.01,3,775560.31,24,4,15,4,True
8283520,1217,0,20,1903,488949538,1,0,0,1125.13,3,774435.18,24,6,22,4,True
8283822,156,4,30,2149,488949538,1,0,0,1124.8,8,773310.38,18,0,6,5,True
8659382,98,0,20,8045,488949538,1,0,0,1124.81,5,772185.57,3,1,16,5,True
8861671,199,0,25,6426,488949538,1,0,0,1124.85,8,771060.72,18,1,6,6,True
9226818,156,4,451,7378,488949538,1,0,0,1124.91,7,769935.81,18,3,20,7,True
9443715,199,0,30,2063,488949538,1,0,0,1124.97,8,768810.84,18,6,9,7,True
9542090,104,4,30,3180,488949538,1,0,0,1125.08,8,767685.76,3,0,21,9,True
9617395,869,2,20,1268,488949538,1,0,0,1124.94,5,766560.82,24,2,2,10,True
9640649,199,0,-1,9464,488949538,1,1,0,1125.01,4,766560.82,18,1,4,10,True
9664383,199,0,451,6227,488949538,1,0,0,1125.02,7,765435.8,18,3,6,11,True
9674650,104,4,451,2418,488949538,1,0,0,1124.96,7,764310.84,3,4,21,11,True
9976314,1389,4,451,8702,488949538,1,0,0,1124.84,7,763186.0,24,4,9,11,True
1062580,1387,1,10,2370,550056777,1,0,0,209.96,0,230701.96,24,2,13,1,True
1426295,1232,1,-1,4778,550056777,1,1,0,210.01,4,230701.96,18,5,2,1,True
1463582,1134,1,10,2370,550056777,1,0,0,210.3,6,230912.26,24,1,19,2,True
1699352,524,1,451,7631,550056777,1,0,0,209.91,7,230702.35,18,1,23,2,True
1820143,1088,4,30,4778,550056777,1,0,0,210.02,8,230492.33,18,2,21,2,True
1876698,630,0,10,5039,550056777,1,0,0,210.16,6,230702.49,11,5,19,2,True
2049476,873,4,25,5039,550056777,1,0,0,209.95,8,230492.54,24,4,0,3,True
2183765,883,0,20,2148,550056777,1,0,0,210.09,3,230282.45,24,0,22,3,True
2468628,873,4,30,6831,550056777,1,0,0,210.02,8,230072.43,24,4,1,3,True
2559374,524,1,30,2148,550056777,1,0,0,210.13,8,229862.3,18,6,8,5,True
2767887,182,1,451,4778,550056777,1,0,0,209.97,7,229652.33,18,0,12,5,True
2913275,1488,0,10,1370,550056777,1,0,0,209.9,6,229862.23,24,3,21,6,False
2984826,1053,1,10,2848,550056777,1,0,0,210.32,6,230072.55,11,3,19,7,True
3116921,1088,4,451,5497,550056777,1,0,0,210.04,7,229862.51,18,4,8,8,True
3124327,945,1,10,2868,550056777,1,0,0,210.12,6,230072.63,24,6,11,8,True
3129146,420,4,451,2148,550056777,1,0,0,209.9,7,229862.73,18,2,10,8,True
3138297,1088,4,-1,2868,550056777,1,1,0,209.74,1,229862.73,18,2,13,9,True
3355162,1232,1,451,2980,550056777,1,0,0,210.02,7,229652.71,18,4,19,10,True
3468574,524,1,25,8397,550056777,1,0,0,209.97,8,229442.74,18,3,2,10,True
3664866,1063,0,10,2868,550056777,1,0,0,210.11,6,229652.85,11,5,19,11,True
3754771,420,4,451,4731,550056777,1,0,0,209.88,7,229442.97,18,3,17,2,True
4012045,1413,0,20,1860,550056777,1,0,0,209.95,5,229233.02,24,1,3,3,True
4118653,873,4,25,8397,550056777,1,0,0,209.9,8,229023.12,24,3,2,3,True
4171335,524,1,30,5039,550056777,1,0,0,209.91,8,228813.21,18,1,9,5,True
4238495,1189,2,-1,6831,550056777,1,1,0,210.07,1,228813.21,24,2,12,5,True
4330006,1319,1,10,8397,550056777,1,0,0,209.86,0,229023.07,18,6,5,5,True
4709223,182,1,451,7443,550056777,1,0,0,210.14,7,228812.93,18,2,23,6,True
4715184,420,4,-1,4778,550056777,1,1,0,209.68,4,228812.93,18,4,14,6,True
5032251,1029,0,10,6744,550056777,1,0,0,209.87,6,229022.8,11,5,8,7,True
5286766,144,1,10,7631,550056777,1,0,0,210.13,6,229232.93,18,1,12,7,True
5566930,873,4,451,2148,550056777,1,0,0,210.04,7,229022.89,24,1,13,8,True
5667734,420,4,-1,1370,550056777,1,1,0,209.92,4,229022.89,18,5,23,8,True
5735969,524,1,25,2848,550056777,1,0,0,210.14,8,228812.75,18,0,5,9,True
5797048,1088,4,451,2148,550056777,1,0,0,209.52,7,228603.23,18,5,11,10,True
5904625,1232,1,25,2370,550056777,1,0,0,210.04,8,228393.19,18,2,14,10,True
5931476,1111,0,20,7443,550056777,1,0,0,210.11,5,228183.08,0,3,21,10,True
6036474,182,1,-1,3563,550056777,1,1,0,209.86,4,228183.08,18,6,3,11,True
6104121,215,0,10,6831,550056777,1,0,0,209.76,6,228392.84,9,0,15,11,True
6661606,1192,2,20,2980,550056777,1,0,0,210.17,5,228182.67,24,3,5,11,True
6673749,1014,1,10,6831,550056777,1,0,0,210.07,6,228392.74,26,0,15,12,True
6966894,1088,4,25,2148,550056777,1,0,0,209.87,8,228182.87,18,6,11,12,True
7160683,269,0,20,7631,550056777,1,0,0,209.82,5,227973.05,24,4,17,1,True
7599222,1232,1,451,2370,550056777,1,0,0,210.09,7,227762.96,18,1,1,1,True
7642737,182,1,30,2848,550056777,1,0,0,209.77,8,227553.19,18,2,7,1,False
7888398,420,4,30,7443,550056777,1,0,0,209.7,8,227343.49,18,6,14,2,True
8170396,1088,4,451,7865,550056777,1,0,0,209.88,7,227133.61,18,1,22,2,True
8235240,1189,2,30,1860,550056777,1,0,0,209.89,8,226923.72,24,1,12,3,True
8239252,524,1,451,7443,550056777,1,0,0,210.1,7,226713.62,18,0,7,4,True
8259369,1232,1,451,3563,550056777,1,0,0,210.09,7,226503.53,18,0,1,5,True
8419787,794,2,20,2148,550056777,1,0,0,210.06,3,226293.47,11,3,8,6,True
8445412,695,2,20,8397,550056777,1,0,0,209.85,5,226083.62,24,5,7,6,True
8549293,53,0,20,7443,550056777,1,0,0,210.25,5,225873.37,20,6,4,6,True
8778182,1088,4,451,7631,550056777,1,0,0,209.86,7,225663.51,18,3,20,7,True
8792402,420,4,30,2868,550056777,1,0,0,209.81,8,225453.7,18,2,5,8,True
8914705,524,1,451,8397,550056777,1,0,0,209.89,7,225243.81,18,1,12,9,True
9164000,873,4,30,5497,550056777,1,0,0,209.98,8,225033.83,24,4,19,9,True
9261440,182,1,30,1860,550056777,1,0,0,209.97,8,224823.86,18,0,18,10,True
9817480,182,1,451,3563,550056777,1,0,0,209.84,7,224614.02,18,4,3,11,True
1182527,474,4,-1,5487,745490357,0,1,0,375.21,1,811208.0,5,0,20,1,True
1448592,218,0,20,3324,745490357,0,0,0,374.98,5,810833.02,9,4,13,5,True
1454252,1455,2,20,5801,745490357,0,0,0,375.14,3,810457.88,11,2,18,7,True
1573338,1114,1,10,8918,745490357,0,0,0,375.03,0,810832.91,0,3,8,7,True
1786582,234,0,30,2167,745490357,0,0,0,375.12,8,810457.79,26,3,21,8,True
2295688,1493,4,30,9150,745490357,0,0,0,374.99,8,810082.8,24,4,1,9,True
2521240,234,0,30,8421,745490357,0,0,0,375.03,8,809707.77,26,3,19,4,True
2739601,177,4,-1,6880,745490357,0,1,0,375.37,4,809707.77,24,6,21,4,True
2797411,297,0,20,8569,745490357,0,0,0,374.8,5,809332.97,4,1,12,8,True
2896051,980,1,451,2167,745490357,0,0,0,374.92,7,808958.05,22,6,20,9,True
2930774,360,0,451,4658,745490357,0,0,0,374.8,7,808583.25,24,4,4,9,True
2990344,366,0,20,3960,745490357,0,0,0,375.14,5,808208.11,25,4,22,12,False
3217075,487,4,451,9729,745490357,0,0,0,374.84,7,807833.27,12,5,3,12,True
3269876,360,0,451,4831,745490357,0,0,0,375.0,7,807458.27,24,5,9,12,True
3301699,916,0,10,7368,745490357,0,0,0,375.05,0,807833.32,18,2,23,12,True
3313027,1246,0,20,7190,745490357,0,0,0,374.9,3,807458.42,23,1,15,2,True
3765246,1198,4,451,6593,745490357,0,0,0,374.75,7,807083.67,24,5,8,3,True
4088992,1219,1,10,2167,745490357,0,0,0,375.16,0,807458.83,24,1,21,4,True
4120191,487,4,30,8421,745490357,0,0,0,374.99,8,807083.84,12,0,22,4,True
4356391,132,2,20,5801,745490357,0,0,0,374.69,5,806709.15,18,0,7,7,True
4695151,980,1,30,9618,745490357,0,0,0,375.03,8,806334.12,22,2,14,9,True
4859032,177,4,-1,8199,745490357,0,1,0,375.12,4,806334.12,24,1,6,10,True
4863868,177,4,-1,7190,745490357,0,2,0,374.94,1,806334.12,24,4,8,10,True
5102640,1493,4,-1,9329,745490357,0,3,1,375.26,4,0.0,24,2,11,10,True
1015115,927,4,30,2191,402911113,0,0,0,290.96,8,229446.04,18,6,18,1,True
1166429,328,0,451,5754,402911113,0,0,0,290.99,7,229155.05,11,5,7,2,True
1371285,1336,2,30,9021,402911113,0,0,0,290.82,8,228864.23,18,1,15,3,True
1897328,328,0,30,6909,402911113,0,0,0,291.06,8,228573.17,11,4,22,3,True
1959412,1277,2,451,3886,402911113,0,0,0,291.03,7,228282.14,24,0,5,4,True
2339578,328,0,25,6909,402911113,0,0,0,291.11,8,227991.03,11,2,13,5,True
2584714,1262,0,10,7472,402911113,0,0,0,291.14,6,228282.17,23,3,15,5,True
2651028,369,1,10,4875,402911113,0,0,0,291.21,6,228573.38,25,6,8,7,True
3115546,857,1,-1,4100,402911113,0,1,0,290.91,4,228573.38,24,0,23,8,True
3233276,1336,2,451,4875,402911113,0,0,0,291.02,7,228282.36,18,0,7,8,True
3234666,857,1,30,5085,402911113,0,0,0,290.97,8,227991.39,24,5,13,9,True
3253965,865,0,20,7472,402911113,0,0,0,290.91,5,227700.48,24,0,9,10,True
3653465,115,2,20,4875,402911113,0,0,0,291.18,5,227409.3,3,3,6,10,True
3815417,1277,2,451,5152,402911113,0,0,0,291.2,7,227118.1,24,4,9,10,True
3844819,857,1,30,6909,402911113,0,0,0,291.09,8,226827.01,24,5,4,10,True
4053604,1314,2,20,5754,402911113,0,0,0,291.19,3,226535.82,5,3,8,12,True
4116690,927,4,451,9221,402911113,0,0,0,290.81,7,226245.01,18,5,9,12,True
4132340,857,1,30,4100,402911113,0,0,0,291.11,8,225953.9,24,1,11,1,True
4143305,927,4,30,3549,402911113,0,0,0,291.17,8,225662.73,18,3,11,2,True
4686421,857,1,25,5771,402911113,0,0,0,290.78,8,225371.95,24,3,12,3,True
4834129,857,1,-1,9650,402911113,0,1,0,291.18,4,225371.95,24,6,11,4,True
4895443,1262,0,20,2191,402911113,0,0,0,290.89,5,225081.06,23,1,17,4,True
5167423,1336,2,451,2462,402911113,0,0,0,291.06,7,224790.0,18,1,7,5,True
5271130,328,0,25,6909,402911113,0,0,0,291.21,8,224498.79,11,5,7,5,True
5412101,325,0,10,2191,402911113,0,0,0,290.9,6,224789.69,11,1,2,6,True
5540203,1277,2,30,4100,402911113,0,0,0,290.59,8,224499.1,24,6,22,7,True
5575230,857,1,25,7472,402911113,0,0,0,290.95,8,224208.15,24,4,21,7,True
5705173,857,1,25,3886,402911113,0,0,0,291.17,8,223916.98,24,2,1,8,True
5898245,871,0,10,4875,402911113,0,0,0,290.82,0,224207.8,24,4,19,8,True
6005122,927,4,-1,5085,402911113,0,1,0,290.88,1,224207.8,18,6,11,10,True
6316349,328,0,25,3549,402911113,0,0,0,290.9,8,223916.9,11,2,6,10,True
6511839,59,0,20,5085,402911113,0,0,0,290.9,3,223626.0,20,4,14,11,True
6683297,927,4,25,3886,402911113,0,0,0,291.26,8,223334.74,18,4,23,12,True
6760593,328,0,30,2191,402911113,0,0,0,291.03,8,223043.71,11,1,6,12,True
6996977,927,4,25,9650,402911113,0,0,0,291.16,8,222752.55,18,1,5,12,True
7088458,857,1,30,6909,402911113,0,0,0,290.89,8,222461.66,24,6,8,1,True
7169054,857,1,25,2722,402911113,0,0,0,290.95,8,222170.71,24,3,0,1,True
7305142,81,0,10,3549,402911113,0,0,0,290.89,6,222461.6,1,4,20,2,True
7621831,694,2,20,2191,402911113,0,0,0,291.25,5,222170.35,24,5,12,2,True
7838530,1336,2,451,9221,402911113,0,0,0,290.94,7,221879.41,18,6,5,3,True
8098617,328,0,451,8105,402911113,0,0,0,291.16,7,221588.25,11,2,4,4,True
8116224,399,2,20,9650,402911113,0,0,0,291.07,5,221297.18,10,3,16,4,True
8176368,927,4,451,2722,402911113,0,0,0,290.96,7,221006.22,18,2,23,5,True
8253825,998,0,20,2191,402911113,0,0,0,291.08,3,220715.14,26,4,18,5,True
8291631,1336,2,451,9021,402911113,0,0,0,291.35,7,220423.79,18,3,0,5,True
8305454,857,1,30,5085,402911113,0,0,0,291.32,8,220132.47,24,5,16,5,True
8465074,328,0,451,5771,402911113,0,0,0,290.92,7,219841.55,11,5,19,5,True
8824529,1277,2,-1,6402,402911113,0,1,0,291.04,4,219841.55,24,2,14,6,True
8879146,927,4,30,5152,402911113,0,0,0,290.89,8,219550.66,18,3,12,6,True
8900543,1277,2,30,7472,402911113,0,0,0,290.87,8,219259.79,24,1,11,7,True
8918390,1277,2,-1,7472,402911113,0,1,0,291.04,4,219259.79,24,3,17,7,True
9270082,927,4,451,4100,402911113,0,0,0,291.12,7,218968.67,18,3,1,7,True
9512130,927,4,-1,5771,402911113,0,1,0,290.75,4,218968.67,18,0,6,9,True
9527785,1277,2,25,2462,402911113,0,0,0,290.54,8,218678.13,24,3,14,9,True
9703734,328,0,451,9650,402911113,0,0,0,290.9,7,218387.23,11,4,13,9,True
9718885,857,1,25,5152,402911113,0,0,0,291.05,8,218096.18,24,4,7,11,True
9777133,1336,2,30,9650,402911113,0,0,0,291.07,8,217805.11,18,0,14,11,True
9977203,857,1,30,4100,402911113,0,0,0,290.87,8,217514.24,24,3,6,11,True
1075613,115,2,25,6951,308944062,1,0,0,525.83,8,921418.17,3,4,11,2,True
1160294,108,2,20,3963,308944062,1,0,0,525.93,3,920892.24,3,0,5,12,True
1597180,1439,4,30,2483,308944062,1,0,0,525.98,8,920366.26,24,5,14,7,True
1709854,115,2,451,6398,308944062,1,0,0,525.9,7,919840.36,3,1,20,10,True
1879081,366,0,10,6398,308944062,1,0,0,526.31,6,920366.67,25,1,8,10,True
1955343,1012,0,10,1813,308944062,1,0,0,525.89,6,920892.56,26,1,18,1,True
2141653,765,4,-1,6030,308944062,1,1,0,526.12,4,920892.56,14,1,18,2,True
2371786,39,3,-1,3874,308944062,1,2,0,526.19,4,920892.56,11,3,2,7,True
2655967,765,4,-1,2648,308944062,1,3,1,525.78,1,920892.56,14,1,12,8,True
1002162,1146,2,30,2148,123100439,1,0,0,343.05,8,854451.95,15,4,1,1,True
1014316,1181,2,30,7966,123100439,1,0,0,343.08,8,854108.87,24,5,15,1,True
1183201,1146,2,451,7966,123100439,1,0,0,342.85,7,853766.02,15,0,7,3,True
1191607,1181,2,30,9816,123100439,1,0,0,343.02,8,853423.0,24,2,16,4,True
1204785,1146,2,25,7926,123100439,1,0,0,342.99,8,853080.01,15,6,23,4,True
1302975,151,4,25,5766,123100439,1,0,0,343.3,8,852736.71,18,3,17,5,True
1507181,151,4,30,7966,123100439,1,0,0,343.14,8,852393.57,18,1,1,7,True
1550417,40,4,25,7620,123100439,1,0,0,343.06,8,852050.51,11,0,5,9,True
1738363,1319,1,451,4748,123100439,1,0,0,343.09,7,851707.42,18,0,15,10,True
1860830,1146,2,451,5456,123100439,1,0,0,343.1,7,851364.32,15,6,23,11,True
1887153,1319,1,30,2148,123100439,1,0,0,343.31,8,851021.01,18,6,18,12,True
1935185,1164,0,10,2606,123100439,1,0,0,343.13,6,851364.14,24,6,13,12,True
2096754,40,4,25,1271,123100439,1,0,0,343.22,8,851020.92,11,3,14,12,True
2276122,1319,1,-1,4276,123100439,1,1,0,343.01,4,851020.92,18,6,23,2,True
2409555,276,0,10,7620,123100439,1,0,0,343.01,6,851363.93,24,4,9,2,True
2463852,40,4,451,9816,123100439,1,0,0,343.05,7,851020.88,11,6,10,5,True
2613698,1082,3,25,6044,123100439,1,0,0,343.19,8,850677.69,18,1,7,5,True
2712798,40,4,30,1271,123100439,1,0,0,342.69,8,850335.0,11,4,6,5,True
2854412,1082,3,451,2148,123100439,1,0,0,342.99,7,849992.01,18,1,13,5,True
2876263,1146,2,451,1271,123100439,1,0,0,342.91,7,849649.1,15,5,5,6,True
3516580,1146,2,451,4276,123100439,1,0,0,343.0,7,849306.1,15,0,14,6,True
4099858,151,4,-1,7926,123100439,1,1,0,343.0,4,849306.1,18,0,9,7,True
4114364,151,4,30,2148,123100439,1,0,0,343.03,8,848963.07,18,2,19,8,True
4136060,1146,2,451,2606,123100439,1,0,0,342.92,7,848620.15,15,3,6,8,True
4404129,1319,1,451,7620,123100439,1,0,0,343.02,7,848277.13,18,3,20,8,False
4441707,151,4,451,1859,123100439,1,0,0,343.11,7,847934.02,18,6,1,8,True
4654795,537,0,20,7620,123100439,1,0,0,343.19,3,847590.83,18,6,17,9,True
4682334,1012,0,10,4527,123100439,1,0,0,342.88,6,847933.71,26,2,10,9,True
4881596,664,2,20,6044,123100439,1,0,0,343.26,5,847590.45,18,3,4,10,True
5055756,857,1,10,7966,123100439,1,0,0,342.97,6,847933.42,24,4,8,10,True
5371510,168,0,10,1721,123100439,1,0,0,343.03,6,848276.45,24,3,2,10,True
5532984,1205,0,25,1859,123100439,1,0,0,343.2,8,847933.25,24,2,23,11,True
5669636,1205,0,25,9816,123100439,1,0,0,342.91,8,847590.34,24,0,5,11,True
6026150,40,4,30,5456,123100439,1,0,0,342.96,8,847247.38,11,5,19,11,True
6847984,40,4,25,9816,123100439,1,0,0,342.9,8,846904.48,11,4,20,1,True
7144390,1205,0,451,6444,123100439,1,0,0,342.9,7,846561.58,24,0,16,1,True
7171647,40,4,30,1721,123100439,1,0,0,342.96,8,846218.62,11,6,6,1,True
7593146,1181,2,451,2148,123100439,1,0,0,343.14,7,845875.48,24,5,20,3,True
8171528,1219,1,10,1859,123100439,1,0,0,342.84,6,846218.32,24,2,9,4,True
8263543,687,0,20,2148,123100439,1,0,0,343.05,5,845875.27,24,4,16,5,True
8401920,1319,1,451,9816,123100439,1,0,0,342.95,7,845532.32,18,1,16,6,False
8740751,1082,3,25,2606,123100439,1,0,0,342.71,8,845189.61,18,1,22,6,True
8858194,1319,1,25,3032,123100439,1,0,0,343.1,8,844846.51,18,1,13,6,False
8894254,1205,0,451,6444,123100439,1,0,0,343.0,7,844503.51,24,0,21,6,True
8984061,1082,3,451,4748,123100439,1,0,0,342.7,7,844160.81,18,4,22,7,True
9020265,1181,2,30,7926,123100439,1,0,0,343.02,8,843817.79,24,5,18,7,True
9383192,1082,3,-1,1271,123100439,1,1,0,343.13,4,843817.79,18,0,16,7,True
9664254,1181,2,451,1271,123100439,1,0,0,342.92,7,843474.87,24,2,14,8,True
9788242,53,0,20,6044,123100439,1,0,0,342.87,5,843132.0,20,3,22,8,False
9826662,151,4,451,6444,123100439,1,0,0,343.06,7,842788.94,18,5,3,10,True
9848449,1181,2,451,5456,123100439,1,0,0,342.79,7,842446.15,24,4,8,10,True
9946789,349,2,20,6044,123100439,1,0,0,342.8,3,842103.35,24,6,19,11,True
1163845,480,0,-1,8297,856444864,0,1,0,360.08,4,247095.0,5,1,12,2,True
1185741,865,0,25,7665,856444864,0,0,0,359.61,8,246735.39,24,2,16,3,True
1482492,187,4,-1,5960,856444864,0,1,0,360.17,4,246735.39,18,1,3,3,True
1701142,399,2,30,7226,856444864,0,0,0,359.83,8,246375.56,10,6,14,4,True
1865467,562,1,10,7226,856444864,0,0,0,359.92,0,246735.48,17,4,2,4,True
1928187,1164,0,10,2449,856444864,0,0,0,359.87,6,247095.35,24,6,15,4,True
2300574,907,0,20,4420,856444864,0,0,0,360.11,5,246735.24,2,3,20,5,True
2561317,480,0,30,4120,856444864,0,0,0,360.12,8,246375.12,5,1,2,6,True
2575541,1191,4,30,4595,856444864,0,0,0,359.75,8,246015.37,24,5,19,6,True
2918496,766,4,-1,4404,856444864,0,1,0,360.16,1,246015.37,14,5,1,6,True
2983059,736,1,30,7573,856444864,0,0,0,360.09,8,245655.28,11,1,4,6,True
3148998,1390,0,20,4067,856444864,0,0,0,359.92,5,245295.36,24,0,19,7,True
3215478,1401,1,10,4420,856444864,0,0,0,360.15,6,245655.51,24,3,20,7,True
3300575,399,2,30,4404,856444864,0,0,0,360.15,8,245295.36,10,6,4,10,True
3565082,865,0,25,6706,856444864,0,0,0,359.89,8,244935.47,24,6,19,10,True
3981124,865,0,30,4067,856444864,0,0,0,360.05,8,244575.42,24,5,17,11,True
4270259,736,1,-1,4067,856444864,0,1,0,359.97,4,244575.42,11,3,7,11,True
4413848,399,2,30,8297,856444864,0,0,0,359.98,8,244215.44,10,5,7,11,True
4557819,1191,4,-1,4067,856444864,0,1,0,359.89,4,244215.44,24,0,9,12,True
4632292,791,3,25,5960,856444864,0,0,0,359.96,8,243855.48,11,3,2,12,True
4719022,367,1,10,2449,856444864,0,0,0,359.88,6,244215.36,25,0,11,1,True
5095181,736,1,451,4595,856444864,0,0,0,359.83,7,243855.53,11,2,17,3,True
5119424,399,2,451,9745,856444864,0,0,0,360.06,7,243495.47,10,5,8,3,True
5305549,736,1,-1,6706,856444864,0,1,0,360.01,4,243495.47,11,6,5,4,True
5341716,865,0,25,5960,856444864,0,0,0,360.06,8,243135.41,24,6,10,4,True
5345896,736,1,30,4067,856444864,0,0,0,359.77,8,242775.64,11,3,13,7,True
5433424,350,0,30,4120,856444864,0,0,0,360.28,8,242415.36,24,0,2,8,True
5616290,1052,0,20,5960,856444864,0,0,0,360.25,5,242055.11,11,3,17,8,True
5655708,980,1,10,4067,856444864,0,0,0,360.2,6,242415.31,22,5,19,8,True
5656260,766,4,-1,9745,856444864,0,1,0,360.03,4,242415.31,14,6,23,8,True
5966039,728,1,10,7573,856444864,0,0,0,359.88,6,242775.19,11,3,17,8,True
6102089,1191,4,-1,4595,856444864,0,1,0,359.85,4,242775.19,24,1,2,9,True
6113341,187,4,451,4120,856444864,0,0,0,359.78,7,242415.41,18,4,10,10,True
6402414,1191,4,451,4420,856444864,0,0,0,359.87,7,242055.54,24,4,0,11,True
6588352,726,0,20,8297,856444864,0,0,0,360.12,5,241695.42,11,1,1,11,True
6658204,399,2,451,2449,856444864,0,0,0,359.99,7,241335.43,10,0,6,12,True
6690711,791,3,30,2327,856444864,0,0,0,359.81,8,240975.62,11,3,0,12,False
6976776,1421,0,10,8395,856444864,0,0,0,359.93,0,241335.55,24,4,19,12,True
7009983,736,1,30,5960,856444864,0,0,0,360.06,8,240975.49,11,2,16,1,True
7107413,882,0,20,5960,856444864,0,0,0,360.05,3,240615.44,27,4,23,2,True
7116418,865,0,30,8297,856444864,0,0,0,360.24,8,240255.2,24,0,12,3,True
7174287,812,0,20,4067,856444864,0,0,0,360.01,5,239895.19,18,6,13,3,True
7347070,187,4,-1,4420,856444864,0,1,0,359.92,4,239895.19,18,5,2,3,True
7452775,865,0,30,4404,856444864,0,0,0,360.05,8,239535.14,24,1,16,4,True
7741922,865,0,-1,8297,856444864,0,1,0,359.99,4,239535.14,24,2,7,4,True
7774886,736,1,451,2327,856444864,0,0,0,360.26,7,239174.88,11,6,11,4,True
7853246,898,1,10,2449,856444864,0,0,0,360.15,6,239535.03,24,0,0,4,True
7877450,480,0,25,8395,856444864,0,0,0,359.97,8,239175.06,5,5,0,5,True
8054687,1191,4,451,6706,856444864,0,0,0,359.71,7,238815.35,24,0,0,6,True
8353568,727,0,20,6706,856444864,0,0,0,360.04,3,238455.31,11,5,1,6,True
8544085,865,0,30,8395,856444864,0,0,0,359.97,8,238095.34,24,3,6,7,True
9129707,1053,1,10,2327,856444864,0,0,0,359.94,6,238455.28,11,3,20,8,True
9239351,350,0,451,8395,856444864,0,0,0,360.13,7,238095.15,24,6,21,8,True
9243430,480,0,451,2327,856444864,0,0,0,360.04,7,237735.11,5,0,1,8,True
9354084,736,1,-1,4404,856444864,0,1,0,360.12,4,237735.11,11,5,12,8,True
9618250,480,0,451,7665,856444864,0,0,0,359.81,7,237375.3,5,6,17,9,True
9691271,187,4,25,8395,856444864,0,0,0,360.04,8,237015.26,18,1,3,10,False
9799203,480,0,-1,8297,856444864,0,1,0,359.93,1,237015.26,5,4,5,10,True
9941584,399,2,451,2327,856444864,0,0,0,360.27,7,236654.99,10,2,16,11,True
1002548,220,0,25,7069,383363365,1,0,0,965.34,8,396618.66,26,1,3,1,True
1210415,1431,4,451,5896,383363365,1,0,0,965.05,7,395653.61,24,4,7,1,True
1362838,1431,4,25,7253,383363365,1,0,0,964.84,8,394688.77,24,0,19,2,True
1787088,220,0,-1,3613,383363365,1,1,0,965.03,4,394688.77,26,4,15,2,True
2061252,834,0,30,2678,383363365,1,0,0,964.96,8,393723.81,5,5,9,4,True
2197682,220,0,30,1079,383363365,1,0,0,964.96,8,392758.85,26,0,13,6,True
2614094,685,3,-1,8567,383363365,1,1,0,964.92,1,392758.85,24,4,11,7,True
2632425,525,0,25,1376,383363365,1,0,0,964.99,8,391793.86,18,4,1,7,True
2662425,194,1,10,5805,383363365,1,0,0,965.08,6,392758.94,18,6,20,7,True
2685487,1431,4,25,1653,383363365,1,0,0,964.92,8,391794.02,24,1,5,8,True
2858959,204,0,20,2048,383363365,1,0,0,965.03,3,390828.99,9,4,8,8,True
2970303,1431,4,451,5523,383363365,1,0,0,964.79,7,389864.2,24,0,6,8,True
3099412,834,0,-1,8256,383363365,1,1,0,965.1,1,389864.2,5,5,5,9,True
3222848,621,2,20,5896,383363365,1,0,0,964.77,5,388899.43,11,5,11,10,True
3274499,1162,2,20,2114,383363365,1,0,0,964.94,5,387934.49,24,3,23,11,True
3363632,220,0,30,2048,383363365,1,0,0,965.02,8,386969.47,26,6,11,11,True
3403006,1112,1,10,1653,383363365,1,0,0,964.96,6,387934.43,0,2,11,12,True
3435981,834,0,30,9326,383363365,1,0,0,965.05,8,386969.38,5,1,18,12,True
3874646,1431,4,451,8256,383363365,1,0,0,964.88,7,386004.5,24,5,4,1,True
4529302,834,0,25,3710,383363365,1,0,0,964.82,8,385039.68,5,6,17,1,False
4780762,1255,0,20,7501,383363365,1,0,0,965.04,3,384074.64,23,5,13,2,True
4906579,685,3,451,5523,383363365,1,0,0,964.83,7,383109.81,24,1,8,2,True
4987117,1431,4,25,4960,383363365,1,0,0,964.84,8,382144.97,24,6,8,2,True
5076130,685,3,30,2114,383363365,1,0,0,964.74,8,381180.23,24,1,6,4,True
5578270,850,1,10,1376,383363365,1,0,0,964.95,6,382145.18,5,4,1,6,True
5597089,220,0,451,1376,383363365,1,0,0,965.03,7,381180.15,26,6,6,7,True
6050349,220,0,30,8844,383363365,1,0,0,964.99,8,380215.16,26,5,20,8,True
6113798,525,0,30,7069,383363365,1,0,0,964.95,8,379250.21,18,6,20,10,True
6200442,1431,4,25,2048,383363365,1,0,0,965.01,8,378285.2,24,0,16,10,False
6258071,220,0,451,6090,383363365,1,0,0,965.0,7,377320.2,26,0,23,10,True
6293829,708,2,20,1653,383363365,1,0,0,965.03,5,376355.17,18,0,10,11,True
6478128,685,3,-1,2678,383363365,1,1,0,965.17,1,376355.17,24,5,12,12,True
6493265,220,0,25,3098,383363365,1,0,0,965.14,8,375390.03,26,5,10,12,True
6587858,525,0,25,7501,383363365,1,0,0,965.13,8,374424.9,18,3,22,12,True
6669189,220,0,451,7069,383363365,1,0,0,964.95,7,373459.95,26,5,0,1,True
6756249,685,3,451,1376,383363365,1,0,0,964.84,7,372495.11,24,0,4,1,True
6792859,525,0,451,2043,383363365,1,0,0,965.04,7,371530.07,18,0,5,1,True
6897151,525,0,30,7501,383363365,1,0,0,965.1,8,370564.97,18,6,5,2,False
6918787,1431,4,451,2396,383363365,1,0,0,965.04,7,369599.93,24,5,8,2,True
6946267,220,0,451,2114,383363365,1,0,0,964.92,7,368635.01,26,3,2,3,True
6952215,525,0,30,7501,383363365,1,0,0,964.7,8,367670.31,18,6,15,4,False
7094821,834,0,-1,5805,383363365,1,1,0,964.9,4,367670.31,5,1,11,5,True
7792266,220,0,-1,5805,383363365,1,2,0,965.01,4,367670.31,26,2,13,6,True
8190048,685,3,451,7501,383363365,1,0,0,964.96,7,366705.35,24,6,11,7,True
8242708,917,0,10,2048,383363365,1,0,0,965.13,6,367670.48,18,2,0,7,True
8304820,1272,0,20,6090,383363365,1,0,0,965.03,3,366705.45,24,6,5,8,True
8439906,220,0,25,8783,383363365,1,0,0,965.23,8,365740.22,26,6,1,9,True
8526866,525,0,451,2396,383363365,1,0,0,965.06,7,364775.16,18,6,6,9,True
8595278,1431,4,451,5805,383363365,1,0,0,965.06,7,363810.1,24,5,11,9,True
8843247,685,3,30,2396,383363365,1,0,0,964.88,8,362845.22,24,3,14,10,True
8907118,1123,2,20,7069,383363365,1,0,0,964.79,3,361880.43,24,5,11,10,True
8909346,834,0,25,6090,383363365,1,0,0,965.03,8,360915.4,5,3,16,10,True
9060299,525,0,25,1376,383363365,1,0,0,964.9,8,359950.5,18,2,22,10,True
9327263,1431,4,25,7501,383363365,1,0,0,965.08,8,358985.42,24,6,9,10,True
9595242,996,0,20,3098,383363365,1,0,0,965.12,3,358020.3,26,5,20,11,True
9739846,220,0,-1,3710,383363365,1,1,0,964.79,4,358020.3,26,2,2,11,True
1102310,993,0,-1,3930,431847786,1,1,0,1128.12,4,818849.0,22,0,5,1,True
1122941,531,0,30,5553,431847786,1,0,0,1127.83,8,817721.17,18,2,17,2,True
1430224,20,0,10,5530,431847786,1,0,0,1128.06,0,818849.23,24,1,6,2,True
1497697,1273,0,20,5997,431847786,1,0,0,1127.92,3,817721.31,24,2,1,5,True
1574427,651,4,30,7142,431847786,1,0,0,1127.96,8,816593.35,24,4,22,5,True
1609512,1119,0,25,3930,431847786,1,0,0,1128.01,8,815465.34,24,0,20,5,True
1728413,993,0,25,5997,431847786,1,0,0,1127.98,8,814337.36,22,3,17,6,True
1779538,993,0,451,1960,431847786,1,0,0,1127.94,7,813209.42,22,5,21,7,True
2126772,531,0,30,7041,431847786,1,0,0,1127.85,8,812081.57,18,5,22,8,True
2718670,424,1,10,7993,431847786,1,0,0,1128.17,6,813209.74,18,6,21,9,True
2927801,535,0,10,2066,431847786,1,0,0,1127.95,6,814337.69,18,4,7,9,True
3062215,651,4,25,9906,431847786,1,0,0,1128.09,8,813209.6,24,4,14,9,True
3297636,238,0,-1,7993,431847786,1,1,0,1128.18,4,813209.6,26,3,7,9,True
3451814,1429,0,20,5997,431847786,1,0,0,1127.86,5,812081.74,24,5,22,10,True
3491601,651,4,25,7041,431847786,1,0,0,1128.07,8,810953.67,24,4,21,12,True
3547784,195,1,-1,9906,431847786,1,1,0,1128.23,4,810953.67,18,1,19,3,True
3578359,238,0,25,7041,431847786,1,0,0,1127.92,8,809825.75,26,3,4,5,True
3759704,503,0,30,2766,431847786,1,0,0,1128.09,8,808697.66,12,4,1,5,True
3801938,238,0,451,2766,431847786,1,0,0,1128.03,7,807569.63,26,5,11,5,True
3814331,993,0,451,8651,431847786,1,0,0,1127.88,7,806441.75,22,6,21,5,True
4044876,195,1,451,5965,431847786,1,0,0,1127.88,7,805313.87,18,0,8,6,True
4293807,443,2,30,5997,431847786,1,0,0,1128.04,8,804185.83,24,2,17,7,True
4490316,651,4,30,5997,431847786,1,0,0,1128.12,8,803057.71,24,5,13,8,True
4620703,443,2,-1,2066,431847786,1,1,0,1127.95,1,803057.71,24,0,19,8,True
4793503,651,4,-1,7041,431847786,1,2,0,1128.08,4,803057.71,24,6,3,9,True
5006541,531,0,30,7142,431847786,1,0,0,1127.94,8,801929.77,18,4,3,9,True
5015071,651,4,25,3930,431847786,1,0,0,1127.99,8,800801.78,24,3,9,10,True
5502559,211,0,20,5553,431847786,1,0,0,1128.09,3,799673.69,9,4,7,11,True
5508334,443,2,451,7993,431847786,1,0,0,1127.99,7,798545.7,24,4,12,11,True
5812200,1413,0,10,3930,431847786,1,0,0,1127.97,6,799673.67,24,2,21,11,True
6005536,1155,0,20,5553,431847786,1,0,0,1128.13,5,798545.54,15,3,9,11,True
6051791,909,2,20,7993,431847786,1,0,0,1128.04,5,797417.5,18,6,2,12,True
6352094,1298,0,20,1960,431847786,1,0,0,1127.68,5,796289.82,5,5,16,12,True
6772421,503,0,451,4412,431847786,1,0,0,1127.98,7,795161.84,12,0,11,1,True
6849954,443,2,30,2766,431847786,1,0,0,1128.03,8,794033.81,24,2,8,1,True
6870620,239,1,10,5997,431847786,1,0,0,1128.0,6,795161.81,26,1,18,2,False
6974403,1119,0,25,6499,431847786,1,0,0,1127.75,8,794034.06,24,1,5,2,True
7060663,651,4,25,5530,431847786,1,0,0,1128.06,8,792906.0,24,2,0,2,True
7098744,443,2,-1,2066,431847786,1,1,0,1127.96,4,792906.0,24,3,12,3,False
7271916,195,1,-1,5965,431847786,1,2,0,1128.15,4,792906.0,18,0,2,3,True
7350291,167,2,20,4412,431847786,1,0,0,1127.87,5,791778.13,24,1,2,3,True
7413566,195,1,451,4412,431847786,1,0,0,1127.75,7,790650.38,18,2,23,3,True
7500334,531,0,25,5997,431847786,1,0,0,1127.94,8,789522.44,18,4,0,4,True
7725783,443,2,25,5530,431847786,1,0,0,1128.06,8,788394.38,24,2,4,4,True
7785928,1255,0,10,2766,431847786,1,0,0,1127.93,0,789522.31,23,4,21,4,True
8408183,812,0,10,2766,431847786,1,0,0,1128.21,6,790650.52,18,6,8,4,True
8465158,195,1,30,1960,431847786,1,0,0,1127.99,8,789522.53,18,5,9,6,True
8482240,780,0,10,7142,431847786,1,0,0,1128.17,6,790650.7,14,0,14,6,True
8946259,1119,0,-1,7041,431847786,1,1,0,1127.94,4,790650.7,24,1,23,6,True
8987216,1119,0,-1,4412,431847786,1,2,0,1128.07,4,790650.7,24,4,18,7,False
9251005,993,0,451,1960,431847786,1,0,0,1128.27,7,789522.43,22,6,14,8,True
9258432,238,0,30,1960,431847786,1,0,0,1128.13,8,788394.3,26,5,23,9,True
9717392,503,0,451,6499,431847786,1,0,0,1128.13,7,787266.17,12,3,14,10,True
9767324,651,4,30,2766,431847786,1,0,0,1127.77,8,786138.4,24,3,18,10,True
9918911,204,0,20,7142,431847786,1,0,0,1127.91,5,785010.49,9,2,16,11,True
1018335,358,4,25,9057,861605364,1,0,0,1082.91,8,543714.09,24,0,21,2,True
1043009,579,0,10,3791,861605364,1,0,0,1082.89,6,544796.98,11,1,2,3,True
1146191,851,1,10,3791,861605364,1,0,0,1083.12,6,545880.1,5,0,4,3,True
1277049,1433,4,451,6800,861605364,1,0,0,1083.1,7,544797.0,24,4,15,4,True
1285553,96,0,30,1337,861605364,1,0,0,1083.2,8,543713.8,1,2,15,5,True
1765817,802,2,20,6800,861605364,1,0,0,1083.09,3,542630.71,11,3,21,5,True
2396835,96,0,25,9990,861605364,1,0,0,1083.14,8,541547.57,1,3,22,5,True
2401795,96,0,-1,3791,861605364,1,1,0,1082.92,4,541547.57,1,0,23,5,True
2955127,53,0,10,4316,861605364,1,0,0,1082.69,6,542630.26,20,2,7,6,True
2996677,1428,1,10,6301,861605364,1,0,0,1082.97,0,543713.23,24,0,10,7,True
3318541,96,0,25,6210,861605364,1,0,0,1082.9,8,542630.33,1,2,4,7,True
3434070,558,0,20,6948,861605364,1,0,0,1082.85,5,541547.48,17,0,16,8,True
3606453,358,4,451,3714,861605364,1,0,0,1083.0,7,540464.48,24,3,4,8,True
4108258,1433,4,-1,5413,861605364,1,1,0,1083.01,1,540464.48,24,1,12,8,True
4113329,1433,4,25,6800,861605364,1,0,0,1082.83,8,539381.65,24,5,21,8,True
4270781,358,4,25,6948,861605364,1,0,0,1083.02,8,538298.63,24,2,11,8,True
4911765,1134,1,10,9057,861605364,1,0,0,1082.99,6,539381.62,24,6,20,9,True
5050538,96,0,30,3791,861605364,1,0,0,1083.18,8,538298.44,1,1,15,9,True
5179595,96,0,30,9821,861605364,1,0,0,1082.94,8,537215.5,1,2,2,9,True
5289310,358,4,451,1816,861605364,1,0,0,1082.99,7,536132.51,24,6,11,10,True
5339182,355,1,-1,3791,861605364,1,1,0,1083.04,4,536132.51,24,2,15,11,True
5752570,27,0,-1,3791,861605364,1,2,0,1083.03,4,536132.51,11,3,9,11,True
5760074,358,4,451,6301,861605364,1,0,0,1082.76,7,535049.75,24,5,16,1,True
5790686,1174,3,451,8676,861605364,1,0,0,1082.82,7,533966.93,24,3,1,2,True
5880414,1174,3,25,7319,861605364,1,0,0,1083.09,8,532883.84,24,5,20,2,True
5997200,1433,4,451,5413,861605364,1,0,0,1083.01,7,531800.83,24,0,23,2,True
6098575,970,4,451,1337,861605364,1,0,0,1083.04,7,530717.79,13,6,8,3,True
6100818,1434,0,10,6301,861605364,1,0,0,1082.99,6,531800.78,24,3,21,3,True
6152029,518,2,20,4770,861605364,1,0,0,1083.04,5,530717.74,18,2,4,5,True
6409302,96,0,30,1965,861605364,1,0,0,1082.67,8,529635.07,1,1,22,7,True
6473398,970,4,-1,7319,861605364,1,1,0,1083.08,4,529635.07,13,2,16,8,True
6767035,649,0,20,9821,861605364,1,0,0,1083.14,5,528551.93,24,5,13,8,True
6784850,1238,0,20,5999,861605364,1,0,0,1083.04,5,527468.89,18,2,11,10,True
6861805,1433,4,451,5062,861605364,1,0,0,1083.05,7,526385.84,24,0,15,10,True
7128293,970,4,30,4770,861605364,1,0,0,1083.3,8,525302.54,13,1,21,10,True
7142769,27,0,25,5026,861605364,1,0,0,1082.73,8,524219.81,11,6,0,11,False
7151775,355,1,451,4316,861605364,1,0,0,1083.12,7,523136.69,24,2,20,12,True
7247799,1152,0,10,4864,861605364,1,0,0,1082.83,0,524219.52,15,6,11,12,True
7313671,406,1,10,4316,861605364,1,0,0,1082.86,0,525302.38,10,5,4,12,True
7364476,1433,4,25,8676,861605364,1,0,0,1082.99,8,524219.39,24,1,7,1,True
7442661,96,0,451,6948,861605364,1,0,0,1082.95,7,523136.44,1,2,4,1,False
7454281,27,0,30,5026,861605364,1,0,0,1083.03,8,522053.41,11,6,1,1,True
7594294,970,4,30,1965,861605364,1,0,0,1083.4,8,520970.01,13,2,23,1,True
7684205,96,0,451,4770,861605364,1,0,0,1083.13,7,519886.88,1,2,15,2,True
7947603,358,4,451,6210,861605364,1,0,0,1083.0,7,518803.88,24,5,22,2,True
8362621,970,4,451,7319,861605364,1,0,0,1083.06,7,517720.82,13,1,8,2,True
8468235,96,0,-1,4864,861605364,1,1,0,1083.14,4,517720.82,1,0,11,3,True
8602585,1382,0,20,8676,861605364,1,0,0,1083.0,5,516637.82,16,6,6,3,True
8664762,1433,4,25,6948,861605364,1,0,0,1082.96,8,515554.86,24,0,5,3,True
8764981,27,0,30,9057,861605364,1,0,0,1082.91,8,514471.95,11,0,13,4,True
8817504,96,0,451,4770,861605364,1,0,0,1082.91,7,513389.04,1,6,17,6,True
8946374,355,1,451,9990,861605364,1,0,0,1083.18,7,512305.86,24,4,20,6,False
9029657,1364,0,10,3737,861605364,1,0,0,1083.02,6,513388.88,16,5,19,8,True
9262281,355,1,30,4770,861605364,1,0,0,1082.92,8,512305.96,24,2,13,10,True
9402263,1174,3,30,6948,861605364,1,0,0,1082.99,8,511222.97,24,2,14,10,True
9608221,355,1,25,5413,861605364,1,0,0,1083.11,8,510139.86,24,4,14,10,True
9733400,27,0,451,6210,861605364,1,0,0,1082.86,7,509057.0,11,0,16,10,True
9876179,355,1,25,5026,861605364,1,0,0,1082.91,8,507974.09,24,6,14,10,True
9996886,1433,4,-1,1965,861605364,1,1,0,1082.86,4,507974.09,24,0,11,11,True
1001798,734,0,451,6583,445015583,0,0,0,1139.02,7,641198.98,11,2,10,3,True
1100561,734,0,451,1571,445015583,0,0,0,1138.94,7,640060.04,11,5,7,3,True
1400426,1144,2,20,2096,445015583,0,0,0,1139.05,5,638920.99,15,0,21,4,True
1489630,167,2,30,1401,445015583,0,0,0,1138.99,8,637782.0,24,3,0,4,True
1612995,702,4,451,6583,445015583,0,0,0,1139.3,7,636642.7,18,4,1,4,False
1728344,940,1,30,7563,445015583,0,0,0,1139.36,8,635503.34,24,0,11,4,True
1858000,1289,1,10,9373,445015583,0,0,0,1138.72,0,636642.06,24,4,7,5,True
2006225,1089,0,10,5080,445015583,0,0,0,1139.1,6,637781.16,18,4,19,7,True
2116001,167,2,30,8963,445015583,0,0,0,1138.88,8,636642.28,24,5,11,8,True
2204363,592,4,30,8141,445015583,0,0,0,1138.95,8,635503.33,24,0,9,9,True
2397639,591,0,451,2096,445015583,0,0,0,1139.07,7,634364.26,24,2,3,9,True
2532922,734,0,451,9373,445015583,0,0,0,1139.32,7,633224.94,11,5,7,10,True
2542362,889,0,20,2357,445015583,0,0,0,1138.81,5,632086.13,27,3,10,10,True
2907866,942,0,20,3991,445015583,0,0,0,1139.1,3,630947.03,24,5,6,11,True
2963190,734,0,451,1401,445015583,0,0,0,1138.89,7,629808.14,11,0,18,11,False
3029530,862,4,25,9373,445015583,0,0,0,1138.75,8,628669.39,24,4,11,1,True
3189394,862,4,30,7563,445015583,0,0,0,1138.84,8,627530.55,24,5,5,4,True
3296762,882,0,20,2520,445015583,0,0,0,1139.16,5,626391.39,27,0,5,5,True
3381216,167,2,451,5260,445015583,0,0,0,1138.9,7,625252.49,24,6,11,5,True
3678171,840,3,451,4829,445015583,0,0,0,1139.14,7,624113.35,5,5,16,6,True
3824726,940,1,25,2096,445015583,0,0,0,1138.99,8,622974.36,24,2,3,7,True
4128841,1087,4,-1,8963,445015583,0,1,0,1138.91,4,622974.36,18,1,11,8,True
4349439,840,3,451,8963,445015583,0,0,0,1139.19,7,621835.17,5,1,3,9,True
4647549,531,0,20,2520,445015583,0,0,0,1139.02,5,620696.15,18,4,21,10,False
4722061,167,2,30,5260,445015583,0,0,0,1138.96,8,619557.19,24,5,1,12,True
4911863,346,0,20,8141,445015583,0,0,0,1139.12,5,618418.07,24,1,5,1,True
5076682,167,2,451,3991,445015583,0,0,0,1139.12,7,617278.95,24,2,20,1,True
5106393,734,0,-1,8297,445015583,0,1,0,1138.98,4,617278.95,11,4,10,2,True
5376014,665,2,20,8963,445015583,0,0,0,1138.98,5,616139.97,18,0,14,2,True
5481360,940,1,451,3991,445015583,0,0,0,1139.04,7,615000.93,24,4,9,2,True
5604911,702,4,25,9373,445015583,0,0,0,1138.99,8,613861.94,18,5,9,4,True
5709676,1087,4,451,6583,445015583,0,0,0,1138.97,7,612722.97,18,3,19,4,True
5771698,1455,2,20,2952,445015583,0,0,0,1138.94,5,611584.03,11,6,18,4,True
5824604,393,1,10,8297,445015583,0,0,0,1139.03,0,612723.06,10,1,13,4,True
5902091,591,0,30,2520,445015583,0,0,0,1139.03,8,611584.03,24,3,23,5,False
6048391,592,4,-1,8141,445015583,0,1,0,1139.1,1,611584.03,24,6,17,9,True
6415784,592,4,-1,8963,445015583,0,2,0,1139.06,4,611584.03,24,5,9,11,True
6844087,591,0,-1,2096,445015583,0,3,1,1138.71,4,0.0,24,2,18,11,True
1013927,27,0,20,6794,670732003,1,0,0,569.96,5,540705.04,11,1,15,2,True
1279111,734,0,20,6496,670732003,1,0,0,570.1,3,540134.94,11,5,19,2,True
1317331,1243,2,451,1321,670732003,1,0,0,569.83,7,539565.11,18,6,23,2,True
1367715,269,0,20,5243,670732003,1,0,0,569.67,5,538995.44,24,6,8,2,True
1638789,1127,0,20,2797,670732003,1,0,0,570.07,5,538425.37,24,3,10,3,True
1641004,1183,4,25,2109,670732003,1,0,0,570.08,8,537855.29,24,5,18,4,False
1710756,96,0,10,5532,670732003,1,0,0,570.06,0,538425.35,1,6,9,7,True
1795772,370,4,25,8994,670732003,1,0,0,570.09,8,537855.26,25,0,23,7,True
2109218,1485,0,10,4129,670732003,1,0,0,569.91,6,538425.17,24,5,5,8,True
2174998,1116,0,30,6496,670732003,1,0,0,570.09,8,537855.08,24,0,22,9,True
2535136,1243,2,25,3812,670732003,1,0,0,570.07,8,537285.01,18,4,4,10,True
2631817,398,0,10,6322,670732003,1,0,0,569.79,6,537854.8,10,6,11,10,True
3161343,1183,4,-1,2601,670732003,1,1,0,569.99,1,537854.8,24,6,1,10,True
4241104,370,4,-1,9063,670732003,1,2,0,569.8,4,537854.8,25,6,19,10,True
4268474,1116,0,30,6702,670732003,1,0,0,569.83,8,537284.97,24,2,22,12,True
4421610,1183,4,30,4952,670732003,1,0,0,570.29,8,536714.68,24,2,21,2,True
4467808,940,1,10,7623,670732003,1,0,0,569.97,6,537284.65,24,4,3,2,True
4504987,1243,2,25,6829,670732003,1,0,0,570.17,8,536714.48,18,6,8,3,True
4612359,370,4,451,6322,670732003,1,0,0,570.07,7,536144.41,25,4,22,3,True
4705530,1243,2,451,7623,670732003,1,0,0,569.86,7,535574.55,18,6,11,4,True
4758349,1116,0,451,2604,670732003,1,0,0,570.07,7,535004.48,24,1,16,4,True
4933444,1183,4,25,2601,670732003,1,0,0,569.89,8,534434.59,24,2,17,5,True
5177054,1183,4,451,5117,670732003,1,0,0,570.14,7,533864.45,24,3,0,6,True
5849607,1116,0,30,2601,670732003,1,0,0,570.01,8,533294.44,24,3,6,7,True
6085286,1116,0,-1,6715,670732003,1,1,0,569.93,4,533294.44,24,5,13,7,True
6190094,71,1,10,7626,670732003,1,0,0,570.29,6,533864.73,20,6,15,7,True
6203099,1116,0,451,1398,670732003,1,0,0,570.09,7,533294.64,24,3,4,8,True
6484847,1116,0,-1,6322,670732003,1,1,0,569.7,4,533294.64,24,1,8,9,True
6505711,1243,2,451,8711,670732003,1,0,0,570.03,7,532724.61,18,0,19,10,True
7126938,1183,4,30,3812,670732003,1,0,0,570.05,8,532154.56,24,5,22,1,True
7529887,1339,2,30,4129,670732003,1,0,0,570.06,8,531584.5,18,0,20,2,True
7590581,1183,4,30,6715,670732003,1,0,0,569.77,8,531014.73,24,6,18,3,True
7951599,1243,2,451,9210,670732003,1,0,0,569.96,7,530444.77,18,5,21,3,True
8092501,127,1,10,6702,670732003,1,0,0,569.86,6,531014.63,18,6,19,3,True
8446569,370,4,-1,8711,670732003,1,1,0,570.23,1,531014.63,25,1,16,4,True
8506765,1110,0,10,2830,670732003,1,0,0,570.17,0,531584.8,0,4,7,5,True
8609713,1339,2,451,7626,670732003,1,0,0,569.77,7,531015.03,18,3,16,5,True
8734378,1243,2,30,4799,670732003,1,0,0,570.31,8,530444.72,18,0,5,6,True
8757475,1339,2,451,2601,670732003,1,0,0,570.14,7,529874.58,18,4,10,6,True
8810803,149,2,20,6794,670732003,1,0,0,570.32,5,529304.26,18,3,23,6,False
8818181,370,4,451,9044,670732003,1,0,0,570.09,7,528734.17,25,4,16,6,True
8972645,1183,4,25,8711,670732003,1,0,0,569.73,8,528164.44,24,6,10,6,True
8972988,1116,0,451,2830,670732003,1,0,0,570.12,7,527594.32,24,5,0,9,True
9141829,470,1,10,1398,670732003,1,0,0,569.93,6,528164.25,5,6,6,9,True
9269590,29,0,20,7626,670732003,1,0,0,569.98,5,527594.27,11,3,19,9,True
9438543,1183,4,30,7626,670732003,1,0,0,570.02,8,527024.25,24,2,7,10,True
9573828,385,1,10,1398,670732003,1,0,0,569.97,6,527594.22,25,4,17,10,True
9692611,1243,2,-1,2109,670732003,1,1,0,569.99,4,527594.22,18,4,1,11,True
9721277,1380,0,20,6557,670732003,1,0,0,569.84,3,527024.38,16,6,14,11,True
9813669,201,1,10,1321,670732003,1,0,0,570.32,0,527594.7,9,2,23,11,False
1009770,106,4,-1,4200,764369448,0,1,0,1113.1,4,451621.0,3,6,5,1,True
1271948,1189,2,451,1999,764369448,0,0,0,1112.8,7,450508.2,24,1,13,3,True
1504701,95,2,20,5640,764369448,0,0,0,1113.16,5,449395.04,1,6,8,3,True
1514860,712,0,20,1775,764369448,0,0,0,1112.84,5,448282.2,18,3,0,4,True
1591997,1037,0,20,3362,764369448,0,0,0,1112.9,5,447169.3,11,3,9,4,True
1648857,1419,1,10,7763,764369448,0,0,0,1112.84,6,448282.14,24,5,0,4,True
1675517,591,0,30,9256,764369448,0,0,0,1113.03,8,447169.11,24,1,12,5,True
1722425,1352,1,10,5640,764369448,0,0,0,1113.01,6,448282.12,24,1,14,5,True
1813014,1181,2,20,8345,764369448,0,0,0,1113.14,5,447168.98,24,5,2,5,True
2054317,106,4,30,5640,764369448,0,0,0,1112.9,8,446056.08,3,1,22,5,True
2134852,200,0,10,3675,764369448,0,0,0,1112.74,6,447168.82,9,5,8,5,True
2620781,991,1,451,2782,764369448,0,0,0,1113.14,7,446055.68,22,2,18,6,True
2742501,1189,2,451,5476,764369448,0,0,0,1113.3,7,444942.38,24,1,8,7,True
2983882,1075,0,10,5315,764369448,0,0,0,1112.98,6,446055.36,18,2,6,7,True
3268512,507,4,451,5476,764369448,0,0,0,1112.91,7,444942.45,12,6,15,7,True
3302775,192,2,20,7978,764369448,0,0,0,1113.01,5,443829.44,18,6,2,8,True
3448754,507,4,451,9807,764369448,0,0,0,1112.9,7,442716.54,12,1,6,8,True
3962738,570,2,20,2782,764369448,0,0,0,1112.74,3,441603.8,11,0,14,9,True
4008470,130,0,20,2187,764369448,0,0,0,1112.94,5,440490.86,18,1,9,12,True
4041462,106,4,-1,8345,764369448,0,1,0,1113.32,4,440490.86,3,2,14,12,True
4433378,1017,2,20,9665,764369448,0,0,0,1112.9,5,439377.96,26,4,14,1,True
5036396,106,4,30,8788,764369448,0,0,0,1112.81,8,438265.15,3,2,19,3,True
5070501,147,0,451,9256,764369448,0,0,0,1113.08,7,437152.07,18,6,4,4,True
5113006,445,0,20,6438,764369448,0,0,0,1112.94,5,436039.13,13,0,16,4,True
5195931,106,4,-1,7381,764369448,0,1,0,1112.87,1,436039.13,3,3,11,6,True
5626180,147,0,451,7763,764369448,0,0,0,1112.98,7,434926.15,18,0,23,6,True
5941762,509,0,20,6686,764369448,0,0,0,1113.29,5,433812.86,12,6,22,7,True
6007613,1345,2,30,1974,764369448,0,0,0,1112.97,8,432699.89,24,5,3,7,True
6230144,147,0,451,1999,764369448,0,0,0,1112.78,7,431587.11,18,2,20,7,True
6260353,106,4,30,7763,764369448,0,0,0,1113.17,8,430473.94,3,2,23,9,True
6278332,1345,2,451,8076,764369448,0,0,0,1113.0,7,429360.94,24,1,14,10,True
6293186,28,1,30,1775,764369448,0,0,0,1112.97,8,428247.97,11,4,9,10,True
6613793,341,0,10,1583,764369448,0,0,0,1112.91,6,429360.88,24,0,7,11,True
6638840,106,4,451,5679,764369448,0,0,0,1112.92,7,428247.96,3,2,20,12,True
6873491,1345,2,30,8992,764369448,0,0,0,1113.09,8,427134.87,24,4,4,12,True
7017144,507,4,30,4200,764369448,0,0,0,1112.72,8,426022.15,12,3,12,1,True
7106339,106,4,-1,8076,764369448,0,1,0,1113.17,4,426022.15,3,4,1,2,True
8032774,147,0,25,8076,764369448,0,0,0,1112.95,8,424909.2,18,4,4,2,True
8055792,147,0,30,7978,764369448,0,0,0,1113.0,8,423796.2,18,4,23,2,True
8252842,1345,2,30,9422,764369448,0,0,0,1112.86,8,422683.34,24,5,11,3,True
8419985,1345,2,30,7381,764369448,0,0,0,1112.78,8,421570.56,24,4,3,3,True
8493199,542,0,20,8345,764369448,0,0,0,1112.89,5,420457.67,17,6,17,4,True
8772789,28,1,25,6686,764369448,0,0,0,1113.1,8,419344.57,11,5,11,4,True
8894851,106,4,30,9807,764369448,0,0,0,1113.03,8,418231.54,3,1,13,4,True
9075976,106,4,451,8345,764369448,0,0,0,1112.93,7,417118.61,3,5,9,4,True
9112850,507,4,25,6686,764369448,0,0,0,1112.86,8,416005.75,12,2,5,5,True
9166433,512,0,10,5315,764369448,0,0,0,1113.06,6,417118.81,12,4,17,6,True
9284117,591,0,-1,1974,764369448,0,1,0,1113.15,4,417118.81,24,4,4,6,True
9623373,518,2,20,8076,764369448,0,0,0,1113.02,5,416005.79,18,4,5,6,True
9913475,991,1,-1,9256,764369448,0,1,0,1113.02,4,416005.79,22,0,4,7,True
9975525,147,0,451,6438,764369448,0,0,0,1112.78,7,414893.01,18,1,10,8,True
9994867,1476,0,20,6438,764369448,0,0,0,1112.82,3,413780.19,24,2,10,9,True
1386650,1384,4,25,9548,594578657,1,0,0,417.73,8,368632.27,24,4,10,1,True
1504136,1255,0,451,9328,594578657,1,0,0,417.66,7,368214.61,23,6,18,1,True
1613337,1255,0,451,3631,594578657,1,0,0,417.86,7,367796.75,23,6,21,1,True
2178115,509,0,25,7593,594578657,1,0,0,418.05,8,367378.7,12,5,13,2,False
2186698,991,1,-1,9238,594578657,1,1,0,417.99,4,367378.7,22,2,4,2,True
2236774,586,4,30,9431,594578657,1,0,0,418.05,8,366960.65,24,5,15,3,True
2977658,991,1,451,6510,594578657,1,0,0,418.25,7,366542.4,22,6,16,4,True
3067009,410,4,30,5041,594578657,1,0,0,418.02,8,366124.38,18,5,18,5,True
3302686,787,0,10,8852,594578657,1,0,0,417.67,6,366542.05,14,1,9,5,True
3497116,1213,2,-1,5037,594578657,1,1,0,418.11,4,366542.05,24,2,17,6,True
3740159,1213,2,451,6539,594578657,1,0,0,417.93,7,366124.12,24,2,9,6,True
3758110,128,0,10,3942,594578657,1,0,0,417.86,6,366541.98,18,5,23,7,True
4025286,1213,2,451,3631,594578657,1,0,0,418.0,7,366123.98,24,2,14,8,True
4155607,991,1,451,9238,594578657,1,0,0,417.75,7,365706.23,22,2,17,9,True
4257578,586,4,451,5041,594578657,1,0,0,418.11,7,365288.12,24,5,2,10,True
4640044,723,1,10,2098,594578657,1,0,0,418.08,6,365706.2,11,5,8,11,True
4735363,1336,2,-1,4459,594578657,1,1,0,418.03,4,365706.2,18,0,7,12,True
4929883,586,4,25,3631,594578657,1,0,0,418.06,8,365288.14,24,5,18,12,False
4963769,551,0,20,5021,594578657,1,0,0,418.11,5,364870.03,17,2,12,2,True
5084534,1336,2,451,5041,594578657,1,0,0,417.93,7,364452.1,18,5,6,3,True
5348989,1322,2,20,4459,594578657,1,0,0,417.73,5,364034.37,18,3,17,3,True
5448037,1336,2,451,7593,594578657,1,0,0,418.08,7,363616.29,18,2,9,4,True
5634823,1336,2,25,9330,594578657,1,0,0,418.05,8,363198.24,18,5,13,5,True
5856020,1255,0,451,9008,594578657,1,0,0,417.87,7,362780.37,23,4,20,6,True
6031148,667,4,451,4459,594578657,1,0,0,418.29,7,362362.08,18,4,10,6,True
6157266,586,4,451,2629,594578657,1,0,0,417.96,7,361944.12,24,6,0,7,True
6249964,584,0,10,6937,594578657,1,0,0,418.14,0,362362.26,11,4,10,7,True
6347218,1213,2,451,9330,594578657,1,0,0,417.96,7,361944.3,24,4,13,7,True
6352093,410,4,451,7593,594578657,1,0,0,418.09,7,361526.21,18,5,15,8,True
6787293,509,0,30,6937,594578657,1,0,0,417.97,8,361108.24,12,0,5,8,True
6982805,1412,2,20,7593,594578657,1,0,0,417.95,5,360690.29,24,5,22,9,True
7025547,1384,4,451,2098,594578657,1,0,0,417.98,7,360272.31,24,4,0,9,True
7057426,1384,4,-1,9238,594578657,1,1,0,418.24,4,360272.31,24,4,5,10,True
7094614,1321,0,20,7593,594578657,1,0,0,418.01,5,359854.3,18,1,4,11,True
7630774,29,0,20,2543,594578657,1,0,0,418.22,3,359436.08,11,5,17,11,True
7685902,509,0,451,4439,594578657,1,0,0,418.16,7,359017.92,12,1,21,12,True
7916436,1384,4,451,9238,594578657,1,0,0,417.86,7,358600.06,24,3,19,12,True
8086252,1336,2,-1,2098,594578657,1,1,0,417.83,4,358600.06,18,4,17,12,True
8527195,991,1,30,6539,594578657,1,0,0,417.8,8,358182.26,22,2,14,12,True
8548205,979,0,10,2098,594578657,1,0,0,418.14,6,358600.4,22,3,6,1,True
8808506,865,0,10,8359,594578657,1,0,0,418.22,0,359018.62,24,0,15,2,True
9050977,1384,4,451,9328,594578657,1,0,0,418.25,7,358600.37,24,4,3,2,True
9139733,394,0,20,2543,594578657,1,0,0,417.71,5,358182.66,10,4,2,3,True
9456253,1255,0,451,4459,594578657,1,0,0,417.7,7,357764.96,23,0,18,3,True
9593116,1213,2,30,2098,594578657,1,0,0,417.91,8,357347.05,24,5,13,3,True
9595237,1336,2,30,3942,594578657,1,0,0,417.87,8,356929.18,18,2,19,5,True
9608771,586,4,451,3942,594578657,1,0,0,418.1,7,356511.08,24,4,6,6,True
9632343,509,0,-1,6510,594578657,1,1,0,417.97,4,356511.08,12,4,23,7,True
9645103,410,4,-1,9008,594578657,1,2,0,418.18,4,356511.08,18,2,17,8,True
9689543,1255,0,451,2098,594578657,1,0,0,417.83,7,356093.25,23,6,7,9,True
9707725,667,4,451,5021,594578657,1,0,0,418.05,7,355675.2,18,0,20,10,True
9825490,255,2,20,9431,594578657,1,0,0,417.86,3,355257.34,6,4,8,11,True
9953856,991,1,25,8616,594578657,1,0,0,418.0,8,354839.34,22,5,14,11,True
9983515,509,0,25,4439,594578657,1,0,0,417.75,8,354421.59,12,5,23,11,True
1004030,200,0,25,5505,410869150,1,0,0,206.84,8,543252.16,9,1,13,3,True
1176924,68,0,10,8118,410869150,1,0,0,206.93,0,543459.09,20,2,3,3,True
1401343,584,0,-1,8414,410869150,1,1,0,206.98,4,543459.09,11,6,2,5,True
1606119,152,4,25,1930,410869150,1,0,0,206.75,8,543252.34,18,1,10,5,True
1708720,584,0,451,4394,410869150,1,0,0,207.09,7,543045.25,11,2,7,6,True
1808888,854,0,10,6430,410869150,1,0,0,207.13,0,543252.38,24,3,20,7,True
1825346,1436,0,451,3222,410869150,1,0,0,206.87,7,543045.51,24,5,14,8,True
1831729,200,0,30,9676,410869150,1,0,0,206.87,8,542838.64,9,1,11,8,True
1980660,1364,0,10,8295,410869150,1,0,0,206.79,6,543045.43,16,0,17,9,True
2078631,101,3,30,9139,410869150,1,0,0,206.87,8,542838.56,3,5,3,10,True
2345352,200,0,451,8176,410869150,1,0,0,206.98,7,542631.58,9,1,23,10,True
2405129,712,0,10,1930,410869150,1,0,0,207.12,6,542838.7,18,1,9,11,True
2586998,1436,0,451,8414,410869150,1,0,0,206.86,7,542631.84,24,5,0,11,True
3110647,584,0,-1,8176,410869150,1,1,0,206.99,4,542631.84,11,6,22,11,True
3183066,200,0,-1,5505,410869150,1,2,0,206.79,4,542631.84,9,3,7,1,True
3585074,152,4,451,3222,410869150,1,0,0,207.08,7,542424.76,18,1,10,1,True
3720674,584,0,451,2482,410869150,1,0,0,206.84,7,542217.92,11,1,5,2,True
4116564,152,4,30,8414,410869150,1,0,0,207.0,8,542010.92,18,5,5,3,True
4179752,35,2,20,9139,410869150,1,0,0,206.9,5,541804.02,11,6,15,4,True
4213934,101,3,30,5505,410869150,1,0,0,206.79,8,541597.23,3,0,5,4,True
4271593,101,3,451,7050,410869150,1,0,0,206.97,7,541390.26,3,4,19,4,True
4309653,1436,0,25,3938,410869150,1,0,0,207.3,8,541182.96,24,0,17,5,True
4389044,152,4,25,3938,410869150,1,0,0,206.91,8,540976.05,18,5,2,5,True
4850949,127,1,10,7398,410869150,1,0,0,207.04,0,541183.09,18,5,8,5,True
5421937,101,3,30,1628,410869150,1,0,0,207.0,8,540976.09,3,5,17,6,True
5595411,385,1,10,7412,410869150,1,0,0,207.05,0,541183.14,25,5,19,6,True
5692434,584,0,451,8295,410869150,1,0,0,206.93,7,540976.21,11,3,2,6,True
5860821,1436,0,451,1628,410869150,1,0,0,207.3,7,540768.91,24,6,1,7,True
6080382,152,4,451,5505,410869150,1,0,0,206.59,7,540562.32,18,0,22,7,True
6284325,584,0,30,6430,410869150,1,0,0,207.05,8,540355.27,11,5,1,8,True
6300345,152,4,30,7701,410869150,1,0,0,206.78,8,540148.49,18,3,18,9,True
6398822,1210,0,20,7701,410869150,1,0,0,207.06,5,539941.43,24,3,22,9,True
6500807,101,3,30,8159,410869150,1,0,0,206.91,8,539734.52,3,0,10,10,True
6574176,812,0,20,8118,410869150,1,0,0,206.74,3,539527.78,18,4,14,10,True
6587778,200,0,451,5505,410869150,1,0,0,207.14,7,539320.64,9,5,7,10,True
6588323,101,3,451,7701,410869150,1,0,0,207.01,7,539113.63,3,1,20,12,True
6810879,1436,0,25,5505,410869150,1,0,0,206.9,8,538906.73,24,3,1,12,True
7291812,152,4,-1,3938,410869150,1,1,0,206.79,1,538906.73,18,6,6,1,True
7330981,1436,0,451,2749,410869150,1,0,0,207.09,7,538699.64,24,2,7,1,True
7418550,101,3,-1,2482,410869150,1,1,0,206.96,4,538699.64,3,6,11,2,False
7552387,152,4,25,3938,410869150,1,0,0,206.73,8,538492.91,18,6,8,2,True
7614731,889,0,20,1930,410869150,1,0,0,207.13,5,538285.78,27,4,7,2,False
7793526,152,4,451,8118,410869150,1,0,0,207.01,7,538078.77,18,2,2,3,True
7907213,480,0,20,6430,410869150,1,0,0,206.87,5,537871.9,5,5,0,3,True
8164553,200,0,25,9139,410869150,1,0,0,206.67,8,537665.23,9,4,8,3,False
8604125,465,0,20,8414,410869150,1,0,0,207.0,5,537458.23,13,5,3,4,False
8855885,200,0,451,9118,410869150,1,0,0,206.93,7,537251.3,9,2,12,5,True
8924007,1270,1,10,2749,410869150,1,0,0,206.91,6,537458.21,23,2,13,6,True
8934029,714,2,20,1116,410869150,1,0,0,206.96,5,537251.25,18,6,16,7,True
8980020,200,0,451,7050,410869150,1,0,0,207.08,7,537044.17,9,5,19,7,True
8987914,1436,0,451,7701,410869150,1,0,0,207.06,7,536837.11,24,4,19,7,True
9400967,584,0,451,7412,410869150,1,0,0,207.05,7,536630.06,11,2,20,10,True
9453250,200,0,-1,7050,410869150,1,1,0,207.1,4,536630.06,9,6,16,10,True
9474623,584,0,25,1116,410869150,1,0,0,206.92,8,536423.14,11,5,10,10,True
9549626,101,3,25,1628,410869150,1,0,0,207.04,8,536216.1,3,6,19,10,True
9683871,584,0,-1,8176,410869150,1,1,0,207.19,4,536216.1,11,0,1,10,True
9722102,1455,2,20,3938,410869150,1,0,0,207.1,5,536009.0,11,6,7,11,True
9820706,1436,0,451,8176,410869150,1,0,0,206.81,7,535802.19,24,0,23,11,True
1103693,745,4,30,8572,279387932,1,0,0,683.08,8,268605.92,24,1,4,1,True
1113636,1393,3,451,8754,279387932,1,0,0,683.25,7,267922.67,24,0,21,1,True
1303084,659,4,30,4807,279387932,1,0,0,683.05,8,267239.62,18,4,17,2,True
1362592,1245,1,30,8042,279387932,1,0,0,683.04,8,266556.58,18,2,22,3,True
1931999,210,4,451,3036,279387932,1,0,0,683.07,7,265873.51,9,0,11,3,True
2396595,31,3,451,8572,279387932,1,0,0,683.17,7,265190.34,11,1,6,3,True
2774287,1393,3,30,3053,279387932,1,0,0,682.94,8,264507.4,24,2,10,5,True
3066877,848,2,451,6577,279387932,1,0,0,682.96,7,263824.44,5,5,15,7,True
3098409,180,0,10,8775,279387932,1,0,0,682.93,6,264507.37,18,4,17,7,True
3226643,210,4,30,4315,279387932,1,0,0,682.76,8,263824.61,9,5,14,8,True
3392215,1393,3,451,1983,279387932,1,0,0,682.99,7,263141.62,24,6,14,8,True
3736186,269,0,-1,9736,279387932,1,1,0,683.11,4,263141.62,24,3,6,8,True
3746930,848,2,-1,3633,279387932,1,2,0,683.14,4,263141.62,5,5,8,8,True
3833031,1393,3,451,8042,279387932,1,0,0,682.96,7,262458.66,24,0,6,9,True
3861177,210,4,451,7083,279387932,1,0,0,683.04,7,261775.62,9,0,2,10,True
3920326,1245,1,30,2327,279387932,1,0,0,682.83,8,261092.79,18,2,0,10,True
4169687,917,0,20,2042,279387932,1,0,0,682.85,3,260409.94,18,0,11,12,True
4180252,31,3,30,3633,279387932,1,0,0,682.91,8,259727.03,11,1,12,2,True
4264409,1297,0,10,8805,279387932,1,0,0,682.98,0,260410.01,5,0,19,2,True
4338767,659,4,451,4315,279387932,1,0,0,683.12,7,259726.89,18,1,17,5,True
4510118,848,2,30,1139,279387932,1,0,0,683.14,8,259043.75,5,6,16,6,True
4530528,1245,1,451,1139,279387932,1,0,0,682.63,7,258361.12,18,5,19,7,True
4823036,1245,1,-1,1746,279387932,1,1,0,682.96,4,258361.12,18,0,6,8,True
4904361,942,0,20,8775,279387932,1,0,0,682.85,3,257678.27,24,4,9,8,True
5008310,659,4,25,3206,279387932,1,0,0,682.97,8,256995.3,18,0,10,8,True
5316290,249,0,20,9736,279387932,1,0,0,682.97,5,256312.33,6,1,9,9,True
5844337,269,0,25,4022,279387932,1,0,0,682.84,8,255629.49,24,1,10,9,True
6004216,31,3,451,4885,279387932,1,0,0,683.21,7,254946.28,11,3,0,10,True
6047855,1169,0,10,8805,279387932,1,0,0,683.17,6,255629.45,24,5,7,10,False
6272286,1393,3,30,3053,279387932,1,0,0,683.11,8,254946.34,24,0,7,11,True
6672194,659,4,451,3036,279387932,1,0,0,683.13,7,254263.21,18,2,13,11,True
6806845,745,4,30,2345,279387932,1,0,0,682.85,8,253580.36,24,3,9,11,True
6811276,269,0,451,8775,279387932,1,0,0,682.73,7,252897.63,24,5,12,12,True
6928742,1245,1,30,4022,279387932,1,0,0,682.89,8,252214.74,18,2,0,1,True
7020770,309,0,10,3036,279387932,1,0,0,682.75,6,252897.49,4,3,8,1,True
7791730,659,4,-1,7083,279387932,1,1,0,682.76,1,252897.49,18,5,0,3,True
7926150,659,4,-1,1983,279387932,1,2,0,682.92,1,252897.49,18,2,0,4,True
8062136,1245,1,451,8042,279387932,1,0,0,683.22,7,252214.27,18,2,21,4,True
8134971,848,2,25,8805,279387932,1,0,0,683.07,8,251531.2,5,4,3,4,True
8305128,910,0,10,4885,279387932,1,0,0,682.92,6,252214.12,18,3,2,5,True
8315224,745,4,30,4807,279387932,1,0,0,683.2,8,251530.92,24,4,19,5,True
8385876,642,0,20,2345,279387932,1,0,0,683.15,3,250847.77,24,0,13,5,True
8698035,192,2,20,8463,279387932,1,0,0,683.03,5,250164.74,18,2,6,5,True
8724453,1393,3,451,3036,279387932,1,0,0,683.15,7,249481.59,24,4,11,5,True
8806165,1094,0,10,4885,279387932,1,0,0,683.22,6,250164.81,0,0,0,7,False
8808310,659,4,25,8805,279387932,1,0,0,683.09,8,249481.72,18,2,14,7,True
8980409,269,0,451,3036,279387932,1,0,0,683.23,7,248798.49,24,6,14,7,False
9039338,611,0,10,3206,279387932,1,0,0,683.23,0,249481.72,11,5,5,8,True
9272130,659,4,-1,4542,279387932,1,1,0,683.02,1,249481.72,18,5,16,8,True
9416386,807,0,10,7083,279387932,1,0,0,682.95,6,250164.67,11,3,15,8,True
9425532,1245,1,-1,8572,279387932,1,1,0,683.05,4,250164.67,18,0,11,11,True
1414399,1264,0,20,8595,973142228,0,0,0,466.07,5,258175.93,23,2,3,1,True
1463688,931,0,20,9823,973142228,0,0,0,465.82,5,257710.11,24,6,16,1,True
1897740,688,0,20,8242,973142228,0,0,0,465.93,5,257244.18,24,0,12,2,True
2065714,998,0,10,7089,973142228,0,0,0,466.04,6,257710.22,26,1,6,3,True
2329716,1411,0,451,2299,973142228,0,0,0,466.14,7,257244.08,24,1,22,3,True
2591915,216,4,451,9875,973142228,0,0,0,466.11,7,256777.97,9,5,15,4,True
2625500,1177,4,25,4329,973142228,0,0,0,466.23,8,256311.74,24,3,16,4,True
2865229,1307,0,20,4994,973142228,0,0,0,466.12,5,255845.62,5,4,9,4,True
2908487,405,4,25,5111,973142228,0,0,0,465.99,8,255379.63,10,0,8,6,True
2936853,90,4,451,9823,973142228,0,0,0,465.99,7,254913.64,1,0,22,7,True
3174791,405,4,451,7089,973142228,0,0,0,466.01,7,254447.63,10,6,22,7,True
3301481,1411,0,-1,5277,973142228,0,1,0,466.04,4,254447.63,24,2,9,9,True
3349557,90,4,25,5111,973142228,0,0,0,465.6,8,253982.03,1,2,14,10,True
3485839,1101,2,20,1652,973142228,0,0,0,466.13,5,253515.9,0,4,10,10,True
3528254,1298,0,10,4994,973142228,0,0,0,465.97,6,253981.87,5,4,13,11,True
4115605,1177,4,-1,5111,973142228,0,1,0,466.23,4,253981.87,24,5,7,11,True
4251195,1177,4,-1,8595,973142228,0,2,0,466.04,4,253981.87,24,3,4,1,True
4359569,635,2,20,3846,973142228,0,0,0,465.99,5,253515.88,24,2,3,2,True
4650519,811,0,20,8256,973142228,0,0,0,465.88,5,253050.0,18,3,15,2,True
4741980,1273,0,10,3230,973142228,0,0,0,466.11,0,253516.11,24,6,10,4,True
4889053,954,4,451,7692,973142228,0,0,0,465.99,7,253050.12,13,1,16,5,True
5164026,1468,1,10,3230,973142228,0,0,0,466.28,6,253516.4,11,6,12,7,True
5176651,540,4,451,4863,973142228,0,0,0,465.99,7,253050.41,17,3,14,8,True
5668023,1113,1,451,1652,973142228,0,0,0,466.08,7,252584.33,0,2,5,8,True
5724561,445,0,451,7338,973142228,0,0,0,465.86,7,252118.47,13,3,21,9,True
5739717,1113,1,-1,8740,973142228,0,1,0,466.01,4,252118.47,0,2,7,9,True
5945381,998,0,20,8788,973142228,0,0,0,465.9,5,251652.57,26,5,18,9,True
6061118,90,4,451,8256,973142228,0,0,0,466.27,7,251186.3,1,5,16,10,True
6221688,1177,4,451,9823,973142228,0,0,0,465.99,7,250720.31,24,0,0,10,True
6518394,192,2,20,8595,973142228,0,0,0,465.99,5,250254.32,18,1,10,12,True
6842704,1177,4,25,8740,973142228,0,0,0,465.99,8,249788.33,24,3,22,12,True
6847115,954,4,25,3653,973142228,0,0,0,466.1,8,249322.23,13,1,18,2,True
6930172,1177,4,451,9738,973142228,0,0,0,466.19,7,248856.04,24,2,12,2,True
6994091,216,4,451,7808,973142228,0,0,0,466.08,7,248389.96,9,6,12,4,True
7092335,993,0,20,5277,973142228,0,0,0,465.9,5,247924.06,22,4,0,5,True
7274726,216,4,-1,7692,973142228,0,1,0,465.96,1,247924.06,9,6,2,5,True
7312938,1210,0,20,8256,973142228,0,0,0,465.99,5,247458.07,24,2,14,5,True
7420529,445,0,25,8242,973142228,0,0,0,466.15,8,246991.92,13,4,23,5,True
7506358,954,4,-1,4329,973142228,0,1,0,466.09,4,246991.92,13,5,3,5,True
7667016,1411,0,25,8242,973142228,0,0,0,466.1,8,246525.82,24,1,0,5,True
7842522,635,2,20,4329,973142228,0,0,0,465.97,3,246059.85,24,0,2,7,True
8051798,1113,1,-1,9738,973142228,0,1,0,466.14,4,246059.85,0,4,19,7,True
8378397,679,0,20,8242,973142228,0,0,0,466.11,5,245593.74,24,0,21,7,True
8702415,1382,0,20,1652,973142228,0,0,0,465.99,3,245127.75,16,0,5,8,True
8827184,954,4,451,4329,973142228,0,0,0,465.82,7,244661.93,13,5,21,8,True
9290227,580,0,10,9823,973142228,0,0,0,466.17,6,245128.1,11,4,11,8,True
9323595,199,0,10,7849,973142228,0,0,0,465.84,0,245593.94,18,6,4,9,True
9348108,540,4,30,8595,973142228,0,0,0,466.02,8,245127.92,17,0,20,10,True
9408962,560,2,20,4329,973142228,0,0,0,466.12,5,244661.8,17,1,5,11,True
9727421,1410,1,10,8788,973142228,0,0,0,465.95,6,245127.75,24,0,7,11,True
1209501,529,2,451,2109,963925436,0,0,0,401.01,7,878860.99,18,6,20,1,True
1323046,561,4,451,4214,963925436,0,0,0,401.17,7,878459.82,17,6,2,1,True
1446353,842,2,25,2800,963925436,0,0,0,401.06,8,878058.76,5,5,6,1,True
1448374,1014,1,10,4069,963925436,0,0,0,400.68,6,878459.44,26,0,16,2,True
1561653,842,2,-1,4108,963925436,0,1,0,401.03,4,878459.44,5,4,6,3,True
1783808,1030,4,30,9208,963925436,0,0,0,401.31,8,878058.13,11,2,1,3,True
2274727,842,2,-1,7593,963925436,0,1,0,400.79,1,878058.13,5,3,15,3,True
2275938,561,4,25,9499,963925436,0,0,0,400.89,8,877657.24,17,5,10,4,True
2535841,34,1,10,6711,963925436,0,0,0,400.88,6,878058.12,11,1,17,5,True
2890020,1012,0,20,2925,963925436,0,0,0,401.12,3,877657.0,26,5,11,6,True
3067482,849,1,10,2393,963925436,0,0,0,400.96,0,878057.96,5,1,9,6,True
3179986,733,3,451,2925,963925436,0,0,0,401.01,7,877656.95,11,3,1,8,True
3204149,360,0,10,3121,963925436,0,0,0,400.77,6,878057.72,24,4,5,9,True
3349311,529,2,451,4309,963925436,0,0,0,401.07,7,877656.65,18,1,23,9,True
3371875,561,4,30,4108,963925436,0,0,0,400.97,8,877255.68,17,2,21,10,True
3605424,1227,0,20,3540,963925436,0,0,0,401.22,3,876854.46,18,2,16,11,True
3800947,1325,0,10,9208,963925436,0,0,0,401.09,6,877255.55,18,2,22,11,True
3880978,529,2,25,2925,963925436,0,0,0,400.95,8,876854.6,18,5,10,12,True
3924285,842,2,451,8854,963925436,0,0,0,400.99,7,876453.61,5,6,20,1,True
4195493,561,4,25,3121,963925436,0,0,0,401.17,8,876052.44,17,0,5,1,True
5126138,561,4,30,6992,963925436,0,0,0,400.97,8,875651.47,17,5,9,2,True
5293587,1132,0,10,8350,963925436,0,0,0,400.86,6,876052.33,24,1,8,2,True
5482290,1426,1,10,4806,963925436,0,0,0,400.75,6,876453.08,24,6,2,3,True
5681753,561,4,25,3832,963925436,0,0,0,400.98,8,876052.1,17,2,12,3,True
5805450,1399,0,10,9580,963925436,0,0,0,400.81,6,876452.91,24,5,22,4,True
6263900,733,3,30,2924,963925436,0,0,0,400.97,8,876051.94,11,0,18,5,True
6339464,842,2,451,4806,963925436,0,0,0,401.07,7,875650.87,5,6,21,5,True
6563376,733,3,-1,3540,963925436,0,1,0,400.89,4,875650.87,11,1,13,5,True
6785816,561,4,25,2027,963925436,0,0,0,400.88,8,875249.99,17,6,16,6,True
6861204,1217,0,10,1532,963925436,0,0,0,400.83,6,875650.82,24,0,8,6,True
6932768,529,2,25,3832,963925436,0,0,0,401.17,8,875249.65,18,2,1,6,True
6983849,529,2,-1,2109,963925436,0,1,0,400.87,4,875249.65,18,3,13,7,True
7182695,733,3,30,3963,963925436,0,0,0,401.01,8,874848.64,11,5,13,7,True
7439761,96,0,20,4069,963925436,0,0,0,401.01,5,874447.63,1,4,19,7,True
7586333,529,2,25,2800,963925436,0,0,0,401.09,8,874046.54,18,5,7,7,True
7587349,1030,4,25,9479,963925436,0,0,0,400.97,8,873645.57,11,5,9,9,True
7594003,561,4,-1,2924,963925436,0,1,0,401.02,1,873645.57,17,2,6,10,True
7750030,842,2,30,2925,963925436,0,0,0,400.82,8,873244.75,5,2,8,11,True
8003994,842,2,451,1552,963925436,0,0,0,400.89,7,872843.86,5,5,15,11,False
8059156,733,3,451,7593,963925436,0,0,0,400.96,7,872442.9,11,1,13,11,True
8240578,842,2,-1,3092,963925436,0,1,0,401.16,4,872442.9,5,4,2,12,True
8392588,1030,4,25,2027,963925436,0,0,0,400.96,8,872041.94,11,5,4,12,True
8529937,605,0,20,4806,963925436,0,0,0,400.79,3,871641.15,24,6,11,12,True
8554892,842,2,-1,4806,963925436,0,1,0,400.84,4,871641.15,5,5,13,1,False
8630818,733,3,451,6992,963925436,0,0,0,401.1,7,871240.05,11,2,22,1,True
9164711,1030,4,451,2925,963925436,0,0,0,400.81,7,870839.24,11,6,10,3,True
9236263,701,2,20,4108,963925436,0,0,0,401.07,5,870438.17,18,3,0,3,False
9245545,529,2,25,2393,963925436,0,0,0,401.33,8,870036.84,18,3,6,4,True
9269690,842,2,-1,4108,963925436,0,1,0,401.15,4,870036.84,5,3,18,5,True
9375635,733,3,451,4309,963925436,0,0,0,401.01,7,869635.83,11,2,6,8,True
9455884,733,3,451,2393,963925436,0,0,0,400.88,7,869234.95,11,1,21,8,True
9633190,561,4,-1,5510,963925436,0,1,0,401.0,4,869234.95,17,4,11,9,True
9688078,842,2,-1,1235,963925436,0,2,0,400.96,4,869234.95,5,2,13,10,True
9950809,733,3,30,8350,963925436,0,0,0,401.19,8,868833.76,11,5,15,11,False
1044061,858,1,25,3031,622626117,1,0,0,236.81,8,860690.19,24,5,11,1,False
1168845,255,2,451,1895,622626117,1,0,0,237.21,7,860452.98,6,1,15,1,True
1197410,184,0,451,7283,622626117,1,0,0,236.72,7,860216.26,18,5,1,1,True
1474065,524,1,10,9856,622626117,1,0,0,237.18,6,860453.44,18,4,22,2,True
1528822,1012,0,20,6955,622626117,1,0,0,237.05,5,860216.39,26,0,18,2,True
1555271,184,0,-1,7713,622626117,1,1,0,236.99,1,860216.39,18,4,11,3,True
1950760,858,1,30,8800,622626117,1,0,0,237.01,8,859979.38,24,6,13,3,True
2112134,858,1,25,9856,622626117,1,0,0,236.69,8,859742.69,24,2,0,3,True
2147259,255,2,30,8119,622626117,1,0,0,237.05,8,859505.64,6,2,7,4,True
2154406,255,2,-1,1895,622626117,1,1,0,236.93,4,859505.64,6,3,22,4,True
2222848,416,2,25,3161,622626117,1,0,0,236.98,8,859268.66,18,6,17,4,True
2254361,580,0,10,2356,622626117,1,0,0,236.94,6,859505.6,11,0,19,4,True
2344186,184,0,-1,9269,622626117,1,1,0,236.96,4,859505.6,18,2,6,4,True
2659188,858,1,25,7283,622626117,1,0,0,236.7,8,859268.9,24,4,2,4,True
2910913,416,2,25,9856,622626117,1,0,0,237.19,8,859031.71,18,4,12,5,True
3344026,255,2,30,2753,622626117,1,0,0,237.03,8,858794.68,6,4,17,7,True
3686851,858,1,451,8119,622626117,1,0,0,237.03,7,858557.65,24,4,2,8,True
3945066,255,2,-1,5227,622626117,1,1,0,237.36,4,858557.65,6,6,9,8,True
4022552,255,2,451,3031,622626117,1,0,0,237.13,7,858320.52,6,6,2,8,True
4036171,255,2,-1,6922,622626117,1,1,0,236.93,4,858320.52,6,2,15,8,True
4151893,866,0,10,1895,622626117,1,0,0,237.14,6,858557.66,24,5,13,8,True
4391412,416,2,25,5227,622626117,1,0,0,236.95,8,858320.71,18,6,9,9,True
4504123,255,2,451,3031,622626117,1,0,0,237.13,7,858083.58,6,2,16,9,True
4623900,1090,0,20,9856,622626117,1,0,0,236.81,3,857846.77,18,6,14,10,True
4716900,255,2,451,5227,622626117,1,0,0,236.99,7,857609.78,6,2,4,10,True
4798103,255,2,-1,8800,622626117,1,1,0,236.92,4,857609.78,6,5,21,11,True
4854113,480,0,20,3031,622626117,1,0,0,236.79,5,857372.99,5,1,19,11,True
4903376,858,1,-1,8381,622626117,1,1,0,237.39,4,857372.99,24,2,14,11,True
5094816,1121,3,25,7283,622626117,1,0,0,237.09,8,857135.9,24,6,21,12,True
5255295,184,0,30,9269,622626117,1,0,0,237.14,8,856898.76,18,3,9,1,True
5685891,858,1,30,7283,622626117,1,0,0,236.88,8,856661.88,24,6,18,1,True
5717143,990,0,20,7935,622626117,1,0,0,237.18,5,856424.7,22,2,13,2,True
6118655,255,2,25,9269,622626117,1,0,0,237.15,8,856187.55,6,4,18,4,True
6324928,1121,3,30,3161,622626117,1,0,0,237.01,8,855950.54,24,6,8,4,True
6415379,184,0,451,2356,622626117,1,0,0,236.95,7,855713.59,18,6,4,5,True
6726951,255,2,-1,6922,622626117,1,1,0,236.78,4,855713.59,6,1,12,7,True
6778697,1434,0,10,9269,622626117,1,0,0,237.15,0,855950.74,24,2,23,8,True
6898379,858,1,30,2601,622626117,1,0,0,237.18,8,855713.56,24,5,4,9,True
7002444,255,2,30,7283,622626117,1,0,0,237.27,8,855476.29,6,0,8,10,True
7141713,1421,0,20,8381,622626117,1,0,0,237.12,5,855239.17,24,3,14,10,True
7180124,858,1,30,8381,622626117,1,0,0,237.12,8,855002.05,24,3,16,12,True
7489603,416,2,30,4984,622626117,1,0,0,237.11,8,854764.94,18,0,13,1,True
7640098,748,1,10,7283,622626117,1,0,0,236.99,6,855001.93,24,0,16,1,True
7897182,1319,1,10,7283,622626117,1,0,0,236.87,6,855238.8,18,0,17,1,True
7955637,757,0,20,8119,622626117,1,0,0,236.89,5,855001.91,24,5,4,2,True
8004316,1227,0,20,8800,622626117,1,0,0,237.27,5,854764.64,18,6,12,2,True
8617439,255,2,451,7713,622626117,1,0,0,236.77,7,854527.87,6,6,11,3,True
8619515,184,0,30,9269,622626117,1,0,0,236.92,8,854290.95,18,6,21,4,True
8917475,1121,3,30,3161,622626117,1,0,0,237.07,8,854053.88,24,0,11,5,True
9117781,184,0,451,3084,622626117,1,0,0,237.0,7,853816.88,18,0,21,5,True
9356243,858,1,25,5227,622626117,1,0,0,237.19,8,853579.69,24,3,14,7,True
9501768,416,2,-1,4984,622626117,1,1,0,237.05,1,853579.69,18,5,11,8,True
9657695,1121,3,451,8119,622626117,1,0,0,237.15,7,853342.54,24,2,14,9,True
9699645,416,2,451,8800,622626117,1,0,0,237.22,7,853105.32,18,6,6,10,True
9821040,1121,3,25,2753,622626117,1,0,0,237.09,8,852868.23,24,2,17,10,True
9859591,184,0,25,3775,622626117,1,0,0,237.09,8,852631.14,18,5,17,11,True
9948324,416,2,30,3775,622626117,1,0,0,237.06,8,852394.08,18,2,5,11,True
1003707,1311,2,20,6441,447240663,0,0,0,559.96,3,879533.04,5,0,6,1,True
1185627,1255,0,20,4497,447240663,0,0,0,560.08,3,878972.96,23,3,3,6,True
1505881,530,0,25,7834,447240663,0,0,0,560.09,8,878412.87,18,3,15,6,True
1699983,820,1,10,6441,447240663,0,0,0,559.93,6,878972.8,18,4,15,6,True
2271309,708,2,30,6441,447240663,0,0,0,560.01,8,878412.79,18,1,17,6,True
2290302,1399,0,10,4919,447240663,0,0,0,560.04,6,878972.83,24,1,12,7,False
2299515,816,0,10,3513,447240663,0,0,0,560.2,0,879533.03,18,4,1,8,True
2529233,530,0,451,6800,447240663,0,0,0,559.95,7,878973.08,18,0,21,8,True
2648116,523,2,451,3050,447240663,0,0,0,559.9,7,878413.18,18,3,4,9,True
2684537,523,2,30,4666,447240663,0,0,0,560.02,8,877853.16,18,4,11,9,False
2729214,554,4,25,2341,447240663,0,0,0,560.16,8,877293.0,17,3,15,9,True
2843805,708,2,30,8154,447240663,0,0,0,559.63,8,876733.37,18,4,8,10,True
2890196,1014,1,10,7649,447240663,0,0,0,559.72,6,877293.09,26,6,10,11,True
2900077,530,0,25,7649,447240663,0,0,0,559.78,8,876733.31,18,5,8,11,True
3011257,1459,1,10,6800,447240663,0,0,0,560.08,6,877293.39,11,5,11,12,True
3554577,530,0,25,7649,447240663,0,0,0,559.92,8,876733.47,18,4,19,1,True
3581409,523,2,25,4497,447240663,0,0,0,559.97,8,876173.5,18,3,17,3,True
3634399,282,2,20,2341,447240663,0,0,0,559.96,5,875613.54,24,4,6,4,True
3843949,554,4,451,3513,447240663,0,0,0,559.95,7,875053.59,17,3,2,4,True
3890202,350,0,10,9762,447240663,0,0,0,560.23,6,875613.82,24,0,14,5,True
4260104,918,2,20,4967,447240663,0,0,0,560.14,5,875053.68,18,1,23,6,True
4339055,990,0,10,7834,447240663,0,0,0,560.21,6,875613.89,22,0,5,6,True
4650837,530,0,25,7834,447240663,0,0,0,559.81,8,875054.08,18,3,23,8,True
4701200,993,0,10,9212,447240663,0,0,0,560.32,6,875614.4,22,3,6,8,True
4721341,708,2,451,2341,447240663,0,0,0,559.86,7,875054.54,18,2,21,8,True
4846183,708,2,30,9457,447240663,0,0,0,559.84,8,874494.7,18,5,4,9,True
4879908,530,0,451,3513,447240663,0,0,0,559.81,7,873934.89,18,3,2,9,True
4995813,530,0,-1,4967,447240663,0,1,0,560.12,4,873934.89,18,4,9,11,True
5118267,160,0,10,4666,447240663,0,0,0,559.77,6,874494.66,24,6,17,11,True
5210383,708,2,30,6800,447240663,0,0,0,559.84,8,873934.82,18,0,20,12,True
5312379,523,2,25,9212,447240663,0,0,0,560.01,8,873374.81,18,1,9,12,True
5659812,367,1,25,8154,447240663,0,0,0,560.16,8,872814.65,25,3,1,12,True
5734277,523,2,451,7834,447240663,0,0,0,560.15,7,872254.5,18,2,21,12,True
6224528,1288,0,10,9762,447240663,0,0,0,560.04,0,872814.54,24,4,14,12,True
6469629,708,2,-1,9762,447240663,0,1,0,559.73,4,872814.54,18,4,16,1,True
6803431,367,1,451,6996,447240663,0,0,0,560.02,7,872254.52,25,4,10,1,True
6815538,716,0,10,8316,447240663,0,0,0,560.11,0,872814.63,18,0,4,2,True
6921647,554,4,30,4919,447240663,0,0,0,560.21,8,872254.42,17,2,15,2,True
7283599,523,2,-1,3513,447240663,0,1,0,560.01,1,872254.42,18,4,15,4,True
7362975,879,1,10,5540,447240663,0,0,0,560.06,6,872814.48,27,1,21,4,True
7913149,367,1,25,9346,447240663,0,0,0,559.88,8,872254.6,25,5,23,5,True
7916391,800,0,20,8154,447240663,0,0,0,560.02,5,871694.58,11,6,22,5,True
8120866,530,0,-1,7649,447240663,0,1,0,559.95,1,871694.58,18,5,6,6,True
8349169,554,4,25,9346,447240663,0,0,0,560.07,8,871134.51,17,5,7,6,True
8453900,530,0,451,9212,447240663,0,0,0,559.76,7,870574.75,18,5,8,6,True
8601231,708,2,30,6519,447240663,0,0,0,560.2,8,870014.55,18,6,16,6,True
8611379,530,0,30,2341,447240663,0,0,0,559.88,8,869454.67,18,0,9,7,True
8703943,530,0,30,6996,447240663,0,0,0,560.19,8,868894.48,18,3,5,8,True
8747578,367,1,30,7063,447240663,0,0,0,560.04,8,868334.44,25,4,15,8,True
8861683,523,2,451,6996,447240663,0,0,0,560.14,7,867774.3,18,4,20,8,True
9074392,530,0,-1,2341,447240663,0,1,0,559.96,1,867774.3,18,4,23,8,True
9080505,367,1,-1,4666,447240663,0,2,0,560.1,4,867774.3,25,2,10,10,True
1004888,1093,0,451,9343,305426918,0,0,0,421.15,7,926533.85,18,3,4,1,True
1017318,108,2,25,9004,305426918,0,0,0,420.73,8,926113.12,3,1,4,2,True
1021015,22,3,25,1422,305426918,0,0,0,420.87,8,925692.25,11,0,15,2,True
1122412,369,1,25,3170,305426918,0,0,0,421.09,8,925271.16,25,4,10,3,True
1240160,333,1,10,3434,305426918,0,0,0,421.11,6,925692.27,11,3,5,3,True
1458885,681,2,20,2050,305426918,0,0,0,421.08,5,925271.19,24,5,22,3,True
1514396,1436,0,10,4952,305426918,0,0,0,420.88,0,925692.07,24,2,12,5,True
1586541,406,1,25,2050,305426918,0,0,0,421.06,8,925271.01,10,5,17,5,True
1595017,108,2,30,6048,305426918,0,0,0,420.77,8,924850.24,3,2,6,7,True
1797658,406,1,30,7561,305426918,0,0,0,421.14,8,924429.1,10,0,15,7,True
1804194,1159,0,10,4021,305426918,0,0,0,421.12,6,924850.22,15,3,11,8,True
1916453,406,1,30,2453,305426918,0,0,0,420.85,8,924429.37,10,3,17,9,True
2008084,1425,0,10,2453,305426918,0,0,0,421.04,6,924850.41,24,5,12,10,True
2065002,117,1,25,3436,305426918,0,0,0,421.06,8,924429.35,18,2,4,10,True
2157128,22,3,-1,7561,305426918,0,1,0,421.11,4,924429.35,11,6,20,10,False
2296459,1180,1,10,4952,305426918,0,0,0,420.88,6,924850.23,24,3,3,10,True
2365520,1400,3,30,6048,305426918,0,0,0,421.04,8,924429.19,24,2,12,11,True
2414123,319,0,10,4952,305426918,0,0,0,421.18,6,924850.37,11,6,19,12,True
2981166,369,1,25,2828,305426918,0,0,0,421.18,8,924429.19,25,4,6,1,True
3137867,348,0,20,2050,305426918,0,0,0,420.77,5,924008.42,24,1,7,1,True
3385214,996,0,20,2978,305426918,0,0,0,421.03,3,923587.39,26,5,1,2,True
3506093,117,1,451,3170,305426918,0,0,0,421.16,7,923166.23,18,1,10,2,True
3513103,1400,3,451,4021,305426918,0,0,0,420.98,7,922745.25,24,1,6,5,True
3870787,406,1,-1,6048,305426918,0,1,0,421.09,4,922745.25,10,2,9,6,True
3877854,129,0,10,3436,305426918,0,0,0,420.93,0,923166.18,18,2,16,6,True
3882155,108,2,-1,4021,305426918,0,1,0,420.97,1,923166.18,3,0,18,7,True
4038034,22,3,30,6048,305426918,0,0,0,420.93,8,922745.25,11,1,13,8,True
4145101,22,3,451,2559,305426918,0,0,0,421.11,7,922324.14,11,6,22,9,True
4515110,108,2,30,4021,305426918,0,0,0,420.92,8,921903.22,3,0,13,9,True
4676811,1093,0,451,3434,305426918,0,0,0,420.9,7,921482.32,18,0,6,9,True
4851188,22,3,451,3436,305426918,0,0,0,420.89,7,921061.43,11,5,15,9,True
5036033,108,2,30,3436,305426918,0,0,0,421.04,8,920640.39,3,1,5,9,True
5135693,406,1,25,2050,305426918,0,0,0,420.95,8,920219.44,10,4,13,10,True
5241371,117,1,25,1422,305426918,0,0,0,420.91,8,919798.53,18,0,3,10,True
6037529,117,1,451,2050,305426918,0,0,0,420.98,7,919377.55,18,4,1,11,True
6308159,1093,0,-1,9004,305426918,0,1,0,421.13,1,919377.55,18,6,20,12,True
6334201,990,0,20,1422,305426918,0,0,0,421.22,5,918956.33,22,1,8,12,True
6643302,406,1,25,4021,305426918,0,0,0,421.0,8,918535.33,10,4,1,1,True
6713391,406,1,30,2453,305426918,0,0,0,421.12,8,918114.21,10,6,2,1,True
7105323,1093,0,30,2453,305426918,0,0,0,421.24,8,917692.97,18,0,11,1,True
7136916,907,0,10,9004,305426918,0,0,0,420.89,6,918113.86,2,5,11,2,True
7377257,1400,3,-1,6048,305426918,0,1,0,420.83,1,918113.86,24,5,0,3,True
7565776,1072,0,10,9004,305426918,0,0,0,420.83,6,918534.69,18,0,6,4,True
7702349,1400,3,30,2828,305426918,0,0,0,421.21,8,918113.48,24,5,19,4,True
7712244,369,1,451,3434,305426918,0,0,0,420.94,7,917692.54,25,1,2,4,True
7746476,630,0,10,4952,305426918,0,0,0,421.02,6,918113.56,11,2,13,6,True
7955917,108,2,25,2559,305426918,0,0,0,420.97,8,917692.59,3,1,13,6,True
7970709,406,1,451,3170,305426918,0,0,0,420.89,7,917271.7,10,4,4,6,True
8319845,1255,0,20,9004,305426918,0,0,0,421.22,5,916850.48,23,2,0,7,True
8515837,1304,0,10,3267,305426918,0,0,0,421.16,6,917271.64,5,1,3,8,True
8947406,406,1,-1,6048,305426918,0,1,0,420.88,4,917271.64,10,6,6,8,True
9172223,22,3,30,2559,305426918,0,0,0,420.89,8,916850.75,11,4,9,8,True
9191758,350,0,10,4021,305426918,0,0,0,421.02,0,917271.77,24,2,1,9,True
9307030,796,2,20,9343,305426918,0,0,0,420.76,5,916851.01,11,5,5,9,True
9719231,1093,0,-1,3267,305426918,0,1,0,421.09,1,916851.01,18,0,11,10,True
9868773,1400,3,-1,3170,305426918,0,2,0,421.0,4,916851.01,24,3,12,10,True
9931934,117,1,451,2978,305426918,0,0,0,420.89,7,916430.12,18,5,10,11,True
1800795,705,1,10,2305,119625355,0,0,0,184.8,6,982785.8,18,1,3,1,True
1877295,444,2,451,9909,119625355,0,0,0,184.88,7,982600.92,24,1,4,1,True
2258600,444,2,25,5398,119625355,0,0,0,185.06,8,982415.86,24,0,13,1,True
2269697,444,2,451,4042,119625355,0,0,0,185.12,7,982230.74,24,1,11,3,True
2337689,129,0,30,9909,119625355,0,0,0,185.1,8,982045.64,18,0,12,3,True
2969464,1041,0,451,9408,119625355,0,0,0,185.09,7,981860.55,11,4,14,3,True
3146335,1041,0,451,6328,119625355,0,0,0,184.96,7,981675.59,11,1,16,3,True
3254400,1226,2,451,5964,119625355,0,0,0,185.11,7,981490.48,18,5,7,4,True
3733798,1226,2,30,4236,119625355,0,0,0,184.92,8,981305.56,18,1,16,4,True
3747245,996,0,20,5964,119625355,0,0,0,185.07,5,981120.49,26,4,13,4,True
3906047,129,0,451,9408,119625355,0,0,0,185.21,7,980935.28,18,4,17,4,True
3938254,325,0,25,9189,119625355,0,0,0,185.09,8,980750.19,11,0,19,5,True
3940270,1226,2,25,3128,119625355,0,0,0,185.19,8,980565.0,18,2,11,6,True
4167270,438,1,-1,9408,119625355,0,1,0,184.72,4,980565.0,24,5,17,7,True
4416275,53,0,10,4236,119625355,0,0,0,185.02,6,980750.02,20,5,20,8,True
4641567,616,1,10,4042,119625355,0,0,0,185.2,0,980935.22,11,2,11,10,True
4865710,1189,2,20,5964,119625355,0,0,0,184.97,5,980750.25,24,4,16,10,True
5024634,444,2,25,9238,119625355,0,0,0,185.01,8,980565.24,24,0,1,12,True
5206762,1451,1,10,5553,119625355,0,0,0,185.07,6,980750.31,11,1,7,2,True
5226135,164,4,451,5756,119625355,0,0,0,185.04,7,980565.27,24,2,21,2,True
5731773,362,0,10,3128,119625355,0,0,0,184.76,0,980750.03,24,3,16,2,True
5917051,444,2,-1,4042,119625355,0,1,0,184.95,1,980750.03,24,6,6,3,True
5955364,1226,2,30,8149,119625355,0,0,0,184.87,8,980565.16,18,2,22,3,True
6127062,444,2,25,9669,119625355,0,0,0,185.11,8,980380.05,24,6,13,4,True
6132069,444,2,25,8149,119625355,0,0,0,185.12,8,980194.93,24,1,1,4,True
6435176,438,1,25,4715,119625355,0,0,0,185.16,8,980009.77,24,1,15,5,True
6491464,1226,2,-1,9408,119625355,0,1,0,185.04,4,980009.77,18,5,7,5,True
6514765,783,0,20,4236,119625355,0,0,0,184.99,5,979824.78,14,0,17,5,True
6917538,129,0,451,5964,119625355,0,0,0,185.05,7,979639.73,18,1,0,5,True
7031603,325,0,451,9238,119625355,0,0,0,184.95,7,979454.78,11,3,7,5,True
7215403,164,4,25,9909,119625355,0,0,0,185.04,8,979269.74,24,0,11,6,False
7548440,1226,2,30,8149,119625355,0,0,0,185.01,8,979084.73,18,4,15,8,True
7622038,1226,2,451,2305,119625355,0,0,0,184.95,7,978899.78,18,4,8,9,True
7637774,1226,2,451,8200,119625355,0,0,0,185.01,7,978714.77,18,4,9,11,True
7716390,1226,2,451,2660,119625355,0,0,0,185.28,7,978529.49,18,3,8,11,True
8176270,411,2,20,4042,119625355,0,0,0,185.05,5,978344.44,18,1,12,12,True
8183134,1419,1,10,6351,119625355,0,0,0,185.21,6,978529.65,24,3,1,1,True
8215020,204,0,20,9238,119625355,0,0,0,184.87,5,978344.78,9,0,20,1,True
8261075,1425,0,10,2329,119625355,0,0,0,185.09,6,978529.87,24,4,22,3,True
8281030,1086,0,10,9620,119625355,0,0,0,185.13,6,978715.0,18,5,6,3,True
8323176,1226,2,451,9189,119625355,0,0,0,185.11,7,978529.89,18,5,13,3,True
8337824,967,1,10,4715,119625355,0,0,0,184.86,0,978714.75,13,2,10,4,True
8545902,1041,0,451,5964,119625355,0,0,0,185.05,7,978529.7,11,3,6,5,True
8605294,1226,2,30,9909,119625355,0,0,0,184.88,8,978344.82,18,3,23,6,True
8677005,438,1,451,3128,119625355,0,0,0,185.0,7,978159.82,24,5,15,6,True
8715762,1041,0,451,6351,119625355,0,0,0,184.94,7,977974.88,11,5,3,8,True
8792366,1325,0,10,5964,119625355,0,0,0,185.23,6,978160.11,18,6,2,8,True
8864620,1226,2,-1,6328,119625355,0,1,0,184.95,4,978160.11,18,2,10,8,True
8896182,325,0,30,8149,119625355,0,0,0,184.87,8,977975.24,11,1,0,9,True
8978239,1041,0,30,8200,119625355,0,0,0,184.91,8,977790.33,11,3,4,10,True
9102340,444,2,-1,4236,119625355,0,1,0,184.94,4,977790.33,24,1,16,10,True
9394808,438,1,25,2305,119625355,0,0,0,184.82,8,977605.51,24,5,21,11,True
9883330,325,0,451,2329,119625355,0,0,0,185.18,7,977420.33,11,0,0,11,True
1062686,1421,0,20,1650,956721481,0,0,0,1025.21,5,541986.79,24,5,9,1,True
1289455,1303,0,10,8694,956721481,0,0,0,1025.01,0,543011.8,5,1,5,1,True
1830645,1208,4,30,5810,956721481,0,0,0,1024.95,8,541986.85,24,5,18,1,True
2075198,200,0,25,5634,956721481,0,0,0,1025.0,8,540961.85,9,0,20,1,True
2207728,330,3,30,1650,956721481,0,0,0,1025.14,8,539936.71,11,0,6,4,True
2590387,1125,1,10,7634,956721481,0,0,0,1024.78,6,540961.49,24,3,2,5,True
2610975,1312,0,10,5810,956721481,0,0,0,1024.94,0,541986.43,5,0,22,5,True
2662288,309,0,20,4964,956721481,0,0,0,1024.88,3,540961.55,4,2,22,6,True
2694371,52,4,25,4189,956721481,0,0,0,1024.96,8,539936.59,20,1,14,6,True
3039693,1304,0,10,3803,956721481,0,0,0,1024.9,6,540961.49,5,2,10,7,True
3051341,1114,1,10,7674,956721481,0,0,0,1025.0,0,541986.49,0,4,5,8,True
3194846,402,3,451,3182,956721481,0,0,0,1024.76,7,540961.73,10,3,9,8,True
3709235,917,0,20,5045,956721481,0,0,0,1025.09,3,539936.64,18,2,6,9,True
3858113,330,3,451,5810,956721481,0,0,0,1024.93,7,538911.71,11,6,14,10,True
3860647,982,4,25,3006,956721481,0,0,0,1025.02,8,537886.69,22,4,14,10,True
4089068,320,1,-1,5045,956721481,0,1,0,1025.02,4,537886.69,11,0,8,10,True
4206165,917,0,-1,2377,956721481,0,2,0,1024.98,4,537886.69,18,4,8,11,True
4276809,402,3,30,3803,956721481,0,0,0,1024.88,8,536861.81,10,5,0,11,True
4371207,320,1,30,8694,956721481,0,0,0,1025.02,8,535836.79,11,6,5,12,True
4432976,402,3,25,1650,956721481,0,0,0,1024.8,8,534811.99,10,3,17,12,True
4725374,402,3,-1,1650,956721481,0,1,0,1024.98,4,534811.99,10,2,3,1,True
4727671,201,1,10,4912,956721481,0,0,0,1024.68,0,535836.67,9,5,4,1,True
4909976,52,4,-1,3182,956721481,0,1,0,1024.95,4,535836.67,20,3,23,1,True
4972718,761,2,20,9733,956721481,0,0,0,1024.74,5,534811.93,24,5,19,3,True
5056365,52,4,25,4912,956721481,0,0,0,1025.07,8,533786.86,20,1,4,4,True
5253440,200,0,25,8694,956721481,0,0,0,1024.96,8,532761.9,9,3,8,4,True
5588922,402,3,451,3006,956721481,0,0,0,1024.94,7,531736.96,10,2,23,5,True
5653956,402,3,30,7634,956721481,0,0,0,1024.86,8,530712.1,10,3,10,5,False
5873150,917,0,30,4964,956721481,0,0,0,1025.12,8,529686.98,18,0,17,6,True
5898869,330,3,-1,2410,956721481,0,1,0,1025.2,1,529686.98,11,2,18,7,False
6130084,599,0,20,7547,956721481,0,0,0,1024.88,5,528662.1,24,5,10,7,True
6185443,330,3,25,3026,956721481,0,0,0,1024.9,8,527637.2,11,4,17,7,True
6695067,211,0,20,2338,956721481,0,0,0,1024.95,3,526612.25,9,5,17,8,True
6821335,52,4,30,4964,956721481,0,0,0,1025.24,8,525587.01,20,2,11,9,True
6980781,1116,0,20,5045,956721481,0,0,0,1025.08,3,524561.93,24,4,15,9,True
7013058,917,0,451,5428,956721481,0,0,0,1024.9,7,523537.03,18,6,4,10,True
7282167,982,4,451,7547,956721481,0,0,0,1025.18,7,522511.85,22,4,8,10,True
7335016,200,0,30,4964,956721481,0,0,0,1025.07,8,521486.78,9,2,15,1,True
7578302,734,0,10,8139,956721481,0,0,0,1025.11,6,522511.89,11,2,4,1,True
8139776,52,4,-1,3182,956721481,0,1,0,1024.71,1,522511.89,20,4,5,1,False
8361284,1409,1,10,4912,956721481,0,0,0,1025.1,6,523536.99,24,3,17,2,True
8748689,200,0,451,2338,956721481,0,0,0,1025.0,7,522511.99,9,5,5,3,True
8814040,330,3,-1,3803,956721481,0,1,0,1024.86,1,522511.99,11,5,13,4,True
8861808,1208,4,25,8694,956721481,0,0,0,1025.35,8,521486.64,24,6,18,4,True
8878841,200,0,30,3545,956721481,0,0,0,1025.03,8,520461.61,9,0,22,4,False
8923170,402,3,-1,4189,956721481,0,1,0,1025.19,4,520461.61,10,6,11,5,True
9004929,64,0,20,8694,956721481,0,0,0,1024.85,5,519436.76,20,3,2,5,True
9104034,917,0,25,1650,956721481,0,0,0,1024.88,8,518411.88,18,2,4,6,True
9128668,982,4,25,8694,956721481,0,0,0,1024.89,8,517386.99,22,1,4,7,True
9253963,1208,4,451,3026,956721481,0,0,0,1025.22,7,516361.77,24,2,14,7,True
9335848,320,1,30,2410,956721481,0,0,0,1024.9,8,515336.87,11,1,12,7,True
9356191,52,4,451,7547,956721481,0,0,0,1024.8,7,514312.07,20,3,16,8,True
9462560,320,1,-1,7634,956721481,0,1,0,1025.12,1,514312.07,11,6,20,10,True
9496643,52,4,30,2377,956721481,0,0,0,1024.73,8,513287.34,20,1,13,11,True
9830752,982,4,451,5810,956721481,0,0,0,1025.24,7,512262.1,22,2,11,11,True
9958671,1303,0,20,7674,956721481,0,0,0,1025.04,5,511237.06,5,6,14,11,True
1072382,1211,4,451,9095,658810916,1,0,0,319.92,7,270113.08,24,1,14,1,True
1093493,112,4,-1,7454,658810916,1,1,0,320.03,1,270113.08,3,2,6,1,True
1145712,319,0,20,4249,658810916,1,0,0,319.92,5,269793.16,11,0,17,1,True
1560600,201,1,10,6124,658810916,1,0,0,319.86,0,270113.02,9,3,1,4,True
1574772,342,0,10,5318,658810916,1,0,0,320.2,6,270433.22,24,3,12,4,True
1604196,1211,4,25,2389,658810916,1,0,0,319.94,8,270113.28,24,2,12,5,True
1637663,1140,0,20,2517,658810916,1,0,0,319.89,5,269793.39,15,5,8,5,True
1724244,897,0,30,2389,658810916,1,0,0,319.84,8,269473.55,24,0,7,5,True
1772841,260,0,20,8772,658810916,1,0,0,320.01,5,269153.54,6,5,14,5,True
1776970,147,0,10,1439,658810916,1,0,0,319.83,6,269473.37,18,2,1,6,True
1826419,594,0,10,8143,658810916,1,0,0,319.88,6,269793.25,24,4,8,6,True
2351807,112,4,451,4249,658810916,1,0,0,320.25,7,269473.0,3,1,1,7,True
2398542,1164,0,10,2389,658810916,1,0,0,319.88,6,269792.88,24,6,6,8,True
2839073,112,4,451,8772,658810916,1,0,0,320.12,7,269472.76,3,2,18,10,True
3064779,1211,4,451,1439,658810916,1,0,0,319.97,7,269152.79,24,4,8,12,True
3295010,1111,0,30,7454,658810916,1,0,0,320.23,8,268832.56,0,4,23,12,True
3424687,1111,0,451,9163,658810916,1,0,0,320.13,7,268512.43,0,3,21,1,True
3452137,644,0,20,7652,658810916,1,0,0,319.76,5,268192.67,24,0,10,2,True
3474428,1102,2,20,6124,658810916,1,0,0,319.92,5,267872.75,0,6,8,3,True
3760971,662,1,10,7454,658810916,1,0,0,319.76,0,268192.51,18,0,13,4,True
3952169,1102,2,20,7652,658810916,1,0,0,319.94,5,267872.57,0,3,4,4,True
4053285,1111,0,30,5318,658810916,1,0,0,320.01,8,267552.56,0,5,0,4,True
4290037,897,0,30,1784,658810916,1,0,0,320.23,8,267232.33,24,5,20,5,True
4292485,1009,0,10,7454,658810916,1,0,0,320.11,0,267552.44,26,2,3,5,True
4779780,897,0,-1,9236,658810916,1,1,0,320.25,1,267552.44,24,6,20,5,True
4784557,1211,4,30,9163,658810916,1,0,0,319.95,8,267232.49,24,6,12,6,True
4801323,732,0,20,5318,658810916,1,0,0,320.1,3,266912.39,11,0,13,7,True
5069990,1111,0,25,7454,658810916,1,0,0,320.0,8,266592.39,0,1,10,8,True
5159413,937,0,20,9163,658810916,1,0,0,319.96,3,266272.43,24,3,4,8,True
5250363,56,4,-1,1439,658810916,1,1,0,320.11,1,266272.43,20,2,10,9,True
5274192,1111,0,-1,4249,658810916,1,2,0,319.87,4,266272.43,0,2,10,10,True
5291471,1101,2,30,2517,658810916,1,0,0,320.2,8,265952.23,0,1,11,10,True
5389772,269,0,20,4249,658810916,1,0,0,319.73,3,265632.5,24,0,8,10,True
5421553,112,4,451,4249,658810916,1,0,0,319.86,7,265312.64,3,4,11,11,True
5618585,1111,0,451,8772,658810916,1,0,0,320.13,7,264992.51,0,1,2,11,True
5635128,1211,4,-1,5318,658810916,1,1,0,319.96,1,264992.51,24,0,0,11,True
5810781,669,2,20,2517,658810916,1,0,0,320.09,3,264672.42,18,0,20,12,True
6208472,588,0,10,2517,658810916,1,0,0,320.09,6,264992.51,24,3,2,12,True
6403920,1297,0,20,9163,658810916,1,0,0,319.88,5,264672.63,5,4,1,12,True
6417371,897,0,451,1439,658810916,1,0,0,319.88,7,264352.75,24,1,3,12,True
6475936,137,2,20,8772,658810916,1,0,0,320.07,5,264032.68,18,0,4,12,True
6503422,20,0,10,3769,658810916,1,0,0,320.0,6,264352.68,24,6,18,1,True
6557328,28,1,-1,1398,658810916,1,1,0,320.2,4,264352.68,11,0,13,2,False
6558520,1111,0,30,7652,658810916,1,0,0,319.61,8,264033.07,0,4,9,2,True
6773834,1111,0,451,1398,658810916,1,0,0,320.35,7,263712.72,0,1,21,3,True
7462644,1246,0,10,1398,658810916,1,0,0,319.79,6,264032.51,23,4,14,3,True
7475150,297,0,10,9095,658810916,1,0,0,320.2,6,264352.71,4,5,13,5,True
7629304,28,1,-1,9163,658810916,1,1,0,319.9,4,264352.71,11,3,20,7,True
7639956,1101,2,25,3769,658810916,1,0,0,320.11,8,264032.6,0,4,5,8,True
7794148,1101,2,451,1398,658810916,1,0,0,319.92,7,263712.68,0,0,5,8,True
8105154,112,4,25,1784,658810916,1,0,0,319.96,8,263392.72,3,5,9,9,True
8250065,1211,4,451,1439,658810916,1,0,0,320.0,7,263072.72,24,0,21,9,True
8397096,1206,0,20,4249,658810916,1,0,0,320.13,3,262752.59,24,5,15,10,True
8505585,1211,4,451,4249,658810916,1,0,0,319.81,7,262432.78,24,0,13,10,True
9023712,564,0,20,4249,658810916,1,0,0,319.68,3,262113.1,17,1,18,11,True
9593170,1012,0,10,3023,658810916,1,0,0,319.85,6,262432.95,26,4,18,11,True
1010350,1195,1,451,1660,201244212,0,0,0,495.95,7,965696.05,24,5,5,1,True
1087626,1195,1,451,8492,201244212,0,0,0,495.89,7,965200.16,24,3,7,2,True
1124106,620,3,451,4695,201244212,0,0,0,495.99,7,964704.17,11,0,16,2,True
1151845,1195,1,25,5563,201244212,0,0,0,496.02,8,964208.15,24,2,13,3,True
1194045,574,2,30,3906,201244212,0,0,0,495.96,8,963712.19,11,1,2,3,True
1400489,1124,0,10,5139,201244212,0,0,0,496.05,6,964208.24,24,3,0,4,True
1519606,1195,1,25,7056,201244212,0,0,0,496.11,8,963712.13,24,0,14,5,True
1555854,1111,0,10,2148,201244212,0,0,0,495.72,0,964207.85,0,6,16,6,True
1632994,1144,2,30,5139,201244212,0,0,0,496.05,8,963711.8,15,3,0,6,True
1924761,620,3,-1,7508,201244212,0,1,0,495.62,1,963711.8,11,3,9,8,True
1990646,1443,4,451,4209,201244212,0,0,0,496.22,7,963215.58,24,1,14,9,True
2136387,620,3,-1,9232,201244212,0,1,0,495.98,4,963215.58,11,3,5,10,True
2294997,1195,1,25,3208,201244212,0,0,0,496.05,8,962719.53,24,0,19,10,True
2629185,1144,2,30,7508,201244212,0,0,0,496.21,8,962223.32,15,3,14,11,True
2642993,574,2,-1,2314,201244212,0,1,0,495.87,4,962223.32,11,2,21,12,True
2705437,1195,1,30,8193,201244212,0,0,0,495.87,8,961727.45,24,0,15,1,True
3083489,1443,4,25,8492,201244212,0,0,0,496.14,8,961231.31,24,5,19,1,True
3182223,1012,0,20,4695,201244212,0,0,0,496.03,5,960735.28,26,5,16,2,True
3201932,574,2,25,4209,201244212,0,0,0,496.02,8,960239.26,11,6,3,2,True
3740763,553,1,451,2314,201244212,0,0,0,496.12,7,959743.14,17,0,8,2,True
3783657,1443,4,451,6656,201244212,0,0,0,495.66,7,959247.48,24,0,12,2,True
4021939,1195,1,25,1660,201244212,0,0,0,495.97,8,958751.51,24,6,12,2,True
4151972,537,0,20,1660,201244212,0,0,0,496.04,5,958255.47,18,2,8,3,True
4175957,1144,2,451,2314,201244212,0,0,0,495.93,7,957759.54,15,5,14,3,True
4638352,652,0,20,8063,201244212,0,0,0,496.13,3,957263.41,24,5,19,4,True
4744436,1195,1,451,4687,201244212,0,0,0,496.06,7,956767.35,24,1,3,4,True
5006197,553,1,25,1367,201244212,0,0,0,495.79,8,956271.56,17,2,7,4,True
5227578,574,2,25,2808,201244212,0,0,0,495.95,8,955775.61,11,3,1,4,True
5612603,738,2,30,4209,201244212,0,0,0,495.77,8,955279.84,11,0,2,4,True
5775250,790,0,10,9232,201244212,0,0,0,495.99,0,955775.83,11,0,4,5,True
5856203,1195,1,30,4695,201244212,0,0,0,496.07,8,955279.76,24,6,14,5,True
5987801,738,2,30,8492,201244212,0,0,0,495.94,8,954783.82,11,0,23,5,True
6072789,1195,1,30,2148,201244212,0,0,0,496.28,8,954287.54,24,4,3,6,True
6263087,1443,4,30,7626,201244212,0,0,0,495.77,8,953791.77,24,1,0,6,True
6288129,553,1,451,5139,201244212,0,0,0,495.78,7,953295.99,17,3,19,7,True
6648687,665,2,20,6541,201244212,0,0,0,495.75,5,952800.24,18,0,2,8,True
6765938,574,2,-1,7508,201244212,0,1,0,495.9,4,952800.24,11,2,7,9,True
6949114,1195,1,451,4695,201244212,0,0,0,495.87,7,952304.37,24,2,9,9,True
7012529,553,1,451,1496,201244212,0,0,0,496.01,7,951808.36,17,5,13,9,False
7294480,1144,2,30,9265,201244212,0,0,0,496.05,8,951312.31,15,2,12,10,True
7505227,211,0,10,6277,201244212,0,0,0,496.08,6,951808.39,9,5,3,10,True
7547206,1195,1,30,8063,201244212,0,0,0,495.85,8,951312.54,24,6,11,11,True
7741066,238,0,20,2307,201244212,0,0,0,495.93,5,950816.61,26,4,12,11,True
7830649,574,2,451,6656,201244212,0,0,0,496.33,7,950320.28,11,2,3,12,True
7977958,1315,0,20,8268,201244212,0,0,0,496.02,3,949824.26,5,6,10,1,True
8379121,956,1,10,2148,201244212,0,0,0,496.14,6,950320.4,13,3,14,2,True
8511987,211,0,20,7508,201244212,0,0,0,495.88,5,949824.52,9,0,16,4,True
8556711,1227,0,10,6656,201244212,0,0,0,495.89,6,950320.41,18,5,9,6,True
8632322,1443,4,-1,6277,201244212,0,1,0,495.86,1,950320.41,24,6,10,7,True
8644743,132,2,20,3906,201244212,0,0,0,495.87,3,949824.54,18,4,19,8,True
8769334,1144,2,451,4687,201244212,0,0,0,496.12,7,949328.42,15,3,7,8,True
8890794,1132,0,10,2148,201244212,0,0,0,495.83,0,949824.25,24,1,13,9,True
8932166,574,2,-1,5139,201244212,0,1,0,495.89,4,949824.25,11,2,19,9,True
9202579,1201,0,20,4687,201244212,0,0,0,495.72,3,949328.53,24,1,11,10,True
9310010,1195,1,451,3906,201244212,0,0,0,495.8,7,948832.73,24,2,21,10,True
9318184,738,2,30,1647,201244212,0,0,0,495.95,8,948336.78,11,3,11,10,True
9542151,1144,2,-1,4687,201244212,0,1,0,496.03,4,948336.78,15,5,17,10,True
9651090,951,0,20,6656,201244212,0,0,0,495.99,5,947840.79,24,0,9,11,True
9861746,404,1,10,8268,201244212,0,0,0,495.82,6,948336.61,10,0,18,11,True
1002188,224,3,451,4183,955496040,0,0,0,1058.1,7,937385.9,26,3,0,1,True
1229156,895,0,451,6083,955496040,0,0,0,1057.82,7,936328.08,24,6,1,1,True
1319774,632,4,25,8105,955496040,0,0,0,1057.9,8,935270.18,11,4,15,2,True
1414826,561,4,25,8984,955496040,0,0,0,1058.16,8,934212.02,17,5,5,2,True
1658847,1151,4,451,4183,955496040,0,0,0,1058.11,7,933153.91,15,4,8,3,True
1668109,459,1,10,8105,955496040,0,0,0,1057.92,0,934211.83,13,4,15,3,True
1711709,962,0,20,5111,955496040,0,0,0,1057.98,5,933153.85,13,0,13,6,True
1806428,1062,3,25,8105,955496040,0,0,0,1057.98,8,932095.87,11,4,2,7,True
1922594,632,4,451,5795,955496040,0,0,0,1058.3,7,931037.57,11,5,12,7,True
1926390,632,4,25,8984,955496040,0,0,0,1057.76,8,929979.81,11,5,0,8,True
2044559,224,3,451,9752,955496040,0,0,0,1058.16,7,928921.65,26,3,14,9,True
2233110,1151,4,30,1752,955496040,0,0,0,1058.04,8,927863.61,15,0,15,10,True
2255343,1151,4,30,3178,955496040,0,0,0,1058.09,8,926805.52,15,0,8,11,True
2338083,35,2,20,4183,955496040,0,0,0,1058.18,5,925747.34,11,4,9,11,True
2391719,632,4,30,2048,955496040,0,0,0,1058.03,8,924689.31,11,6,20,11,True
2422299,1151,4,451,9752,955496040,0,0,0,1058.16,7,923631.15,15,3,20,12,True
3816333,632,4,25,7911,955496040,0,0,0,1057.84,8,922573.31,11,3,23,1,True
4004033,895,0,451,3697,955496040,0,0,0,1057.81,7,921515.5,24,6,11,1,True
4153993,1413,0,20,9850,955496040,0,0,0,1057.84,5,920457.66,24,3,21,2,True
4181617,1062,3,451,4191,955496040,0,0,0,1058.03,7,919399.63,11,1,4,2,True
4355226,561,4,25,1023,955496040,0,0,0,1057.93,8,918341.7,17,0,16,3,True
4479417,184,0,20,5477,955496040,0,0,0,1058.07,5,917283.63,18,2,21,3,True
4512858,1062,3,451,8168,955496040,0,0,0,1057.77,7,916225.86,11,5,17,3,False
4547322,1151,4,25,3446,955496040,0,0,0,1057.95,8,915167.91,15,4,0,3,True
4741480,561,4,30,9850,955496040,0,0,0,1057.92,8,914109.99,17,5,7,4,True
4968547,895,0,30,7911,955496040,0,0,0,1057.99,8,913052.0,24,2,10,4,True
4983692,224,3,30,3697,955496040,0,0,0,1058.01,8,911993.99,26,2,23,5,True
5311746,1151,4,30,7176,955496040,0,0,0,1058.15,8,910935.84,15,6,10,7,True
5426603,1151,4,451,4191,955496040,0,0,0,1058.15,7,909877.69,15,0,1,8,True
5532455,844,1,10,9438,955496040,0,0,0,1057.99,6,910935.68,5,4,13,9,True
5595161,620,3,30,7781,955496040,0,0,0,1058.01,8,909877.67,11,3,8,10,True
5632243,677,0,20,9438,955496040,0,0,0,1057.85,5,908819.82,24,1,3,11,True
5804326,632,4,451,4062,955496040,0,0,0,1058.18,7,907761.64,11,5,16,11,False
6397609,632,4,25,7911,955496040,0,0,0,1057.85,8,906703.79,11,5,17,11,True
6546599,632,4,-1,5111,955496040,0,1,0,1058.14,4,906703.79,11,6,8,11,False
6695385,895,0,30,6083,955496040,0,0,0,1058.12,8,905645.67,24,5,10,11,True
6814347,632,4,25,3178,955496040,0,0,0,1058.26,8,904587.41,11,3,3,2,True
6962614,632,4,-1,9752,955496040,0,1,0,1057.87,4,904587.41,11,1,23,2,True
7221046,1062,3,25,3935,955496040,0,0,0,1057.93,8,903529.48,11,3,2,3,True
7458285,620,3,25,7658,955496040,0,0,0,1058.15,8,902471.33,11,1,13,4,True
7601973,215,0,10,9850,955496040,0,0,0,1057.96,0,903529.29,9,6,11,4,True
8074088,895,0,25,2048,955496040,0,0,0,1057.77,8,902471.52,24,3,21,4,True
8118068,642,0,20,1023,955496040,0,0,0,1057.65,3,901413.87,24,5,18,8,True
8508639,632,4,451,2563,955496040,0,0,0,1057.55,7,900356.32,11,1,3,9,True
8781427,224,3,25,7176,955496040,0,0,0,1058.02,8,899298.3,26,3,23,9,True
8939785,561,4,451,9752,955496040,0,0,0,1058.16,7,898240.14,17,3,7,10,True
8949606,1062,3,451,9850,955496040,0,0,0,1058.19,7,897181.95,11,0,20,10,True
9125071,1151,4,25,3178,955496040,0,0,0,1057.97,8,896123.98,15,1,8,10,True
9196277,1069,1,10,9438,955496040,0,0,0,1058.46,6,897182.44,18,0,13,10,False
9799711,787,0,10,1023,955496040,0,0,0,1057.91,6,898240.35,14,5,9,10,True
9878862,372,0,10,7781,955496040,0,0,0,1057.91,6,899298.26,25,0,17,11,True
9946390,895,0,451,4183,955496040,0,0,0,1058.08,7,898240.18,24,2,13,11,True
1242717,1421,0,30,3335,268329228,0,0,0,1125.15,8,501686.85,24,1,11,1,True
1250948,1035,0,10,7291,268329228,0,0,0,1125.01,0,502811.86,11,5,22,2,True
1266784,1217,0,20,9587,268329228,0,0,0,1124.97,5,501686.89,24,6,22,2,True
1417597,1112,1,30,3335,268329228,0,0,0,1124.85,8,500562.04,0,2,20,3,True
1894238,703,0,451,8192,268329228,0,0,0,1124.89,7,499437.15,18,1,7,4,True
1900497,542,0,10,9871,268329228,0,0,0,1124.9,6,500562.05,17,2,19,4,True
2119418,979,0,10,7766,268329228,0,0,0,1124.97,6,501687.02,22,5,11,5,True
2370335,703,0,25,7766,268329228,0,0,0,1125.1,8,500561.92,18,5,4,5,True
2537160,384,3,30,8192,268329228,0,0,0,1124.9,8,499437.02,25,4,21,5,True
2700701,1112,1,451,3117,268329228,0,0,0,1125.13,7,498311.89,0,6,7,6,True
2741588,866,0,10,3117,268329228,0,0,0,1125.1,6,499436.99,24,0,11,6,True
3350597,956,1,451,9110,268329228,0,0,0,1125.08,7,498311.91,13,1,1,6,True
3388545,1112,1,-1,7291,268329228,0,1,0,1125.05,4,498311.91,0,5,15,7,True
3397862,384,3,451,8192,268329228,0,0,0,1124.97,7,497186.94,25,5,12,7,True
3570017,1112,1,25,5848,268329228,0,0,0,1125.16,8,496061.78,0,1,23,8,True
3590157,384,3,451,4604,268329228,0,0,0,1125.06,7,494936.72,25,1,11,9,True
3864255,1112,1,451,9587,268329228,0,0,0,1124.95,7,493811.77,0,1,15,9,True
4177725,703,0,30,9871,268329228,0,0,0,1124.78,8,492686.99,18,1,15,9,True
4366709,384,3,30,4604,268329228,0,0,0,1125.06,8,491561.93,25,2,9,9,True
4386887,1170,0,10,8192,268329228,0,0,0,1125.24,6,492687.17,24,6,3,10,True
4589144,1112,1,451,3335,268329228,0,0,0,1125.16,7,491562.01,0,5,8,10,True
4979358,956,1,451,3117,268329228,0,0,0,1124.9,7,490437.11,13,4,12,11,True
5256525,1089,0,10,9871,268329228,0,0,0,1125.14,6,491562.25,18,6,12,11,True
5412940,384,3,30,9110,268329228,0,0,0,1125.09,8,490437.16,25,3,14,12,True
5501206,1421,0,451,3117,268329228,0,0,0,1124.98,7,489312.18,24,0,14,1,True
5647381,1112,1,451,8789,268329228,0,0,0,1124.79,7,488187.39,0,1,21,1,True
5801076,384,3,451,9587,268329228,0,0,0,1124.86,7,487062.53,25,1,17,3,True
6118367,703,0,25,9815,268329228,0,0,0,1124.91,8,485937.62,18,3,2,4,True
6125881,1076,1,10,7766,268329228,0,0,0,1124.83,0,487062.45,18,1,12,5,True
6283385,703,0,30,6388,268329228,0,0,0,1125.13,8,485937.32,18,4,13,6,True
6442597,97,0,20,9871,268329228,0,0,0,1124.83,5,484812.49,3,1,15,6,True
6486267,670,0,20,4604,268329228,0,0,0,1125.09,5,483687.4,18,5,8,8,True
6666935,1421,0,25,8789,268329228,0,0,0,1124.95,8,482562.45,24,4,21,8,True
6803595,384,3,25,9815,268329228,0,0,0,1125.17,8,481437.28,25,3,19,8,True
6866826,183,1,10,9815,268329228,0,0,0,1125.07,6,482562.35,18,2,5,8,True
7018849,384,3,-1,6388,268329228,0,1,0,1124.56,1,482562.35,25,3,12,9,True
7272886,703,0,25,7291,268329228,0,0,0,1124.84,8,481437.51,18,5,13,9,True
7301467,1421,0,25,7402,268329228,0,0,0,1125.09,8,480312.42,24,3,21,12,True
7560537,703,0,30,7291,268329228,0,0,0,1125.14,8,479187.28,18,4,2,12,True
7670217,384,3,25,7291,268329228,0,0,0,1124.95,8,478062.33,25,0,15,1,True
7838099,1112,1,451,8192,268329228,0,0,0,1124.96,7,476937.37,0,3,16,1,True
7863482,562,1,10,5848,268329228,0,0,0,1125.06,0,478062.43,17,2,3,1,True
8308066,384,3,-1,8192,268329228,0,1,0,1124.83,4,478062.43,25,6,19,2,True
8440994,384,3,451,3117,268329228,0,0,0,1125.02,7,476937.41,25,2,4,2,False
8642232,956,1,25,3117,268329228,0,0,0,1124.87,8,475812.54,13,6,7,5,True
8679507,1421,0,451,9871,268329228,0,0,0,1124.97,7,474687.57,24,3,14,5,True
9117977,848,2,20,9871,268329228,0,0,0,1124.84,3,473562.73,5,1,4,6,True
9233103,384,3,451,9815,268329228,0,0,0,1124.93,7,472437.8,25,3,21,7,True
9594592,1112,1,25,3117,268329228,0,0,0,1124.96,8,471312.84,0,3,3,9,True
9712903,1421,0,30,5848,268329228,0,0,0,1125.13,8,470187.71,24,5,23,9,True
9809743,1112,1,451,4604,268329228,0,0,0,1125.05,7,469062.66,0,3,7,10,True
9840712,384,3,30,9871,268329228,0,0,0,1124.94,8,467937.72,25,5,14,11,True
1203755,488,3,451,7933,496227508,1,0,0,837.0,7,438574.0,12,5,8,1,True
1321445,1060,1,10,9155,496227508,1,0,0,837.26,6,439411.26,11,1,6,1,True
1402754,191,3,25,4647,496227508,1,0,0,837.02,8,438574.24,18,3,11,1,True
1477498,1314,2,20,4190,496227508,1,0,0,837.02,3,437737.22,5,0,5,2,True
1482194,488,3,451,7528,496227508,1,0,0,836.95,7,436900.27,12,1,5,2,True
1622298,456,4,451,8027,496227508,1,0,0,836.92,7,436063.35,13,2,14,5,True
1849782,1468,1,10,7933,496227508,1,0,0,837.22,0,436900.57,11,6,20,6,True
1922917,1072,0,25,1915,496227508,1,0,0,836.97,8,436063.6,18,6,8,7,True
2386703,1265,4,451,9326,496227508,1,0,0,836.82,7,435226.78,23,6,14,7,True
2402346,456,4,451,7528,496227508,1,0,0,836.91,7,434389.87,13,3,9,8,True
2504282,1476,0,10,9326,496227508,1,0,0,836.88,6,435226.75,24,0,3,8,True
2651131,1265,4,30,3750,496227508,1,0,0,837.08,8,434389.67,23,4,1,8,True
2747941,907,0,10,4139,496227508,1,0,0,836.85,6,435226.52,2,0,12,8,True
2812226,1467,0,10,4647,496227508,1,0,0,837.06,6,436063.58,11,5,17,9,True
2850104,1265,4,30,8778,496227508,1,0,0,837.14,8,435226.44,23,6,15,9,True
2957348,1233,0,10,3720,496227508,1,0,0,837.1,6,436063.54,18,3,22,10,True
3134390,488,3,25,5084,496227508,1,0,0,837.05,8,435226.49,12,0,21,10,True
3149854,456,4,25,9155,496227508,1,0,0,836.94,8,434389.55,13,2,13,10,True
3252608,488,3,451,3720,496227508,1,0,0,837.04,7,433552.51,12,1,18,11,True
3302885,456,4,25,9155,496227508,1,0,0,836.95,8,432715.56,13,5,10,12,True
3323740,1265,4,25,9572,496227508,1,0,0,837.04,8,431878.52,23,5,13,4,True
3500121,1072,0,-1,4139,496227508,1,1,0,837.19,1,431878.52,18,1,18,5,True
3516751,488,3,451,9326,496227508,1,0,0,836.84,7,431041.68,12,5,5,6,True
3901097,203,0,20,5670,496227508,1,0,0,836.91,5,430204.77,9,5,18,6,True
4003647,456,4,-1,9572,496227508,1,1,0,836.9,1,430204.77,13,0,7,6,True
4098436,1231,2,20,9572,496227508,1,0,0,836.83,3,429367.94,18,1,4,7,True
4373308,456,4,30,9572,496227508,1,0,0,836.92,8,428531.02,13,3,16,7,True
4430354,361,4,-1,3720,496227508,1,1,0,836.96,4,428531.02,24,2,13,7,True
4772589,145,0,20,7917,496227508,1,0,0,837.05,5,427693.97,18,2,14,8,True
5144280,1265,4,-1,3720,496227508,1,1,0,836.59,4,427693.97,23,3,12,8,True
5174551,860,1,25,7528,496227508,1,0,0,836.92,8,426857.05,24,5,15,8,True
5228942,1072,0,451,6131,496227508,1,0,0,836.98,7,426020.07,18,0,3,8,True
5704255,456,4,30,8027,496227508,1,0,0,837.19,8,425182.88,13,0,18,8,True
6034497,488,3,25,3720,496227508,1,0,0,836.97,8,424345.91,12,2,4,9,True
6035908,1265,4,451,9572,496227508,1,0,0,836.85,7,423509.06,23,3,4,10,True
6228909,1265,4,-1,7044,496227508,1,1,0,837.01,4,423509.06,23,5,2,11,True
6395276,774,2,20,3750,496227508,1,0,0,837.04,5,422672.02,14,3,5,12,True
6628184,759,0,10,7917,496227508,1,0,0,837.12,6,423509.14,24,3,6,12,True
6849569,1265,4,451,8778,496227508,1,0,0,836.97,7,422672.17,23,3,1,1,True
7088893,1072,0,451,9326,496227508,1,0,0,837.1,7,421835.07,18,1,19,2,True
7622165,729,0,20,1646,496227508,1,0,0,836.93,5,420998.14,11,5,18,3,True
7701380,1265,4,30,7933,496227508,1,0,0,837.0,8,420161.14,23,4,18,3,True
7870595,1140,0,20,3019,496227508,1,0,0,837.07,3,419324.07,15,2,20,4,True
7888536,1265,4,25,4139,496227508,1,0,0,837.07,8,418487.0,23,1,15,5,True
8119146,488,3,-1,3019,496227508,1,1,0,837.09,4,418487.0,12,3,8,6,True
8180998,1318,0,20,8778,496227508,1,0,0,836.89,5,417650.11,18,4,7,6,True
8252047,1201,0,10,4139,496227508,1,0,0,836.93,0,418487.04,24,3,3,6,True
8506839,1156,1,10,1646,496227508,1,0,0,837.04,6,419324.08,15,3,12,6,True
8522008,488,3,30,9155,496227508,1,0,0,837.01,8,418487.07,12,3,15,7,True
8565517,611,0,20,4190,496227508,1,0,0,837.01,5,417650.06,11,3,1,9,True
8619598,361,4,25,1646,496227508,1,0,0,837.08,8,416812.98,24,5,17,10,True
8783428,346,0,10,1915,496227508,1,0,0,837.03,0,417650.01,24,5,11,11,True
9239560,361,4,30,1915,496227508,1,0,0,836.8,8,416813.21,24,6,8,11,True
1095991,1038,3,451,5894,373712246,0,0,0,1036.02,7,870076.98,11,5,0,1,True
1184873,1207,4,25,3284,373712246,0,0,0,1036.24,8,869040.74,24,3,8,3,True
1427595,913,0,20,8678,373712246,0,0,0,1035.87,5,868004.87,18,6,6,3,True
1512182,362,0,30,5688,373712246,0,0,0,1036.03,8,866968.84,24,2,17,4,True
1577667,560,2,20,1522,373712246,0,0,0,1036.01,5,865932.83,17,6,8,4,True
1628718,1207,4,25,7972,373712246,0,0,0,1035.88,8,864896.95,24,2,15,4,True
2202413,193,1,10,5478,373712246,0,0,0,1036.08,6,865933.03,18,1,5,4,True
2390268,476,1,10,2250,373712246,0,0,0,1035.93,6,866968.96,5,2,18,6,True
2786364,1463,2,20,7972,373712246,0,0,0,1035.88,5,865933.08,11,1,17,6,True
2948793,475,4,-1,9702,373712246,0,1,0,1035.91,4,865933.08,5,2,10,6,True
3184911,259,4,451,2250,373712246,0,0,0,1035.9,7,864897.18,6,1,22,7,True
3289331,1249,2,30,4548,373712246,0,0,0,1035.82,8,863861.36,23,3,5,7,False
3358945,1207,4,-1,8678,373712246,0,1,0,1036.0,4,863861.36,24,5,23,8,True
3443140,1038,3,25,9702,373712246,0,0,0,1035.85,8,862825.51,11,3,2,9,True
3751067,195,1,10,5478,373712246,0,0,0,1035.86,6,863861.37,18,2,8,10,True
4030290,475,4,-1,7182,373712246,0,1,0,1036.29,4,863861.37,5,5,3,10,True
4123848,939,0,10,7182,373712246,0,0,0,1035.98,6,864897.35,24,3,5,11,True
4280053,475,4,25,4049,373712246,0,0,0,1035.94,8,863861.41,5,3,3,11,True
4332767,362,0,451,3284,373712246,0,0,0,1035.95,7,862825.46,24,4,20,1,True
4587135,362,0,25,3733,373712246,0,0,0,1036.31,8,861789.15,24,5,1,1,True
4599473,1461,0,10,2250,373712246,0,0,0,1036.22,6,862825.37,11,3,10,2,True
4732498,1038,3,451,6337,373712246,0,0,0,1036.01,7,861789.36,11,2,9,2,False
4760932,1249,2,25,3284,373712246,0,0,0,1035.99,8,860753.37,23,1,11,3,False
4798147,1207,4,25,3733,373712246,0,0,0,1035.78,8,859717.59,24,5,15,3,False
4880530,362,0,30,9278,373712246,0,0,0,1035.8,8,858681.79,24,5,18,3,True
4944846,1207,4,451,3284,373712246,0,0,0,1035.97,7,857645.82,24,1,0,3,True
4967706,1207,4,451,5688,373712246,0,0,0,1036.03,7,856609.79,24,0,9,4,True
5017424,314,0,20,1226,373712246,0,0,0,1035.92,5,855573.87,4,4,9,4,True
5285592,1207,4,30,9278,373712246,0,0,0,1035.84,8,854538.03,24,0,19,4,False
5462301,1207,4,30,6734,373712246,0,0,0,1035.99,8,853502.04,24,1,12,4,True
5661798,1413,0,20,3733,373712246,0,0,0,1035.9,5,852466.14,24,0,13,5,True
5760700,630,0,20,9278,373712246,0,0,0,1035.97,3,851430.17,11,3,0,6,True
5895891,1207,4,451,7972,373712246,0,0,0,1035.96,7,850394.21,24,1,1,6,True
5934277,95,2,20,1522,373712246,0,0,0,1036.0,3,849358.21,1,1,22,6,True
6075746,1207,4,451,5688,373712246,0,0,0,1036.11,7,848322.1,24,6,6,7,True
6322299,1038,3,451,4049,373712246,0,0,0,1036.01,7,847286.09,11,0,1,7,True
6615503,1038,3,25,1226,373712246,0,0,0,1035.84,8,846250.25,11,0,1,7,True
6725003,1038,3,-1,7972,373712246,0,1,0,1036.1,4,846250.25,11,0,23,8,True
6761717,1311,2,20,1522,373712246,0,0,0,1035.92,5,845214.33,5,1,3,8,True
6781302,1038,3,451,1522,373712246,0,0,0,1035.89,7,844178.44,11,6,18,9,True
6986141,642,0,10,4548,373712246,0,0,0,1035.73,0,845214.17,24,3,7,9,True
7201540,1249,2,25,4049,373712246,0,0,0,1036.13,8,844178.04,23,6,2,10,True
7365792,362,0,-1,6734,373712246,0,1,0,1035.98,1,844178.04,24,5,7,10,True
7393338,259,4,25,8678,373712246,0,0,0,1035.95,8,843142.09,6,2,5,11,True
7488565,259,4,-1,5894,373712246,0,1,0,1036.05,4,843142.09,6,1,1,11,True
7745560,1207,4,-1,4049,373712246,0,2,0,1035.94,4,843142.09,24,2,12,12,True
8619368,670,0,20,5894,373712246,0,0,0,1035.92,5,842106.17,18,0,23,1,True
8651936,1249,2,-1,3733,373712246,0,1,0,1036.03,4,842106.17,23,3,10,2,True
8765383,910,0,20,3733,373712246,0,0,0,1036.04,5,841070.13,18,6,8,2,True
8838937,1249,2,451,7182,373712246,0,0,0,1036.06,7,840034.07,23,2,16,3,True
9103924,1038,3,30,6337,373712246,0,0,0,1036.33,8,838997.74,11,4,12,5,True
9160515,475,4,30,5688,373712246,0,0,0,1036.12,8,837961.62,5,5,23,7,True
9389112,1038,3,451,4548,373712246,0,0,0,1035.98,7,836925.64,11,0,13,7,True
9439349,1038,3,451,9278,373712246,0,0,0,1036.08,7,835889.56,11,3,15,8,True
9451964,579,0,10,8678,373712246,0,0,0,1036.08,6,836925.64,11,6,5,9,True
9748682,475,4,451,6337,373712246,0,0,0,1035.99,7,835889.65,5,3,0,10,True
9942556,259,4,25,6337,373712246,0,0,0,1035.91,8,834853.74,6,3,13,11,True
1328166,474,4,25,6964,691299089,1,0,0,472.86,8,969421.14,5,1,3,3,True
1636764,1338,0,10,7579,691299089,1,0,0,473.03,6,969894.17,18,6,17,4,True
1696608,1094,0,10,7140,691299089,1,0,0,472.89,0,970367.06,0,1,7,5,True
1986397,705,1,10,1353,691299089,1,0,0,473.0,6,970840.06,18,3,4,5,True
1992271,965,4,-1,9879,691299089,1,1,0,472.84,4,970840.06,13,1,19,5,True
2699451,203,0,10,8568,691299089,1,0,0,472.9,6,971312.96,9,5,7,5,True
2959775,318,0,20,7579,691299089,1,0,0,473.19,5,970839.77,11,4,6,6,True
3128629,548,2,451,4578,691299089,1,0,0,472.81,7,970366.96,17,4,23,6,True
3154286,309,0,10,4578,691299089,1,0,0,472.77,0,970839.73,4,5,3,7,True
3208173,965,4,-1,1680,691299089,1,1,0,473.16,4,970839.73,13,0,3,7,True
3384044,965,4,25,8568,691299089,1,0,0,473.29,8,970366.44,13,1,20,7,True
3447851,475,4,30,7830,691299089,1,0,0,472.91,8,969893.53,5,5,2,7,True
3451906,223,2,20,8568,691299089,1,0,0,473.0,5,969420.53,26,3,20,8,True
3518724,965,4,451,3168,691299089,1,0,0,473.04,7,968947.49,13,5,12,8,True
3562174,958,2,25,7579,691299089,1,0,0,472.93,8,968474.56,13,6,20,8,True
3987556,848,2,20,3168,691299089,1,0,0,473.19,3,968001.37,5,0,9,8,True
4001785,965,4,451,7140,691299089,1,0,0,473.03,7,967528.34,13,5,7,9,True
4895966,1041,0,10,4499,691299089,1,0,0,472.89,6,968001.23,11,6,1,9,True
4975245,965,4,451,2793,691299089,1,0,0,473.0,7,967528.23,13,3,7,9,True
5093696,1322,2,25,4499,691299089,1,0,0,472.78,8,967055.45,18,5,9,9,True
5310438,958,2,25,7830,691299089,1,0,0,473.04,8,966582.41,13,1,12,1,True
5396470,965,4,451,6964,691299089,1,0,0,473.17,7,966109.24,13,6,21,2,True
5486477,130,0,10,1353,691299089,1,0,0,473.23,6,966582.47,18,1,6,2,True
5718467,362,0,10,7579,691299089,1,0,0,472.91,0,967055.38,24,4,11,2,True
5825775,735,1,10,2366,691299089,1,0,0,473.14,0,967528.52,11,2,0,3,True
5860150,965,4,451,3168,691299089,1,0,0,472.85,7,967055.67,13,2,4,5,False
5872863,548,2,451,6278,691299089,1,0,0,472.92,7,966582.75,17,1,10,5,True
5905493,1037,0,20,1680,691299089,1,0,0,472.94,3,966109.81,11,1,8,6,True
6153045,958,2,451,6278,691299089,1,0,0,473.05,7,965636.76,13,2,7,7,True
6163155,792,1,10,3168,691299089,1,0,0,472.89,0,966109.65,11,2,11,7,True
6198418,958,2,-1,6316,691299089,1,1,0,472.91,1,966109.65,13,2,14,7,True
6226199,474,4,451,9879,691299089,1,0,0,473.11,7,965636.54,5,1,9,8,True
6299487,931,0,20,9879,691299089,1,0,0,473.12,5,965163.42,24,2,13,8,True
6413928,475,4,30,6964,691299089,1,0,0,472.85,8,964690.57,5,6,5,8,True
6618339,1210,0,20,3168,691299089,1,0,0,472.96,5,964217.61,24,1,7,9,True
6698788,579,0,20,9879,691299089,1,0,0,472.85,5,963744.76,11,3,16,9,True
6973582,548,2,451,5732,691299089,1,0,0,473.17,7,963271.59,17,5,22,10,True
7070569,548,2,25,4499,691299089,1,0,0,473.17,8,962798.42,17,2,16,11,True
7205479,475,4,451,6316,691299089,1,0,0,472.83,7,962325.59,5,3,18,11,True
7221552,548,2,25,4578,691299089,1,0,0,472.8,8,961852.79,17,4,22,11,True
7253570,548,2,25,6316,691299089,1,0,0,473.07,8,961379.72,17,0,9,12,True
7587140,403,0,10,4499,691299089,1,0,0,472.89,6,961852.61,10,6,14,1,True
7670724,548,2,-1,6964,691299089,1,1,0,472.99,1,961852.61,17,4,18,1,True
7923465,965,4,30,3168,691299089,1,0,0,473.21,8,961379.4,13,4,12,2,True
7931248,1322,2,451,3168,691299089,1,0,0,473.08,7,960906.32,18,3,23,5,True
8000637,958,2,451,4499,691299089,1,0,0,472.87,7,960433.45,13,4,10,5,True
8314833,910,0,10,1353,691299089,1,0,0,472.93,6,960906.38,18,1,12,6,True
8381502,965,4,451,4578,691299089,1,0,0,473.05,7,960433.33,13,3,10,6,True
8666040,475,4,25,6964,691299089,1,0,0,473.11,8,959960.22,5,0,21,7,True
8801483,376,0,10,2366,691299089,1,0,0,472.9,0,960433.12,25,1,17,8,True
9266788,958,2,451,6278,691299089,1,0,0,472.91,7,959960.21,13,4,17,9,True
9335886,1354,0,10,7830,691299089,1,0,0,473.18,6,960433.39,24,6,13,9,True
9450550,958,2,25,1680,691299089,1,0,0,473.24,8,959960.15,13,6,12,10,True
9512780,434,3,30,7830,691299089,1,0,0,472.82,8,959487.33,24,0,12,11,True
9947155,958,2,25,7830,691299089,1,0,0,472.81,8,959014.52,13,3,2,11,True
1134821,991,1,10,3218,852095186,0,0,0,421.12,6,671368.12,22,0,15,1,True
1170824,238,0,25,6741,852095186,0,0,0,421.19,8,670946.93,26,3,10,1,True
1249785,818,1,25,9828,852095186,0,0,0,420.84,8,670526.09,18,2,12,2,True
1397083,1231,2,-1,5591,852095186,0,1,0,420.99,4,670526.09,18,4,10,2,True
1499208,695,2,20,6741,852095186,0,0,0,420.86,5,670105.23,24,6,13,4,True
1900640,194,1,30,3371,852095186,0,0,0,420.68,8,669684.55,18,4,3,6,False
2113670,1231,2,25,7411,852095186,0,0,0,421.23,8,669263.32,18,2,11,6,True
2171088,654,1,25,7997,852095186,0,0,0,420.79,8,668842.53,18,4,12,7,True
2456833,1120,4,-1,3371,852095186,0,1,0,421.12,1,668842.53,24,4,15,7,True
2588085,966,4,30,5435,852095186,0,0,0,420.99,8,668421.54,13,5,23,7,True
3076439,194,1,25,9922,852095186,0,0,0,421.02,8,668000.52,18,5,2,8,True
3129383,1120,4,30,5964,852095186,0,0,0,421.14,8,667579.38,24,6,22,8,True
3575816,1120,4,25,3295,852095186,0,0,0,421.13,8,667158.25,24,1,20,8,True
3591880,1390,0,10,9365,852095186,0,0,0,421.16,0,667579.41,24,5,19,10,True
3715404,897,0,10,8413,852095186,0,0,0,420.96,6,668000.37,24,0,0,10,True
4174380,238,0,-1,3218,852095186,0,1,0,421.02,4,668000.37,26,0,16,10,True
4220035,654,1,25,7563,852095186,0,0,0,420.96,8,667579.41,18,0,11,11,True
4364950,1366,4,451,9619,852095186,0,0,0,420.91,7,667158.5,16,0,7,12,True
4486531,1231,2,25,7563,852095186,0,0,0,420.98,8,666737.52,18,2,6,1,True
4616610,194,1,25,1305,852095186,0,0,0,420.92,8,666316.6,18,0,21,1,True
4952066,194,1,25,3295,852095186,0,0,0,420.83,8,665895.77,18,0,15,2,True
5012216,654,1,451,3347,852095186,0,0,0,420.83,7,665474.94,18,2,12,2,True
5103463,1132,0,10,7100,852095186,0,0,0,420.84,6,665895.78,24,5,15,2,True
5124211,1231,2,451,3635,852095186,0,0,0,421.17,7,665474.61,18,6,23,3,True
5200316,1231,2,-1,1305,852095186,0,1,0,420.81,4,665474.61,18,2,9,3,True
5668323,1231,2,25,7563,852095186,0,0,0,421.03,8,665053.58,18,4,5,3,False
5900771,1366,4,451,5964,852095186,0,0,0,421.22,7,664632.36,16,0,10,4,True
5964508,1120,4,-1,1312,852095186,0,1,0,421.01,4,664632.36,24,1,1,4,True
6024615,966,4,-1,7411,852095186,0,2,0,421.23,1,664632.36,13,6,2,6,True
6025520,194,1,30,3635,852095186,0,0,0,420.91,8,664211.45,18,6,1,6,True
6085480,818,1,25,9828,852095186,0,0,0,421.04,8,663790.41,18,1,0,7,True
6267500,1231,2,-1,1243,852095186,0,1,0,421.02,4,663790.41,18,2,18,8,True
6321248,378,0,10,9619,852095186,0,0,0,421.14,6,664211.55,25,5,21,9,True
6343351,654,1,451,3218,852095186,0,0,0,421.19,7,663790.36,18,6,6,9,True
6384406,28,1,10,1312,852095186,0,0,0,421.14,0,664211.5,11,1,5,10,False
6458564,654,1,-1,9922,852095186,0,1,0,420.86,1,664211.5,18,4,5,12,True
6751397,1120,4,451,3218,852095186,0,0,0,420.99,7,663790.51,24,5,8,1,True
6953717,966,4,25,1243,852095186,0,0,0,421.03,8,663369.48,13,1,2,1,True
6968006,1120,4,451,5435,852095186,0,0,0,420.88,7,662948.6,24,6,20,2,True
7040788,1120,4,451,2254,852095186,0,0,0,421.1,7,662527.5,24,3,16,3,True
7636186,1314,2,20,8589,852095186,0,0,0,421.07,5,662106.43,5,0,0,4,True
7680269,966,4,451,3218,852095186,0,0,0,421.0,7,661685.43,13,1,12,4,True
7795045,135,2,20,3371,852095186,0,0,0,421.05,3,661264.38,18,6,13,5,True
7915631,498,0,10,6741,852095186,0,0,0,421.1,0,661685.48,12,2,21,5,True
8021796,1120,4,30,9922,852095186,0,0,0,420.89,8,661264.59,24,6,17,5,True
8433921,1231,2,-1,1243,852095186,0,1,0,421.02,4,661264.59,18,4,2,5,True
8508265,1231,2,25,3635,852095186,0,0,0,421.2,8,660843.39,18,2,6,7,True
8577265,565,4,451,1305,852095186,0,0,0,421.09,7,660422.3,11,2,11,7,True
8831427,1366,4,25,8936,852095186,0,0,0,421.13,8,660001.17,16,6,13,7,True
9178202,238,0,25,9365,852095186,0,0,0,420.98,8,659580.19,26,6,19,8,False
9217927,1366,4,451,3347,852095186,0,0,0,421.09,7,659159.1,16,4,4,8,True
9265607,966,4,451,9365,852095186,0,0,0,420.75,7,658738.35,13,5,6,8,False
9726740,1112,1,10,9828,852095186,0,0,0,420.89,6,659159.24,0,1,0,8,True
9960845,1226,2,20,7563,852095186,0,0,0,420.8,5,658738.44,18,4,23,9,True
9973211,1120,4,451,9828,852095186,0,0,0,421.02,7,658317.42,24,1,15,11,True
1175369,151,4,451,1143,540828728,0,0,0,613.09,7,290715.91,18,6,12,1,True
1316490,867,0,451,5923,540828728,0,0,0,612.97,7,290102.94,24,4,23,1,True
1385060,151,4,451,5923,540828728,0,0,0,613.04,7,289489.9,18,3,4,2,True
1503361,918,2,20,4067,540828728,0,0,0,613.02,3,288876.88,18,3,16,2,False
1544313,372,0,20,8632,540828728,0,0,0,612.73,5,288264.15,25,0,13,2,True
1637294,1483,0,20,3905,540828728,0,0,0,612.95,3,287651.2,24,3,9,3,True
2105395,960,3,25,9273,540828728,0,0,0,612.87,8,287038.33,13,5,15,4,True
2202237,867,0,30,1447,540828728,0,0,0,612.93,8,286425.4,24,6,22,4,True
3052607,1345,2,-1,6174,540828728,0,1,0,613.05,4,286425.4,24,2,22,5,True
3056685,867,0,451,1636,540828728,0,0,0,613.21,7,285812.19,24,6,21,5,True
3117326,1345,2,451,3935,540828728,0,0,0,612.94,7,285199.25,24,3,15,6,True
3223171,696,2,20,9375,540828728,0,0,0,612.94,5,284586.31,24,3,6,7,True
3666759,1345,2,-1,7747,540828728,0,1,0,613.09,1,284586.31,24,5,23,8,True
3783301,713,0,20,1474,540828728,0,0,0,612.92,5,283973.39,18,1,3,8,True
3952888,1409,1,10,8211,540828728,0,0,0,612.93,0,284586.32,24,5,20,9,True
4028653,304,0,25,6391,540828728,0,0,0,613.12,8,283973.2,4,6,5,9,True
4145206,304,0,25,4802,540828728,0,0,0,612.64,8,283360.56,4,1,19,9,True
4178624,1429,0,10,5789,540828728,0,0,0,612.95,6,283973.51,24,2,13,10,True
4645782,867,0,30,9273,540828728,0,0,0,612.91,8,283360.6,24,4,10,11,True
4810009,1345,2,451,8127,540828728,0,0,0,612.9,7,282747.7,24,2,6,12,True
4854207,304,0,451,8632,540828728,0,0,0,612.78,7,282134.92,4,4,17,2,True
4907373,867,0,30,4119,540828728,0,0,0,612.96,8,281521.96,24,5,6,3,True
5171685,97,0,10,1636,540828728,0,0,0,613.13,6,282135.09,3,5,17,4,True
5250831,1304,0,20,9303,540828728,0,0,0,613.18,5,281521.91,5,3,9,5,True
5297345,192,2,20,6174,540828728,0,0,0,613.11,5,280908.8,18,5,0,5,True
5569528,960,3,25,6530,540828728,0,0,0,613.23,8,280295.57,13,2,14,5,True
5671329,1009,0,10,1143,540828728,0,0,0,613.2,6,280908.77,26,3,18,6,True
5788675,1345,2,30,4837,540828728,0,0,0,612.83,8,280295.94,24,5,5,6,True
5881632,304,0,30,6174,540828728,0,0,0,612.87,8,279683.07,4,1,13,6,True
6011353,867,0,451,5923,540828728,0,0,0,612.87,7,279070.2,24,1,22,6,True
6043508,1092,1,10,6530,540828728,0,0,0,613.03,6,279683.23,18,2,1,7,True
6062378,1345,2,451,7120,540828728,0,0,0,612.92,7,279070.31,24,4,19,8,True
6093567,341,0,20,3666,540828728,0,0,0,613.14,5,278457.17,24,5,14,8,True
6288057,607,2,20,6391,540828728,0,0,0,612.91,3,277844.26,24,2,15,10,True
6390241,304,0,-1,4837,540828728,0,1,0,612.93,4,277844.26,4,0,10,10,True
6467762,960,3,-1,4960,540828728,0,2,0,612.89,4,277844.26,13,6,23,11,True
6955218,1123,2,20,9375,540828728,0,0,0,613.02,3,277231.24,24,2,5,11,True
6993168,304,0,25,4119,540828728,0,0,0,612.75,8,276618.49,4,2,22,12,True
7012155,960,3,451,9375,540828728,0,0,0,613.28,7,276005.21,13,4,12,12,True
7098484,151,4,451,9375,540828728,0,0,0,613.25,7,275391.96,18,5,5,12,True
7144382,1345,2,-1,4119,540828728,0,1,0,612.96,1,275391.96,24,6,23,12,True
7665956,480,0,10,3820,540828728,0,0,0,612.93,6,276004.89,5,5,20,2,True
7776010,522,0,10,9303,540828728,0,0,0,613.14,6,276618.03,18,4,5,3,True
7862381,304,0,30,6530,540828728,0,0,0,612.88,8,276005.15,4,4,17,4,True
8487760,304,0,451,3905,540828728,0,0,0,612.87,7,275392.28,4,6,10,6,False
8601360,304,0,451,5789,540828728,0,0,0,613.1,7,274779.18,4,0,5,7,True
8664038,151,4,-1,8211,540828728,0,1,0,612.96,1,274779.18,18,3,2,8,True
8763890,1345,2,-1,4837,540828728,0,2,0,613.08,1,274779.18,24,4,19,8,True
8850328,727,0,20,5923,540828728,0,0,0,612.88,5,274166.3,11,5,17,8,False
9007833,218,0,20,1636,540828728,0,0,0,613.16,3,273553.14,9,6,11,9,True
9311861,304,0,451,1474,540828728,0,0,0,612.98,7,272940.16,4,5,23,9,True
9465061,304,0,30,4837,540828728,0,0,0,613.07,8,272327.09,4,6,16,9,True
9996217,1288,0,20,8127,540828728,0,0,0,612.88,3,271714.21,24,6,16,10,True
1022063,1145,4,-1,4190,816927907,1,1,0,503.23,4,996798.0,15,5,6,1,True
1260445,1217,0,10,5120,816927907,1,0,0,502.78,6,997300.78,24,4,17,1,True
1372570,192,2,20,9004,816927907,1,0,0,502.95,5,996797.83,18,4,19,3,True
1373586,46,1,-1,8479,816927907,1,1,0,502.97,4,996797.83,24,2,16,3,True
1697928,384,3,30,9351,816927907,1,0,0,503.05,8,996294.78,25,0,15,3,True
1699452,1288,0,20,9306,816927907,1,0,0,502.99,5,995791.79,24,5,0,4,True
1701384,1319,1,25,8861,816927907,1,0,0,503.03,8,995288.76,18,4,12,5,True
2213221,757,0,20,9306,816927907,1,0,0,502.83,3,994785.93,24,2,19,5,True
2226758,384,3,30,4190,816927907,1,0,0,503.28,8,994282.65,25,4,21,5,True
3036167,1319,1,-1,9113,816927907,1,1,0,503.2,4,994282.65,18,6,3,5,True
3128832,670,0,20,3465,816927907,1,0,0,502.79,3,993779.86,18,1,5,5,True
3343976,1111,0,20,8703,816927907,1,0,0,502.99,5,993276.87,0,5,8,7,True
3698707,58,2,451,3465,816927907,1,0,0,502.92,7,992773.95,20,6,5,7,True
3840028,58,2,25,2161,816927907,1,0,0,503.08,8,992270.87,20,5,20,9,True
3905558,413,4,25,4190,816927907,1,0,0,503.03,8,991767.84,18,3,15,10,True
4193482,46,1,451,9306,816927907,1,0,0,502.8,7,991265.04,24,4,22,10,True
4441495,840,3,-1,9306,816927907,1,1,0,502.83,4,991265.04,5,4,11,10,True
4446077,46,1,10,8693,816927907,1,0,0,503.43,0,991768.47,24,3,21,11,True
4576131,218,0,10,3565,816927907,1,0,0,503.12,6,992271.59,9,6,17,11,True
4924859,1319,1,25,3472,816927907,1,0,0,502.97,8,991768.62,18,1,19,12,True
4969116,46,1,451,6111,816927907,1,0,0,503.19,7,991265.43,24,1,20,12,True
4969628,384,3,-1,9004,816927907,1,1,0,503.15,4,991265.43,25,1,18,12,True
5437356,228,0,10,3465,816927907,1,0,0,503.13,6,991768.56,26,6,8,1,True
5456429,840,3,-1,9351,816927907,1,1,0,503.02,1,991768.56,5,1,11,1,True
5573468,46,1,30,9306,816927907,1,0,0,502.76,8,991265.8,24,4,12,2,True
5648575,58,2,-1,7100,816927907,1,1,0,503.12,4,991265.8,20,1,19,3,True
5722933,1145,4,25,9004,816927907,1,0,0,502.94,8,990762.86,15,3,23,3,True
5803638,1137,1,10,5120,816927907,1,0,0,503.11,6,991265.97,24,6,6,4,True
5900706,384,3,451,8987,816927907,1,0,0,502.88,7,990763.09,25,4,10,4,True
6249905,1319,1,451,5120,816927907,1,0,0,502.95,7,990260.14,18,0,13,5,True
6425054,394,0,20,2974,816927907,1,0,0,502.99,5,989757.15,10,1,12,5,True
6627232,223,2,20,6495,816927907,1,0,0,503.21,3,989253.94,26,0,12,6,True
6659437,840,3,30,4190,816927907,1,0,0,503.17,8,988750.77,5,1,19,6,True
6850105,1145,4,30,9306,816927907,1,0,0,503.23,8,988247.54,15,1,21,6,True
7126467,46,1,30,2161,816927907,1,0,0,502.88,8,987744.66,24,4,2,7,True
7231892,951,0,10,5591,816927907,1,0,0,502.76,6,988247.42,24,6,7,7,True
7682391,51,0,10,2974,816927907,1,0,0,502.91,6,988750.33,20,4,13,8,True
7708370,1409,1,10,3565,816927907,1,0,0,503.11,0,989253.44,24,0,13,8,True
7735392,46,1,451,6111,816927907,1,0,0,503.11,7,988750.33,24,2,19,8,True
7831174,384,3,25,8987,816927907,1,0,0,502.72,8,988247.61,25,3,9,10,True
8074293,854,0,20,8479,816927907,1,0,0,502.89,3,987744.72,24,2,12,11,True
8270466,413,4,25,8693,816927907,1,0,0,502.89,8,987241.83,18,5,3,12,True
8392882,46,1,-1,8693,816927907,1,1,0,502.97,1,987241.83,24,0,0,12,True
8641541,1210,0,20,2974,816927907,1,0,0,502.84,5,986738.99,24,1,5,12,True
8681837,530,0,10,2161,816927907,1,0,0,503.15,0,987242.14,18,3,13,12,True
8857076,328,0,10,8987,816927907,1,0,0,502.82,6,987744.96,11,3,4,1,True
8892506,255,2,20,8987,816927907,1,0,0,503.03,5,987241.93,6,4,9,1,True
8923439,1319,1,-1,9004,816927907,1,1,0,502.83,4,987241.93,18,4,14,2,True
8961601,1145,4,-1,5120,816927907,1,2,0,503.25,4,987241.93,15,0,5,2,True
8980573,1145,4,25,4190,816927907,1,0,0,503.17,8,986738.76,15,5,20,5,True
8981675,1205,0,20,9306,816927907,1,0,0,502.95,3,986235.81,24,5,10,6,True
9294975,58,2,-1,2146,816927907,1,1,0,503.25,4,986235.81,20,3,17,6,True
9348731,840,3,25,8602,816927907,1,0,0,502.99,8,985732.82,5,0,4,7,True
9373043,1145,4,30,8693,816927907,1,0,0,502.82,8,985230.0,15,1,23,7,True
9702532,413,4,25,2974,816927907,1,0,0,503.03,8,984726.97,18,4,18,7,True
9829143,1319,1,25,6111,816927907,1,0,0,503.13,8,984223.84,18,0,15,7,True
9857311,1145,4,25,3565,816927907,1,0,0,502.93,8,983720.91,15,6,16,8,True
9896790,385,1,10,8479,816927907,1,0,0,503.21,6,984224.12,25,2,4,9,True
9992807,701,2,20,3565,816927907,1,0,0,503.15,5,983720.97,18,5,5,11,True
1297077,655,3,25,5465,625068913,0,0,0,656.17,8,134034.83,18,5,9,1,True
1351406,1124,0,20,6354,625068913,0,0,0,656.06,5,133378.77,24,0,10,1,True
1656284,1439,4,30,8556,625068913,0,0,0,655.81,8,132722.96,24,4,9,2,True
1658243,1397,4,25,8556,625068913,0,0,0,655.98,8,132066.98,24,1,5,3,True
1672387,655,3,451,5465,625068913,0,0,0,655.94,7,131411.04,18,3,12,3,True
1733756,1439,4,30,6152,625068913,0,0,0,655.96,8,130755.08,24,2,15,4,True
1956090,1397,4,25,6354,625068913,0,0,0,655.91,8,130099.17,24,5,18,4,True
2259179,328,0,-1,6830,625068913,0,1,0,655.99,4,130099.17,11,6,23,5,True
2404623,1284,2,20,5682,625068913,0,0,0,655.93,5,129443.24,24,4,4,5,True
2528558,804,0,20,8858,625068913,0,0,0,656.08,3,128787.16,11,1,4,5,True
2849973,1439,4,451,6152,625068913,0,0,0,656.19,7,128130.97,24,3,12,7,True
3057298,1439,4,30,6354,625068913,0,0,0,656.0,8,127474.97,24,2,2,8,True
3093759,1412,2,20,3192,625068913,0,0,0,655.7,3,126819.27,24,1,7,9,True
3600757,1113,1,10,6354,625068913,0,0,0,655.87,6,127475.14,0,5,5,10,True
3651078,328,0,30,6152,625068913,0,0,0,656.12,8,126819.02,11,6,7,10,True
3872812,655,3,30,6830,625068913,0,0,0,656.33,8,126162.69,18,2,0,11,True
4264397,328,0,30,8672,625068913,0,0,0,655.83,8,125506.86,11,0,20,12,True
4573542,802,2,25,8672,625068913,0,0,0,656.13,8,124850.73,11,1,8,2,True
4731399,328,0,451,6152,625068913,0,0,0,655.83,7,124194.9,11,3,4,2,True
4752831,1397,4,-1,8556,625068913,0,1,0,656.07,1,124194.9,24,4,13,3,True
5016155,1397,4,25,1548,625068913,0,0,0,656.0,8,123538.9,24,6,5,4,True
5084118,802,2,30,7024,625068913,0,0,0,656.17,8,122882.73,11,4,9,4,True
5315990,655,3,451,8858,625068913,0,0,0,656.0,7,122226.73,18,6,22,5,False
5541133,314,0,10,5476,625068913,0,0,0,655.84,0,122882.57,4,1,1,5,True
5600622,802,2,451,5682,625068913,0,0,0,655.96,7,122226.61,11,5,18,5,True
5702726,1406,0,10,8556,625068913,0,0,0,656.07,6,122882.68,24,2,6,6,True
5933595,1397,4,451,6354,625068913,0,0,0,655.57,7,122227.11,24,5,19,6,True
6101544,1439,4,-1,5476,625068913,0,1,0,655.98,1,122227.11,24,4,20,8,True
6192696,1439,4,30,7725,625068913,0,0,0,656.26,8,121570.85,24,2,6,8,True
6330634,1397,4,25,3192,625068913,0,0,0,656.06,8,120914.79,24,3,15,9,True
7019134,1439,4,451,6830,625068913,0,0,0,656.09,7,120258.7,24,4,6,9,True
7027883,1093,0,10,5465,625068913,0,0,0,655.97,6,120914.67,18,2,14,9,True
7029190,1397,4,-1,8858,625068913,0,1,0,656.3,4,120914.67,24,3,15,10,True
7115128,1397,4,25,4057,625068913,0,0,0,655.98,8,120258.69,24,1,20,10,True
7231990,1044,0,10,8672,625068913,0,0,0,655.98,6,120914.67,11,2,15,11,True
7326343,655,3,-1,3192,625068913,0,1,0,655.91,4,120914.67,18,6,23,12,True
7492888,1397,4,30,6830,625068913,0,0,0,655.87,8,120258.8,24,1,6,1,True
7562599,1397,4,451,5682,625068913,0,0,0,655.77,7,119603.03,24,3,12,1,True
8285058,1439,4,-1,1548,625068913,0,1,0,655.97,4,119603.03,24,5,5,2,True
8315424,328,0,30,7024,625068913,0,0,0,655.92,8,118947.11,11,6,6,2,True
8496030,1439,4,30,6830,625068913,0,0,0,656.17,8,118290.94,24,1,14,4,True
8576709,1397,4,-1,8672,625068913,0,1,0,656.23,1,118290.94,24,6,20,4,True
8667873,328,0,-1,4188,625068913,0,2,0,656.02,4,118290.94,11,0,4,6,True
8741527,655,3,30,5476,625068913,0,0,0,656.06,8,117634.88,18,0,14,6,True
8754351,1439,4,30,7024,625068913,0,0,0,655.89,8,116978.99,24,0,16,7,True
8833662,1397,4,30,6152,625068913,0,0,0,656.01,8,116322.98,24,5,9,8,True
9062281,759,0,20,4188,625068913,0,0,0,655.99,5,115666.99,24,6,5,8,True
9166303,1429,0,10,8858,625068913,0,0,0,655.87,6,116322.86,24,3,15,9,True
9522363,802,2,25,6354,625068913,0,0,0,656.12,8,115666.74,11,4,2,9,True
9627577,802,2,451,7024,625068913,0,0,0,655.77,7,115010.97,11,5,14,11,False
9722776,328,0,30,5476,625068913,0,0,0,655.75,8,114355.22,11,5,23,11,True
9985873,802,2,-1,4057,625068913,0,1,0,655.87,1,114355.22,11,6,1,11,True
1205335,1118,4,25,6882,111449910,1,0,0,883.08,8,102846.92,24,5,2,1,True
1720577,1118,4,30,1442,111449910,1,0,0,883.07,8,101963.85,24,5,1,1,True
2072243,1260,0,10,8452,111449910,1,0,0,882.71,0,102846.56,23,3,12,2,True
2133919,1118,4,30,7081,111449910,1,0,0,882.97,8,101963.59,24,1,17,3,True
2162447,1345,2,25,4694,111449910,1,0,0,882.85,8,101080.74,24,1,0,3,True
2286946,185,1,10,5467,111449910,1,0,0,882.96,6,101963.7,18,6,0,5,True
2373594,1358,4,451,4694,111449910,1,0,0,882.8,7,101080.9,24,2,18,6,True
2380391,1300,4,451,8828,111449910,1,0,0,883.11,7,100197.79,5,5,19,6,True
2617024,362,0,10,9803,111449910,1,0,0,882.92,6,101080.71,24,4,1,6,True
2796339,1434,0,10,5467,111449910,1,0,0,882.88,6,101963.59,24,4,19,7,True
2954765,90,4,451,8452,111449910,1,0,0,882.91,7,101080.68,1,6,11,7,True
3002824,1345,2,451,8452,111449910,1,0,0,883.13,7,100197.55,24,5,21,8,True
3122150,1345,2,-1,3216,111449910,1,1,0,882.84,1,100197.55,24,1,3,8,True
3416670,669,2,20,1442,111449910,1,0,0,883.0,5,99314.55,18,5,16,8,True
3565201,195,1,10,3119,111449910,1,0,0,882.79,6,100197.34,18,2,22,9,True
3645810,1364,0,10,6630,111449910,1,0,0,882.82,0,101080.16,16,3,13,9,True
3679329,465,0,451,1442,111449910,1,0,0,882.92,7,100197.24,13,5,17,10,True
3773240,1345,2,451,7874,111449910,1,0,0,883.1,7,99314.14,24,1,6,10,False
3843587,1358,4,-1,4565,111449910,1,1,0,882.81,1,99314.14,24,3,11,11,True
3960160,1345,2,25,3119,111449910,1,0,0,883.25,8,98430.89,24,3,14,11,True
4062399,1406,0,10,2721,111449910,1,0,0,882.92,0,99313.81,24,1,20,11,True
4073814,1205,0,20,3119,111449910,1,0,0,883.13,5,98430.68,24,3,22,12,True
4163076,81,0,20,8452,111449910,1,0,0,882.81,5,97547.87,1,2,14,12,True
4527580,465,0,-1,6630,111449910,1,1,0,882.6,4,97547.87,13,6,9,1,True
5129499,465,0,25,6107,111449910,1,0,0,882.95,8,96664.92,13,1,18,1,True
5177281,90,4,30,5171,111449910,1,0,0,882.88,8,95782.04,1,6,3,1,True
5210991,1358,4,-1,1598,111449910,1,1,0,883.26,4,95782.04,24,5,10,1,True
5386574,1358,4,-1,8828,111449910,1,2,0,882.89,4,95782.04,24,1,19,1,True
5435116,1345,2,30,4694,111449910,1,0,0,883.12,8,94898.92,24,4,17,2,True
5472457,531,0,10,3192,111449910,1,0,0,882.95,6,95781.87,18,2,14,3,True
5622655,1300,4,25,1598,111449910,1,0,0,882.87,8,94899.0,5,2,14,3,True
5666320,90,4,-1,6107,111449910,1,1,0,883.14,4,94899.0,1,0,16,4,True
5668677,1101,2,20,3624,111449910,1,0,0,883.07,5,94015.93,0,4,22,4,True
5794693,757,0,20,5467,111449910,1,0,0,883.09,3,93132.84,24,2,17,4,True
5889551,1377,0,20,4694,111449910,1,0,0,883.18,5,92249.66,16,1,15,4,True
6210831,1358,4,451,6107,111449910,1,0,0,882.77,7,91366.89,24,5,4,6,True
6234570,465,0,451,3119,111449910,1,0,0,883.26,7,90483.63,13,4,13,6,True
6437573,1118,4,-1,6107,111449910,1,1,0,882.95,1,90483.63,24,5,4,7,True
6473644,1345,2,451,9803,111449910,1,0,0,883.01,7,89600.62,24,5,15,7,True
6546611,465,0,30,8452,111449910,1,0,0,882.85,8,88717.77,13,6,7,7,True
6586288,97,0,10,9227,111449910,1,0,0,883.16,0,89600.93,3,4,21,7,True
6594735,90,4,451,1442,111449910,1,0,0,883.03,7,88717.9,1,2,23,7,True
7032019,421,3,-1,2721,111449910,1,1,0,883.01,4,88717.9,18,5,21,8,True
7267569,465,0,30,4565,111449910,1,0,0,883.22,8,87834.68,13,3,4,8,True
7338741,1219,1,10,9803,111449910,1,0,0,882.87,0,88717.55,24,0,1,9,True
7608279,1300,4,-1,7081,111449910,1,1,0,882.73,1,88717.55,5,1,6,10,True
7758537,1300,4,451,4565,111449910,1,0,0,883.05,7,87834.5,5,6,8,11,True
7845236,182,1,10,7874,111449910,1,0,0,882.98,6,88717.48,18,1,22,11,True
7868159,454,1,10,9128,111449910,1,0,0,882.97,6,89600.45,13,6,2,1,True
8335313,1285,1,10,9227,111449910,1,0,0,882.77,6,90483.22,24,1,0,1,True
8849927,421,3,451,3070,111449910,1,0,0,882.97,7,89600.25,18,3,18,2,True
8857247,1118,4,451,4565,111449910,1,0,0,882.88,7,88717.37,24,6,13,3,True
8968845,1358,4,451,9227,111449910,1,0,0,883.28,7,87834.09,24,6,12,3,True
9194756,1127,0,20,3624,111449910,1,0,0,883.15,3,86950.94,24,0,5,5,True
9402490,68,0,10,9227,111449910,1,0,0,882.74,6,87833.68,20,6,3,5,False
9484687,90,4,451,1442,111449910,1,0,0,882.99,7,86950.69,1,5,22,6,True
9576717,1300,4,25,6107,111449910,1,0,0,882.92,8,86067.77,5,1,10,7,True
9819324,123,0,20,4565,111449910,1,0,0,883.16,5,85184.61,18,5,19,11,False
9999940,1118,4,451,3448,111449910,1,0,0,882.84,7,84301.77,24,3,22,11,True
1293438,704,3,-1,9981,792962581,0,1,0,845.67,4,698077.0,18,3,11,1,True
1353689,1467,0,30,2201,792962581,0,0,0,846.08,8,697230.92,11,4,22,1,True
1595319,362,0,20,8499,792962581,0,0,0,845.83,5,696385.09,24,6,12,3,True
1746208,1027,0,20,7236,792962581,0,0,0,846.28,5,695538.81,11,1,11,3,True
2026323,602,4,-1,3208,792962581,0,1,0,845.86,4,695538.81,24,0,19,4,True
2038279,1052,0,451,9981,792962581,0,0,0,846.28,7,694692.53,11,5,1,4,True
2045265,704,3,-1,7236,792962581,0,1,0,846.39,1,694692.53,18,2,0,5,True
2166475,704,3,-1,2201,792962581,0,2,0,845.84,4,694692.53,18,5,6,6,True
2250364,297,0,25,9379,792962581,0,0,0,846.0,8,693846.53,4,5,10,6,True
2514069,751,4,30,7952,792962581,0,0,0,846.0,8,693000.53,24,3,3,8,True
2570613,602,4,25,5545,792962581,0,0,0,845.98,8,692154.55,24,5,1,8,True
2751868,602,4,25,6564,792962581,0,0,0,845.94,8,691308.61,24,3,23,10,True
2808237,704,3,30,3148,792962581,0,0,0,846.2,8,690462.41,18,0,22,12,True
2831911,1247,0,10,9007,792962581,0,0,0,845.75,0,691308.16,23,3,22,12,True
2898388,443,2,451,3148,792962581,0,0,0,845.61,7,690462.55,24,1,4,12,True
3067271,327,0,10,9007,792962581,0,0,0,846.22,0,691308.77,11,1,8,1,True
3101676,751,4,30,9007,792962581,0,0,0,846.23,8,690462.54,24,5,18,1,True
3937414,1134,1,-1,2048,792962581,0,1,0,845.94,4,690462.54,24,6,2,1,True
3948589,802,2,-1,5496,792962581,0,2,0,845.96,4,690462.54,11,0,16,2,True
4343718,602,4,25,7724,792962581,0,0,0,845.79,8,689616.75,24,0,9,3,True
4480281,1303,0,20,3148,792962581,0,0,0,846.29,3,688770.46,5,3,15,3,True
4781912,704,3,30,6079,792962581,0,0,0,845.91,8,687924.55,18,1,5,4,True
4796862,751,4,451,3208,792962581,0,0,0,845.9,7,687078.65,24,0,5,4,True
4848656,1052,0,25,2660,792962581,0,0,0,846.05,8,686232.6,11,0,14,5,True
4929653,785,0,20,7952,792962581,0,0,0,845.93,3,685386.67,14,6,2,5,True
5005501,704,3,25,8161,792962581,0,0,0,846.05,8,684540.62,18,5,18,8,True
5178610,704,3,-1,3148,792962581,0,1,0,846.09,4,684540.62,18,3,14,9,True
5518518,802,2,451,9981,792962581,0,0,0,846.21,7,683694.41,11,1,22,9,False
5764713,580,0,20,7300,792962581,0,0,0,846.0,3,682848.41,11,6,7,10,True
5806473,802,2,451,4246,792962581,0,0,0,845.69,7,682002.72,11,1,16,10,True
5824481,802,2,30,4563,792962581,0,0,0,846.07,8,681156.65,11,2,2,10,True
6307216,1052,0,25,9981,792962581,0,0,0,845.83,8,680310.82,11,2,7,11,True
6315516,704,3,-1,9007,792962581,0,1,0,845.95,1,680310.82,18,0,4,11,True
6367595,1305,2,20,8872,792962581,0,0,0,845.9,5,679464.92,5,6,15,12,True
6394945,208,0,10,9451,792962581,0,0,0,846.13,0,680311.05,9,1,4,12,True
6665892,751,4,-1,4979,792962581,0,1,0,846.0,4,680311.05,24,3,7,12,True
6685378,704,3,451,4563,792962581,0,0,0,846.0,7,679465.05,18,5,18,1,True
6817387,1052,0,451,6079,792962581,0,0,0,845.84,7,678619.21,11,4,8,2,True
6834779,704,3,451,6079,792962581,0,0,0,845.86,7,677773.35,18,5,13,2,True
6954513,297,0,-1,4386,792962581,0,1,0,846.23,1,677773.35,4,5,13,3,True
7004320,297,0,451,2048,792962581,0,0,0,846.06,7,676927.29,4,3,5,3,True
7121217,738,2,20,2660,792962581,0,0,0,845.89,3,676081.4,11,3,22,3,True
7200476,1467,0,25,5496,792962581,0,0,0,845.87,8,675235.53,11,2,1,4,True
7259501,297,0,30,4246,792962581,0,0,0,846.11,8,674389.42,4,0,14,4,True
7456793,802,2,451,9981,792962581,0,0,0,846.03,7,673543.39,11,5,14,4,True
7536024,297,0,30,8499,792962581,0,0,0,846.43,8,672696.96,4,3,19,5,True
7586130,443,2,30,6079,792962581,0,0,0,845.86,8,671851.1,24,0,3,5,True
8032595,297,0,451,5496,792962581,0,0,0,846.13,7,671004.97,4,0,19,5,True
8074454,297,0,451,4386,792962581,0,0,0,845.89,7,670159.08,4,4,1,5,True
8751525,704,3,-1,3148,792962581,0,1,0,846.09,4,670159.08,18,2,10,6,True
8752569,1195,1,10,5087,792962581,0,0,0,846.07,6,671005.15,24,4,18,8,False
8863067,1260,0,20,3148,792962581,0,0,0,846.01,3,670159.14,23,0,20,9,True
8874818,522,0,10,9451,792962581,0,0,0,845.99,6,671005.13,18,5,22,9,True
9206438,1467,0,451,3208,792962581,0,0,0,845.85,7,670159.28,11,1,9,10,True
9436149,704,3,25,4246,792962581,0,0,0,845.93,8,669313.35,18,6,23,11,True
9463003,297,0,30,9451,792962581,0,0,0,846.11,8,668467.24,4,2,10,11,True
9537213,29,0,20,4723,792962581,0,0,0,846.31,5,667620.93,11,1,0,11,True
9902224,704,3,-1,2048,792962581,0,1,0,846.03,4,667620.93,18,2,20,11,True
1300281,466,4,30,6504,296881602,0,0,0,480.29,8,863743.71,13,1,19,1,True
1355796,1015,0,25,7081,296881602,0,0,0,479.84,8,863263.87,26,1,22,2,True
1431067,283,4,30,6667,296881602,0,0,0,480.25,8,862783.62,24,1,8,2,True
1506404,499,3,25,8073,296881602,0,0,0,479.95,8,862303.67,12,0,1,2,True
1891680,283,4,-1,1172,296881602,0,1,0,479.65,4,862303.67,24,0,2,2,True
2080432,1313,4,25,6567,296881602,0,0,0,479.76,8,861823.91,5,1,20,3,True
2119311,283,4,451,4584,296881602,0,0,0,479.98,7,861343.93,24,4,7,3,True
2171865,573,0,20,7848,296881602,0,0,0,479.95,5,860863.98,11,3,5,3,True
2191141,1089,0,20,8463,296881602,0,0,0,480.03,5,860383.95,18,0,17,4,True
2399453,1015,0,-1,8528,296881602,0,1,0,479.99,4,860383.95,26,0,2,5,True
2504176,531,0,10,8859,296881602,0,0,0,480.16,6,860864.11,18,1,2,5,True
2521747,97,0,451,5797,296881602,0,0,0,479.82,7,860384.29,3,5,23,6,True
2587372,794,2,30,7197,296881602,0,0,0,479.94,8,859904.35,11,0,13,6,True
2655163,466,4,-1,7439,296881602,0,1,0,480.01,4,859904.35,13,4,10,7,True
2902148,147,0,10,8073,296881602,0,0,0,479.96,0,860384.31,18,2,23,8,True
3461068,97,0,-1,1790,296881602,0,1,0,479.83,1,860384.31,3,5,11,10,True
3599431,871,0,10,2017,296881602,0,0,0,479.94,6,860864.25,24,3,22,10,True
3700464,794,2,451,8528,296881602,0,0,0,479.96,7,860384.29,11,4,12,10,True
3725752,1015,0,451,2842,296881602,0,0,0,479.98,7,859904.31,26,3,21,10,True
3951457,1351,4,30,7450,296881602,0,0,0,479.8,8,859424.51,24,6,20,11,True
3962769,466,4,451,9624,296881602,0,0,0,480.05,7,858944.46,13,3,11,12,True
3975260,116,0,20,1064,296881602,0,0,0,480.09,5,858464.37,3,4,17,12,True
4149193,1015,0,30,7835,296881602,0,0,0,480.09,8,857984.28,26,1,4,12,True
4312550,1313,4,25,8463,296881602,0,0,0,480.24,8,857504.04,5,2,16,1,True
4514211,97,0,-1,4204,296881602,0,1,0,479.94,4,857504.04,3,6,15,2,True
4648317,97,0,30,6504,296881602,0,0,0,479.94,8,857024.1,3,3,18,4,True
4675645,794,2,30,6567,296881602,0,0,0,480.1,8,856544.0,11,2,21,5,True
4682899,1015,0,-1,8528,296881602,0,1,0,479.96,1,856544.0,26,5,10,5,True
4710861,466,4,-1,7081,296881602,0,2,0,479.95,4,856544.0,13,0,5,7,True
5068055,1313,4,451,9149,296881602,0,0,0,480.11,7,856063.89,5,2,20,8,True
5149947,1351,4,-1,7197,296881602,0,1,0,480.38,4,856063.89,24,2,2,8,False
5338132,1245,1,451,7439,296881602,0,0,0,480.21,7,855583.68,18,2,16,8,True
5580441,1313,4,451,7935,296881602,0,0,0,480.08,7,855103.6,5,0,18,11,True
6373739,848,2,20,7439,296881602,0,0,0,480.05,5,854623.55,5,6,18,12,True
6442642,794,2,451,2028,296881602,0,0,0,480.0,7,854143.55,11,3,4,12,True
6825652,1015,0,30,9149,296881602,0,0,0,480.06,8,853663.49,26,0,14,12,True
6854688,794,2,30,4993,296881602,0,0,0,480.3,8,853183.19,11,6,3,12,False
7378328,466,4,25,4204,296881602,0,0,0,480.13,8,852703.06,13,2,18,1,True
7491730,757,0,20,7835,296881602,0,0,0,480.11,5,852222.95,24,0,23,1,True
7496406,794,2,30,9149,296881602,0,0,0,479.82,8,851743.13,11,0,8,3,True
7496891,794,2,-1,7450,296881602,0,1,0,479.63,4,851743.13,11,2,9,4,True
7664318,97,0,451,8528,296881602,0,0,0,479.93,7,851263.2,3,6,14,5,True
7724561,1245,1,30,8528,296881602,0,0,0,480.05,8,850783.15,18,0,17,5,True
7879206,1313,4,30,7081,296881602,0,0,0,480.08,8,850303.07,5,3,0,6,True
8127163,466,4,451,8463,296881602,0,0,0,480.11,7,849822.96,13,6,9,6,True
8137512,466,4,451,6504,296881602,0,0,0,480.2,7,849342.76,13,0,12,6,True
8402188,794,2,451,8859,296881602,0,0,0,480.08,7,848862.68,11,2,22,6,False
8653908,283,4,25,2017,296881602,0,0,0,479.94,8,848382.74,24,2,4,7,True
8779566,1356,2,20,9149,296881602,0,0,0,480.14,5,847902.6,24,3,13,7,True
8951919,283,4,451,1064,296881602,0,0,0,479.89,7,847422.71,24,2,0,8,True
9045545,577,0,20,9629,296881602,0,0,0,480.02,5,846942.69,11,2,22,8,True
9209446,260,0,10,9984,296881602,0,0,0,480.01,6,847422.7,6,1,3,10,True
9802294,1297,0,10,7835,296881602,0,0,0,479.77,6,847902.47,5,3,23,11,True
9807239,794,2,20,4584,296881602,0,0,0,480.04,5,847422.43,11,5,17,11,True
9978326,1351,4,-1,7780,296881602,0,1,0,479.99,4,847422.43,24,1,20,11,True
1054654,348,0,451,2250,785737963,0,0,0,568.98,7,299574.02,24,4,7,2,True
1426354,348,0,-1,9210,785737963,0,1,0,569.1,4,299574.02,24,3,3,3,True
1533755,837,3,451,3964,785737963,0,0,0,569.22,7,299004.8,5,0,4,4,True
1579535,1322,2,451,9810,785737963,0,0,0,569.01,7,298435.79,18,3,23,5,True
1609729,837,3,-1,7776,785737963,0,1,0,568.95,1,298435.79,5,3,15,8,True
1640310,350,0,20,9210,785737963,0,0,0,569.2,5,297866.59,24,4,12,9,True
2219810,1120,4,-1,6052,785737963,0,1,0,569.08,4,297866.59,24,5,10,9,True
2394735,348,0,-1,4932,785737963,0,2,0,568.96,4,297866.59,24,2,0,10,True
2445077,837,3,30,4855,785737963,0,0,0,569.13,8,297297.46,5,4,11,10,True
2503801,326,4,451,4193,785737963,0,0,0,569.08,7,296728.38,11,1,0,10,True
2587522,326,4,30,9393,785737963,0,0,0,568.91,8,296159.47,11,2,13,10,True
2621685,1322,2,451,9810,785737963,0,0,0,568.88,7,295590.59,18,2,1,11,True
3306220,1454,1,10,1437,785737963,0,0,0,569.22,6,296159.81,11,2,18,11,True
3573248,394,0,20,2934,785737963,0,0,0,568.84,5,295590.97,10,0,6,1,True
3574927,326,4,30,4193,785737963,0,0,0,569.02,8,295021.95,11,1,2,2,True
3595491,348,0,451,6545,785737963,0,0,0,568.85,7,294453.1,24,3,22,3,True
3610340,577,0,10,6796,785737963,0,0,0,568.79,6,295021.89,11,1,3,3,True
3771689,837,3,30,8108,785737963,0,0,0,568.93,8,294452.96,5,0,15,4,True
3846352,1463,2,20,2934,785737963,0,0,0,568.72,3,293884.24,11,2,11,4,True
3979063,326,4,-1,8952,785737963,0,1,0,569.09,4,293884.24,11,3,10,5,True
4415367,837,3,30,4855,785737963,0,0,0,568.96,8,293315.28,5,5,13,5,True
4483869,837,3,-1,1668,785737963,0,1,0,568.89,4,293315.28,5,5,6,6,True
4573008,348,0,30,6052,785737963,0,0,0,568.98,8,292746.3,24,5,21,6,True
4669585,837,3,-1,2415,785737963,0,1,0,569.25,4,292746.3,5,0,12,7,True
4779106,837,3,451,6090,785737963,0,0,0,568.93,7,292177.37,5,0,1,7,True
4973553,341,0,10,8952,785737963,0,0,0,568.93,0,292746.3,24,1,19,7,True
4989697,348,0,30,1437,785737963,0,0,0,568.99,8,292177.31,24,4,13,7,True
5418383,348,0,451,4193,785737963,0,0,0,569.17,7,291608.14,24,5,16,8,True
5606270,1477,2,20,2934,785737963,0,0,0,569.06,5,291039.08,24,1,11,8,True
5809160,348,0,30,9393,785737963,0,0,0,569.1,8,290469.98,24,3,2,9,True
6003604,837,3,25,7776,785737963,0,0,0,568.87,8,289901.11,5,0,10,10,True
6229999,1322,2,-1,6545,785737963,0,1,0,568.87,4,289901.11,18,1,13,10,True
6284785,627,0,20,6545,785737963,0,0,0,568.72,5,289332.39,11,2,5,10,True
6461294,1120,4,25,6705,785737963,0,0,0,569.22,8,288763.17,24,0,8,11,True
6771104,1322,2,451,3853,785737963,0,0,0,569.08,7,288194.09,18,2,8,11,True
6799656,348,0,30,8952,785737963,0,0,0,568.97,8,287625.12,24,2,18,12,True
7031042,367,1,10,6796,785737963,0,0,0,569.08,0,288194.2,25,5,2,2,True
7036546,1093,0,10,9210,785737963,0,0,0,569.16,6,288763.36,18,2,15,2,True
7092409,1120,4,25,6090,785737963,0,0,0,568.85,8,288194.51,24,1,1,2,True
7222543,1120,4,451,1668,785737963,0,0,0,568.84,7,287625.67,24,1,14,2,True
7264509,326,4,451,1668,785737963,0,0,0,568.93,7,287056.74,11,0,0,3,True
7473373,411,2,20,1807,785737963,0,0,0,569.12,5,286487.62,18,5,9,5,True
7909006,348,0,30,3853,785737963,0,0,0,569.0,8,285918.62,24,5,13,5,True
8061136,326,4,451,2934,785737963,0,0,0,568.73,7,285349.89,11,0,4,7,True
8204312,591,0,10,8108,785737963,0,0,0,568.94,0,285918.83,24,0,12,9,True
8470792,837,3,451,3481,785737963,0,0,0,568.79,7,285350.04,5,2,14,9,True
8774352,348,0,-1,9210,785737963,0,1,0,569.06,4,285350.04,24,4,22,9,True
8979651,1116,0,10,4932,785737963,0,0,0,568.81,6,285918.85,24,1,21,10,True
9503434,348,0,25,1807,785737963,0,0,0,569.09,8,285349.76,24,0,6,10,True
9576880,326,4,30,4932,785737963,0,0,0,569.01,8,284780.75,11,5,8,10,True
9674158,1322,2,451,5490,785737963,0,0,0,569.08,7,284211.67,18,6,18,10,True
9763059,1120,4,30,4855,785737963,0,0,0,568.87,8,283642.8,24,0,9,11,True
1009936,1152,0,20,6010,507639056,1,0,0,605.23,5,182158.77,15,3,21,2,True
1198136,319,0,25,2211,507639056,1,0,0,604.57,8,181554.2,11,0,18,3,True
1355018,485,1,30,9413,507639056,1,0,0,604.97,8,180949.23,5,5,4,5,True
1518025,726,0,20,6537,507639056,1,0,0,605.3,5,180343.93,11,6,2,5,True
1524776,485,1,30,6531,507639056,1,0,0,604.91,8,179739.02,5,3,2,6,True
1719341,634,1,25,2211,507639056,1,0,0,604.86,8,179134.16,24,5,10,8,True
1771881,1075,0,20,5816,507639056,1,0,0,604.74,5,178529.42,18,3,11,8,True
1834594,634,1,30,5634,507639056,1,0,0,605.17,8,177924.25,24,0,18,9,True
1998518,739,1,10,2536,507639056,1,0,0,605.04,0,178529.29,24,2,18,9,True
2066739,485,1,25,5634,507639056,1,0,0,604.87,8,177924.42,5,0,5,10,True
2115181,1359,2,20,6556,507639056,1,0,0,604.83,5,177319.59,24,4,14,11,True
2150613,476,1,10,4597,507639056,1,0,0,605.03,0,177924.62,5,0,1,2,True
2337476,23,0,-1,1875,507639056,1,1,0,604.99,4,177924.62,11,1,6,3,True
2669990,300,0,20,2211,507639056,1,0,0,604.67,5,177319.95,4,6,9,3,True
2678901,168,0,10,6537,507639056,1,0,0,605.06,6,177925.01,24,0,0,3,True
2702685,485,1,451,1968,507639056,1,0,0,604.82,7,177320.19,5,4,13,4,True
2802329,23,0,451,5392,507639056,1,0,0,605.1,7,176715.09,11,6,13,5,True
3483658,302,1,30,5816,507639056,1,0,0,605.16,8,176109.93,4,6,23,5,True
3517882,1404,2,20,7082,507639056,1,0,0,605.12,3,175504.81,24,3,10,6,True
3522150,1166,2,20,3104,507639056,1,0,0,604.86,5,174899.95,24,6,22,7,True
3926573,302,1,30,2472,507639056,1,0,0,605.17,8,174294.78,4,1,0,8,True
4325087,1114,1,10,6480,507639056,1,0,0,605.1,6,174899.88,0,3,9,9,True
4422352,41,2,451,6531,507639056,1,0,0,604.92,7,174294.96,11,3,14,9,True
4610555,319,0,30,5096,507639056,1,0,0,604.86,8,173690.1,11,0,16,11,True
4676217,23,0,25,4310,507639056,1,0,0,605.32,8,173084.78,11,2,12,11,True
4716173,634,1,451,5096,507639056,1,0,0,605.18,7,172479.6,24,3,0,12,True
4889051,302,1,25,3104,507639056,1,0,0,605.0,8,171874.6,4,4,14,12,True
4895851,712,0,10,3890,507639056,1,0,0,604.86,0,172479.46,18,0,9,3,True
5108086,634,1,451,5392,507639056,1,0,0,604.97,7,171874.49,24,5,9,3,True
5235672,1192,2,20,6010,507639056,1,0,0,605.01,3,171269.48,24,6,14,3,True
5612291,1170,0,20,5634,507639056,1,0,0,605.02,3,170664.46,24,6,17,4,True
5627854,406,1,30,5096,507639056,1,0,0,604.97,8,170059.49,10,3,16,6,True
5755452,302,1,451,5096,507639056,1,0,0,604.86,7,169454.63,4,5,15,6,True
5848062,406,1,-1,1875,507639056,1,1,0,605.05,4,169454.63,10,1,13,7,True
6001063,406,1,-1,5096,507639056,1,2,0,604.83,4,169454.63,10,5,12,8,False
6130697,217,4,-1,5127,507639056,1,3,1,605.08,1,169454.63,9,5,18,9,False
1363081,770,4,-1,4848,439695388,1,1,0,1131.15,4,471322.0,14,0,12,1,True
1601049,770,4,451,2009,439695388,1,0,0,1130.67,7,470191.33,14,1,10,1,False
1661515,482,1,30,9315,439695388,1,0,0,1131.03,8,469060.3,5,0,12,2,True
1714335,770,4,25,1510,439695388,1,0,0,1131.09,8,467929.21,14,6,19,3,True
2128974,1011,4,30,7359,439695388,1,0,0,1131.05,8,466798.16,26,0,18,3,True
2158751,482,1,25,9409,439695388,1,0,0,1130.98,8,465667.18,5,4,11,5,True
2398615,482,1,-1,8110,439695388,1,1,0,1131.03,4,465667.18,5,4,2,5,True
2807692,1023,2,20,4769,439695388,1,0,0,1131.08,5,464536.1,11,6,17,5,True
2979061,482,1,30,9409,439695388,1,0,0,1131.27,8,463404.83,5,3,0,6,True
3283135,1281,3,-1,8562,439695388,1,1,0,1130.99,1,463404.83,24,1,5,6,True
3327802,635,2,20,9315,439695388,1,0,0,1130.77,5,462274.06,24,4,14,7,True
3339804,1181,2,20,2307,439695388,1,0,0,1130.9,3,461143.16,24,3,6,8,True
3386677,1380,0,10,2307,439695388,1,0,0,1130.74,6,462273.9,16,0,12,9,True
3506182,770,4,451,4341,439695388,1,0,0,1131.12,7,461142.78,14,1,3,10,False
3522077,482,1,451,8316,439695388,1,0,0,1130.91,7,460011.87,5,6,10,10,True
3975071,482,1,25,8110,439695388,1,0,0,1130.98,8,458880.89,5,2,2,10,True
4352673,770,4,451,8110,439695388,1,0,0,1131.03,7,457749.86,14,0,6,11,True
4364487,274,1,10,9315,439695388,1,0,0,1131.18,0,458881.04,24,2,13,11,True
4379673,887,2,451,8562,439695388,1,0,0,1131.06,7,457749.98,27,0,19,12,True
4438330,1273,0,10,3089,439695388,1,0,0,1130.93,6,458880.91,24,4,5,12,True
4504556,482,1,-1,2009,439695388,1,1,0,1131.12,4,458880.91,5,4,7,2,True
4572087,1281,3,451,8717,439695388,1,0,0,1131.14,7,457749.77,24,5,11,2,True
4806537,502,0,20,4848,439695388,1,0,0,1130.87,5,456618.9,12,6,14,4,True
4826734,1483,0,20,1106,439695388,1,0,0,1130.95,3,455487.95,24,5,15,4,True
4863373,1281,3,25,4848,439695388,1,0,0,1130.72,8,454357.23,24,6,21,4,True
5423407,329,1,10,9315,439695388,1,0,0,1131.04,6,455488.27,11,2,4,5,True
5506050,1281,3,-1,7148,439695388,1,1,0,1131.28,1,455488.27,24,0,23,5,True
5539125,1012,0,10,2574,439695388,1,0,0,1130.9,6,456619.17,26,3,8,6,True
5787718,770,4,451,8562,439695388,1,0,0,1131.21,7,455487.96,14,4,15,8,True
6152455,1011,4,30,1106,439695388,1,0,0,1131.06,8,454356.9,26,3,21,8,True
6199572,1011,4,451,7808,439695388,1,0,0,1130.84,7,453226.06,26,2,9,8,True
6262173,1011,4,30,6355,439695388,1,0,0,1131.13,8,452094.93,26,6,2,9,True
6331247,1110,0,10,9437,439695388,1,0,0,1131.16,0,453226.09,0,2,20,10,False
6832872,245,4,30,3089,439695388,1,0,0,1130.96,8,452095.13,26,1,14,11,True
7337760,1011,4,-1,9315,439695388,1,1,0,1131.01,4,452095.13,26,5,14,12,True
7345501,482,1,25,8110,439695388,1,0,0,1130.94,8,450964.19,5,0,6,12,False
7445540,1011,4,-1,7148,439695388,1,1,0,1130.88,1,450964.19,26,4,15,2,True
7587343,1192,2,20,4595,439695388,1,0,0,1131.13,5,449833.06,24,2,22,3,True
7714057,245,4,451,9437,439695388,1,0,0,1130.97,7,448702.09,26,2,20,3,True
7752234,887,2,25,4081,439695388,1,0,0,1131.02,8,447571.07,27,1,5,4,True
7818997,812,0,10,3089,439695388,1,0,0,1131.02,0,448702.09,18,2,20,5,True
7861297,1281,3,451,5677,439695388,1,0,0,1131.15,7,447570.94,24,3,6,6,True
7888316,770,4,451,4595,439695388,1,0,0,1130.93,7,446440.01,14,3,10,6,True
8024679,1011,4,25,8110,439695388,1,0,0,1130.88,8,445309.13,26,4,7,7,True
8069810,1281,3,30,8562,439695388,1,0,0,1130.97,8,444178.16,24,0,11,7,True
8200320,1281,3,451,8562,439695388,1,0,0,1130.88,7,443047.28,24,3,17,7,True
8251033,834,0,10,3089,439695388,1,0,0,1131.12,6,444178.4,5,4,15,7,True
8340407,1090,0,10,4595,439695388,1,0,0,1131.25,6,445309.65,18,4,8,8,True
8676758,770,4,451,8316,439695388,1,0,0,1131.14,7,444178.51,14,0,22,8,True
8702198,887,2,30,7148,439695388,1,0,0,1131.14,8,443047.37,27,4,2,9,True
9266340,1011,4,25,4081,439695388,1,0,0,1130.89,8,441916.48,26,2,15,10,True
9308809,1281,3,25,8562,439695388,1,0,0,1130.9,8,440785.58,24,4,22,11,True
9527339,1377,0,20,7148,439695388,1,0,0,1131.22,5,439654.36,16,6,2,11,True
9754767,887,2,25,6355,439695388,1,0,0,1130.95,8,438523.41,27,5,3,11,True
1145439,1283,2,20,9762,415496396,1,0,0,873.06,5,829301.94,24,4,21,2,True
1326127,586,4,25,2698,415496396,1,0,0,872.91,8,828429.03,24,2,15,3,True
1650738,1264,0,451,5634,415496396,1,0,0,872.93,7,827556.1,23,6,4,3,True
1707402,979,0,451,5634,415496396,1,0,0,872.77,7,826683.33,22,3,2,3,True
1832997,366,0,20,7651,415496396,1,0,0,873.21,3,825810.12,25,3,19,3,True
1919351,1211,4,25,9762,415496396,1,0,0,872.74,8,824937.38,24,6,3,3,True
1994026,1264,0,30,9407,415496396,1,0,0,872.96,8,824064.42,23,0,21,4,True
2045519,1264,0,451,4824,415496396,1,0,0,872.74,7,823191.68,23,6,5,5,True
2062385,917,0,20,1413,415496396,1,0,0,872.98,5,822318.7,18,5,13,6,True
2191404,940,1,10,2488,415496396,1,0,0,872.96,6,823191.66,24,3,4,6,True
2446293,679,0,451,5634,415496396,1,0,0,873.13,7,822318.53,24,3,19,6,True
2713184,1264,0,451,5986,415496396,1,0,0,873.1,7,821445.43,23,3,16,6,True
2989900,871,0,20,3721,415496396,1,0,0,872.82,5,820572.61,24,1,11,6,False
3339226,883,0,20,8967,415496396,1,0,0,872.92,5,819699.69,24,1,3,8,True
3456187,860,1,10,9155,415496396,1,0,0,873.05,6,820572.74,24,2,23,8,True
4182913,635,2,20,9860,415496396,1,0,0,872.98,5,819699.76,24,3,9,8,True
4199665,1264,0,-1,7661,415496396,1,1,0,872.98,4,819699.76,23,2,1,8,True
4343440,586,4,451,9762,415496396,1,0,0,873.27,7,818826.49,24,0,10,9,True
4432830,1264,0,-1,4526,415496396,1,1,0,873.15,4,818826.49,23,0,15,9,True
4549464,882,0,20,5624,415496396,1,0,0,872.91,5,817953.58,27,2,13,10,True
4773260,649,0,20,7651,415496396,1,0,0,873.12,5,817080.46,24,6,5,10,True
4773763,1211,4,451,9860,415496396,1,0,0,873.12,7,816207.34,24,2,15,11,True
4913216,1264,0,451,8967,415496396,1,0,0,872.98,7,815334.36,23,1,17,11,True
4930006,679,0,30,9407,415496396,1,0,0,873.02,8,814461.34,24,6,13,11,True
5076332,268,2,20,7661,415496396,1,0,0,873.11,5,813588.23,24,2,10,11,True
5089189,679,0,30,3721,415496396,1,0,0,873.07,8,812715.16,24,3,14,12,True
5200670,652,0,10,1400,415496396,1,0,0,873.17,6,813588.33,24,4,15,1,True
5227826,1211,4,451,2698,415496396,1,0,0,872.76,7,812715.57,24,5,7,1,True
5235246,1211,4,451,9860,415496396,1,0,0,872.99,7,811842.58,24,1,0,2,True
5567393,586,4,25,4824,415496396,1,0,0,873.1,8,810969.48,24,2,9,2,True
6005778,670,0,20,3721,415496396,1,0,0,873.0,3,810096.48,18,5,5,3,True
6107963,586,4,-1,7651,415496396,1,1,0,873.44,1,810096.48,24,2,10,5,True
6449272,679,0,30,8967,415496396,1,0,0,873.04,8,809223.44,24,0,16,6,True
6462271,979,0,-1,5986,415496396,1,1,0,873.12,4,809223.44,22,0,22,7,True
6492612,1119,0,10,9155,415496396,1,0,0,873.01,6,810096.45,24,2,10,8,True
6538308,979,0,30,6366,415496396,1,0,0,873.08,8,809223.37,22,3,15,9,True
6844950,679,0,451,4526,415496396,1,0,0,872.61,7,808350.76,24,0,2,11,True
6865846,1211,4,451,4526,415496396,1,0,0,872.98,7,807477.78,24,6,8,11,True
7032644,979,0,451,4526,415496396,1,0,0,872.95,7,806604.83,22,2,14,11,True
7123564,1211,4,451,4824,415496396,1,0,0,872.83,7,805732.0,24,2,17,12,True
7247878,1211,4,25,9155,415496396,1,0,0,873.04,8,804858.96,24,2,17,1,True
7458365,979,0,25,9407,415496396,1,0,0,872.95,8,803986.01,22,5,15,2,True
7480227,1211,4,451,4526,415496396,1,0,0,873.43,7,803112.58,24,0,1,3,True
7493728,860,1,10,3721,415496396,1,0,0,872.95,6,803985.53,24,2,11,3,True
7910143,679,0,30,9407,415496396,1,0,0,873.3,8,803112.23,24,4,14,3,True
8174224,979,0,-1,6366,415496396,1,1,0,872.84,1,803112.23,22,6,13,5,True
8248971,591,0,20,9762,415496396,1,0,0,873.02,3,802239.21,24,3,21,5,True
8365457,1264,0,30,5624,415496396,1,0,0,872.96,8,801366.25,23,5,22,5,True
8836238,1211,4,25,7651,415496396,1,0,0,873.01,8,800493.24,24,3,1,6,True
8857380,679,0,451,9407,415496396,1,0,0,873.04,7,799620.2,24,0,12,7,True
9004995,1160,0,20,1400,415496396,1,0,0,872.82,3,798747.38,15,4,4,8,True
9029783,1211,4,451,8967,415496396,1,0,0,873.18,7,797874.2,24,0,16,8,True
9094853,627,0,10,3721,415496396,1,0,0,873.08,6,798747.28,11,2,20,9,True
9130547,537,0,20,3589,415496396,1,0,0,873.12,5,797874.16,18,4,9,10,False
9350760,979,0,451,9860,415496396,1,0,0,872.88,7,797001.28,22,6,14,10,True
9467530,1211,4,30,5624,415496396,1,0,0,872.78,8,796128.5,24,6,3,11,True
9603804,586,4,451,7661,415496396,1,0,0,873.07,7,795255.43,24,3,6,11,True
9807960,1211,4,-1,5634,415496396,1,1,0,872.99,4,795255.43,24,2,7,11,True
9827398,1211,4,25,7661,415496396,1,0,0,873.02,8,794382.41,24,2,12,11,True
1249519,444,2,30,1880,128792772,0,0,0,935.36,8,118861.64,24,3,18,2,True
1264254,444,2,25,4318,128792772,0,0,0,934.92,8,117926.72,24,2,0,3,True
1281532,1092,1,-1,6500,128792772,0,1,0,935.4,4,117926.72,18,6,21,5,True
1357820,979,0,10,9788,128792772,0,0,0,934.81,6,118861.53,22,4,19,5,True
1947864,1160,0,25,7655,128792772,0,0,0,934.97,8,117926.56,15,6,14,5,True
2090551,228,0,10,1072,128792772,0,0,0,935.1,6,118861.66,26,6,19,6,True
2237321,328,0,20,8154,128792772,0,0,0,934.85,3,117926.81,11,0,16,8,True
2374137,314,0,20,4916,128792772,0,0,0,934.67,5,116992.14,4,5,8,8,True
2973163,444,2,451,9763,128792772,0,0,0,935.08,7,116057.06,24,0,11,10,True
3070207,1092,1,451,8592,128792772,0,0,0,934.88,7,115122.18,18,5,9,11,True
3107628,427,2,20,7090,128792772,0,0,0,935.19,5,114186.99,18,3,11,12,True
3419126,261,3,25,5683,128792772,0,0,0,935.23,8,113251.76,6,5,8,12,True
3556103,1092,1,30,1346,128792772,0,0,0,934.88,8,112316.88,18,1,19,3,True
3582206,1160,0,451,1525,128792772,0,0,0,935.0,7,111381.88,15,3,10,3,True
3582878,588,0,25,8664,128792772,0,0,0,935.03,8,110446.85,24,3,18,3,True
3816990,1160,0,30,8592,128792772,0,0,0,934.92,8,109511.93,15,1,4,4,False
4342206,1287,4,25,1880,128792772,0,0,0,935.01,8,108576.92,24,5,10,4,True
4683342,588,0,-1,1360,128792772,0,1,0,935.09,4,108576.92,24,6,21,6,True
4877019,1160,0,25,4318,128792772,0,0,0,935.11,8,107641.81,15,3,10,6,True
5436873,1160,0,25,8664,128792772,0,0,0,935.12,8,106706.69,15,0,14,7,True
5778207,1287,4,25,1072,128792772,0,0,0,935.09,8,105771.6,24,5,18,8,True
5798403,524,1,10,7282,128792772,0,0,0,934.84,0,106706.44,18,4,9,9,True
5913043,1160,0,30,1072,128792772,0,0,0,935.31,8,105771.13,15,3,8,9,True
5926300,358,4,451,4934,128792772,0,0,0,934.92,7,104836.21,24,1,20,10,True
5949246,525,0,20,4934,128792772,0,0,0,934.98,5,103901.23,18,6,7,10,True
6082032,47,1,25,3823,128792772,0,0,0,934.7,8,102966.53,24,6,20,11,True
6147627,1287,4,30,9763,128792772,0,0,0,934.97,8,102031.56,24,3,4,12,True
6193622,47,1,30,1525,128792772,0,0,0,934.92,8,101096.64,24,6,21,12,True
6515310,1303,0,10,9788,128792772,0,0,0,935.0,0,102031.64,5,6,8,12,True
6549456,588,0,30,5683,128792772,0,0,0,934.92,8,101096.72,24,2,16,2,True
6639330,261,3,451,9763,128792772,0,0,0,934.95,7,100161.77,6,2,2,3,True
6696844,1092,1,451,1072,128792772,0,0,0,934.97,7,99226.8,18,5,6,3,True
6703970,1092,1,451,8137,128792772,0,0,0,934.97,7,98291.83,18,2,11,4,False
6734082,261,3,30,1346,128792772,0,0,0,935.26,8,97356.57,6,3,9,4,True
6935532,358,4,30,9763,128792772,0,0,0,935.2,8,96421.37,24,4,0,4,True
6942851,562,1,10,1880,128792772,0,0,0,935.08,6,97356.45,17,0,8,4,True
7278423,358,4,30,7282,128792772,0,0,0,934.86,8,96421.59,24,0,20,5,True
7333229,1160,0,451,8137,128792772,0,0,0,934.88,7,95486.71,15,2,7,5,True
8076115,261,3,451,8154,128792772,0,0,0,935.19,7,94551.52,6,4,17,5,True
8085868,358,4,451,4934,128792772,0,0,0,934.86,7,93616.66,24,4,17,6,True
8480437,261,3,-1,8592,128792772,0,1,0,935.01,4,93616.66,6,1,13,6,True
8680008,262,2,20,8592,128792772,0,0,0,935.02,3,92681.64,6,5,16,6,True
8727590,1092,1,-1,4916,128792772,0,1,0,935.04,1,92681.64,18,5,21,6,True
9153333,444,2,25,2280,128792772,0,0,0,935.13,8,91746.51,24,0,20,6,True
9570363,261,3,451,8751,128792772,0,0,0,934.82,7,90811.69,6,1,15,7,False
9607518,358,4,-1,8137,128792772,0,1,0,935.09,4,90811.69,24,6,18,8,True
9660182,588,0,30,1360,128792772,0,0,0,935.1,8,89876.59,24,0,2,9,True
9735740,444,2,451,8137,128792772,0,0,0,935.35,7,88941.24,24,1,21,9,True
9809626,588,0,30,9763,128792772,0,0,0,934.92,8,88006.32,24,3,3,9,True
9888466,1092,1,10,7655,128792772,0,0,0,935.19,0,88941.51,18,4,6,11,True
1216810,147,0,10,6846,518191198,0,0,0,931.72,6,755281.72,18,0,12,1,True
1222724,1132,0,20,4431,518191198,0,0,0,931.93,5,754349.79,24,1,1,1,True
1245660,907,0,25,1474,518191198,0,0,0,932.1,8,753417.69,2,2,21,1,False
1290158,1468,1,10,8845,518191198,0,0,0,931.96,6,754349.65,11,1,6,1,True
1499377,1308,3,-1,8348,518191198,0,1,0,931.94,4,754349.65,5,6,9,2,True
1651751,1401,1,25,7953,518191198,0,0,0,932.18,8,753417.47,24,3,23,3,True
1674563,343,1,451,8348,518191198,0,0,0,932.08,7,752485.39,24,5,9,4,True
2009635,907,0,451,3661,518191198,0,0,0,932.08,7,751553.31,2,4,5,4,True
2565735,665,2,30,9531,518191198,0,0,0,931.9,8,750621.41,18,4,14,4,True
2794107,665,2,30,9750,518191198,0,0,0,932.27,8,749689.14,18,4,4,5,True
2813614,343,1,-1,1249,518191198,0,1,0,931.89,4,749689.14,24,3,9,6,True
2852987,1363,0,20,7193,518191198,0,0,0,931.92,5,748757.22,16,1,16,6,True
3308123,1233,0,20,3941,518191198,0,0,0,932.07,5,747825.15,18,3,3,7,True
3373815,95,2,20,3981,518191198,0,0,0,931.96,3,746893.19,1,0,22,7,True
3390940,907,0,451,7985,518191198,0,0,0,931.88,7,745961.31,2,4,14,7,False
3550113,1401,1,-1,7985,518191198,0,1,0,932.05,1,745961.31,24,1,5,8,True
3753728,359,2,451,3077,518191198,0,0,0,932.22,7,745029.09,24,3,9,8,True
3864250,269,0,451,9693,518191198,0,0,0,932.14,7,744096.95,24,5,21,8,True
3915120,1401,1,30,6826,518191198,0,0,0,931.97,8,743164.98,24,5,14,8,True
3959583,372,0,10,1359,518191198,0,0,0,932.09,6,744097.07,25,2,14,8,True
4026006,457,0,20,7939,518191198,0,0,0,932.23,5,743164.84,13,4,5,9,True
4047744,1401,1,451,7985,518191198,0,0,0,931.94,7,742232.9,24,4,18,9,True
4061158,1205,0,20,6846,518191198,0,0,0,932.38,5,741300.52,24,5,11,10,True
4392516,465,0,10,8845,518191198,0,0,0,931.91,6,742232.43,13,6,5,11,True
4639342,34,1,451,8348,518191198,0,0,0,932.29,7,741300.14,11,5,5,11,True
4694641,1217,0,20,3941,518191198,0,0,0,932.05,5,740368.09,24,2,22,11,True
5177354,1401,1,-1,1249,518191198,0,1,0,931.79,4,740368.09,24,5,11,12,True
5307236,834,0,20,1359,518191198,0,0,0,931.97,5,739436.12,5,1,0,2,True
5411870,503,0,20,3661,518191198,0,0,0,932.13,3,738503.99,12,2,21,5,True
5675497,269,0,-1,9134,518191198,0,1,0,931.91,1,738503.99,24,3,5,5,True
5800720,269,0,-1,6041,518191198,0,2,0,932.09,4,738503.99,24,2,17,5,True
5843948,23,0,20,4231,518191198,0,0,0,931.99,3,737572.0,11,2,14,6,True
6063200,34,1,-1,3981,518191198,0,1,0,932.29,4,737572.0,11,4,4,7,True
6138368,1401,1,25,7953,518191198,0,0,0,931.75,8,736640.25,24,4,23,7,True
6290958,806,1,10,4431,518191198,0,0,0,932.37,6,737572.62,11,3,20,7,True
6494828,907,0,25,9693,518191198,0,0,0,932.09,8,736640.53,2,1,17,8,True
6886579,287,0,20,7377,518191198,0,0,0,931.94,5,735708.59,24,3,17,9,True
7171662,1308,3,451,3077,518191198,0,0,0,932.13,7,734776.46,5,4,16,9,False
7275408,849,1,25,7953,518191198,0,0,0,932.02,8,733844.44,5,4,18,10,True
7288253,34,1,25,7193,518191198,0,0,0,931.95,8,732912.49,11,5,15,10,True
7486443,1308,3,30,7953,518191198,0,0,0,932.17,8,731980.32,5,2,14,10,True
7577170,348,0,20,3077,518191198,0,0,0,932.01,5,731048.31,24,2,10,1,True
7814615,665,2,451,1249,518191198,0,0,0,931.84,7,730116.47,18,0,11,4,True
8121155,34,1,451,4231,518191198,0,0,0,931.69,7,729184.78,11,0,11,4,True
8465119,343,1,451,3941,518191198,0,0,0,931.96,7,728252.82,24,6,14,5,True
8549067,1110,0,20,3077,518191198,0,0,0,932.21,5,727320.61,0,3,17,5,True
8599930,1308,3,30,9693,518191198,0,0,0,932.1,8,726388.51,5,1,17,7,True
8632278,343,1,30,9134,518191198,0,0,0,932.01,8,725456.5,24,2,3,8,True
9031665,1401,1,-1,6041,518191198,0,1,0,931.92,1,725456.5,24,2,10,8,True
9241924,334,0,20,5313,518191198,0,0,0,931.97,5,724524.53,11,3,16,9,True
9733399,1308,3,451,7377,518191198,0,0,0,932.17,7,723592.36,5,1,5,10,True
9975287,665,2,-1,9750,518191198,0,1,0,931.92,4,723592.36,18,3,1,10,True
1003421,332,4,451,6261,179936822,0,0,0,889.1,7,779437.9,11,3,4,1,True
1054872,512,0,25,7919,179936822,0,0,0,888.76,8,778549.14,12,0,21,1,True
1078097,637,4,-1,2460,179936822,0,1,0,888.87,4,778549.14,24,1,7,1,True
1189036,332,4,451,3111,179936822,0,0,0,889.06,7,777660.08,11,4,4,3,True
1792807,630,0,10,3111,179936822,0,0,0,888.92,6,778549.0,11,4,9,3,True
1826556,512,0,451,8345,179936822,0,0,0,889.05,7,777659.95,12,1,17,3,True
2038094,297,0,20,8560,179936822,0,0,0,888.89,5,776771.06,4,0,0,3,False
2879852,679,0,20,8099,179936822,0,0,0,888.88,3,775882.18,24,0,20,5,True
3107445,513,4,451,1934,179936822,0,0,0,889.12,7,774993.06,12,0,19,5,True
3268531,470,1,10,4880,179936822,0,0,0,888.98,6,775882.04,5,4,4,6,True
3379219,513,4,25,4880,179936822,0,0,0,889.16,8,774992.88,12,1,22,7,True
3478741,584,0,20,4446,179936822,0,0,0,888.87,5,774104.01,11,6,8,8,True
3577960,398,0,20,1785,179936822,0,0,0,889.16,5,773214.85,10,2,20,8,True
3590177,513,4,451,7919,179936822,0,0,0,889.02,7,772325.83,12,6,23,9,True
3646132,512,0,451,7789,179936822,0,0,0,889.05,7,771436.78,12,5,1,10,True
3662650,931,0,10,2247,179936822,0,0,0,888.89,6,772325.67,24,6,5,10,True
3760903,305,1,10,4446,179936822,0,0,0,888.74,0,773214.41,4,5,11,11,True
3902900,513,4,30,1785,179936822,0,0,0,888.89,8,772325.52,12,1,8,11,True
3986814,653,1,10,2968,179936822,0,0,0,889.03,0,773214.55,24,4,3,1,True
4040586,1112,1,10,6371,179936822,0,0,0,889.15,6,774103.7,0,4,22,1,True
4124153,637,4,30,2161,179936822,0,0,0,889.13,8,773214.57,24,2,15,1,True
4365394,513,4,25,2460,179936822,0,0,0,889.0,8,772325.57,12,1,3,1,True
4395383,332,4,451,8560,179936822,0,0,0,889.05,7,771436.52,11,4,8,1,True
5065585,513,4,30,4239,179936822,0,0,0,888.98,8,770547.54,12,2,7,3,True
5223573,650,3,-1,4880,179936822,0,1,0,889.07,1,770547.54,24,0,18,3,True
5272295,716,0,20,1245,179936822,0,0,0,888.9,5,769658.64,18,6,13,4,True
5412227,512,0,25,8345,179936822,0,0,0,889.24,8,768769.4,12,3,7,4,True
5498008,58,2,25,2914,179936822,0,0,0,889.01,8,767880.39,20,2,19,5,False
5977433,58,2,30,8099,179936822,0,0,0,889.02,8,766991.37,20,4,12,5,True
5985438,513,4,451,3845,179936822,0,0,0,889.4,7,766101.97,12,1,19,5,True
6171653,332,4,-1,2552,179936822,0,1,0,888.95,4,766101.97,11,3,13,6,True
6225091,637,4,25,7825,179936822,0,0,0,888.87,8,765213.1,24,4,11,6,True
6336606,650,3,25,1785,179936822,0,0,0,889.06,8,764324.04,24,6,16,8,True
6456325,332,4,30,1785,179936822,0,0,0,888.97,8,763435.07,11,4,4,9,True
6730940,332,4,25,2552,179936822,0,0,0,889.18,8,762545.89,11,5,9,9,True
6764336,58,2,30,3166,179936822,0,0,0,888.8,8,761657.09,20,3,23,9,True
7227987,203,0,20,2552,179936822,0,0,0,888.79,5,760768.3,9,4,20,9,True
7263393,332,4,30,2968,179936822,0,0,0,889.01,8,759879.29,11,0,11,10,True
7599116,703,0,20,1245,179936822,0,0,0,888.94,5,758990.35,18,6,16,11,True
7715890,1471,0,10,1245,179936822,0,0,0,889.11,6,759879.46,24,4,1,12,True
7852199,535,0,20,1411,179936822,0,0,0,888.83,5,758990.63,18,4,3,1,True
8043947,513,4,451,8099,179936822,0,0,0,888.89,7,758101.74,12,2,13,2,False
8122215,332,4,451,7919,179936822,0,0,0,888.86,7,757212.88,11,6,13,3,True
8125496,513,4,451,3111,179936822,0,0,0,888.83,7,756324.05,12,1,17,3,True
8340279,513,4,25,2247,179936822,0,0,0,888.78,8,755435.27,12,1,17,5,True
8483397,637,4,30,1411,179936822,0,0,0,888.74,8,754546.53,24,6,7,6,True
8597594,513,4,451,6287,179936822,0,0,0,889.13,7,753657.4,12,0,12,7,True
8619976,650,3,30,7919,179936822,0,0,0,888.77,8,752768.63,24,3,5,8,True
8792461,513,4,30,1245,179936822,0,0,0,889.03,8,751879.6,12,6,19,8,True
8927658,1380,0,20,3666,179936822,0,0,0,889.02,3,750990.58,16,4,23,8,True
9041133,513,4,25,3111,179936822,0,0,0,888.86,8,750101.72,12,5,0,9,True
9051918,513,4,30,6957,179936822,0,0,0,888.89,8,749212.83,12,4,11,9,True
9308760,332,4,451,1934,179936822,0,0,0,889.08,7,748323.75,11,5,5,9,True
9325224,1140,0,10,2914,179936822,0,0,0,889.08,6,749212.83,15,0,19,10,True
9576802,650,3,-1,2460,179936822,0,1,0,888.82,1,749212.83,24,2,13,10,True
9672240,512,0,451,8345,179936822,0,0,0,889.06,7,748323.77,12,3,13,10,True
1430074,28,1,451,9313,654155968,0,0,0,542.87,7,530454.13,11,0,21,2,True
1453008,761,2,30,8016,654155968,0,0,0,542.88,8,529911.25,24,5,20,2,True
1933656,462,4,451,3750,654155968,0,0,0,542.88,7,529368.37,13,6,6,5,True
1979926,200,0,20,2821,654155968,0,0,0,542.86,5,528825.51,9,6,19,5,True
2302517,574,2,-1,8361,654155968,0,1,0,543.16,1,528825.51,11,4,21,5,False
2625180,1284,2,20,3701,654155968,0,0,0,543.08,5,528282.43,24,5,14,6,True
2629058,462,4,30,3701,654155968,0,0,0,542.94,8,527739.49,13,5,21,7,True
2979033,840,3,-1,2996,654155968,0,1,0,542.95,4,527739.49,5,2,0,9,True
3009453,574,2,451,3575,654155968,0,0,0,543.11,7,527196.38,11,0,6,9,True
3087606,462,4,-1,4309,654155968,0,1,0,543.23,4,527196.38,13,1,5,10,True
3215089,611,0,10,6062,654155968,0,0,0,543.11,6,527739.49,11,4,22,12,True
3271629,462,4,451,8938,654155968,0,0,0,542.74,7,527196.75,13,1,9,1,True
3957031,503,0,10,2996,654155968,0,0,0,543.02,6,527739.77,12,1,7,2,True
4001533,476,1,10,6620,654155968,0,0,0,543.15,0,528282.92,5,4,3,3,True
4022071,840,3,30,9198,654155968,0,0,0,542.87,8,527740.05,5,0,6,4,True
4247609,462,4,25,9955,654155968,0,0,0,542.94,8,527197.11,13,6,3,4,True
4395810,574,2,30,9313,654155968,0,0,0,543.16,8,526653.95,11,1,2,5,True
4608298,761,2,25,7292,654155968,0,0,0,542.78,8,526111.17,24,1,3,5,True
4885961,840,3,451,6454,654155968,0,0,0,542.77,7,525568.4,5,6,13,6,True
4965658,462,4,451,3750,654155968,0,0,0,543.02,7,525025.38,13,4,7,6,True
5018249,840,3,451,1001,654155968,0,0,0,543.22,7,524482.16,5,4,15,6,True
5210750,28,1,-1,9313,654155968,0,1,0,543.12,4,524482.16,11,3,15,7,False
5435554,574,2,25,2996,654155968,0,0,0,542.95,8,523939.21,11,4,13,7,True
5637321,1471,0,20,1595,654155968,0,0,0,542.85,5,523396.36,24,0,20,9,True
5751755,574,2,25,8938,654155968,0,0,0,542.8,8,522853.56,11,4,4,9,True
5863643,485,1,10,6062,654155968,0,0,0,542.88,0,523396.44,5,3,19,11,True
6198986,574,2,451,1790,654155968,0,0,0,542.7,7,522853.74,11,4,0,11,True
6343506,205,0,10,3575,654155968,0,0,0,542.77,6,523396.51,9,5,18,11,True
6577159,28,1,451,1790,654155968,0,0,0,543.22,7,522853.29,11,1,7,12,True
6806196,574,2,25,2996,654155968,0,0,0,542.94,8,522310.35,11,3,16,12,True
6858529,462,4,25,6254,654155968,0,0,0,543.1,8,521767.25,13,2,10,12,True
6886526,574,2,451,7292,654155968,0,0,0,542.8,7,521224.45,11,3,2,12,True
6926906,761,2,25,5128,654155968,0,0,0,543.08,8,520681.37,24,3,19,1,True
6986115,215,0,20,9327,654155968,0,0,0,543.06,5,520138.31,9,4,16,1,True
7033117,462,4,25,3575,654155968,0,0,0,542.86,8,519595.45,13,5,16,1,True
7063180,840,3,451,6620,654155968,0,0,0,542.9,7,519052.55,5,2,18,1,True
7318034,28,1,25,4309,654155968,0,0,0,543.17,8,518509.38,11,6,15,2,True
7403550,28,1,30,9327,654155968,0,0,0,542.85,8,517966.53,11,1,14,2,True
7532656,1315,0,10,2996,654155968,0,0,0,542.86,0,518509.39,5,6,8,3,True
7581675,28,1,451,6062,654155968,0,0,0,542.86,7,517966.53,11,3,0,3,True
7830670,28,1,30,9732,654155968,0,0,0,543.02,8,517423.51,11,4,8,4,True
7907661,129,0,10,3701,654155968,0,0,0,543.3,0,517966.81,18,6,9,4,True
8134377,462,4,451,9198,654155968,0,0,0,543.05,7,517423.76,13,1,9,4,True
8285827,522,0,10,9313,654155968,0,0,0,542.93,0,517966.69,18,5,16,5,True
8398774,1339,2,20,9198,654155968,0,0,0,543.0,5,517423.69,18,6,12,6,True
8689528,28,1,451,2996,654155968,0,0,0,543.11,7,516880.58,11,2,18,6,True
8786949,28,1,25,8938,654155968,0,0,0,543.14,8,516337.44,11,1,22,7,True
8848566,76,0,20,2821,654155968,0,0,0,543.31,3,515794.13,20,3,8,8,True
9161643,840,3,451,1001,654155968,0,0,0,543.05,7,515251.08,5,0,18,9,True
9432472,840,3,-1,6620,654155968,0,1,0,543.1,4,515251.08,5,6,16,10,True
9557298,318,0,20,6454,654155968,0,0,0,543.06,3,514708.02,11,5,2,10,True
9607582,574,2,30,1790,654155968,0,0,0,543.18,8,514164.84,11,0,15,10,True
9752236,840,3,25,1595,654155968,0,0,0,543.03,8,513621.81,5,6,13,11,True
9761399,840,3,25,8361,654155968,0,0,0,543.22,8,513078.59,5,4,18,11,True
9872486,462,4,451,5128,654155968,0,0,0,542.89,7,512535.7,13,1,6,11,True
1017250,1306,4,451,8276,830509311,1,0,0,660.01,7,602450.99,5,1,5,1,True
1203237,178,4,451,7623,830509311,1,0,0,660.07,7,601790.92,24,0,22,2,True
1703859,1035,0,20,9193,830509311,1,0,0,660.24,3,601130.68,11,2,8,2,True
1738082,422,4,25,5844,830509311,1,0,0,660.2,8,600470.48,18,6,4,2,True
1883984,488,3,451,2703,830509311,1,0,0,660.37,7,599810.11,12,2,9,3,True
1950343,1146,2,20,9239,830509311,1,0,0,659.74,5,599150.37,15,3,10,3,True
2065228,297,0,10,7946,830509311,1,0,0,660.31,0,599810.68,4,2,22,4,True
2718480,27,0,10,7623,830509311,1,0,0,659.76,0,600470.44,11,1,13,4,False
3203535,570,2,20,8235,830509311,1,0,0,659.99,3,599810.45,11,3,12,5,True
3267329,178,4,-1,3248,830509311,1,1,0,660.21,4,599810.45,24,4,19,5,True
3335037,1306,4,25,3134,830509311,1,0,0,659.64,8,599150.81,5,5,8,5,True
3529884,933,4,451,1755,830509311,1,0,0,660.25,7,598490.56,24,3,19,7,True
3572294,207,4,-1,9239,830509311,1,1,0,659.93,4,598490.56,9,1,9,9,True
3680493,1009,0,25,6282,830509311,1,0,0,659.96,8,597830.6,26,6,11,9,True
3730195,1306,4,25,8807,830509311,1,0,0,660.14,8,597170.46,5,6,14,10,True
3839009,503,0,10,6282,830509311,1,0,0,660.04,6,597830.5,12,5,16,10,True
4039954,933,4,25,3248,830509311,1,0,0,660.39,8,597170.11,24,1,12,10,True
4127209,488,3,25,6689,830509311,1,0,0,659.93,8,596510.18,12,1,16,10,True
4379534,897,0,10,6689,830509311,1,0,0,660.13,6,597170.31,24,2,10,12,True
4461809,933,4,25,6528,830509311,1,0,0,660.0,8,596510.31,24,5,3,1,False
4552493,207,4,30,7946,830509311,1,0,0,659.67,8,595850.64,9,2,20,1,True
4586286,488,3,-1,8671,830509311,1,1,0,660.05,1,595850.64,12,4,0,2,True
4877413,488,3,451,8323,830509311,1,0,0,660.27,7,595190.37,12,3,21,2,True
4879717,1245,1,10,8276,830509311,1,0,0,659.88,6,595850.25,18,0,4,2,False
4946985,1036,1,10,5363,830509311,1,0,0,659.99,0,596510.24,11,2,20,3,False
5070557,488,3,30,3248,830509311,1,0,0,659.98,8,595850.26,12,0,5,3,True
5072647,1306,4,451,5403,830509311,1,0,0,660.11,7,595190.15,5,2,8,6,True
5090505,437,4,30,6466,830509311,1,0,0,660.02,8,594530.13,24,2,12,6,True
5383819,178,4,-1,8276,830509311,1,1,0,659.99,4,594530.13,24,4,18,7,True
5608905,207,4,451,3359,830509311,1,0,0,660.23,7,593869.9,9,6,18,7,True
5619499,1306,4,-1,6528,830509311,1,1,0,660.08,4,593869.9,5,6,8,7,True
5792363,933,4,451,7623,830509311,1,0,0,660.15,7,593209.75,24,6,9,8,True
5802634,1306,4,30,6528,830509311,1,0,0,659.86,8,592549.89,5,4,20,8,True
5897718,422,4,-1,7623,830509311,1,1,0,660.2,1,592549.89,18,4,8,10,True
6156106,488,3,30,6689,830509311,1,0,0,659.94,8,591889.95,12,2,12,10,True
6184401,437,4,451,5790,830509311,1,0,0,659.91,7,591230.04,24,0,22,10,True
6304220,989,1,10,7623,830509311,1,0,0,660.23,6,591890.27,22,1,16,10,True
6494329,933,4,25,3407,830509311,1,0,0,660.05,8,591230.22,24,3,19,11,True
6550282,178,4,25,1428,830509311,1,0,0,659.95,8,590570.27,24,1,8,12,True
6929282,1306,4,451,1167,830509311,1,0,0,660.18,7,589910.09,5,4,13,12,True
6935709,422,4,-1,6282,830509311,1,1,0,659.89,4,589910.09,18,1,9,12,True
7159589,1306,4,451,2703,830509311,1,0,0,660.16,7,589249.93,5,5,11,1,True
7211239,437,4,451,2267,830509311,1,0,0,660.01,7,588589.92,24,0,19,1,True
7239547,1380,0,10,3359,830509311,1,0,0,660.05,6,589249.97,16,4,5,1,True
7340572,437,4,25,6689,830509311,1,0,0,659.63,8,588590.34,24,1,10,2,True
7419907,1306,4,451,1755,830509311,1,0,0,660.01,7,587930.33,5,5,6,3,True
7640445,850,1,10,3248,830509311,1,0,0,660.07,6,588590.4,5,0,11,3,True
8087538,1429,0,10,9511,830509311,1,0,0,659.91,6,589250.31,24,1,10,3,True
8234388,1390,0,20,8235,830509311,1,0,0,660.23,3,588590.08,24,5,20,3,True
8359126,780,0,20,5403,830509311,1,0,0,660.04,3,587930.04,14,4,21,4,True
8565841,933,4,25,5403,830509311,1,0,0,660.0,8,587270.04,24,2,4,5,True
8679016,1338,0,20,6689,830509311,1,0,0,660.12,5,586609.92,18,5,20,6,True
9263609,1009,0,-1,1428,830509311,1,1,0,660.12,4,586609.92,26,5,7,6,True
9610251,207,4,451,8235,830509311,1,0,0,659.94,7,585949.98,9,6,14,6,True
9615043,1277,2,20,9239,830509311,1,0,0,660.11,3,585289.87,24,5,20,8,True
9637661,1009,0,451,5844,830509311,1,0,0,660.17,7,584629.7,26,3,3,9,True
9716871,1363,0,10,3134,830509311,1,0,0,660.04,6,585289.74,16,6,8,9,True
9772186,1411,0,10,7623,830509311,1,0,0,660.05,6,585949.79,24,1,17,10,True
9929777,178,4,-1,3134,830509311,1,1,0,660.24,4,585949.79,24,1,13,11,True
1158653,1273,0,20,2947,255153350,1,0,0,824.97,3,692001.03,24,6,21,1,True
1161017,931,0,451,5826,255153350,1,0,0,824.91,7,691176.12,24,1,18,2,True
1428246,266,2,20,1932,255153350,1,0,0,825.3,5,690350.82,6,0,9,3,True
1455645,1298,0,451,1266,255153350,1,0,0,825.14,7,689525.68,5,4,17,4,True
1881509,1449,0,20,4245,255153350,1,0,0,824.64,5,688701.04,11,4,7,4,True
2197003,1298,0,30,1266,255153350,1,0,0,825.37,8,687875.67,5,1,0,4,True
2492526,1429,0,451,4127,255153350,1,0,0,825.31,7,687050.36,24,0,2,5,True
2533201,1191,4,-1,6999,255153350,1,1,0,824.73,4,687050.36,24,5,12,5,True
2755267,1298,0,451,2947,255153350,1,0,0,824.85,7,686225.51,5,6,17,5,True
2789222,1298,0,-1,4245,255153350,1,1,0,824.86,4,686225.51,5,6,18,6,True
2930591,464,1,-1,6999,255153350,1,2,0,825.4,1,686225.51,13,6,14,6,False
2944234,1298,0,451,3883,255153350,1,0,0,824.97,7,685400.54,5,0,7,7,True
3084325,471,0,20,1266,255153350,1,0,0,825.21,5,684575.33,5,2,11,7,True
3089592,503,0,20,1932,255153350,1,0,0,825.16,3,683750.17,12,4,19,7,True
3302695,1446,1,10,1932,255153350,1,0,0,824.98,6,684575.15,24,3,13,8,True
3509277,1270,1,10,9594,255153350,1,0,0,824.81,6,685399.96,23,6,12,9,False
3797210,677,0,25,9594,255153350,1,0,0,824.62,8,684575.34,24,5,20,10,True
3833861,1298,0,-1,4245,255153350,1,1,0,824.85,4,684575.34,5,1,12,10,True
3862394,1041,0,20,1503,255153350,1,0,0,824.96,5,683750.38,11,2,19,10,True
3936929,160,0,20,1932,255153350,1,0,0,825.22,5,682925.16,24,4,5,10,True
4034300,1298,0,25,1059,255153350,1,0,0,824.65,8,682100.51,5,3,3,11,True
4322325,1191,4,451,1503,255153350,1,0,0,824.9,7,681275.61,24,2,12,12,True
4422128,1191,4,25,4127,255153350,1,0,0,825.02,8,680450.59,24,6,9,2,True
4463557,1298,0,-1,1503,255153350,1,1,0,825.01,1,680450.59,5,5,15,3,True
4504074,1429,0,25,9594,255153350,1,0,0,824.83,8,679625.76,24,2,15,3,False
4666956,464,1,30,1503,255153350,1,0,0,825.24,8,678800.52,13,1,19,3,True
4828657,610,0,10,1059,255153350,1,0,0,824.81,0,679625.33,11,3,20,3,True
5172266,1137,1,10,9594,255153350,1,0,0,825.09,6,680450.42,24,1,8,4,True
5574389,1429,0,-1,1266,255153350,1,1,0,824.76,4,680450.42,24,1,1,5,True
5819748,1474,0,20,3495,255153350,1,0,0,825.17,5,679625.25,24,5,18,5,True
6009838,1298,0,451,2921,255153350,1,0,0,824.87,7,678800.38,5,2,6,6,True
6141084,1191,4,30,6999,255153350,1,0,0,825.08,8,677975.3,24,3,3,6,True
6213597,1244,4,451,3883,255153350,1,0,0,825.1,7,677150.2,18,4,22,7,True
6550048,1426,1,10,5826,255153350,1,0,0,824.99,6,677975.19,24,4,23,7,True
6584396,215,0,10,3495,255153350,1,0,0,824.69,6,678799.88,9,0,8,8,True
6918159,1244,4,25,3883,255153350,1,0,0,825.11,8,677974.77,18,3,21,8,True
7009922,931,0,-1,2921,255153350,1,1,0,825.09,1,677974.77,24,0,12,9,True
7266104,783,0,20,1468,255153350,1,0,0,825.1,5,677149.67,14,3,17,9,True
7372255,677,0,451,1266,255153350,1,0,0,824.89,7,676324.78,24,2,17,10,True
7493761,708,2,20,1266,255153350,1,0,0,824.91,3,675499.87,18,3,5,10,True
7499917,1244,4,451,2921,255153350,1,0,0,825.19,7,674674.68,18,6,7,10,True
7548018,350,0,20,3495,255153350,1,0,0,824.9,5,673849.78,24,0,4,11,True
7800184,358,4,451,1468,255153350,1,0,0,824.93,7,673024.85,24,3,1,1,True
7804324,358,4,451,3495,255153350,1,0,0,825.13,7,672199.72,24,0,12,2,True
7873799,1429,0,451,5826,255153350,1,0,0,825.1,7,671374.62,24,4,14,2,True
7985439,677,0,30,5826,255153350,1,0,0,824.95,8,670549.67,24,6,7,3,True
8093266,931,0,451,1059,255153350,1,0,0,824.95,7,669724.72,24,1,18,4,True
8134893,1298,0,451,2921,255153350,1,0,0,824.85,7,668899.87,5,1,22,4,True
8468159,1270,1,10,1059,255153350,1,0,0,825.24,0,669725.11,23,4,12,5,True
8544135,444,2,20,4245,255153350,1,0,0,825.12,3,668899.99,24,4,20,7,True
8754923,464,1,451,8903,255153350,1,0,0,824.85,7,668075.14,13,2,6,8,True
8772401,115,2,20,3883,255153350,1,0,0,825.15,5,667249.99,3,5,5,8,True
8940427,931,0,30,3883,255153350,1,0,0,824.96,8,666425.03,24,1,2,9,True
8992085,1298,0,-1,3883,255153350,1,1,0,825.12,4,666425.03,5,6,9,9,True
9153234,1191,4,30,9594,255153350,1,0,0,825.21,8,665599.82,24,3,21,10,True
9541272,1244,4,25,9594,255153350,1,0,0,825.13,8,664774.69,18,5,15,10,True
9780047,358,4,30,5826,255153350,1,0,0,825.26,8,663949.43,24,3,0,10,True
9817802,677,0,30,4127,255153350,1,0,0,824.72,8,663124.71,24,3,14,11,True
1021696,769,3,25,2963,720044336,1,0,0,528.14,8,72356.86,14,6,0,1,True
1029629,1224,4,25,9825,720044336,1,0,0,528.09,8,71828.77,24,1,14,2,True
1201986,1169,0,10,1766,720044336,1,0,0,528.21,6,72356.98,24,0,5,4,True
1243984,743,4,-1,4467,720044336,1,1,0,527.75,4,72356.98,24,2,22,4,True
1382390,611,0,10,9825,720044336,1,0,0,528.25,6,72885.23,11,4,14,4,True
1400694,1224,4,451,5420,720044336,1,0,0,527.98,7,72357.25,24,1,14,5,True
1696308,1064,0,10,1639,720044336,1,0,0,527.74,0,72884.99,11,4,8,6,True
1896999,297,0,10,3360,720044336,1,0,0,528.19,6,73413.18,4,4,11,6,True
1986991,743,4,25,2266,720044336,1,0,0,527.7,8,72885.48,24,0,21,6,True
2052858,743,4,25,2288,720044336,1,0,0,528.25,8,72357.23,24,6,5,7,True
2233432,429,0,451,5083,720044336,1,0,0,528.07,7,71829.16,24,3,1,7,True
2385746,84,4,30,2297,720044336,1,0,0,528.06,8,71301.1,1,1,18,9,True
2388147,429,0,451,2963,720044336,1,0,0,527.92,7,70773.18,24,1,15,10,True
2982185,1447,4,30,2963,720044336,1,0,0,527.92,8,70245.26,24,0,0,11,True
3161787,743,4,-1,2266,720044336,1,1,0,527.88,4,70245.26,24,3,18,11,True
3612867,180,0,20,8760,720044336,1,0,0,527.74,5,69717.52,18,3,15,12,True
3698038,147,0,20,2297,720044336,1,0,0,527.82,5,69189.7,18,5,17,12,True
3725485,429,0,451,8760,720044336,1,0,0,527.88,7,68661.82,24,0,0,12,True
4062780,833,4,30,4869,720044336,1,0,0,527.9,8,68133.92,5,0,21,1,True
4256565,429,0,25,2963,720044336,1,0,0,527.71,8,67606.21,24,0,13,1,True
4983900,743,4,30,2266,720044336,1,0,0,528.24,8,67077.97,24,6,10,1,True
5411141,1224,4,25,9825,720044336,1,0,0,528.07,8,66549.9,24,0,1,1,True
5481191,806,1,451,4467,720044336,1,0,0,528.07,7,66021.83,11,4,6,2,True
5500244,1380,0,10,4869,720044336,1,0,0,528.2,6,66550.03,16,6,5,2,True
6080503,833,4,451,4467,720044336,1,0,0,528.03,7,66022.0,5,1,15,2,True
6303289,806,1,451,6116,720044336,1,0,0,528.07,7,65493.93,11,4,1,3,True
6675068,1447,4,25,9871,720044336,1,0,0,528.06,8,64965.87,24,1,16,4,True
6687010,485,1,10,8760,720044336,1,0,0,528.06,6,65493.93,5,2,11,5,True
6928458,774,2,20,9580,720044336,1,0,0,527.93,5,64966.0,14,5,6,5,True
7064837,811,0,10,8760,720044336,1,0,0,528.13,6,65494.13,18,1,21,7,True
7282368,1447,4,30,2297,720044336,1,0,0,527.96,8,64966.17,24,4,20,8,True
7290916,1052,0,30,4869,720044336,1,0,0,527.89,8,64438.28,11,5,8,8,True
7451236,743,4,451,9825,720044336,1,0,0,528.06,7,63910.22,24,0,18,9,True
7488264,1224,4,451,9871,720044336,1,0,0,527.87,7,63382.35,24,3,19,9,True
7602349,1231,2,20,3525,720044336,1,0,0,527.99,5,62854.36,18,4,0,9,True
7776216,806,1,30,3525,720044336,1,0,0,528.09,8,62326.27,11,3,8,10,True
8475280,253,2,20,4741,720044336,1,0,0,528.12,5,61798.15,6,0,3,12,True
8704586,1271,0,10,2297,720044336,1,0,0,527.91,6,62326.06,23,4,16,1,True
8891981,84,4,30,2963,720044336,1,0,0,528.1,8,61797.96,1,4,6,3,True
8932596,84,4,451,4467,720044336,1,0,0,527.89,7,61270.07,1,0,16,4,True
9164445,1052,0,30,2288,720044336,1,0,0,528.28,8,60741.79,11,3,23,4,True
9271025,312,0,20,4741,720044336,1,0,0,527.79,3,60214.0,4,0,23,5,True
9290897,1447,4,451,2297,720044336,1,0,0,527.97,7,59686.03,24,5,16,5,True
9299398,1264,0,10,6116,720044336,1,0,0,528.0,0,60214.03,23,6,12,7,True
9414966,84,4,25,1639,720044336,1,0,0,528.27,8,59685.76,1,6,3,8,True
9451367,84,4,451,2297,720044336,1,0,0,527.92,7,59157.84,1,3,11,8,True
9494311,806,1,-1,9580,720044336,1,1,0,528.07,4,59157.84,11,3,0,9,True
9518594,1224,4,30,5083,720044336,1,0,0,528.17,8,58629.67,24,5,14,9,True
9533751,769,3,451,3606,720044336,1,0,0,527.88,7,58101.79,14,1,18,9,True
9680748,621,2,20,4467,720044336,1,0,0,528.05,5,57573.74,11,4,1,9,True
9763715,743,4,30,9825,720044336,1,0,0,527.97,8,57045.77,24,4,0,10,True
9983470,833,4,30,9871,720044336,1,0,0,528.04,8,56517.73,5,6,20,11,True
1064036,85,2,20,4727,117144351,1,0,0,536.1,5,214051.9,1,6,12,2,True
1070734,673,0,451,1512,117144351,1,0,0,536.14,7,213515.76,18,2,2,3,True
1160532,98,0,10,7449,117144351,1,0,0,536.16,6,214051.92,3,1,5,3,True
2037153,643,4,451,3832,117144351,1,0,0,535.81,7,213516.11,24,3,13,4,True
2234314,449,4,25,3136,117144351,1,0,0,536.12,8,212979.99,13,5,13,4,True
2510971,673,0,30,4727,117144351,1,0,0,536.22,8,212443.77,18,3,7,5,True
2528798,51,0,30,3136,117144351,1,0,0,535.99,8,211907.78,20,1,18,5,True
2573026,783,0,10,6113,117144351,1,0,0,536.05,0,212443.83,14,4,20,6,True
2656939,673,0,25,4727,117144351,1,0,0,535.89,8,211907.94,18,3,4,6,True
2735350,897,0,20,1512,117144351,1,0,0,536.15,3,211371.79,24,2,6,6,True
2888817,673,0,30,2998,117144351,1,0,0,536.1,8,210835.69,18,4,7,7,True
2908059,1338,0,25,1771,117144351,1,0,0,535.94,8,210299.75,18,4,8,8,True
3105600,189,4,-1,9703,117144351,1,1,0,535.97,1,210299.75,18,3,13,9,True
3118725,673,0,-1,6299,117144351,1,2,0,535.98,4,210299.75,18,5,21,9,True
3243326,51,0,30,6299,117144351,1,0,0,536.14,8,209763.61,20,0,5,10,True
3325434,448,0,451,1771,117144351,1,0,0,535.89,7,209227.72,13,3,10,10,True
3465240,643,4,25,4174,117144351,1,0,0,535.87,8,208691.85,24,2,15,11,True
3470125,643,4,25,9777,117144351,1,0,0,535.78,8,208156.07,24,6,16,11,True
3570505,448,0,25,7013,117144351,1,0,0,536.04,8,207620.03,13,5,20,12,True
3907911,1338,0,451,6299,117144351,1,0,0,536.2,7,207083.83,18,6,23,1,True
4147164,23,0,20,9667,117144351,1,0,0,535.93,5,206547.9,11,4,5,2,True
4265963,643,4,25,9667,117144351,1,0,0,536.09,8,206011.81,24,0,12,2,True
4298722,1338,0,-1,7013,117144351,1,1,0,536.28,4,206011.81,18,0,0,3,True
4319290,51,0,30,1512,117144351,1,0,0,536.27,8,205475.54,20,4,6,3,True
4486811,448,0,-1,6943,117144351,1,1,0,535.85,1,205475.54,13,1,21,3,True
4539169,616,1,10,6299,117144351,1,0,0,536.15,6,206011.69,11,3,19,4,True
4640836,1338,0,25,6299,117144351,1,0,0,536.18,8,205475.51,18,2,16,5,True
4643782,1205,0,10,7449,117144351,1,0,0,536.22,6,206011.73,24,5,13,7,True
4690179,448,0,451,1512,117144351,1,0,0,535.82,7,205475.91,13,4,15,8,True
4919414,316,2,20,3127,117144351,1,0,0,535.92,5,204939.99,4,5,15,8,True
5168984,449,4,451,5992,117144351,1,0,0,535.86,7,204404.13,13,2,2,9,True
5288274,279,2,20,7449,117144351,1,0,0,535.9,5,203868.23,24,1,4,9,True
5366773,1303,0,20,6402,117144351,1,0,0,535.9,3,203332.33,5,1,12,9,True
5379850,81,0,20,6196,117144351,1,0,0,535.9,5,202796.43,1,6,4,10,True
5743734,1119,0,10,5899,117144351,1,0,0,536.05,6,203332.48,24,0,10,10,True
5834951,449,4,451,9703,117144351,1,0,0,535.89,7,202796.59,13,2,0,10,True
5850554,189,4,451,4174,117144351,1,0,0,536.04,7,202260.55,18,5,16,10,True
6498589,448,0,451,4569,117144351,1,0,0,535.89,7,201724.66,13,2,8,11,True
6529633,449,4,451,1485,117144351,1,0,0,535.87,7,201188.79,13,3,10,11,True
6632770,570,2,20,1771,117144351,1,0,0,535.84,3,200652.95,11,1,5,12,True
7091665,189,4,30,4727,117144351,1,0,0,536.24,8,200116.71,18,0,22,12,True
7241249,1338,0,451,1512,117144351,1,0,0,536.03,7,199580.68,18,6,6,12,True
7306564,1146,2,20,3889,117144351,1,0,0,536.14,3,199044.54,15,5,12,1,True
7481785,867,0,20,4569,117144351,1,0,0,536.35,5,198508.19,24,5,10,3,True
7578854,476,1,10,1512,117144351,1,0,0,535.88,0,199044.07,5,2,7,3,True
7769984,309,0,10,3889,117144351,1,0,0,536.09,6,199580.16,4,6,4,4,True
7914088,643,4,-1,2998,117144351,1,1,0,536.07,4,199580.16,24,6,11,4,True
8005309,643,4,25,2453,117144351,1,0,0,536.2,8,199043.96,24,5,13,5,True
8042057,189,4,451,6943,117144351,1,0,0,535.77,7,198508.19,18,0,11,5,True
8111058,1307,0,10,9777,117144351,1,0,0,536.14,6,199044.33,5,5,8,5,True
8232693,189,4,451,7449,117144351,1,0,0,536.0,7,198508.33,18,5,11,6,True
8619476,1338,0,25,9667,117144351,1,0,0,536.04,8,197972.29,18,2,22,7,True
8875385,1338,0,30,2998,117144351,1,0,0,536.09,8,197436.2,18,0,19,7,True
9100115,673,0,25,9703,117144351,1,0,0,536.09,8,196900.11,18,6,23,7,True
9181782,96,0,10,6825,117144351,1,0,0,535.98,6,197436.09,1,1,17,8,True
9472150,673,0,25,3889,117144351,1,0,0,536.11,8,196899.98,18,6,15,9,True
9666386,189,4,-1,4174,117144351,1,1,0,536.13,4,196899.98,18,3,17,10,True
9701209,1039,1,10,6402,117144351,1,0,0,535.72,6,197435.7,11,2,2,10,True
9788952,643,4,30,1485,117144351,1,0,0,536.11,8,196899.59,24,6,2,11,True
1072703,1308,3,451,4096,855309763,0,0,0,609.92,7,367888.08,5,1,1,1,True
1350112,594,0,10,2147,855309763,0,0,0,609.95,6,368498.03,24,2,21,1,True
1383779,1443,4,-1,8199,855309763,0,1,0,610.04,1,368498.03,24,3,0,1,True
1426582,1308,3,451,1102,855309763,0,0,0,609.91,7,367888.12,5,1,14,2,True
1558593,588,0,-1,3233,855309763,0,1,0,609.99,4,367888.12,24,3,10,2,False
1649807,1421,0,10,3254,855309763,0,0,0,609.91,6,368498.03,24,6,8,2,True
1904292,253,2,25,5707,855309763,0,0,0,610.09,8,367887.94,6,3,5,3,True
2097763,1318,0,10,4601,855309763,0,0,0,609.82,0,368497.76,18,4,18,4,True
2146206,1308,3,-1,8328,855309763,0,1,0,609.86,4,368497.76,5,5,23,4,True
2426157,253,2,451,6718,855309763,0,0,0,610.2,7,367887.56,6,2,6,4,True
2456261,1443,4,451,6190,855309763,0,0,0,609.98,7,367277.58,24,4,23,5,True
2887307,1308,3,25,8880,855309763,0,0,0,610.05,8,366667.53,5,2,21,5,True
2984249,1443,4,-1,4601,855309763,0,1,0,609.96,4,366667.53,24,2,21,6,True
3023702,1443,4,451,1598,855309763,0,0,0,609.85,7,366057.68,24,0,6,8,True
3196161,372,0,10,2147,855309763,0,0,0,609.95,0,366667.63,25,0,4,10,True
3373004,831,1,10,8880,855309763,0,0,0,609.93,0,367277.56,5,2,8,10,True
3524834,607,2,30,8880,855309763,0,0,0,609.9,8,366667.66,24,3,21,11,True
3685286,1443,4,451,3011,855309763,0,0,0,609.99,7,366057.67,24,4,18,12,True
3872307,588,0,451,8199,855309763,0,0,0,610.12,7,365447.55,24,5,13,12,True
3931718,1308,3,30,3596,855309763,0,0,0,610.24,8,364837.31,5,5,22,12,True
3943036,607,2,451,3596,855309763,0,0,0,610.01,7,364227.3,24,6,19,1,True
3946161,588,0,451,5707,855309763,0,0,0,609.87,7,363617.43,24,3,12,2,True
4256501,860,1,10,1102,855309763,0,0,0,609.98,6,364227.41,24,1,23,2,True
4389188,588,0,25,5707,855309763,0,0,0,610.16,8,363617.25,24,6,8,2,True
4975466,1390,0,10,4601,855309763,0,0,0,610.16,6,364227.41,24,2,5,4,True
5019765,563,4,451,4096,855309763,0,0,0,609.94,7,363617.47,17,1,9,4,True
5239958,588,0,25,5149,855309763,0,0,0,609.73,8,363007.74,24,2,7,5,True
5510749,563,4,451,8328,855309763,0,0,0,610.19,7,362397.55,17,1,20,5,True
5572192,253,2,451,6190,855309763,0,0,0,610.16,7,361787.39,6,2,5,5,True
5721671,253,2,30,4096,855309763,0,0,0,610.19,8,361177.2,6,4,8,5,True
5782520,1308,3,451,1102,855309763,0,0,0,609.81,7,360567.39,5,1,20,6,True
5844521,304,0,20,9772,855309763,0,0,0,610.13,3,359957.26,4,2,10,6,True
5970555,703,0,20,2884,855309763,0,0,0,610.23,5,359347.03,18,0,21,7,True
6097323,607,2,451,5191,855309763,0,0,0,609.87,7,358737.16,24,1,3,10,True
6153454,1308,3,451,8328,855309763,0,0,0,609.55,7,358127.61,5,0,2,10,True
6250437,1443,4,30,9566,855309763,0,0,0,610.01,8,357517.6,24,6,3,11,True
6294074,1308,3,25,1102,855309763,0,0,0,610.08,8,356907.52,5,5,0,12,True
6300057,903,3,451,1598,855309763,0,0,0,609.99,7,356297.53,2,3,7,12,True
6518604,607,2,25,9566,855309763,0,0,0,609.98,8,355687.55,24,5,1,12,True
6541801,1377,0,10,2884,855309763,0,0,0,609.79,6,356297.34,16,6,4,12,True
7561971,253,2,30,5191,855309763,0,0,0,609.86,8,355687.48,6,0,9,1,True
7645042,1308,3,451,5149,855309763,0,0,0,610.18,7,355077.3,5,3,10,1,True
7721287,1443,4,-1,2884,855309763,0,1,0,610.0,1,355077.3,24,5,9,1,True
8083963,588,0,-1,8199,855309763,0,2,0,609.92,4,355077.3,24,2,23,2,True
8100047,607,2,25,2851,855309763,0,0,0,609.87,8,354467.43,24,2,13,2,True
8148176,588,0,-1,6718,855309763,0,1,0,610.01,4,354467.43,24,6,23,3,True
8212381,607,2,-1,3254,855309763,0,2,0,609.78,4,354467.43,24,2,17,3,True
8251409,253,2,30,3011,855309763,0,0,0,610.29,8,353857.14,6,2,22,3,True
8535073,588,0,451,4601,855309763,0,0,0,610.03,7,353247.11,24,3,3,3,True
8655839,253,2,25,3011,855309763,0,0,0,610.38,8,352636.73,6,2,1,4,True
8775243,607,2,25,4096,855309763,0,0,0,610.08,8,352026.65,24,5,14,4,False
8831972,607,2,451,6718,855309763,0,0,0,609.97,7,351416.68,24,0,7,5,True
8891120,607,2,30,5707,855309763,0,0,0,609.95,8,350806.73,24,0,22,5,True
9193407,253,2,451,1102,855309763,0,0,0,609.8,7,350196.93,6,1,20,5,True
9312838,1443,4,-1,1598,855309763,0,1,0,609.96,4,350196.93,24,1,13,9,True
9343015,989,1,10,1598,855309763,0,0,0,609.91,0,350806.84,22,5,21,9,True
9440534,1308,3,25,8199,855309763,0,0,0,610.08,8,350196.76,5,5,10,10,True
9459727,903,3,25,6718,855309763,0,0,0,610.1,8,349586.66,2,1,8,11,True
1087528,611,0,10,9426,372131824,0,0,0,381.07,6,991518.07,11,4,10,1,True
1288775,353,1,10,7211,372131824,0,0,0,381.09,0,991899.16,24,6,22,2,True
1434106,522,0,10,8428,372131824,0,0,0,381.07,6,992280.23,18,0,13,2,True
1578455,1015,0,-1,7211,372131824,0,1,0,380.84,4,992280.23,26,5,8,4,True
1758409,444,2,20,9157,372131824,0,0,0,380.85,5,991899.38,24,4,9,4,True
1880241,1436,0,-1,7639,372131824,0,1,0,380.7,4,991899.38,24,0,8,5,False
1962491,1382,0,20,4166,372131824,0,0,0,381.17,5,991518.21,16,2,12,5,False
2564823,131,4,451,7639,372131824,0,0,0,380.95,7,991137.26,18,6,2,6,True
2783754,940,1,451,7211,372131824,0,0,0,381.04,7,990756.22,24,2,22,6,True
2836034,1436,0,30,7211,372131824,0,0,0,380.65,8,990375.57,24,1,13,8,True
3042595,319,0,10,9001,372131824,0,0,0,380.78,6,990756.35,11,1,19,9,True
3085041,63,3,451,9769,372131824,0,0,0,380.8,7,990375.55,20,0,13,10,True
3191517,1015,0,-1,9426,372131824,0,1,0,381.15,4,990375.55,26,4,7,11,True
3227870,877,2,20,1186,372131824,0,0,0,381.01,5,989994.54,24,0,5,12,True
3404124,226,4,30,7919,372131824,0,0,0,381.15,8,989613.39,26,2,11,12,True
3577632,63,3,30,9769,372131824,0,0,0,380.85,8,989232.54,20,5,8,12,True
4108851,1339,2,20,1186,372131824,0,0,0,381.19,3,988851.35,18,4,14,1,True
4230400,226,4,451,3858,372131824,0,0,0,381.05,7,988470.3,26,1,22,2,True
4414417,940,1,30,9139,372131824,0,0,0,380.91,8,988089.39,24,3,7,2,True
4571098,695,2,20,7639,372131824,0,0,0,380.96,5,987708.43,24,5,1,2,True
4592861,1436,0,25,1433,372131824,0,0,0,381.03,8,987327.4,24,6,18,4,True
4869866,131,4,-1,8605,372131824,0,1,0,381.04,4,987327.4,18,2,13,4,True
4937365,131,4,451,9139,372131824,0,0,0,380.98,7,986946.42,18,6,0,5,True
5095631,653,1,10,1530,372131824,0,0,0,381.22,6,987327.64,24,0,17,5,True
5270841,131,4,451,3858,372131824,0,0,0,380.92,7,986946.72,18,1,2,8,True
5298393,63,3,-1,9426,372131824,0,1,0,380.97,1,986946.72,20,1,16,8,True
5886036,465,0,20,1530,372131824,0,0,0,380.77,3,986565.95,13,2,17,10,True
6254741,1015,0,451,2320,372131824,0,0,0,380.89,7,986185.06,26,1,0,11,True
6339745,131,4,451,9336,372131824,0,0,0,380.91,7,985804.15,18,3,6,11,True
6464961,145,0,10,4166,372131824,0,0,0,380.85,0,986185.0,18,4,23,12,True
6652921,287,0,10,9157,372131824,0,0,0,381.0,6,986566.0,24,3,17,12,True
6720182,226,4,30,9336,372131824,0,0,0,381.05,8,986184.95,26,4,16,12,True
6757857,1436,0,451,9426,372131824,0,0,0,380.94,7,985804.01,24,5,16,3,True
6992927,1015,0,451,8516,372131824,0,0,0,380.9,7,985423.11,26,4,7,3,True
7615810,940,1,30,4318,372131824,0,0,0,381.15,8,985041.96,24,0,0,3,True
7683865,1152,0,10,4318,372131824,0,0,0,381.07,0,985423.03,15,4,9,4,True
7951534,63,3,-1,2320,372131824,0,1,0,380.89,1,985423.03,20,5,3,4,True
8077637,880,1,10,4318,372131824,0,0,0,380.83,6,985803.86,27,6,9,4,True
8302426,1065,0,10,8428,372131824,0,0,0,380.98,6,986184.84,11,3,0,5,True
8422755,834,0,10,4166,372131824,0,0,0,381.27,6,986566.11,5,4,8,5,True
9157301,267,0,20,1530,372131824,0,0,0,380.96,5,986185.15,6,1,21,6,True
9357200,1436,0,451,8605,372131824,0,0,0,381.23,7,985803.92,24,5,9,7,True
9551678,940,1,451,9157,372131824,0,0,0,380.95,7,985422.97,24,2,21,7,True
9626848,940,1,-1,9001,372131824,0,1,0,380.8,1,985422.97,24,0,13,7,True
9632474,1352,1,10,4166,372131824,0,0,0,380.71,0,985803.68,24,3,9,9,True
9778551,131,4,451,1186,372131824,0,0,0,381.23,7,985422.45,18,4,20,9,True
9785700,1436,0,25,7211,372131824,0,0,0,380.79,8,985041.66,24,3,23,9,True
9816641,1436,0,25,9139,372131824,0,0,0,380.7,8,984660.96,24,4,2,10,True
9851104,226,4,-1,3981,372131824,0,1,0,381.09,4,984660.96,26,0,0,10,True
9962703,1015,0,-1,9139,372131824,0,2,0,381.38,4,984660.96,26,1,16,11,True
1000226,832,3,25,1268,174664493,0,0,0,1176.94,8,510161.06,5,2,2,1,True
1009449,832,3,25,9096,174664493,0,0,0,1177.19,8,508983.87,5,2,8,2,True
1204755,268,2,20,9969,174664493,0,0,0,1176.78,5,507807.09,24,1,8,2,True
1406520,608,4,25,6866,174664493,0,0,0,1177.24,8,506629.85,24,3,21,2,True
1715319,44,4,25,9686,174664493,0,0,0,1177.01,8,505452.84,24,5,4,3,True
1721793,44,4,30,6392,174664493,0,0,0,1176.98,8,504275.86,24,4,2,4,True
1745321,463,1,10,8493,174664493,0,0,0,1177.02,6,505452.88,13,0,12,5,True
1952992,603,0,10,8474,174664493,0,0,0,1176.9,6,506629.78,24,5,6,5,True
2110439,608,4,30,9069,174664493,0,0,0,1177.28,8,505452.5,24,0,14,5,True
2408147,832,3,30,4722,174664493,0,0,0,1177.09,8,504275.41,5,4,9,7,True
2515576,1212,0,10,6937,174664493,0,0,0,1177.14,6,505452.55,24,4,10,7,True
2717726,857,1,10,5891,174664493,0,0,0,1177.12,0,506629.67,24,0,8,8,True
2762423,1421,0,10,9686,174664493,0,0,0,1176.98,0,507806.65,24,4,15,8,True
2906843,644,0,10,3435,174664493,0,0,0,1177.22,6,508983.87,24,2,23,9,True
2964873,867,0,10,9686,174664493,0,0,0,1176.89,6,510160.76,24,6,15,9,True
3023807,1328,4,451,1268,174664493,0,0,0,1177.05,7,508983.71,18,4,12,10,True
3038282,599,0,20,6375,174664493,0,0,0,1177.18,5,507806.53,24,3,0,12,True
3052480,337,1,10,4397,174664493,0,0,0,1177.34,6,508983.87,11,2,18,12,True
3084726,1328,4,-1,8963,174664493,0,1,0,1177.08,4,508983.87,18,4,10,1,True
3137565,1227,0,10,5891,174664493,0,0,0,1176.96,0,510160.83,18,5,15,1,True
4341589,1328,4,30,8963,174664493,0,0,0,1177.08,8,508983.75,18,4,10,3,True
4367843,916,0,-1,1268,174664493,0,1,0,1177.12,4,508983.75,18,5,22,3,True
4983692,249,0,10,9112,174664493,0,0,0,1176.87,0,510160.62,6,2,17,5,True
5061483,608,4,-1,8493,174664493,0,1,0,1177.2,1,510160.62,24,3,1,5,True
5131289,44,4,-1,9096,174664493,0,2,0,1177.05,1,510160.62,24,0,19,6,True
5238199,51,0,20,4559,174664493,0,0,0,1176.79,5,508983.83,20,6,22,6,True
5265025,621,2,20,4397,174664493,0,0,0,1177.16,5,507806.67,11,0,23,6,True
5333823,712,0,25,1189,174664493,0,0,0,1177.03,8,506629.64,18,4,4,6,True
5664824,608,4,30,9969,174664493,0,0,0,1177.02,8,505452.62,24,3,3,7,True
6067304,1328,4,25,1916,174664493,0,0,0,1176.89,8,504275.73,18,2,4,7,True
6077194,44,4,451,4397,174664493,0,0,0,1177.16,7,503098.57,24,4,17,7,True
6424462,628,0,20,8474,174664493,0,0,0,1177.13,5,501921.44,11,5,13,7,True
6470144,726,0,451,6375,174664493,0,0,0,1176.9,7,500744.54,11,0,11,8,True
6591691,726,0,-1,4722,174664493,0,1,0,1177.04,1,500744.54,11,0,14,8,True
6820808,1328,4,30,6612,174664493,0,0,0,1176.97,8,499567.57,18,2,10,8,True
6920004,1328,4,30,1697,174664493,0,0,0,1177.01,8,498390.56,18,3,6,10,True
6937479,916,0,25,4559,174664493,0,0,0,1177.17,8,497213.39,18,4,0,11,True
7193382,334,0,20,6612,174664493,0,0,0,1177.05,3,496036.34,11,6,9,11,True
7433147,1328,4,-1,8787,174664493,0,1,0,1177.15,1,496036.34,18,5,8,1,True
7449560,1000,0,20,4722,174664493,0,0,0,1176.9,5,494859.44,26,3,18,1,True
7485342,726,0,451,3435,174664493,0,0,0,1176.96,7,493682.48,11,0,13,1,False
7608406,608,4,25,9096,174664493,0,0,0,1176.92,8,492505.56,24,0,20,3,True
7704199,1461,0,10,9069,174664493,0,0,0,1177.12,6,493682.68,11,5,7,3,True
7820752,967,1,10,1268,174664493,0,0,0,1176.95,6,494859.63,13,6,2,5,True
8013333,916,0,25,6866,174664493,0,0,0,1176.9,8,493682.73,18,0,14,5,True
8088675,1328,4,30,4722,174664493,0,0,0,1177.1,8,492505.63,18,3,14,5,True
8099450,916,0,451,9686,174664493,0,0,0,1177.38,7,491328.25,18,5,14,6,True
8212844,916,0,30,2070,174664493,0,0,0,1177.05,8,490151.2,18,2,22,6,True
8235199,608,4,-1,8184,174664493,0,1,0,1176.84,4,490151.2,24,6,19,6,True
8301721,1041,0,10,5891,174664493,0,0,0,1177.07,6,491328.27,11,5,6,7,True
8523999,1217,0,10,4722,174664493,0,0,0,1176.87,0,492505.14,24,2,9,7,False
8578101,46,1,10,6392,174664493,0,0,0,1177.04,6,493682.18,24,5,1,7,True
8594819,1328,4,25,4397,174664493,0,0,0,1177.09,8,492505.09,18,2,21,8,True
8682160,1239,1,10,8666,174664493,0,0,0,1176.89,6,493681.98,18,4,9,8,True
8759089,1328,4,451,2322,174664493,0,0,0,1177.06,7,492504.92,18,1,5,10,True
8824874,712,0,451,1189,174664493,0,0,0,1177.34,7,491327.58,18,2,2,10,True
9636223,1328,4,-1,6937,174664493,0,1,0,1177.05,4,491327.58,18,5,21,10,True
9686473,1246,0,10,8474,174664493,0,0,0,1176.83,0,492504.41,23,2,22,10,True
9815741,726,0,25,6569,174664493,0,0,0,1176.73,8,491327.68,11,1,8,11,True
1034623,16,4,30,8534,787931501,1,0,0,993.92,8,903456.08,24,4,23,1,True
1113116,16,4,25,1358,787931501,1,0,0,994.05,8,902462.03,24,1,1,1,True
1768989,16,4,30,6280,787931501,1,0,0,993.86,8,901468.17,24,0,17,1,True
2219584,16,4,451,3631,787931501,1,0,0,994.0,7,900474.17,24,3,9,1,True
2607263,1404,2,20,1280,787931501,1,0,0,994.2,5,899479.97,24,5,22,2,True
2997504,117,1,451,5082,787931501,1,0,0,993.92,7,898486.05,18,3,1,2,True
3009020,479,2,25,7554,787931501,1,0,0,994.13,8,897491.92,5,5,17,2,True
3057838,1468,1,10,7463,787931501,1,0,0,994.06,6,898485.98,11,4,0,3,True
3366750,184,0,10,1280,787931501,1,0,0,993.9,0,899479.88,18,4,1,4,True
3724851,465,0,20,6474,787931501,1,0,0,994.12,5,898485.76,13,3,23,5,True
3891983,1159,0,20,7696,787931501,1,0,0,994.05,3,897491.71,15,6,11,5,True
3899679,287,0,30,6474,787931501,1,0,0,993.95,8,896497.76,24,1,2,5,True
3930357,1151,4,451,7463,787931501,1,0,0,993.88,7,895503.88,15,2,2,5,True
4194896,1151,4,25,9831,787931501,1,0,0,993.82,8,894510.06,15,4,16,6,True
4312218,655,3,30,5082,787931501,1,0,0,993.87,8,893516.19,18,3,8,7,True
4318294,417,3,25,3706,787931501,1,0,0,994.12,8,892522.07,18,3,5,7,True
4535848,655,3,30,5476,787931501,1,0,0,993.92,8,891528.15,18,4,17,7,True
4711187,1034,1,25,8596,787931501,1,0,0,994.06,8,890534.09,11,3,19,7,True
4711763,781,1,10,8534,787931501,1,0,0,993.95,6,891528.04,14,4,21,9,True
4842939,16,4,451,9544,787931501,1,0,0,994.02,7,890534.02,24,5,15,9,True
5118179,1034,1,30,3526,787931501,1,0,0,994.04,8,889539.98,11,0,8,10,True
5488268,979,0,20,8019,787931501,1,0,0,993.93,5,888546.05,22,2,9,12,True
5626755,287,0,25,9831,787931501,1,0,0,993.96,8,887552.09,24,4,19,12,True
5904058,1173,1,10,4998,787931501,1,0,0,993.95,0,888546.04,24,3,21,2,True
5982439,16,4,30,6714,787931501,1,0,0,994.0,8,887552.04,24,1,20,2,True
6003603,16,4,451,4998,787931501,1,0,0,993.81,7,886558.23,24,5,2,3,True
6054712,16,4,25,3597,787931501,1,0,0,993.97,8,885564.26,24,2,7,3,True
6261060,479,2,451,9544,787931501,1,0,0,993.93,7,884570.33,5,2,8,3,True
6417535,417,3,30,4998,787931501,1,0,0,994.28,8,883576.05,18,3,12,4,True
6441583,591,0,30,5082,787931501,1,0,0,994.15,8,882581.9,24,0,7,4,True
6452183,16,4,25,1358,787931501,1,0,0,993.9,8,881588.0,24,2,17,4,True
6517122,1363,0,20,7589,787931501,1,0,0,993.84,5,880594.16,16,0,14,4,True
6531094,591,0,25,9038,787931501,1,0,0,993.91,8,879600.25,24,4,17,6,True
6548250,591,0,451,3706,787931501,1,0,0,994.07,7,878606.18,24,4,6,6,True
6558065,16,4,30,6601,787931501,1,0,0,993.93,8,877612.25,24,3,0,7,True
6572001,860,1,10,1280,787931501,1,0,0,994.03,0,878606.28,24,1,18,8,True
6821987,427,2,20,1358,787931501,1,0,0,993.77,5,877612.51,18,0,8,8,True
6993431,200,0,20,3631,787931501,1,0,0,993.99,5,876618.52,9,2,20,8,True
7129826,1125,1,10,3631,787931501,1,0,0,993.96,6,877612.48,24,1,17,9,True
7144639,655,3,451,4840,787931501,1,0,0,994.07,7,876618.41,18,0,3,9,True
7226362,287,0,451,7589,787931501,1,0,0,994.03,7,875624.38,24,2,10,9,True
7366618,117,1,-1,1280,787931501,1,1,0,994.23,4,875624.38,18,3,15,10,True
7468089,287,0,451,1545,787931501,1,0,0,993.98,7,874630.4,24,4,14,10,True
7612577,312,0,20,6477,787931501,1,0,0,994.01,3,873636.39,4,0,23,10,True
7926222,655,3,451,3631,787931501,1,0,0,994.1,7,872642.29,18,4,9,11,True
7981620,591,0,-1,7554,787931501,1,1,0,994.09,1,872642.29,24,6,17,12,True
7997498,16,4,451,5082,787931501,1,0,0,994.31,7,871647.98,24,2,7,12,True
8028248,708,2,20,2943,787931501,1,0,0,993.99,5,870653.99,18,6,17,1,True
8081657,417,3,451,7463,787931501,1,0,0,994.19,7,869659.8,18,3,4,2,True
8496710,1151,4,25,7589,787931501,1,0,0,994.07,8,868665.73,15,3,15,2,False
9000205,417,3,-1,6474,787931501,1,1,0,993.96,4,868665.73,18,6,12,3,True
9050714,1151,4,25,6477,787931501,1,0,0,994.02,8,867671.71,15,4,23,5,True
9064251,655,3,25,3631,787931501,1,0,0,993.93,8,866677.78,18,6,16,7,True
9204919,417,3,451,6714,787931501,1,0,0,994.06,7,865683.72,18,0,11,9,True
9518447,479,2,451,6714,787931501,1,0,0,994.17,7,864689.55,5,1,14,10,True
9526110,580,0,20,1545,787931501,1,0,0,993.81,5,863695.74,11,0,22,10,True
9841400,479,2,30,9786,787931501,1,0,0,994.0,8,862701.74,5,5,13,11,True
9874668,16,4,451,7554,787931501,1,0,0,994.14,7,861707.6,24,3,18,11,True
9981602,117,1,25,6477,787931501,1,0,0,993.82,8,860713.78,18,0,23,11,False
1027631,191,3,30,6633,942167558,0,0,0,267.17,8,528035.83,18,0,10,1,True
1357194,1025,1,10,2309,942167558,0,0,0,267.04,6,528302.87,11,4,19,1,True
1850057,127,1,451,2691,942167558,0,0,0,267.02,7,528035.85,18,0,17,2,True
1973889,129,0,20,2691,942167558,0,0,0,266.92,5,527768.93,18,2,13,3,True
2039365,127,1,451,2406,942167558,0,0,0,266.92,7,527502.01,18,6,0,3,True
2209829,191,3,30,3218,942167558,0,0,0,267.08,8,527234.93,18,2,3,3,True
3026930,1482,3,451,1114,942167558,0,0,0,267.04,7,526967.89,24,4,15,4,True
3294011,736,1,10,9063,942167558,0,0,0,267.2,0,527235.09,11,4,4,5,True
3455171,1486,2,20,8277,942167558,0,0,0,266.84,5,526968.25,24,4,15,6,True
3853403,449,4,-1,2309,942167558,0,1,0,266.84,4,526968.25,13,6,17,7,True
3952865,297,0,10,2691,942167558,0,0,0,267.11,6,527235.36,4,6,18,8,True
4184676,191,3,25,7380,942167558,0,0,0,267.04,8,526968.32,18,6,13,9,True
4316765,291,3,-1,9063,942167558,0,1,0,267.02,4,526968.32,24,2,5,9,True
4416265,191,3,451,6633,942167558,0,0,0,266.99,7,526701.33,18,0,5,10,True
4579296,1246,0,10,7380,942167558,0,0,0,267.01,6,526968.34,23,0,10,11,True
4615647,191,3,451,2691,942167558,0,0,0,267.0,7,526701.34,18,1,12,11,True
4719488,29,0,10,4432,942167558,0,0,0,266.83,0,526968.17,11,6,7,1,True
4887330,112,4,451,6388,942167558,0,0,0,267.1,7,526701.07,3,1,5,2,True
5009582,112,4,30,4467,942167558,0,0,0,266.78,8,526434.29,3,1,10,2,True
5319376,291,3,-1,6900,942167558,0,1,0,267.0,4,526434.29,24,3,3,4,True
5479949,127,1,451,4467,942167558,0,0,0,266.83,7,526167.46,18,5,1,4,True
5516311,127,1,451,1114,942167558,0,0,0,267.11,7,525900.35,18,0,2,7,True
5523383,502,0,20,1955,942167558,0,0,0,267.21,5,525633.14,12,1,20,7,True
5552123,291,3,451,2802,942167558,0,0,0,267.01,7,525366.13,24,0,7,7,True
5783908,695,2,25,4432,942167558,0,0,0,266.89,8,525099.24,24,2,18,8,True
6287870,989,1,10,6388,942167558,0,0,0,266.94,0,525366.18,22,4,1,8,True
6316398,427,2,20,7002,942167558,0,0,0,267.1,5,525099.08,18,2,3,8,True
6368499,801,4,-1,1955,942167558,0,1,0,266.88,4,525099.08,11,0,22,8,True
6484541,127,1,451,2309,942167558,0,0,0,267.26,7,524831.82,18,6,12,11,True
6575783,291,3,25,2406,942167558,0,0,0,267.13,8,524564.69,24,1,1,11,True
6965745,112,4,451,7613,942167558,0,0,0,266.93,7,524297.76,3,0,12,12,True
7587002,897,0,20,6900,942167558,0,0,0,267.05,5,524030.71,24,5,16,1,True
7615929,191,3,-1,4467,942167558,0,1,0,266.92,1,524030.71,18,5,11,2,True
8250897,191,3,-1,3218,942167558,0,2,0,266.88,4,524030.71,18,6,5,3,True
8456896,1482,3,451,6633,942167558,0,0,0,266.97,7,523763.74,24,1,5,3,True
8472859,127,1,25,6071,942167558,0,0,0,267.04,8,523496.7,18,1,20,4,True
8526711,1413,0,20,6633,942167558,0,0,0,266.87,5,523229.83,24,3,21,4,True
8810372,1270,1,10,6388,942167558,0,0,0,267.12,6,523496.95,23,3,5,5,True
8825280,1482,3,-1,6388,942167558,0,1,0,267.05,4,523496.95,24,3,23,5,True
8873467,662,1,10,4432,942167558,0,0,0,266.91,0,523763.86,18,4,18,5,True
9100667,204,0,20,6900,942167558,0,0,0,267.0,5,523496.86,9,4,12,5,True
9151199,1180,1,10,9063,942167558,0,0,0,267.25,6,523764.11,24,0,21,6,True
9250436,449,4,25,4467,942167558,0,0,0,267.09,8,523497.02,13,4,8,7,True
9618998,449,4,25,4432,942167558,0,0,0,266.9,8,523230.12,13,6,9,8,False
9655708,1425,0,10,7054,942167558,0,0,0,267.13,6,523497.25,24,1,4,8,True
9661825,112,4,451,7054,942167558,0,0,0,266.88,7,523230.37,3,0,0,8,True
9666165,59,0,10,7613,942167558,0,0,0,267.21,6,523497.58,20,3,15,9,False
9747415,695,2,30,8277,942167558,0,0,0,267.09,8,523230.49,24,2,12,9,True
9842571,695,2,30,7002,942167558,0,0,0,266.84,8,522963.65,24,0,10,9,True
9928100,191,3,451,7002,942167558,0,0,0,267.1,7,522696.55,18,1,3,9,True
9979902,695,2,25,4655,942167558,0,0,0,267.33,8,522429.22,24,4,4,10,True
1110285,369,1,30,5594,498979888,1,0,0,1098.91,8,526053.09,25,2,3,2,True
1161946,375,4,30,9845,498979888,1,0,0,1099.06,8,524954.03,25,4,7,2,True
1480522,1145,4,25,1610,498979888,1,0,0,1098.88,8,523855.15,15,1,14,2,True
1753072,1342,3,-1,8852,498979888,1,1,0,1098.93,4,523855.15,24,5,0,3,True
1817131,861,4,25,9634,498979888,1,0,0,1099.03,8,522756.12,24,6,17,3,True
1841301,375,4,451,1448,498979888,1,0,0,1099.2,7,521656.92,25,1,15,3,True
2325276,369,1,451,7523,498979888,1,0,0,1098.84,7,520558.08,25,0,18,3,True
2408585,861,4,-1,9845,498979888,1,1,0,1098.87,4,520558.08,24,2,9,4,True
2456678,787,0,10,1610,498979888,1,0,0,1098.98,6,521657.06,14,0,3,4,True
2646072,1342,3,30,9965,498979888,1,0,0,1098.9,8,520558.16,24,4,13,4,True
2894953,369,1,451,5509,498979888,1,0,0,1099.03,7,519459.13,25,1,18,5,True
3127916,517,4,30,8852,498979888,1,0,0,1099.14,8,518359.99,12,2,2,6,True
3731750,369,1,30,4126,498979888,1,0,0,1099.07,8,517260.92,25,2,17,6,True
4144837,1342,3,451,6849,498979888,1,0,0,1099.02,7,516161.9,24,1,15,7,True
4154940,1342,3,451,3987,498979888,1,0,0,1098.87,7,515063.03,24,5,10,7,True
4610719,747,1,10,9965,498979888,1,0,0,1099.13,6,516162.16,24,0,4,7,True
4691222,861,4,451,6280,498979888,1,0,0,1099.04,7,515063.12,24,4,16,7,True
4869791,1342,3,451,6722,498979888,1,0,0,1098.97,7,513964.15,24,4,10,8,True
4888720,563,4,30,1266,498979888,1,0,0,1098.89,8,512865.26,17,0,9,8,True
5004900,375,4,25,2368,498979888,1,0,0,1098.99,8,511766.27,25,6,9,9,True
5135610,1239,1,10,3771,498979888,1,0,0,1099.24,0,512865.51,18,6,12,9,True
5347844,375,4,25,9965,498979888,1,0,0,1099.09,8,511766.42,25,0,21,11,True
5388827,369,1,-1,9914,498979888,1,1,0,1099.03,4,511766.42,25,1,14,12,True
5423309,563,4,451,9965,498979888,1,0,0,1099.06,7,510667.36,17,3,8,12,True
5457231,375,4,30,9914,498979888,1,0,0,1098.88,8,509568.48,25,1,15,1,True
5519097,369,1,451,8852,498979888,1,0,0,1099.07,7,508469.41,25,3,18,1,True
5714864,98,0,20,9634,498979888,1,0,0,1098.93,3,507370.48,3,5,4,3,True
5823589,1145,4,451,1610,498979888,1,0,0,1098.98,7,506271.5,15,0,18,5,True
5889004,1342,3,451,7429,498979888,1,0,0,1098.79,7,505172.71,24,1,22,5,True
6220303,1145,4,30,1610,498979888,1,0,0,1098.92,8,504073.79,15,2,2,6,True
6276958,577,0,20,8851,498979888,1,0,0,1099.03,5,502974.76,11,3,2,6,True
6723264,1145,4,451,3256,498979888,1,0,0,1099.06,7,501875.7,15,4,19,7,True
6738749,369,1,30,5778,498979888,1,0,0,1099.01,8,500776.69,25,1,20,7,True
6823709,579,0,20,4126,498979888,1,0,0,1099.01,5,499677.68,11,4,8,8,True
6875620,563,4,451,9914,498979888,1,0,0,1098.74,7,498578.94,17,6,12,8,True
7200040,628,0,10,9568,498979888,1,0,0,1099.01,6,499677.95,11,0,8,8,True
7462480,1377,0,20,8569,498979888,1,0,0,1099.13,5,498578.82,16,4,16,9,True
7582817,563,4,-1,3256,498979888,1,1,0,1098.91,4,498578.82,17,0,8,10,True
7807794,866,0,10,9914,498979888,1,0,0,1098.76,6,499677.58,24,4,2,11,True
8023148,517,4,451,9914,498979888,1,0,0,1098.82,7,498578.76,12,4,15,12,True
8099232,732,0,10,4126,498979888,1,0,0,1098.9,6,499677.66,11,3,20,12,True
8114116,861,4,25,8569,498979888,1,0,0,1098.84,8,498578.82,24,4,22,12,True
8686648,369,1,30,5594,498979888,1,0,0,1098.98,8,497479.84,25,4,18,1,True
8888519,353,1,10,4126,498979888,1,0,0,1099.16,0,498579.0,24,4,18,2,True
8938384,662,1,10,3771,498979888,1,0,0,1099.07,6,499678.07,18,2,22,3,True
9001983,940,1,10,9845,498979888,1,0,0,1098.9,6,500776.97,24,1,5,6,True
9174514,844,1,10,3256,498979888,1,0,0,1098.94,6,501875.91,5,3,0,8,True
9179561,1145,4,25,1266,498979888,1,0,0,1098.75,8,500777.16,15,0,12,8,True
9266489,1145,4,30,5594,498979888,1,0,0,1099.01,8,499678.15,15,6,8,8,True
9305827,563,4,25,9634,498979888,1,0,0,1098.66,8,498579.49,17,3,16,9,True
1014808,164,4,451,6529,509382539,1,0,0,998.88,7,171531.12,24,3,13,1,True
1112886,502,0,25,7971,509382539,1,0,0,998.87,8,170532.25,12,5,20,2,True
1142293,325,0,10,4725,509382539,1,0,0,999.05,6,171531.3,11,1,5,2,True
1432635,812,0,20,3318,509382539,1,0,0,999.03,5,170532.27,18,0,12,2,True
1634753,643,4,451,2311,509382539,1,0,0,999.24,7,169533.03,24,5,19,4,True
1765517,1231,2,30,9370,509382539,1,0,0,998.92,8,168534.11,18,2,22,4,True
1767046,502,0,451,2036,509382539,1,0,0,998.81,7,167535.3,12,5,3,6,False
1916481,643,4,30,8751,509382539,1,0,0,998.89,8,166536.41,24,4,11,7,True
1978744,1231,2,30,9731,509382539,1,0,0,999.0,8,165537.41,18,0,11,8,True
2052296,164,4,451,8724,509382539,1,0,0,999.32,7,164538.09,24,2,15,8,True
2376172,502,0,25,9370,509382539,1,0,0,998.95,8,163539.14,12,1,13,8,False
2437742,1231,2,451,5688,509382539,1,0,0,998.96,7,162540.18,18,6,6,8,True
2597028,189,4,30,2527,509382539,1,0,0,999.0,8,161541.18,18,6,1,9,True
3135368,502,0,451,2632,509382539,1,0,0,999.2,7,160541.98,12,3,20,10,False
3360580,950,0,10,1228,509382539,1,0,0,999.21,0,161541.19,24,5,0,10,True
3500412,643,4,451,3452,509382539,1,0,0,999.1,7,160542.09,24,6,3,10,True
3685241,540,4,451,8672,509382539,1,0,0,999.16,7,159542.93,17,3,14,10,True
3712052,44,4,451,2476,509382539,1,0,0,999.17,7,158543.76,24,2,9,11,True
3723103,297,0,20,3452,509382539,1,0,0,998.87,5,157544.89,4,2,0,11,True
3872491,1159,0,10,3318,509382539,1,0,0,999.17,0,158544.06,15,1,14,12,True
4088660,540,4,30,1210,509382539,1,0,0,999.03,8,157545.03,17,3,0,12,True
4104303,1183,4,451,2632,509382539,1,0,0,998.79,7,156546.24,24,3,16,1,True
4283587,1063,0,10,2476,509382539,1,0,0,998.85,0,157545.09,11,3,5,2,True
4439232,1183,4,451,5688,509382539,1,0,0,999.08,7,156546.01,24,0,6,2,True
4469521,160,0,10,6025,509382539,1,0,0,999.03,6,157545.04,24,4,23,2,True
4830061,540,4,30,9591,509382539,1,0,0,998.97,8,156546.07,17,0,22,2,True
4862687,208,0,10,8796,509382539,1,0,0,998.89,6,157544.96,9,5,11,4,True
4972870,540,4,25,8751,509382539,1,0,0,999.05,8,156545.91,17,6,20,4,True
4984455,1486,2,20,4235,509382539,1,0,0,998.99,5,155546.92,24,2,19,5,True
5152997,568,1,10,2852,509382539,1,0,0,999.06,0,156545.98,11,5,0,5,True
5159005,85,2,20,2036,509382539,1,0,0,998.91,5,155547.07,1,3,8,6,True
5404795,643,4,30,2679,509382539,1,0,0,998.89,8,154548.18,24,6,22,6,True
5926016,643,4,451,2476,509382539,1,0,0,998.92,7,153549.26,24,2,13,6,True
6201645,502,0,-1,7971,509382539,1,1,0,998.99,4,153549.26,12,3,10,6,True
6261664,189,4,-1,3452,509382539,1,2,0,998.99,4,153549.26,18,3,0,7,True
6371219,164,4,451,7971,509382539,1,0,0,999.21,7,152550.05,24,0,2,7,True
6488288,164,4,30,6025,509382539,1,0,0,999.24,8,151550.81,24,3,7,9,True
7030411,255,2,20,3318,509382539,1,0,0,999.19,3,150551.62,6,0,3,10,True
7067671,164,4,25,4778,509382539,1,0,0,998.98,8,149552.64,24,0,16,10,True
7260454,1231,2,-1,2476,509382539,1,1,0,999.02,4,149552.64,18,5,20,10,True
7265705,780,0,10,6529,509382539,1,0,0,998.9,6,150551.54,14,6,0,10,True
7291338,189,4,30,6529,509382539,1,0,0,999.27,8,149552.27,18,4,13,11,True
7345261,1459,1,10,3452,509382539,1,0,0,999.08,0,150551.35,11,5,19,12,True
7394653,594,0,20,8751,509382539,1,0,0,999.15,5,149552.2,24,4,12,1,True
7473137,1231,2,451,2679,509382539,1,0,0,999.03,7,148553.17,18,5,0,1,True
7610495,14,2,20,2527,509382539,1,0,0,999.01,5,147554.16,24,4,4,1,True
7652370,343,1,10,4435,509382539,1,0,0,998.89,6,148553.05,24,6,22,2,True
7732281,643,4,451,3318,509382539,1,0,0,999.02,7,147554.03,24,4,18,5,True
8042147,502,0,-1,5688,509382539,1,1,0,999.13,4,147554.03,12,3,12,5,True
8172603,164,4,451,2852,509382539,1,0,0,998.92,7,146555.11,24,5,9,6,True
8381921,502,0,25,2862,509382539,1,0,0,999.1,8,145556.01,12,1,12,7,True
8469164,540,4,30,8724,509382539,1,0,0,999.17,8,144556.84,17,6,9,9,True
8528424,540,4,451,9370,509382539,1,0,0,999.33,7,143557.51,17,6,4,9,True
8540107,257,1,10,6025,509382539,1,0,0,998.93,6,144556.44,6,6,17,9,False
8659437,502,0,25,2311,509382539,1,0,0,999.06,8,143557.38,12,1,16,9,True
8880106,643,4,30,2042,509382539,1,0,0,999.12,8,142558.26,24,3,12,9,True
8882778,643,4,451,6529,509382539,1,0,0,999.2,7,141559.06,24,4,17,10,True
9244968,1183,4,-1,4963,509382539,1,1,0,998.93,1,141559.06,24,1,3,11,True
9637040,643,4,451,2036,509382539,1,0,0,998.94,7,140560.12,24,2,12,11,True
1061489,630,0,10,1517,607657794,0,0,0,753.02,6,203154.02,11,3,16,1,True
1547392,458,3,-1,9118,607657794,0,1,0,752.93,1,203154.02,13,1,23,3,True
2274529,900,1,10,8265,607657794,0,0,0,753.05,6,203907.07,24,3,8,3,True
2432709,889,0,25,9202,607657794,0,0,0,752.98,8,203154.09,27,5,19,3,True
3086835,998,0,451,2213,607657794,0,0,0,752.63,7,202401.46,26,0,16,4,True
3160410,653,1,-1,4426,607657794,0,1,0,752.94,1,202401.46,24,4,8,4,True
3315310,998,0,-1,9202,607657794,0,2,0,753.12,4,202401.46,26,4,10,4,True
3464742,1312,0,451,8265,607657794,0,0,0,752.73,7,201648.73,5,1,16,5,True
3537932,275,0,20,1224,607657794,0,0,0,752.98,3,200895.75,24,1,14,6,True
3781625,1177,4,451,9202,607657794,0,0,0,752.97,7,200142.78,24,1,11,6,True
3798771,10,4,451,2213,607657794,0,0,0,753.04,7,199389.74,24,2,12,6,True
3839356,998,0,30,2213,607657794,0,0,0,752.72,8,198637.02,26,6,19,7,True
3919734,135,2,20,5601,607657794,0,0,0,752.93,3,197884.09,18,5,6,7,True
3990912,653,1,30,8606,607657794,0,0,0,753.08,8,197131.01,24,2,17,8,False
4132334,302,1,10,7032,607657794,0,0,0,753.09,0,197884.1,4,4,22,8,True
4354547,653,1,30,4157,607657794,0,0,0,753.14,8,197130.96,24,5,1,8,True
4372337,1312,0,451,1517,607657794,0,0,0,753.01,7,196377.95,5,1,22,9,True
4542361,949,4,25,2401,607657794,0,0,0,752.6,8,195625.35,24,4,11,9,False
4795449,996,0,20,5660,607657794,0,0,0,753.23,5,194872.12,26,2,22,10,True
4797310,998,0,-1,5663,607657794,0,1,0,753.13,4,194872.12,26,0,14,10,True
5119863,889,0,-1,1224,607657794,0,2,0,753.14,4,194872.12,27,5,17,11,True
5225169,81,0,20,2213,607657794,0,0,0,752.95,5,194119.17,1,0,23,11,True
5278437,1312,0,451,4157,607657794,0,0,0,753.08,7,193366.09,5,3,1,12,True
5622726,200,0,10,3726,607657794,0,0,0,753.23,0,194119.32,9,1,22,12,True
6152990,653,1,30,7032,607657794,0,0,0,753.19,8,193366.13,24,3,2,1,True
6166864,949,4,30,8265,607657794,0,0,0,753.03,8,192613.1,24,3,2,2,True
6210618,215,0,10,4426,607657794,0,0,0,752.92,0,193366.02,9,5,11,5,True
6543264,458,3,-1,5660,607657794,0,1,0,753.05,4,193366.02,13,4,10,5,True
6551156,889,0,25,5947,607657794,0,0,0,753.01,8,192613.01,27,0,5,6,True
6554993,577,0,20,8265,607657794,0,0,0,753.05,5,191859.96,11,1,13,6,True
6706980,949,4,-1,2213,607657794,0,1,0,753.25,1,191859.96,24,0,9,7,True
6869781,653,1,-1,5601,607657794,0,2,0,753.04,1,191859.96,24,1,19,10,True
7260355,826,1,10,1517,607657794,0,0,0,753.0,0,192612.96,18,2,16,11,True
7334648,1312,0,25,6798,607657794,0,0,0,753.05,8,191859.91,5,4,7,11,True
7633739,1312,0,451,5947,607657794,0,0,0,752.87,7,191107.04,5,5,17,12,True
7691329,808,3,25,5601,607657794,0,0,0,753.21,8,190353.83,11,4,16,12,True
7697687,1090,0,20,5663,607657794,0,0,0,753.03,5,189600.8,18,0,22,1,True
7809390,808,3,30,6544,607657794,0,0,0,753.11,8,188847.69,11,6,4,1,True
7827690,889,0,451,9202,607657794,0,0,0,752.76,7,188094.93,27,4,17,3,True
7870339,458,3,451,9202,607657794,0,0,0,753.07,7,187341.86,13,5,13,3,True
7886168,808,3,25,5807,607657794,0,0,0,753.1,8,186588.76,11,5,9,3,True
8129201,998,0,-1,7032,607657794,0,1,0,753.07,4,186588.76,26,6,15,3,True
8307498,694,2,20,6798,607657794,0,0,0,752.85,5,185835.91,24,6,18,4,True
8519309,889,0,451,7032,607657794,0,0,0,752.97,7,185082.94,27,6,9,4,True
8772483,85,2,20,6544,607657794,0,0,0,752.93,3,184330.01,1,1,16,5,True
9052440,458,3,30,5660,607657794,0,0,0,752.89,8,183577.12,13,0,10,7,True
9131694,998,0,451,5663,607657794,0,0,0,752.94,7,182824.18,26,2,12,7,True
9448279,889,0,30,8265,607657794,0,0,0,753.23,8,182070.95,27,4,17,8,True
9476571,1273,0,20,7032,607657794,0,0,0,752.89,5,181318.06,24,3,7,9,True
9777771,1177,4,25,9821,607657794,0,0,0,752.71,8,180565.35,24,6,17,9,True
9811807,457,0,20,8265,607657794,0,0,0,753.27,3,179812.08,13,4,10,10,True
9873952,889,0,25,9487,607657794,0,0,0,752.97,8,179059.11,27,3,23,10,True
9922268,653,1,25,3726,607657794,0,0,0,752.77,8,178306.34,24,6,2,11,True
9957901,1312,0,451,3726,607657794,0,0,0,753.08,7,177553.26,5,5,3,11,True
1136611,355,1,30,2276,363251813,0,0,0,210.19,8,516536.81,24,0,3,1,True
1410011,574,2,451,7415,363251813,0,0,0,210.11,7,516326.7,11,6,0,1,True
1736004,355,1,-1,2211,363251813,0,1,0,209.87,4,516326.7,24,3,16,1,True
2087024,854,0,10,2289,363251813,0,0,0,209.98,6,516536.68,24,3,11,2,True
2376457,1378,3,30,2276,363251813,0,0,0,210.24,8,516326.44,16,0,1,2,True
2654548,355,1,30,2473,363251813,0,0,0,210.01,8,516116.43,24,1,18,3,True
2896409,1378,3,25,9788,363251813,0,0,0,210.03,8,515906.4,16,6,14,3,True
3069861,574,2,25,2289,363251813,0,0,0,209.81,8,515696.59,11,2,22,3,True
3385026,1378,3,25,9788,363251813,0,0,0,210.15,8,515486.44,16,2,2,4,True
3628587,355,1,25,5490,363251813,0,0,0,210.1,8,515276.34,24,1,7,5,True
3663093,603,0,-1,2827,363251813,0,1,0,209.85,1,515276.34,24,4,0,6,True
3980757,523,2,-1,2312,363251813,0,2,0,210.0,1,515276.34,18,3,4,7,True
4063108,1206,0,10,1666,363251813,0,0,0,209.94,0,515486.28,24,4,14,7,True
4128317,603,0,-1,6498,363251813,0,1,0,209.96,1,515486.28,24,3,23,8,False
4482750,355,1,-1,9788,363251813,0,2,0,209.96,4,515486.28,24,0,17,8,True
4574517,262,2,20,2312,363251813,0,0,0,209.96,3,515276.32,6,3,17,8,True
4744693,523,2,30,1666,363251813,0,0,0,209.86,8,515066.46,18,5,20,9,True
4944394,184,0,30,2827,363251813,0,0,0,210.23,8,514856.23,18,3,5,9,True
5062818,603,0,30,2276,363251813,0,0,0,209.92,8,514646.31,24,2,10,9,True
5179778,355,1,25,2827,363251813,0,0,0,209.98,8,514436.33,24,3,22,9,True
5183170,603,0,451,1105,363251813,0,0,0,209.57,7,514226.76,24,0,5,10,False
5281878,1378,3,451,5490,363251813,0,0,0,210.23,7,514016.53,16,2,9,11,True
5323818,168,0,451,1629,363251813,0,0,0,210.11,7,513806.42,24,5,6,12,True
5413144,1321,0,20,2276,363251813,0,0,0,209.91,3,513596.51,18,6,13,12,True
5557399,184,0,25,7136,363251813,0,0,0,210.04,8,513386.47,18,2,11,1,True
5643037,795,4,-1,2211,363251813,0,1,0,209.92,4,513386.47,11,0,13,1,True
5729863,523,2,30,4178,363251813,0,0,0,210.39,8,513176.08,18,5,12,1,True
5899326,184,0,30,9942,363251813,0,0,0,209.79,8,512966.29,18,5,18,2,True
5975164,573,0,10,7534,363251813,0,0,0,209.87,6,513176.16,11,1,11,3,True
5999279,1378,3,451,4607,363251813,0,0,0,209.86,7,512966.3,16,0,4,3,True
6196745,1378,3,451,7136,363251813,0,0,0,209.85,7,512756.45,16,2,9,4,True
6225079,603,0,451,2772,363251813,0,0,0,209.93,7,512546.52,24,1,23,4,True
6441818,603,0,451,2827,363251813,0,0,0,210.16,7,512336.36,24,0,20,4,True
6714434,574,2,30,7415,363251813,0,0,0,210.21,8,512126.15,11,4,17,4,True
6836050,795,4,451,2171,363251813,0,0,0,210.15,7,511916.0,11,4,7,7,True
7455653,184,0,-1,1666,363251813,0,1,0,209.83,4,511916.0,18,2,1,8,True
7684742,355,1,25,3107,363251813,0,0,0,209.87,8,511706.13,24,0,4,9,True
7846654,574,2,451,2276,363251813,0,0,0,210.06,7,511496.07,11,3,22,9,True
7909894,584,0,20,4178,363251813,0,0,0,210.2,5,511285.87,11,6,16,9,True
8066670,574,2,451,6650,363251813,0,0,0,210.0,7,511075.87,11,3,20,10,True
8137496,603,0,-1,1105,363251813,0,1,0,210.09,1,511075.87,24,5,15,10,True
8241510,355,1,30,2289,363251813,0,0,0,209.81,8,510866.06,24,5,18,10,True
8256288,355,1,-1,2473,363251813,0,1,0,210.14,1,510866.06,24,4,20,12,True
8452756,574,2,25,2312,363251813,0,0,0,209.84,8,510656.22,11,5,15,12,False
8674497,1378,3,-1,1629,363251813,0,1,0,210.1,1,510656.22,16,5,2,1,True
8679317,1272,0,20,9306,363251813,0,0,0,210.01,3,510446.21,24,0,1,1,True
8727623,168,0,30,5490,363251813,0,0,0,210.08,8,510236.13,24,6,3,2,True
8816327,350,0,10,3768,363251813,0,0,0,209.86,6,510445.99,24,6,13,3,True
9087585,184,0,25,9942,363251813,0,0,0,210.02,8,510235.97,18,1,4,3,False
9100498,168,0,30,4607,363251813,0,0,0,210.13,8,510025.84,24,5,23,3,True
9235457,523,2,451,2827,363251813,0,0,0,210.11,7,509815.73,18,2,21,4,True
9282409,574,2,451,1105,363251813,0,0,0,209.64,7,509606.09,11,0,1,4,True
9402258,228,0,10,5656,363251813,0,0,0,210.11,0,509816.2,26,6,15,5,True
9424785,184,0,20,7398,363251813,0,0,0,210.07,5,509606.13,18,6,11,5,True
9556056,185,1,10,2827,363251813,0,0,0,209.85,6,509815.98,18,1,13,5,True
9656531,574,2,25,3768,363251813,0,0,0,209.92,8,509606.06,11,0,12,6,True
9848144,523,2,451,2473,363251813,0,0,0,210.11,7,509395.95,18,1,15,7,True
9993569,168,0,25,4178,363251813,0,0,0,210.05,8,509185.9,24,3,0,10,True
9999567,184,0,-1,7534,363251813,0,1,0,210.18,1,509185.9,18,5,14,11,True
1719740,126,1,10,9621,491507054,1,0,0,1191.11,0,269660.11,18,0,5,1,True
1819551,656,2,25,8803,491507054,1,0,0,1190.83,8,268469.28,18,2,10,1,True
1830799,1464,4,451,6164,491507054,1,0,0,1191.32,7,267277.96,11,1,4,2,True
2136695,1464,4,25,4574,491507054,1,0,0,1191.05,8,266086.91,11,4,2,3,True
2350303,631,3,25,1088,491507054,1,0,0,1190.94,8,264895.97,11,4,19,4,False
2362556,656,2,30,7173,491507054,1,0,0,1190.83,8,263705.14,18,4,12,4,False
2523287,1463,2,20,4029,491507054,1,0,0,1191.0,5,262514.14,11,3,6,5,False
3128253,1186,2,20,1088,491507054,1,0,0,1191.41,5,261322.73,24,4,7,5,True
3200192,520,4,451,6164,491507054,1,0,0,1191.25,7,260131.48,18,0,5,5,True
3339357,1464,4,-1,4574,491507054,1,1,0,1190.79,4,260131.48,11,6,21,6,True
3353882,631,3,451,9020,491507054,1,0,0,1191.0,7,258940.48,11,2,8,6,True
3383792,1066,4,-1,3172,491507054,1,1,0,1190.69,4,258940.48,11,5,8,6,True
3417661,1464,4,451,3172,491507054,1,0,0,1190.95,7,257749.53,11,4,14,9,True
3502677,866,0,20,3172,491507054,1,0,0,1190.97,5,256558.56,24,1,1,9,True
3654129,656,2,30,1477,491507054,1,0,0,1191.21,8,255367.35,18,5,22,10,True
3862514,394,0,10,8803,491507054,1,0,0,1190.93,6,256558.28,10,4,2,12,True
4092908,752,0,20,1343,491507054,1,0,0,1191.16,5,255367.12,24,1,7,12,True
4207466,1249,2,20,4029,491507054,1,0,0,1190.94,5,254176.18,23,0,17,2,True
4337254,365,0,10,6164,491507054,1,0,0,1190.95,6,255367.13,25,2,19,2,True
4439933,1140,0,20,7658,491507054,1,0,0,1191.11,5,254176.02,15,0,9,3,True
4497028,1066,4,451,7173,491507054,1,0,0,1190.73,7,252985.29,11,3,8,3,True
4949525,656,2,451,7173,491507054,1,0,0,1190.88,7,251794.41,18,4,3,4,True
5030159,812,0,10,2166,491507054,1,0,0,1191.06,0,252985.47,18,6,3,5,True
5098807,631,3,30,4029,491507054,1,0,0,1191.04,8,251794.43,11,6,7,5,True
5207710,631,3,451,7658,491507054,1,0,0,1190.77,7,250603.66,11,3,9,6,True
5475560,656,2,-1,9155,491507054,1,1,0,1190.64,4,250603.66,18,5,4,7,True
5479840,1066,4,30,4574,491507054,1,0,0,1191.24,8,249412.42,11,1,11,7,True
5676689,573,0,20,7173,491507054,1,0,0,1191.01,5,248221.41,11,6,21,7,True
5704057,114,0,20,9020,491507054,1,0,0,1191.25,5,247030.16,3,5,10,10,True
5728234,656,2,25,9715,491507054,1,0,0,1191.02,8,245839.14,18,0,7,10,True
6027581,656,2,451,2166,491507054,1,0,0,1190.99,7,244648.15,18,4,1,10,True
6200585,1066,4,25,9155,491507054,1,0,0,1191.02,8,243457.13,11,4,10,10,True
6206205,1066,4,451,3172,491507054,1,0,0,1190.98,7,242266.15,11,3,6,10,True
6371304,1066,4,451,7658,491507054,1,0,0,1191.06,7,241075.09,11,3,12,1,True
6878454,656,2,-1,9621,491507054,1,1,0,1191.0,4,241075.09,18,5,3,2,True
6927758,656,2,25,7173,491507054,1,0,0,1190.87,8,239884.22,18,3,15,2,True
7070327,1412,2,20,1088,491507054,1,0,0,1191.15,5,238693.07,24,6,4,3,True
7178428,1464,4,451,6164,491507054,1,0,0,1191.23,7,237501.84,11,5,18,3,True
7519747,1066,4,451,6164,491507054,1,0,0,1190.81,7,236311.03,11,4,0,3,True
7933190,752,0,20,1088,491507054,1,0,0,1191.01,3,235120.02,24,6,15,4,True
7994454,656,2,451,8075,491507054,1,0,0,1191.16,7,233928.86,18,2,3,4,True
8163271,1064,0,10,9020,491507054,1,0,0,1191.03,6,235119.89,11,1,9,4,True
8607132,656,2,30,4029,491507054,1,0,0,1190.87,8,233929.02,18,3,6,5,True
8721131,631,3,25,3630,491507054,1,0,0,1190.8,8,232738.22,11,4,15,6,True
8995737,520,4,451,3630,491507054,1,0,0,1191.24,7,231546.98,18,1,11,6,True
9048370,811,0,20,1477,491507054,1,0,0,1191.18,5,230355.8,18,6,23,7,True
9199318,656,2,30,4574,491507054,1,0,0,1191.11,8,229164.69,18,1,6,8,True
9317817,1166,2,20,1477,491507054,1,0,0,1190.84,5,227973.85,24,2,3,8,True
9348822,1066,4,451,9715,491507054,1,0,0,1191.13,7,226782.72,11,3,3,9,True
9420537,520,4,25,9621,491507054,1,0,0,1191.03,8,225591.69,18,1,11,10,True
9514983,549,1,10,1343,491507054,1,0,0,1190.9,6,226782.59,17,6,23,11,True
9739005,168,0,10,8075,491507054,1,0,0,1190.93,0,227973.52,24,5,8,11,True
9879550,378,0,20,4029,491507054,1,0,0,1190.92,5,226782.6,25,3,8,11,True
9893987,1066,4,451,4574,491507054,1,0,0,1190.9,7,225591.7,11,3,18,11,True
1125398,1213,2,20,5211,736889665,0,0,0,1113.36,5,878259.64,24,4,15,3,True
1286544,1474,0,25,7093,736889665,0,0,0,1112.95,8,877146.69,24,4,2,3,True
1368679,1107,3,451,9640,736889665,0,0,0,1112.85,7,876033.84,0,3,0,5,True
1647905,796,2,20,4778,736889665,0,0,0,1113.2,5,874920.64,11,6,3,5,True
1723116,1474,0,30,8303,736889665,0,0,0,1113.03,8,873807.61,24,4,23,6,True
1723692,1107,3,451,8314,736889665,0,0,0,1113.22,7,872694.39,0,4,5,7,True
2089662,454,1,-1,9640,736889665,0,1,0,1112.97,4,872694.39,13,5,14,7,True
2210576,454,1,451,7673,736889665,0,0,0,1113.04,7,871581.35,13,1,19,8,True
2673406,454,1,451,3161,736889665,0,0,0,1112.93,7,870468.42,13,0,4,9,True
2962768,76,0,451,1016,736889665,0,0,0,1113.13,7,869355.29,20,3,22,10,True
3110720,333,1,10,1016,736889665,0,0,0,1113.05,0,870468.34,11,4,1,10,True
3268872,1107,3,25,9928,736889665,0,0,0,1113.27,8,869355.07,0,5,22,10,True
3340117,1053,1,451,1109,736889665,0,0,0,1112.76,7,868242.31,11,4,19,11,True
3436953,525,0,20,8314,736889665,0,0,0,1112.88,5,867129.43,18,1,22,12,True
3701872,76,0,-1,8303,736889665,0,1,0,1112.89,4,867129.43,20,2,17,1,True
4023877,1053,1,25,9289,736889665,0,0,0,1113.21,8,866016.22,11,2,0,2,True
4130242,509,0,10,6762,736889665,0,0,0,1112.98,0,867129.2,12,5,11,3,True
4142628,454,1,-1,9640,736889665,0,1,0,1113.12,4,867129.2,13,3,15,3,True
4252565,76,0,25,9910,736889665,0,0,0,1112.99,8,866016.21,20,3,1,3,True
4427152,454,1,451,9640,736889665,0,0,0,1113.0,7,864903.21,13,4,9,4,True
4431744,362,0,20,4778,736889665,0,0,0,1113.03,3,863790.18,24,4,4,5,True
4447459,1107,3,25,5948,736889665,0,0,0,1113.07,8,862677.11,0,1,16,6,True
4461263,1111,0,20,5171,736889665,0,0,0,1113.09,5,861564.02,0,5,8,6,True
5396362,1107,3,30,9640,736889665,0,0,0,1112.73,8,860451.29,0,4,18,6,True
5489819,1107,3,-1,3161,736889665,0,1,0,1112.76,4,860451.29,0,5,10,6,True
5707363,454,1,-1,1109,736889665,0,2,0,1112.89,4,860451.29,13,6,20,7,True
5762133,76,0,30,9910,736889665,0,0,0,1112.86,8,859338.43,20,5,1,9,True
5792724,916,0,20,8048,736889665,0,0,0,1113.06,3,858225.37,18,6,19,10,True
5843884,76,0,25,5948,736889665,0,0,0,1113.1,8,857112.27,20,6,7,10,True
5884386,168,0,10,4778,736889665,0,0,0,1112.69,0,858224.96,24,0,1,11,True
6259811,454,1,30,6762,736889665,0,0,0,1112.92,8,857112.04,13,3,20,12,True
6296363,454,1,-1,5948,736889665,0,1,0,1113.09,1,857112.04,13,3,3,12,True
6324388,76,0,451,1016,736889665,0,0,0,1112.99,7,855999.05,20,4,13,2,True
6565430,454,1,25,6762,736889665,0,0,0,1113.05,8,854886.0,13,3,16,2,True
6595458,1053,1,451,6762,736889665,0,0,0,1112.98,7,853773.02,11,4,18,3,True
6644946,1107,3,451,5171,736889665,0,0,0,1112.93,7,852660.09,0,4,2,3,True
6820953,76,0,451,5948,736889665,0,0,0,1112.94,7,851547.15,20,5,7,3,True
7153188,1474,0,25,5948,736889665,0,0,0,1112.99,8,850434.16,24,0,20,4,True
7223331,76,0,30,1109,736889665,0,0,0,1112.84,8,849321.32,20,6,11,4,True
7228272,76,0,30,7673,736889665,0,0,0,1113.11,8,848208.21,20,1,14,4,True
7318798,1053,1,25,5211,736889665,0,0,0,1113.1,8,847095.11,11,1,2,4,True
7349192,1474,0,451,2795,736889665,0,0,0,1112.95,7,845982.16,24,4,12,5,True
7374866,1107,3,451,3161,736889665,0,0,0,1112.99,7,844869.17,0,2,7,6,True
7387216,1192,2,20,9910,736889665,0,0,0,1112.87,5,843756.3,24,0,10,6,True
7404261,1053,1,-1,5211,736889665,0,1,0,1112.85,4,843756.3,11,2,7,6,True
7614142,454,1,25,7093,736889665,0,0,0,1112.73,8,842643.57,13,0,4,7,True
7641062,1115,1,10,6762,736889665,0,0,0,1113.08,6,843756.65,0,1,1,7,True
7744686,238,0,20,5948,736889665,0,0,0,1112.95,5,842643.7,26,2,1,7,True
7758204,1474,0,30,8303,736889665,0,0,0,1112.95,8,841530.75,24,3,3,7,True
7771308,1474,0,451,8048,736889665,0,0,0,1112.85,7,840417.9,24,2,23,7,True
7870141,454,1,30,8048,736889665,0,0,0,1112.94,8,839304.96,13,5,7,9,True
8002060,644,0,10,2795,736889665,0,0,0,1112.91,6,840417.87,24,4,6,10,True
8052031,1107,3,451,2795,736889665,0,0,0,1113.05,7,839304.82,0,0,16,10,True
8206789,1053,1,451,4778,736889665,0,0,0,1113.07,7,838191.75,11,6,7,10,True
8980598,1474,0,451,5171,736889665,0,0,0,1112.83,7,837078.92,24,6,16,11,True
9255980,76,0,-1,5211,736889665,0,1,0,1113.04,4,837078.92,20,0,0,11,True
9462177,76,0,25,1109,736889665,0,0,0,1112.93,8,835965.99,20,3,14,11,True
9568477,454,1,30,1109,736889665,0,0,0,1113.05,8,834852.94,13,6,1,11,True
9620658,1474,0,451,6762,736889665,0,0,0,1112.81,7,833740.13,24,6,17,11,True
1047462,359,2,30,4383,243016955,1,0,0,967.86,8,81277.14,24,3,15,1,True
1444467,1409,1,10,8475,243016955,1,0,0,967.82,6,82244.96,24,5,15,2,True
1564149,355,1,10,8710,243016955,1,0,0,968.0,0,83212.96,24,6,13,2,True
1574675,810,4,451,8710,243016955,1,0,0,967.94,7,82245.02,18,3,0,3,True
1857209,405,4,30,6477,243016955,1,0,0,967.88,8,81277.14,10,3,20,3,True
1977541,287,0,10,8352,243016955,1,0,0,968.15,6,82245.29,24,6,13,3,True
2127538,810,4,-1,4596,243016955,1,1,0,967.92,1,82245.29,18,1,19,3,True
2223801,309,0,451,6198,243016955,1,0,0,967.93,7,81277.36,4,3,11,4,True
2371702,341,0,10,3689,243016955,1,0,0,968.08,6,82245.44,24,2,12,5,True
2374746,309,0,451,9028,243016955,1,0,0,968.07,7,81277.37,4,4,6,7,True
2720365,810,4,25,6198,243016955,1,0,0,967.81,8,80309.56,18,0,4,8,True
3210993,333,1,451,2158,243016955,1,0,0,967.85,7,79341.71,11,1,9,8,True
3425308,234,0,20,6198,243016955,1,0,0,968.11,5,78373.6,26,0,21,8,True
3451526,333,1,451,2623,243016955,1,0,0,967.87,7,77405.73,11,5,9,9,True
3581319,78,3,451,4596,243016955,1,0,0,968.09,7,76437.64,1,0,11,9,True
3703169,405,4,30,3205,243016955,1,0,0,967.92,8,75469.72,10,2,22,9,True
3724874,405,4,451,8710,243016955,1,0,0,967.79,7,74501.93,10,5,3,10,True
4109065,867,0,20,4084,243016955,1,0,0,968.07,3,73533.86,24,4,21,11,True
4357218,810,4,30,4551,243016955,1,0,0,968.08,8,72565.78,18,6,15,11,True
4878938,395,4,25,6029,243016955,1,0,0,967.94,8,71597.84,10,0,22,11,True
5072143,78,3,25,2623,243016955,1,0,0,967.91,8,70629.93,1,0,11,11,True
5228821,359,2,451,2676,243016955,1,0,0,968.08,7,69661.85,24,5,16,12,True
5236979,551,0,20,4297,243016955,1,0,0,967.9,5,68693.95,17,2,0,12,True
5677143,359,2,30,2676,243016955,1,0,0,967.95,8,67726.0,24,3,17,1,True
5951929,577,0,20,2158,243016955,1,0,0,968.04,5,66757.96,11,6,6,4,True
5981571,395,4,25,5472,243016955,1,0,0,968.11,8,65789.85,10,4,14,4,True
6022284,676,4,451,3689,243016955,1,0,0,967.99,7,64821.86,24,3,10,5,True
6148681,309,0,-1,6029,243016955,1,1,0,967.97,1,64821.86,4,6,5,7,False
6393005,676,4,25,3953,243016955,1,0,0,967.97,8,63853.89,24,1,21,8,True
6508939,333,1,451,3205,243016955,1,0,0,968.05,7,62885.84,11,4,18,8,True
6660972,395,4,-1,2712,243016955,1,1,0,967.99,4,62885.84,10,4,16,10,True
6720555,314,0,451,3205,243016955,1,0,0,967.9,7,61917.94,4,4,8,11,True
6802958,1260,0,20,4551,243016955,1,0,0,967.89,5,60950.05,23,2,5,11,True
6820440,405,4,451,2712,243016955,1,0,0,967.93,7,59982.12,10,0,9,12,True
6848271,405,4,30,2965,243016955,1,0,0,967.98,8,59014.14,10,1,0,12,True
6887599,1410,1,10,3636,243016955,1,0,0,968.23,6,59982.37,24,0,22,1,True
7295729,810,4,451,6477,243016955,1,0,0,967.86,7,59014.51,18,5,0,2,True
7589759,712,0,10,3689,243016955,1,0,0,967.91,6,59982.42,18,0,20,2,True
8012469,78,3,25,5484,243016955,1,0,0,968.22,8,59014.2,1,4,6,3,True
8337201,882,0,10,2158,243016955,1,0,0,968.13,6,59982.33,27,1,19,3,True
8433616,314,0,25,6545,243016955,1,0,0,968.2,8,59014.13,4,5,16,3,True
8501270,309,0,25,5472,243016955,1,0,0,968.0,8,58046.13,4,2,3,4,True
8600258,314,0,451,9778,243016955,1,0,0,968.31,7,57077.82,4,3,15,5,True
8729383,405,4,25,6477,243016955,1,0,0,967.7,8,56110.12,10,6,7,6,True
8825533,405,4,451,2999,243016955,1,0,0,967.99,7,55142.13,10,4,9,8,True
8852826,333,1,-1,1090,243016955,1,1,0,967.95,1,55142.13,11,5,20,8,True
8919917,333,1,25,5923,243016955,1,0,0,968.22,8,54173.91,11,1,11,9,False
9172922,333,1,25,2965,243016955,1,0,0,968.15,8,53205.76,11,4,8,9,True
9341632,587,2,20,5355,243016955,1,0,0,968.12,5,52237.64,24,1,6,11,True
9593874,309,0,25,7966,243016955,1,0,0,968.14,8,51269.5,4,1,4,11,True
1274753,452,4,25,6311,967485566,0,0,0,510.11,8,260139.89,13,1,5,1,True
1306587,452,4,30,2660,967485566,0,0,0,510.22,8,259629.67,13,1,13,1,True
1331824,427,2,451,2499,967485566,0,0,0,509.99,7,259119.68,18,4,12,2,True
2022285,967,1,10,1216,967485566,0,0,0,510.02,6,259629.7,13,3,10,4,True
2220737,332,4,30,1567,967485566,0,0,0,509.88,8,259119.82,11,5,10,4,True
2588878,859,2,20,8957,967485566,0,0,0,510.01,5,258609.81,24,2,10,4,True
2657258,1446,1,10,5261,967485566,0,0,0,509.96,6,259119.77,24,3,14,5,True
3014052,1172,3,451,3451,967485566,0,0,0,510.01,7,258609.76,24,3,13,6,True
3166778,98,0,10,3451,967485566,0,0,0,509.9,6,259119.66,3,0,0,6,True
3292728,649,0,451,6311,967485566,0,0,0,509.88,7,258609.78,24,3,21,6,True
3453595,16,4,30,9486,967485566,0,0,0,509.98,8,258099.8,24,5,8,6,True
3589159,40,4,-1,2918,967485566,0,1,0,509.81,1,258099.8,11,4,6,7,True
3770696,332,4,451,2499,967485566,0,0,0,510.24,7,257589.56,11,0,0,7,True
3959209,1101,2,20,5261,967485566,0,0,0,509.79,5,257079.77,0,6,12,8,True
4057118,1035,0,20,2499,967485566,0,0,0,510.15,5,256569.62,11,3,1,10,False
4064600,452,4,25,5261,967485566,0,0,0,509.93,8,256059.69,13,3,17,10,True
4116359,1377,0,10,9486,967485566,0,0,0,510.03,0,256569.72,16,6,16,11,True
4124103,202,4,-1,7874,967485566,0,1,0,510.19,4,256569.72,9,6,1,11,True
4128201,1172,3,30,9279,967485566,0,0,0,509.84,8,256059.88,24,5,16,12,True
4295533,16,4,30,9486,967485566,0,0,0,509.9,8,255549.98,24,2,15,1,True
4453303,498,0,10,1757,967485566,0,0,0,510.03,6,256060.01,12,4,7,1,False
4465491,332,4,30,5391,967485566,0,0,0,509.77,8,255550.24,11,5,8,2,True
4490289,192,2,20,9486,967485566,0,0,0,509.81,5,255040.43,18,4,23,3,True
4490933,1110,0,20,4175,967485566,0,0,0,510.3,5,254530.13,0,3,4,4,True
4603847,185,1,10,2499,967485566,0,0,0,509.72,6,255039.85,18,4,18,4,True
4607216,202,4,25,5391,967485566,0,0,0,509.94,8,254529.91,9,3,17,5,True
4621510,427,2,30,2639,967485566,0,0,0,510.05,8,254019.86,18,0,3,6,True
4823878,40,4,-1,9734,967485566,0,1,0,510.12,4,254019.86,11,5,12,6,True
5000184,649,0,451,8773,967485566,0,0,0,509.99,7,253509.87,24,0,21,6,True
5214214,452,4,30,3641,967485566,0,0,0,509.97,8,252999.9,13,3,6,6,True
5352481,452,4,-1,2450,967485566,0,1,0,510.05,1,252999.9,13,1,1,7,True
5385216,1172,3,-1,8957,967485566,0,2,0,509.9,4,252999.9,24,2,13,7,False
5458644,1172,3,25,3451,967485566,0,0,0,510.03,8,252489.87,24,2,22,8,True
5682795,958,2,20,1216,967485566,0,0,0,510.04,5,251979.83,13,5,14,8,True
5738641,40,4,451,3451,967485566,0,0,0,509.9,7,251469.93,11,3,12,8,True
5820032,1468,1,10,8957,967485566,0,0,0,510.07,0,251980.0,11,6,20,8,True
6423203,452,4,25,1567,967485566,0,0,0,510.02,8,251469.98,13,0,20,9,True
6949866,452,4,451,2639,967485566,0,0,0,510.07,7,250959.91,13,0,13,10,True
6980958,332,4,-1,7089,967485566,0,1,0,509.95,4,250959.91,11,2,16,10,True
7001374,649,0,451,4175,967485566,0,0,0,510.02,7,250449.89,24,6,5,11,False
7102239,427,2,25,6046,967485566,0,0,0,509.82,8,249940.07,18,2,19,11,True
7358125,509,0,10,4175,967485566,0,0,0,509.96,6,250450.03,12,5,12,11,True
7693267,332,4,30,9734,967485566,0,0,0,509.94,8,249940.09,11,4,7,1,True
7965279,1172,3,25,4175,967485566,0,0,0,509.98,8,249430.11,24,5,12,1,True
7985083,452,4,25,4988,967485566,0,0,0,510.1,8,248920.01,13,0,19,1,True
8055566,262,2,20,2918,967485566,0,0,0,509.82,5,248410.19,6,1,7,1,True
8474687,1172,3,451,7874,967485566,0,0,0,509.87,7,247900.32,24,2,13,2,True
8854448,628,0,20,7089,967485566,0,0,0,509.79,5,247390.53,11,6,1,3,True
8892962,1010,0,20,2639,967485566,0,0,0,509.9,5,246880.63,26,6,14,5,True
9028377,16,4,451,3451,967485566,0,0,0,510.13,7,246370.5,24,0,9,6,True
9108574,649,0,451,9092,967485566,0,0,0,510.07,7,245860.43,24,6,16,7,True
9225720,328,0,20,7089,967485566,0,0,0,509.94,3,245350.49,11,3,7,7,True
9616974,332,4,-1,9734,967485566,0,1,0,510.01,4,245350.49,11,0,9,8,True
9674324,452,4,451,9734,967485566,0,0,0,509.87,7,244840.62,13,2,12,9,True
9675602,452,4,-1,1757,967485566,0,1,0,510.07,4,244840.62,13,4,21,10,True
9918479,616,1,10,5261,967485566,0,0,0,509.75,6,245350.37,11,5,15,11,True
1104463,1285,1,25,7266,213012550,0,0,0,212.04,8,905549.96,24,2,0,1,True
1191250,1303,0,10,5328,213012550,0,0,0,212.23,6,905762.19,5,0,1,4,True
1656529,1285,1,451,2835,213012550,0,0,0,211.86,7,905550.33,24,2,15,4,True
1931139,801,4,30,7266,213012550,0,0,0,211.99,8,905338.34,11,6,23,4,True
2228250,1446,1,451,4977,213012550,0,0,0,212.07,7,905126.27,24,0,14,4,False
2488425,1285,1,-1,8067,213012550,0,1,0,211.88,4,905126.27,24,3,17,6,True
2610799,801,4,451,4977,213012550,0,0,0,212.09,7,904914.18,11,6,13,7,False
2611427,801,4,30,8760,213012550,0,0,0,211.9,8,904702.28,11,3,20,7,True
2620914,635,2,20,6220,213012550,0,0,0,211.92,5,904490.36,24,2,5,8,False
2912152,1380,0,451,1591,213012550,0,0,0,211.82,7,904278.54,16,3,1,8,True
2924660,309,0,10,8760,213012550,0,0,0,212.11,6,904490.65,4,2,13,10,True
3005269,1284,2,20,5530,213012550,0,0,0,212.06,5,904278.59,24,4,22,11,True
3108522,1446,1,30,2287,213012550,0,0,0,211.97,8,904066.62,24,5,0,11,True
3135972,1285,1,25,4977,213012550,0,0,0,212.12,8,903854.5,24,5,3,12,True
3223418,801,4,451,5328,213012550,0,0,0,212.07,7,903642.43,11,5,22,12,True
3359381,612,4,30,1748,213012550,0,0,0,212.15,8,903430.28,11,3,1,12,True
3669152,348,0,10,1748,213012550,0,0,0,211.87,6,903642.15,24,4,20,12,True
3960164,612,4,-1,2253,213012550,0,1,0,212.04,4,903642.15,11,1,23,1,True
4078043,1380,0,25,2835,213012550,0,0,0,212.0,8,903430.15,16,4,1,2,True
4087048,1380,0,451,9577,213012550,0,0,0,211.81,7,903218.34,16,5,19,3,True
4427504,610,0,10,6418,213012550,0,0,0,212.42,6,903430.76,11,6,21,4,True
4618157,1285,1,30,5328,213012550,0,0,0,212.07,8,903218.69,24,1,8,5,True
4704215,1380,0,-1,4977,213012550,0,1,0,211.94,1,903218.69,16,0,21,6,True
4874412,612,4,30,5530,213012550,0,0,0,212.44,8,903006.25,11,6,14,7,True
5073434,1272,0,20,7246,213012550,0,0,0,211.52,3,902794.73,24,4,9,8,True
5391025,498,0,20,1591,213012550,0,0,0,212.0,3,902582.73,12,0,4,9,True
5542957,612,4,451,8760,213012550,0,0,0,212.27,7,902370.46,11,4,13,9,True
5545729,801,4,451,4977,213012550,0,0,0,212.04,7,902158.42,11,2,15,9,True
5914957,1446,1,25,5530,213012550,0,0,0,211.83,8,901946.59,24,1,8,11,False
6123540,865,0,20,4977,213012550,0,0,0,211.81,3,901734.78,24,6,3,12,True
6183493,484,0,-1,2835,213012550,0,1,0,211.85,1,901734.78,5,0,5,1,True
6798398,1446,1,25,9333,213012550,0,0,0,212.18,8,901522.6,24,5,12,1,True
6816070,993,0,20,5328,213012550,0,0,0,212.11,5,901310.49,22,0,7,1,True
7197232,1285,1,451,1748,213012550,0,0,0,211.95,7,901098.54,24,3,17,2,True
7265941,1446,1,451,2253,213012550,0,0,0,212.09,7,900886.45,24,5,9,2,True
7271415,1380,0,451,6576,213012550,0,0,0,212.07,7,900674.38,16,0,11,3,True
7439321,484,0,25,7246,213012550,0,0,0,212.05,8,900462.33,5,0,17,4,True
7536423,1446,1,30,6576,213012550,0,0,0,212.22,8,900250.11,24,2,16,6,True
7564394,199,0,20,7266,213012550,0,0,0,211.98,5,900038.13,18,4,20,6,True
7783748,1380,0,451,5530,213012550,0,0,0,212.22,7,899825.91,16,5,17,6,True
7804527,579,0,20,2835,213012550,0,0,0,212.08,3,899613.83,11,2,0,7,True
7838062,612,4,451,2287,213012550,0,0,0,212.11,7,899401.72,11,3,11,7,True
7976487,1380,0,451,8067,213012550,0,0,0,211.92,7,899189.8,16,3,20,7,True
8516829,484,0,-1,8067,213012550,0,1,0,212.02,1,899189.8,5,2,12,9,True
8954081,484,0,-1,4977,213012550,0,2,0,212.16,4,899189.8,5,1,19,9,True
8972436,801,4,451,6418,213012550,0,0,0,212.04,7,898977.76,11,6,3,10,True
9267283,1132,0,20,4977,213012550,0,0,0,211.8,5,898765.96,24,3,10,10,True
9468469,1285,1,-1,2253,213012550,0,1,0,211.95,4,898765.96,24,3,14,10,True
9469066,484,0,-1,7246,213012550,0,2,0,212.25,4,898765.96,5,2,0,11,True
9732780,484,0,25,5328,213012550,0,0,0,211.83,8,898554.13,5,3,6,11,True
9916334,612,4,451,6220,213012550,0,0,0,212.33,7,898341.8,11,2,1,11,True
1028701,204,0,-1,7665,471492551,0,1,0,1033.11,4,310539.0,9,4,23,1,True
1533920,987,4,25,3828,471492551,0,0,0,1033.23,8,309505.77,22,4,6,2,True
1824793,1446,1,-1,3171,471492551,0,1,0,1032.91,4,309505.77,24,2,17,4,True
1885572,929,0,30,1652,471492551,0,0,0,1033.1,8,308472.67,18,1,19,5,True
2342997,223,2,20,4625,471492551,0,0,0,1032.93,3,307439.74,26,4,14,8,True
2398236,929,0,451,5981,471492551,0,0,0,1032.94,7,306406.8,18,3,12,8,True
2451351,403,0,30,9026,471492551,0,0,0,1032.96,8,305373.84,10,1,4,9,True
2721098,1449,0,20,5266,471492551,0,0,0,1032.93,5,304340.91,11,4,0,9,True
2789763,929,0,451,4625,471492551,0,0,0,1032.83,7,303308.08,18,0,15,10,True
3104464,987,4,30,4431,471492551,0,0,0,1033.17,8,302274.91,22,5,12,11,True
3141617,1446,1,451,3828,471492551,0,0,0,1033.01,7,301241.9,24,4,0,11,True
3365869,1446,1,30,1604,471492551,0,0,0,1033.3,8,300208.6,24,2,12,11,True
3523652,987,4,451,7665,471492551,0,0,0,1032.94,7,299175.66,22,4,14,11,True
3560412,403,0,30,5981,471492551,0,0,0,1033.08,8,298142.58,10,3,0,12,True
3612117,403,0,30,7873,471492551,0,0,0,1032.84,8,297109.74,10,1,2,1,True
3677864,942,0,20,3828,471492551,0,0,0,1032.93,5,296076.81,24,2,3,2,True
3939970,565,4,30,1652,471492551,0,0,0,1032.97,8,295043.84,11,3,6,2,True
3991400,204,0,-1,4431,471492551,0,1,0,1033.1,4,295043.84,9,5,8,3,True
3996887,1321,0,20,2893,471492551,0,0,0,1033.02,5,294010.82,18,5,7,4,True
4496496,565,4,30,8302,471492551,0,0,0,1032.89,8,292977.93,11,5,8,4,True
4662067,987,4,451,1652,471492551,0,0,0,1032.94,7,291944.99,22,0,10,5,True
4676398,1285,1,10,3828,471492551,0,0,0,1033.15,0,292978.14,24,6,4,7,True
4852742,204,0,25,5266,471492551,0,0,0,1033.03,8,291945.11,9,4,17,7,True
5090896,403,0,25,4625,471492551,0,0,0,1032.79,8,290912.32,10,1,15,8,False
5123095,565,4,-1,3171,471492551,0,1,0,1033.16,4,290912.32,11,4,23,9,True
5124497,548,2,20,8956,471492551,0,0,0,1033.11,5,289879.21,17,6,13,9,False
5348721,987,4,451,1604,471492551,0,0,0,1033.08,7,288846.13,22,0,4,9,True
5403414,204,0,451,7873,471492551,0,0,0,1033.06,7,287813.07,9,1,18,10,True
5618381,1075,0,10,3553,471492551,0,0,0,1033.07,6,288846.14,18,5,4,11,True
5659860,275,0,10,5266,471492551,0,0,0,1033.11,0,289879.25,24,5,18,12,True
6071021,565,4,-1,3828,471492551,0,1,0,1033.18,1,289879.25,11,0,23,1,True
6421472,204,0,30,4625,471492551,0,0,0,1033.07,8,288846.18,9,1,9,1,True
6698994,1446,1,451,1652,471492551,0,0,0,1032.96,7,287813.22,24,4,1,2,True
7020519,96,0,10,3171,471492551,0,0,0,1033.02,6,288846.24,1,4,22,3,True
7370184,929,0,30,4625,471492551,0,0,0,1033.29,8,287812.95,18,0,6,3,True
7463289,403,0,451,5883,471492551,0,0,0,1032.91,7,286780.04,10,5,16,4,True
7492954,97,0,10,1652,471492551,0,0,0,1033.14,0,287813.18,3,0,17,4,True
7732767,1119,0,20,8956,471492551,0,0,0,1033.11,5,286780.07,24,4,12,4,True
7909175,987,4,451,7873,471492551,0,0,0,1033.31,7,285746.76,22,3,18,5,True
7934465,254,0,20,3171,471492551,0,0,0,1032.89,3,284713.87,6,4,7,5,True
8022508,987,4,-1,3828,471492551,0,1,0,1032.9,4,284713.87,22,5,9,7,True
8338132,204,0,30,3553,471492551,0,0,0,1032.75,8,283681.12,9,3,16,7,True
8351609,944,2,20,3828,471492551,0,0,0,1032.9,5,282648.22,24,2,11,8,True
8444967,987,4,25,5981,471492551,0,0,0,1033.07,8,281615.15,22,2,16,8,True
8446604,1446,1,30,8956,471492551,0,0,0,1033.29,8,280581.86,24,4,15,8,True
8511165,267,0,10,5883,471492551,0,0,0,1033.01,6,281614.87,6,3,4,8,True
8652780,929,0,-1,7873,471492551,0,1,0,1032.9,4,281614.87,18,6,16,9,True
8983127,929,0,25,2893,471492551,0,0,0,1032.97,8,280581.9,18,0,0,9,True
9131934,403,0,-1,7665,471492551,0,1,0,1032.91,1,280581.9,10,4,14,9,True
9181394,987,4,-1,9026,471492551,0,2,0,1033.17,1,280581.9,22,5,0,10,True
9534187,204,0,25,9026,471492551,0,0,0,1033.08,8,279548.82,9,1,5,10,True
1255985,824,2,451,5456,951013974,1,0,0,236.81,7,826687.19,18,3,2,1,True
1384663,1255,0,451,2772,951013974,1,0,0,236.87,7,826450.32,23,2,18,1,True
1592984,1084,4,30,1339,951013974,1,0,0,236.99,8,826213.33,18,0,14,3,True
1693377,306,4,-1,7203,951013974,1,1,0,237.16,1,826213.33,4,6,9,4,True
1879105,599,0,20,7795,951013974,1,0,0,237.13,5,825976.2,24,0,19,5,True
1894979,1084,4,25,4424,951013974,1,0,0,237.23,8,825738.97,18,0,23,5,True
2176920,1113,1,10,2555,951013974,1,0,0,236.76,0,825975.73,0,6,7,6,True
2452565,197,4,25,2161,951013974,1,0,0,237.23,8,825738.5,18,0,8,6,True
2631076,1315,0,20,2555,951013974,1,0,0,237.09,5,825501.41,5,2,10,7,True
2690597,1255,0,451,1280,951013974,1,0,0,237.01,7,825264.4,23,6,10,7,False
2884947,306,4,25,2161,951013974,1,0,0,237.03,8,825027.37,4,6,11,10,False
2953964,125,4,451,5873,951013974,1,0,0,237.35,7,824790.02,18,5,14,11,True
3043694,197,4,-1,6368,951013974,1,1,0,237.07,1,824790.02,18,6,12,11,True
3114729,824,2,451,4764,951013974,1,0,0,236.96,7,824553.06,18,6,13,11,False
3333958,29,0,20,6114,951013974,1,0,0,236.98,3,824316.08,11,3,14,12,True
3639525,1255,0,30,4764,951013974,1,0,0,237.23,8,824078.85,23,0,13,1,True
3730592,907,0,20,4424,951013974,1,0,0,236.76,3,823842.09,2,6,11,2,False
3876832,1355,4,451,4764,951013974,1,0,0,237.08,7,823605.01,24,2,22,3,False
4465945,1219,1,10,4424,951013974,1,0,0,237.08,0,823842.09,24,3,11,3,True
4510240,824,2,-1,7723,951013974,1,1,0,237.03,4,823842.09,18,3,14,3,True
4566977,824,2,30,5873,951013974,1,0,0,236.88,8,823605.21,18,4,11,3,True
4722671,824,2,451,1395,951013974,1,0,0,236.98,7,823368.23,18,0,16,5,True
4749259,1255,0,451,2555,951013974,1,0,0,236.96,7,823131.27,23,5,17,5,True
4914439,1255,0,25,1019,951013974,1,0,0,237.12,8,822894.15,23,3,11,6,True
5394084,727,0,10,7723,951013974,1,0,0,236.99,6,823131.14,11,0,23,6,True
5621491,125,4,-1,2555,951013974,1,1,0,237.17,1,823131.14,18,4,0,6,True
5622851,125,4,30,5456,951013974,1,0,0,237.02,8,822894.12,18,4,22,7,True
6055169,895,0,20,4764,951013974,1,0,0,237.0,3,822657.12,24,1,4,8,True
6119717,738,2,20,7203,951013974,1,0,0,237.25,3,822419.87,11,0,11,8,True
6211587,306,4,25,5873,951013974,1,0,0,237.1,8,822182.77,4,2,11,9,True
6361081,195,1,10,7795,951013974,1,0,0,237.12,0,822419.89,18,3,1,9,True
6463721,1084,4,30,2387,951013974,1,0,0,237.04,8,822182.85,18,2,13,11,True
6638951,824,2,-1,2387,951013974,1,1,0,236.84,1,822182.85,18,0,6,12,True
6731997,1084,4,451,6950,951013974,1,0,0,237.05,7,821945.8,18,2,6,12,True
6835421,1411,0,20,7795,951013974,1,0,0,237.1,5,821708.7,24,3,9,12,True
7179699,1355,4,-1,6114,951013974,1,1,0,236.94,4,821708.7,24,3,3,12,True
7243054,125,4,25,1019,951013974,1,0,0,236.97,8,821471.73,18,3,10,12,True
7380979,1084,4,25,5183,951013974,1,0,0,236.56,8,821235.17,18,4,23,12,True
7392834,1000,0,20,5873,951013974,1,0,0,236.99,5,820998.18,26,6,17,1,True
7513104,1084,4,-1,7203,951013974,1,1,0,237.0,4,820998.18,18,6,5,3,True
7718606,1355,4,451,6950,951013974,1,0,0,237.11,7,820761.07,24,1,21,3,True
7868838,1298,0,20,4780,951013974,1,0,0,236.91,5,820524.16,5,4,22,4,True
7983371,125,4,451,7723,951013974,1,0,0,237.17,7,820286.99,18,2,2,6,True
8327955,197,4,30,4764,951013974,1,0,0,236.93,8,820050.06,18,4,1,6,True
8383288,306,4,30,4764,951013974,1,0,0,236.8,8,819813.26,4,5,11,6,True
8929508,197,4,451,2772,951013974,1,0,0,237.05,7,819576.21,18,5,13,7,True
9183306,1084,4,25,4424,951013974,1,0,0,237.1,8,819339.11,18,6,7,9,True
9191071,197,4,25,1280,951013974,1,0,0,236.98,8,819102.13,18,5,9,10,True
9293105,824,2,-1,4424,951013974,1,1,0,236.86,4,819102.13,18,4,21,10,True
9412103,848,2,20,4780,951013974,1,0,0,237.01,5,818865.12,5,5,18,10,True
9495138,1111,0,20,7795,951013974,1,0,0,237.08,5,818628.04,0,5,13,11,True
9555957,1084,4,451,4764,951013974,1,0,0,236.95,7,818391.09,18,1,17,11,True
9916464,498,0,10,6950,951013974,1,0,0,236.65,0,818627.74,12,6,2,11,True
1209989,376,0,10,5198,417330613,0,0,0,1143.0,6,583763.0,25,0,10,1,True
1537108,1206,0,20,6587,417330613,0,0,0,1143.01,3,582619.99,24,3,8,1,True
1742974,996,0,20,3349,417330613,0,0,0,1142.67,5,581477.32,26,6,16,2,True
1835010,649,0,30,4207,417330613,0,0,0,1142.94,8,580334.38,24,1,2,3,True
2129955,1036,1,30,2248,417330613,0,0,0,1142.93,8,579191.45,11,4,16,5,True
2163756,1476,0,30,2312,417330613,0,0,0,1143.01,8,578048.44,24,5,18,6,True
2384487,1320,3,30,5889,417330613,0,0,0,1142.94,8,576905.5,18,4,16,6,True
2559332,729,0,-1,1783,417330613,0,1,0,1142.93,4,576905.5,11,0,13,6,True
2597519,167,2,20,6403,417330613,0,0,0,1142.81,5,575762.69,24,1,15,7,True
2737310,944,2,-1,1645,417330613,0,1,0,1143.09,4,575762.69,24,0,22,8,True
2961094,1320,3,25,7898,417330613,0,0,0,1142.92,8,574619.77,18,2,10,8,True
2963548,944,2,451,1783,417330613,0,0,0,1143.0,7,573476.77,24,5,1,9,True
3572973,1159,0,10,6587,417330613,0,0,0,1142.88,6,574619.65,15,0,20,9,True
3729651,917,0,20,1838,417330613,0,0,0,1142.72,5,573476.93,18,0,8,9,True
3731972,538,0,10,8746,417330613,0,0,0,1142.92,6,574619.85,18,2,7,9,False
3903396,1422,1,10,1783,417330613,0,0,0,1142.92,0,575762.77,24,6,8,10,False
4098411,729,0,451,7898,417330613,0,0,0,1142.9,7,574619.87,11,5,22,10,True
4436256,703,0,10,2312,417330613,0,0,0,1143.01,0,575762.88,18,6,15,12,True
4522972,1361,2,20,4207,417330613,0,0,0,1143.27,5,574619.61,16,2,18,1,True
4577986,1476,0,451,6403,417330613,0,0,0,1142.9,7,573476.71,24,4,17,2,True
4698245,729,0,451,1601,417330613,0,0,0,1142.89,7,572333.82,11,2,21,4,True
4718197,1320,3,451,2248,417330613,0,0,0,1142.96,7,571190.86,18,0,0,4,True
4925701,824,2,30,1036,417330613,0,0,0,1143.09,8,570047.77,18,4,19,6,True
5120188,898,1,10,1783,417330613,0,0,0,1142.83,6,571190.6,24,1,13,6,True
5163111,584,0,451,3869,417330613,0,0,0,1142.95,7,570047.65,11,3,16,7,True
5198483,1114,1,10,7898,417330613,0,0,0,1143.03,6,571190.68,0,3,23,7,True
5573110,944,2,451,8746,417330613,0,0,0,1143.08,7,570047.6,24,4,3,7,True
5696447,824,2,30,1838,417330613,0,0,0,1142.92,8,568904.68,18,3,2,8,True
5828081,1036,1,-1,1783,417330613,0,1,0,1143.27,4,568904.68,11,4,22,8,True
5883797,303,0,20,1036,417330613,0,0,0,1142.98,5,567761.7,4,6,2,8,True
6140773,824,2,-1,1645,417330613,0,1,0,1143.12,4,567761.7,18,2,3,8,False
6475698,729,0,25,5198,417330613,0,0,0,1143.01,8,566618.69,11,6,12,9,True
6476862,993,0,10,5198,417330613,0,0,0,1142.84,6,567761.53,22,1,18,10,True
6581397,1036,1,-1,6403,417330613,0,1,0,1143.03,1,567761.53,11,6,12,10,True
6823541,729,0,-1,4712,417330613,0,2,0,1142.7,1,567761.53,11,5,23,12,True
6921791,1476,0,30,4207,417330613,0,0,0,1143.14,8,566618.39,24,2,15,12,True
7065395,825,2,30,2312,417330613,0,0,0,1143.15,8,565475.24,18,2,13,1,True
7221822,343,1,10,2312,417330613,0,0,0,1142.58,6,566617.82,24,2,15,1,True
7472795,1060,1,10,5198,417330613,0,0,0,1143.11,6,567760.93,11,4,16,1,True
7481237,1060,1,10,2248,417330613,0,0,0,1142.83,6,568903.76,11,5,18,1,True
7888980,824,2,30,1783,417330613,0,0,0,1143.02,8,567760.74,18,4,0,2,True
7998348,1036,1,30,2077,417330613,0,0,0,1143.01,8,566617.73,11,0,23,2,True
8012492,1320,3,30,3349,417330613,0,0,0,1142.94,8,565474.79,18,0,5,4,True
8062391,917,0,20,1783,417330613,0,0,0,1142.76,5,564332.03,18,3,20,4,True
8306520,898,1,10,3869,417330613,0,0,0,1142.6,6,565474.63,24,4,22,6,True
8501638,944,2,451,8746,417330613,0,0,0,1143.19,7,564331.44,24,5,8,8,False
8660063,1036,1,451,9905,417330613,0,0,0,1143.1,7,563188.34,11,5,19,8,True
9150127,1320,3,25,2248,417330613,0,0,0,1142.84,8,562045.5,18,4,1,8,True
9150354,346,0,20,8746,417330613,0,0,0,1142.93,3,560902.57,24,2,3,8,True
9161061,314,0,10,7898,417330613,0,0,0,1142.89,0,562045.46,4,6,15,8,True
9535803,825,2,30,3869,417330613,0,0,0,1143.07,8,560902.39,18,6,10,9,True
9601664,729,0,451,2312,417330613,0,0,0,1143.16,7,559759.23,11,0,15,9,True
9697273,728,1,10,5198,417330613,0,0,0,1143.0,0,560902.23,11,6,11,9,True
9772576,1036,1,451,4207,417330613,0,0,0,1143.23,7,559759.0,11,4,0,9,True
9969869,649,0,25,5889,417330613,0,0,0,1143.0,8,558616.0,24,2,14,10,True
1150798,399,2,20,9800,129979700,0,0,0,906.05,5,589219.95,10,6,13,1,True
1286243,234,0,25,7581,129979700,0,0,0,905.98,8,588313.97,26,3,17,1,True
1315073,723,1,30,7581,129979700,0,0,0,906.0,8,587407.97,11,2,19,3,True
1372598,27,0,20,9461,129979700,0,0,0,906.01,3,586501.96,11,4,3,3,True
1574986,220,0,20,9800,129979700,0,0,0,906.0,5,585595.96,26,4,14,3,True
1951570,1155,0,20,9765,129979700,0,0,0,905.8,5,584690.16,15,0,18,3,True
1970768,72,4,25,9501,129979700,0,0,0,905.84,8,583784.32,20,2,9,5,True
2086228,325,0,20,8764,129979700,0,0,0,905.58,3,582878.74,11,1,0,6,True
3067938,723,1,451,1547,129979700,0,0,0,906.18,7,581972.56,11,6,7,7,True
3103449,944,2,451,7070,129979700,0,0,0,905.94,7,581066.62,24,4,0,7,True
3302979,558,0,25,1547,129979700,0,0,0,906.2,8,580160.42,17,1,15,7,True
3312430,234,0,25,3678,129979700,0,0,0,906.04,8,579254.38,26,5,19,9,True
3314617,800,0,-1,8888,129979700,0,1,0,906.1,1,579254.38,11,5,10,9,True
3599541,558,0,25,9501,129979700,0,0,0,905.74,8,578348.64,17,5,3,10,True
3658982,72,4,451,1634,129979700,0,0,0,906.04,7,577442.6,20,5,15,10,True
3758085,1307,0,10,6971,129979700,0,0,0,905.8,6,578348.4,5,0,5,10,True
3820623,558,0,451,7699,129979700,0,0,0,905.97,7,577442.43,17,3,11,11,False
4076521,64,0,10,2289,129979700,0,0,0,905.87,6,578348.3,20,6,17,11,True
4351531,800,0,451,3312,129979700,0,0,0,906.01,7,577442.29,11,6,1,12,True
4615553,651,4,25,9385,129979700,0,0,0,905.8,8,576536.49,24,0,7,12,True
4918952,1060,1,30,2289,129979700,0,0,0,905.89,8,575630.6,11,2,19,1,True
5100572,800,0,30,4396,129979700,0,0,0,905.95,8,574724.65,11,4,2,1,True
5435110,558,0,30,1547,129979700,0,0,0,905.95,8,573818.7,17,3,20,2,True
5499898,558,0,25,3871,129979700,0,0,0,905.95,8,572912.75,17,0,1,2,True
5572124,652,0,10,1277,129979700,0,0,0,905.96,6,573818.71,24,3,21,3,True
6009017,234,0,25,8347,129979700,0,0,0,905.93,8,572912.78,26,1,23,5,True
6052198,287,0,20,6971,129979700,0,0,0,906.16,3,572006.62,24,1,15,6,True
6126338,661,4,25,6971,129979700,0,0,0,906.2,8,571100.42,18,5,22,7,True
6339073,800,0,451,7058,129979700,0,0,0,905.63,7,570194.79,11,0,10,8,True
6590871,800,0,25,9934,129979700,0,0,0,906.12,8,569288.67,11,1,6,8,True
6604387,234,0,25,3678,129979700,0,0,0,906.14,8,568382.53,26,2,6,9,True
6646802,723,1,30,3312,129979700,0,0,0,905.99,8,567476.54,11,3,3,11,True
6751706,72,4,-1,2835,129979700,0,1,0,906.23,1,567476.54,20,4,12,11,True
6914924,448,0,20,9501,129979700,0,0,0,905.86,5,566570.68,13,1,14,11,True
7101237,72,4,30,1277,129979700,0,0,0,906.39,8,565664.29,20,2,14,12,True
7167667,651,4,-1,7015,129979700,0,1,0,906.19,1,565664.29,24,2,11,1,True
7342081,651,4,451,8888,129979700,0,0,0,906.05,7,564758.24,24,2,20,1,True
7444336,723,1,451,9461,129979700,0,0,0,906.0,7,563852.24,11,2,4,2,True
7815088,723,1,30,7070,129979700,0,0,0,906.05,8,562946.19,11,6,17,2,True
8180341,558,0,-1,2325,129979700,0,1,0,905.91,1,562946.19,17,3,17,3,True
8217673,72,4,30,2077,129979700,0,0,0,905.99,8,562040.2,20,5,22,4,True
8252455,558,0,25,9765,129979700,0,0,0,905.99,8,561134.21,17,3,21,5,True
8528427,198,0,10,9934,129979700,0,0,0,906.08,6,562040.29,18,1,14,5,True
8737245,234,0,-1,1277,129979700,0,1,0,906.02,1,562040.29,26,4,16,5,True
8832295,558,0,451,9765,129979700,0,0,0,906.08,7,561134.21,17,4,23,6,True
8952612,661,4,25,1547,129979700,0,0,0,906.02,8,560228.19,18,3,9,6,True
9183823,654,1,10,9934,129979700,0,0,0,906.01,6,561134.2,18,6,7,6,True
9303424,858,1,10,6971,129979700,0,0,0,905.93,6,562040.13,24,4,15,7,True
9356566,996,0,10,9461,129979700,0,0,0,906.01,6,562946.14,26,5,17,7,True
9390634,800,0,451,6971,129979700,0,0,0,906.2,7,562039.94,11,5,18,7,True
9480879,1124,0,20,9364,129979700,0,0,0,906.06,3,561133.88,24,4,21,7,True
9496581,1461,0,20,8341,129979700,0,0,0,905.94,5,560227.94,11,0,2,9,True
9618751,1060,1,-1,1634,129979700,0,1,0,906.09,1,560227.94,11,0,4,9,True
9921452,661,4,30,1277,129979700,0,0,0,905.8,8,559322.14,18,4,14,11,True
1171606,1196,4,-1,4006,529758209,1,1,0,1134.03,4,203419.0,24,3,3,1,True
1235181,1196,4,25,4899,529758209,1,0,0,1134.05,8,202284.95,24,4,5,1,True
1325366,1196,4,-1,9505,529758209,1,1,0,1134.03,4,202284.95,24,6,15,1,True
1333585,755,3,451,3508,529758209,1,0,0,1134.24,7,201150.71,24,1,1,1,True
1578170,993,0,30,9981,529758209,1,0,0,1133.82,8,200016.89,22,3,21,2,True
1798528,1381,4,25,9981,529758209,1,0,0,1134.03,8,198882.86,16,0,15,3,True
1916323,1035,0,-1,1666,529758209,1,1,0,1134.19,1,198882.86,11,5,10,4,True
1952067,1035,0,-1,5183,529758209,1,2,0,1133.97,4,198882.86,11,0,18,4,True
2179831,877,2,20,1171,529758209,1,0,0,1134.06,3,197748.8,24,0,1,6,True
2383488,273,4,-1,7718,529758209,1,1,0,1134.42,1,197748.8,24,1,12,6,True
2494354,755,3,25,9981,529758209,1,0,0,1133.93,8,196614.87,24,2,6,7,True
2616625,560,2,20,1171,529758209,1,0,0,1133.96,3,195480.91,17,2,4,8,True
2878507,993,0,30,3712,529758209,1,0,0,1133.79,8,194347.12,22,0,15,8,True
2963187,993,0,-1,9505,529758209,1,1,0,1133.94,4,194347.12,22,6,3,10,True
3066832,993,0,-1,4125,529758209,1,2,0,1134.01,4,194347.12,22,5,10,10,True
3741782,1196,4,451,9981,529758209,1,0,0,1134.08,7,193213.04,24,5,13,11,True
3778099,1035,0,30,7718,529758209,1,0,0,1134.13,8,192078.91,11,5,13,12,True
3998232,346,0,20,7718,529758209,1,0,0,1133.88,5,190945.03,24,3,22,12,True
4048702,1381,4,451,9981,529758209,1,0,0,1134.15,7,189810.88,16,6,18,1,True
4060447,993,0,451,4125,529758209,1,0,0,1133.99,7,188676.89,22,1,13,2,True
4403391,755,3,25,4899,529758209,1,0,0,1134.1,8,187542.79,24,1,10,3,True
4594052,993,0,25,3508,529758209,1,0,0,1134.11,8,186408.68,22,3,9,3,True
4756021,1381,4,25,3712,529758209,1,0,0,1134.09,8,185274.59,16,1,22,4,True
4810276,755,3,451,4125,529758209,1,0,0,1133.92,7,184140.67,24,2,16,5,False
4827139,993,0,30,1536,529758209,1,0,0,1134.32,8,183006.35,22,5,23,5,True
5001333,1381,4,-1,1666,529758209,1,1,0,1134.22,4,183006.35,16,6,3,5,True
5474627,993,0,30,7718,529758209,1,0,0,1133.85,8,181872.5,22,0,20,7,True
5689014,1196,4,451,4899,529758209,1,0,0,1133.7,7,180738.8,24,1,3,7,True
5709049,755,3,25,3712,529758209,1,0,0,1134.2,8,179604.6,24,2,4,8,True
5794809,273,4,25,1505,529758209,1,0,0,1133.95,8,178470.65,24,4,7,8,True
5933896,299,1,10,7327,529758209,1,0,0,1133.95,0,179604.6,4,6,0,9,True
6140678,1381,4,451,7718,529758209,1,0,0,1133.96,7,178470.64,16,6,14,9,True
6175333,755,3,25,9138,529758209,1,0,0,1133.94,8,177336.7,24,4,21,9,True
6291073,1035,0,451,1505,529758209,1,0,0,1133.99,7,176202.71,11,1,0,10,True
6371558,755,3,25,7327,529758209,1,0,0,1134.08,8,175068.63,24,2,2,10,True
6405171,1035,0,-1,9505,529758209,1,1,0,1134.1,1,175068.63,11,1,19,10,True
6459819,673,0,10,7327,529758209,1,0,0,1134.36,6,176202.99,18,1,18,11,True
6690212,735,1,10,1536,529758209,1,0,0,1133.94,0,177336.93,11,5,2,11,True
6855367,1381,4,451,1505,529758209,1,0,0,1133.92,7,176203.01,16,0,7,11,True
6875287,1196,4,451,1536,529758209,1,0,0,1133.85,7,175069.16,24,0,15,11,True
7245996,1304,0,20,9981,529758209,1,0,0,1134.0,5,173935.16,5,1,17,11,True
7348869,1196,4,451,9505,529758209,1,0,0,1134.12,7,172801.04,24,3,13,12,True
7486533,755,3,-1,4155,529758209,1,1,0,1134.05,4,172801.04,24,6,9,12,True
7807297,21,0,10,4155,529758209,1,0,0,1133.94,0,173934.98,11,5,12,1,True
7857255,1381,4,25,1666,529758209,1,0,0,1133.92,8,172801.06,16,2,0,2,True
7895547,273,4,25,1505,529758209,1,0,0,1134.1,8,171666.96,24,3,20,2,True
8464653,755,3,451,4155,529758209,1,0,0,1134.15,7,170532.81,24,0,11,2,True
8520673,1035,0,-1,4006,529758209,1,1,0,1133.8,4,170532.81,11,1,21,2,True
8582286,205,0,20,1171,529758209,1,0,0,1133.93,3,169398.88,9,6,13,2,True
8754301,755,3,-1,1536,529758209,1,1,0,1134.03,1,169398.88,24,2,14,3,True
8947823,1196,4,451,4155,529758209,1,0,0,1134.11,7,168264.77,24,5,13,4,True
9097634,149,2,20,9563,529758209,1,0,0,1134.05,3,167130.72,18,2,13,4,True
9395850,116,0,20,4899,529758209,1,0,0,1134.23,5,165996.49,3,2,5,7,True
9614195,993,0,451,3508,529758209,1,0,0,1134.15,7,164862.34,22,1,12,7,True
9678270,993,0,451,4804,529758209,1,0,0,1133.9,7,163728.44,22,5,19,8,True
9799230,993,0,30,4125,529758209,1,0,0,1133.84,8,162594.6,22,4,11,9,True
9882960,1196,4,25,9138,529758209,1,0,0,1133.97,8,161460.63,24,4,4,10,True
9892390,273,4,451,4125,529758209,1,0,0,1134.17,7,160326.46,24,5,15,11,True
9982399,273,4,30,1666,529758209,1,0,0,1134.12,8,159192.34,24,6,8,11,True
1336064,1443,4,25,1642,256997825,0,0,0,1095.09,8,613831.91,24,4,6,2,True
2192777,1032,4,451,1179,256997825,0,0,0,1094.94,7,612736.97,11,2,11,3,True
2299562,1032,4,451,5077,256997825,0,0,0,1095.05,7,611641.92,11,0,14,5,True
2367621,359,2,-1,2570,256997825,0,1,0,1095.17,4,611641.92,24,0,23,5,True
2415720,359,2,30,5740,256997825,0,0,0,1094.75,8,610547.17,24,6,10,6,True
2775882,359,2,25,7083,256997825,0,0,0,1094.68,8,609452.49,24,1,4,7,True
2821383,1272,0,10,8823,256997825,0,0,0,1094.97,6,610547.46,24,1,17,7,True
2974034,1408,1,10,1683,256997825,0,0,0,1094.92,6,611642.38,24,1,7,7,True
3022844,787,0,20,7541,256997825,0,0,0,1094.86,5,610547.52,14,1,13,8,True
3044322,642,0,451,8823,256997825,0,0,0,1095.23,7,609452.29,24,2,4,9,True
3103523,1352,1,10,4226,256997825,0,0,0,1095.15,6,610547.44,24,0,16,9,True
3579228,1101,2,25,8554,256997825,0,0,0,1094.89,8,609452.55,0,2,1,9,True
3632328,1101,2,451,3350,256997825,0,0,0,1095.06,7,608357.49,0,0,8,10,True
3657181,1101,2,451,2570,256997825,0,0,0,1095.14,7,607262.35,0,5,10,11,True
3704583,425,4,30,7083,256997825,0,0,0,1094.96,8,606167.39,18,6,9,11,True
3759414,327,0,10,2584,256997825,0,0,0,1094.91,6,607262.3,11,5,16,12,False
3822396,148,1,10,8354,256997825,0,0,0,1094.86,6,608357.16,18,0,1,12,True
4973094,580,0,20,1683,256997825,0,0,0,1094.81,5,607262.35,11,6,15,1,True
5067498,1032,4,451,8183,256997825,0,0,0,1095.27,7,606167.08,11,2,20,2,True
5283054,1101,2,-1,5355,256997825,0,1,0,1094.91,4,606167.08,0,4,10,2,True
5405963,425,4,25,6431,256997825,0,0,0,1094.9,8,605072.18,18,5,22,2,True
5417828,591,0,10,6431,256997825,0,0,0,1095.15,6,606167.33,24,3,13,3,True
5453179,1032,4,451,6431,256997825,0,0,0,1094.71,7,605072.62,11,5,6,3,True
5607931,343,1,10,1179,256997825,0,0,0,1095.24,6,606167.86,24,2,13,3,True
5909964,1015,0,10,1246,256997825,0,0,0,1095.07,6,607262.93,26,3,3,5,True
6106678,642,0,30,6165,256997825,0,0,0,1094.68,8,606168.25,24,1,14,6,True
6163232,1101,2,451,7083,256997825,0,0,0,1094.91,7,605073.34,0,4,6,6,True
6191611,359,2,451,2570,256997825,0,0,0,1094.88,7,603978.46,24,2,21,6,True
6268140,1217,0,25,1179,256997825,0,0,0,1095.04,8,602883.42,24,4,19,7,True
6366300,865,0,20,3350,256997825,0,0,0,1094.97,3,601788.45,24,6,0,7,True
6483592,425,4,25,8768,256997825,0,0,0,1095.08,8,600693.37,18,2,10,7,True
6645963,580,0,20,7083,256997825,0,0,0,1095.22,3,599598.15,11,5,9,8,True
6708767,1032,4,451,5740,256997825,0,0,0,1094.8,7,598503.35,11,3,17,9,True
6719397,425,4,30,4226,256997825,0,0,0,1095.08,8,597408.27,18,2,18,9,True
6731139,1217,0,451,6431,256997825,0,0,0,1094.94,7,596313.33,24,6,18,10,True
6752180,1361,2,20,7083,256997825,0,0,0,1094.96,5,595218.37,16,2,5,11,True
7037556,276,0,10,8768,256997825,0,0,0,1095.01,6,596313.38,24,6,23,11,True
7228824,425,4,30,2584,256997825,0,0,0,1095.14,8,595218.24,18,0,9,12,True
7417758,628,0,10,8823,256997825,0,0,0,1094.89,0,596313.13,11,2,14,1,True
7539935,1032,4,451,8768,256997825,0,0,0,1095.16,7,595217.97,11,5,11,1,True
7777241,425,4,451,7005,256997825,0,0,0,1095.03,7,594122.94,18,3,4,2,True
7899504,234,0,10,3231,256997825,0,0,0,1095.07,6,595218.01,26,4,3,3,True
7965519,425,4,451,6838,256997825,0,0,0,1095.25,7,594122.76,18,1,0,4,True
8114449,1338,0,20,8823,256997825,0,0,0,1095.16,3,593027.6,18,0,13,6,True
8311812,95,2,20,7832,256997825,0,0,0,1094.92,5,591932.68,1,5,20,6,True
8347667,1443,4,30,5355,256997825,0,0,0,1094.98,8,590837.7,24,3,7,7,True
8507407,1388,1,10,8354,256997825,0,0,0,1094.94,6,591932.64,24,5,23,8,True
8613699,359,2,451,8354,256997825,0,0,0,1094.78,7,590837.86,24,1,6,9,True
8689896,642,0,451,5077,256997825,0,0,0,1094.77,7,589743.09,24,2,11,9,True
8691896,425,4,451,2652,256997825,0,0,0,1095.16,7,588647.93,18,5,12,9,True
9023604,1101,2,30,2570,256997825,0,0,0,1095.15,8,587552.78,0,1,8,10,True
9711941,1443,4,-1,5740,256997825,0,1,0,1095.03,4,587552.78,24,2,12,10,True
9937297,1217,0,30,5740,256997825,0,0,0,1095.17,8,586457.61,24,4,13,11,True
9999514,642,0,451,5077,256997825,0,0,0,1095.26,7,585362.35,24,6,4,11,True
1009077,180,0,25,7780,985323970,1,0,0,602.84,8,741005.16,18,4,19,2,True
1012893,411,2,-1,2155,985323970,1,1,0,603.18,4,741005.16,18,2,6,2,True
1282012,1365,3,-1,3744,985323970,1,2,0,603.01,1,741005.16,16,1,4,3,True
1471576,343,1,451,5293,985323970,1,0,0,602.83,7,740402.33,24,0,1,3,True
1561949,1365,3,30,6745,985323970,1,0,0,603.05,8,739799.28,16,4,7,3,True
1584682,1485,0,20,2155,985323970,1,0,0,602.98,5,739196.3,24,3,15,3,True
1619294,1483,0,451,3744,985323970,1,0,0,602.92,7,738593.38,24,3,5,4,True
1641654,98,0,20,3942,985323970,1,0,0,603.3,3,737990.08,3,6,11,5,True
1791808,343,1,451,3430,985323970,1,0,0,603.16,7,737386.92,24,3,20,5,True
1966253,1483,0,25,2155,985323970,1,0,0,602.99,8,736783.93,24,5,8,6,True
2048528,343,1,25,3748,985323970,1,0,0,603.01,8,736180.92,24,3,14,6,True
2241253,121,4,25,5038,985323970,1,0,0,602.96,8,735577.96,18,6,11,6,True
2287875,1245,1,10,3430,985323970,1,0,0,602.92,0,736180.88,18,2,16,6,True
2622378,720,4,30,4218,985323970,1,0,0,602.76,8,735578.12,11,0,3,7,True
3203905,180,0,451,3744,985323970,1,0,0,603.03,7,734975.09,18,3,0,8,True
3592767,349,2,20,4218,985323970,1,0,0,603.01,5,734372.08,24,1,15,11,True
3735095,180,0,30,3544,985323970,1,0,0,602.89,8,733769.19,18,1,1,11,True
3863388,1010,0,20,9392,985323970,1,0,0,602.82,5,733166.37,26,2,18,12,True
3878702,1365,3,30,5038,985323970,1,0,0,603.07,8,732563.3,16,4,0,12,True
3991220,343,1,451,7728,985323970,1,0,0,603.21,7,731960.09,24,2,18,1,True
4336111,1365,3,451,7728,985323970,1,0,0,603.04,7,731357.05,16,2,10,3,True
4498183,121,4,451,5411,985323970,1,0,0,602.96,7,730754.09,18,4,22,3,True
4520881,720,4,30,3430,985323970,1,0,0,602.92,8,730151.17,11,4,1,3,True
5068554,1322,2,20,2155,985323970,1,0,0,602.95,5,729548.22,18,4,19,4,True
5108682,180,0,451,9521,985323970,1,0,0,603.06,7,728945.16,18,1,4,7,True
5211396,121,4,30,2155,985323970,1,0,0,602.82,8,728342.34,18,1,11,7,True
5378265,1483,0,30,3430,985323970,1,0,0,603.1,8,727739.24,24,2,20,8,True
5429962,411,2,-1,8806,985323970,1,1,0,603.1,4,727739.24,18,3,9,8,True
5649480,480,0,20,5293,985323970,1,0,0,603.02,5,727136.22,5,5,16,9,True
6139019,180,0,30,8806,985323970,1,0,0,602.88,8,726533.34,18,2,18,9,True
6198466,800,0,10,9392,985323970,1,0,0,603.13,6,727136.47,11,3,1,10,True
6280460,587,2,20,8806,985323970,1,0,0,603.07,3,726533.4,24,1,0,10,True
6456430,343,1,-1,5890,985323970,1,1,0,602.78,4,726533.4,24,3,0,1,True
6667993,720,4,451,2556,985323970,1,0,0,603.14,7,725930.26,11,6,20,2,True
6692991,715,0,451,3502,985323970,1,0,0,603.11,7,725327.15,18,5,5,4,True
6789069,720,4,30,6593,985323970,1,0,0,602.85,8,724724.3,11,6,15,6,True
6817053,967,1,10,3748,985323970,1,0,0,602.94,6,725327.24,13,6,4,6,False
7043087,1186,2,20,1036,985323970,1,0,0,602.86,5,724724.38,24,2,6,7,True
7074787,1483,0,451,5038,985323970,1,0,0,602.89,7,724121.49,24,5,17,7,True
7226904,121,4,-1,8554,985323970,1,1,0,602.86,1,724121.49,18,0,3,7,True
7345244,1483,0,-1,7445,985323970,1,2,0,603.2,4,724121.49,24,3,9,7,False
7731805,967,1,10,4980,985323970,1,0,0,603.01,0,724724.5,13,6,6,7,True
8044438,1483,0,-1,3502,985323970,1,1,0,602.96,1,724724.5,24,2,19,7,True
8418965,411,2,451,5038,985323970,1,0,0,603.31,7,724121.19,18,2,20,8,True
8528423,780,0,20,9829,985323970,1,0,0,603.02,5,723518.17,14,1,19,9,True
8884848,1468,1,10,8554,985323970,1,0,0,603.14,6,724121.31,11,2,1,10,True
9383366,121,4,-1,4980,985323970,1,1,0,603.02,1,724121.31,18,3,16,10,True
9837636,20,0,20,2556,985323970,1,0,0,602.8,3,723518.51,24,0,20,10,True
9909478,398,0,20,4980,985323970,1,0,0,602.94,5,722915.57,10,0,19,10,True
9933524,376,0,20,3430,985323970,1,0,0,602.93,5,722312.64,25,2,8,10,True
1595459,1094,0,10,4888,934231474,0,0,0,578.8,6,109950.8,0,3,14,1,True
1646623,1399,0,10,4182,934231474,0,0,0,579.07,0,110529.87,24,5,2,1,True
2055816,1052,0,20,7721,934231474,0,0,0,579.1,3,109950.77,11,5,21,1,True
2127596,943,4,451,3050,934231474,0,0,0,579.1,7,109371.67,24,5,1,2,True
2152213,877,2,-1,2570,934231474,0,1,0,579.14,1,109371.67,24,5,23,4,True
2430648,1053,1,10,4034,934231474,0,0,0,579.1,6,109950.77,11,6,4,4,True
2912233,943,4,25,4182,934231474,0,0,0,578.97,8,109371.8,24,0,22,5,False
2923518,1105,2,451,4837,934231474,0,0,0,579.07,7,108792.73,0,4,1,6,True
2929390,1061,2,451,5999,934231474,0,0,0,579.12,7,108213.61,11,4,9,6,True
3025822,1061,2,-1,1507,934231474,0,1,0,578.94,4,108213.61,11,2,5,6,True
3139233,877,2,25,9622,934231474,0,0,0,578.75,8,107634.86,24,4,18,7,True
3377253,877,2,451,5852,934231474,0,0,0,578.87,7,107055.99,24,2,4,7,True
3462039,1061,2,-1,2068,934231474,0,1,0,579.07,4,107055.99,11,6,22,7,True
3568677,783,0,-1,1770,934231474,0,2,0,578.97,4,107055.99,14,0,22,8,True
3743081,877,2,451,5999,934231474,0,0,0,578.99,7,106477.0,24,4,23,8,True
3782668,943,4,25,6296,934231474,0,0,0,579.15,8,105897.85,24,6,21,8,True
3957693,731,4,-1,4138,934231474,0,1,0,579.1,1,105897.85,11,6,10,8,True
4033142,1105,2,25,2924,934231474,0,0,0,578.95,8,105318.9,0,0,21,8,True
4164454,877,2,25,7721,934231474,0,0,0,578.74,8,104740.16,24,6,12,9,True
4171507,943,4,30,5852,934231474,0,0,0,578.97,8,104161.19,24,5,19,9,True
4174887,1061,2,451,5999,934231474,0,0,0,579.21,7,103581.98,11,1,12,9,True
4276298,1380,0,10,3050,934231474,0,0,0,578.91,6,104160.89,16,4,19,10,True
4279745,877,2,30,9622,934231474,0,0,0,579.04,8,103581.85,24,6,20,11,True
4464281,783,0,30,2924,934231474,0,0,0,579.09,8,103002.76,14,5,22,11,True
4484371,897,0,10,2924,934231474,0,0,0,578.77,6,103581.53,24,6,14,11,True
4824981,1152,0,10,3050,934231474,0,0,0,579.1,6,104160.63,15,5,0,1,True
4860822,1061,2,451,4605,934231474,0,0,0,578.91,7,103581.72,11,1,9,2,True
5011891,1061,2,451,5697,934231474,0,0,0,579.04,7,103002.68,11,1,2,2,True
5183285,1061,2,-1,5573,934231474,0,1,0,579.05,4,103002.68,11,4,19,3,True
5638944,1007,2,20,7721,934231474,0,0,0,579.12,5,102423.56,26,4,15,3,True
5809621,783,0,30,6296,934231474,0,0,0,578.93,8,101844.63,14,1,5,4,True
6003041,943,4,451,4182,934231474,0,0,0,578.9,7,101265.73,24,0,20,5,True
6083209,783,0,451,7669,934231474,0,0,0,579.0,7,100686.73,14,3,6,5,True
6275031,943,4,25,1197,934231474,0,0,0,578.73,8,100108.0,24,5,4,7,True
6392299,943,4,25,4309,934231474,0,0,0,579.27,8,99528.73,24,3,12,8,True
6675361,470,1,10,5299,934231474,0,0,0,578.96,6,100107.69,5,4,14,12,True
6838058,877,2,-1,5697,934231474,0,1,0,579.18,4,100107.69,24,5,13,1,True
7047159,281,1,10,5573,934231474,0,0,0,578.85,0,100686.54,24,2,1,2,True
7153754,1105,2,451,1197,934231474,0,0,0,578.83,7,100107.71,0,4,8,3,True
7198720,21,0,20,4138,934231474,0,0,0,579.01,5,99528.7,11,1,5,3,True
7324486,1105,2,451,3050,934231474,0,0,0,579.19,7,98949.51,0,1,19,4,True
7690616,1061,2,25,2570,934231474,0,0,0,578.88,8,98370.63,11,4,9,4,False
7696982,428,0,20,4138,934231474,0,0,0,578.86,3,97791.77,18,4,0,5,False
8030654,877,2,30,6296,934231474,0,0,0,579.16,8,97212.61,24,3,15,5,True
8097874,312,0,10,5852,934231474,0,0,0,579.07,6,97791.68,4,0,1,6,True
8121689,1105,2,25,4138,934231474,0,0,0,579.35,8,97212.33,0,4,18,6,False
8540944,1061,2,30,1197,934231474,0,0,0,578.89,8,96633.44,11,2,11,7,True
8749750,731,4,25,4138,934231474,0,0,0,578.86,8,96054.58,11,0,0,8,True
8887765,980,1,10,4309,934231474,0,0,0,578.98,6,96633.56,22,1,23,8,True
9166685,989,1,10,1984,934231474,0,0,0,579.21,0,97212.77,22,1,10,8,True
9323212,783,0,451,1984,934231474,0,0,0,578.9,7,96633.87,14,6,9,9,True
9488329,877,2,451,6512,934231474,0,0,0,579.03,7,96054.84,24,2,2,9,True
9759992,1034,1,10,7914,934231474,0,0,0,579.16,6,96634.0,11,0,22,10,True
9962854,1105,2,451,8846,934231474,0,0,0,578.93,7,96055.07,0,0,2,11,True
1127201,433,4,451,4663,949035958,1,0,0,722.79,7,740144.21,24,5,15,1,True
1288661,1092,1,10,5218,949035958,1,0,0,722.99,6,740867.2,18,1,7,1,True
1487886,1068,2,20,3840,949035958,1,0,0,723.34,5,740143.86,18,2,4,4,True
1865646,689,0,-1,5731,949035958,1,1,0,723.31,4,740143.86,24,3,21,5,True
1891953,1288,0,451,7753,949035958,1,0,0,722.9,7,739420.96,24,3,19,5,True
1926143,35,2,30,1974,949035958,1,0,0,723.16,8,738697.8,11,0,12,6,True
2158600,35,2,451,6742,949035958,1,0,0,722.84,7,737974.96,11,3,7,6,False
2317034,689,0,30,8056,949035958,1,0,0,723.03,8,737251.93,24,3,3,7,True
2409084,144,1,10,1745,949035958,1,0,0,723.13,0,737975.06,18,0,19,8,True
2897844,1288,0,10,5731,949035958,1,0,0,722.96,6,738698.02,24,4,22,9,True
2980911,223,2,20,1308,949035958,1,0,0,723.04,5,737974.98,26,5,10,9,True
2999000,114,0,20,4663,949035958,1,0,0,722.9,5,737252.08,3,4,22,9,True
3098045,137,2,-1,9405,949035958,1,1,0,722.85,4,737252.08,18,1,14,12,True
3286367,1288,0,451,4543,949035958,1,0,0,722.94,7,736529.14,24,1,20,12,True
3293516,35,2,451,5218,949035958,1,0,0,722.81,7,735806.33,11,5,19,1,True
3478773,759,0,20,4663,949035958,1,0,0,723.11,5,735083.22,24,1,0,1,True
3560323,204,0,10,4663,949035958,1,0,0,722.92,0,735806.14,9,1,3,2,True
3705781,522,0,10,4543,949035958,1,0,0,723.01,0,736529.15,18,3,2,3,True
3881937,689,0,451,5731,949035958,1,0,0,723.04,7,735806.11,24,4,21,4,True
3883709,35,2,451,6949,949035958,1,0,0,723.08,7,735083.03,11,3,0,5,True
4008543,137,2,30,6949,949035958,1,0,0,723.23,8,734359.8,18,2,18,6,True
4077179,1197,3,451,1081,949035958,1,0,0,722.78,7,733637.02,24,4,6,7,True
4240722,35,2,25,3840,949035958,1,0,0,722.91,8,732914.11,11,1,20,8,True
4342754,137,2,-1,5028,949035958,1,1,0,723.01,1,732914.11,18,4,1,8,True
4558116,689,0,451,4683,949035958,1,0,0,723.06,7,732191.05,24,4,12,9,True
4662678,279,2,20,7240,949035958,1,0,0,723.11,5,731467.94,24,1,5,9,True
4822162,1297,0,10,2619,949035958,1,0,0,723.18,6,732191.12,5,3,3,9,True
5111870,35,2,451,1308,949035958,1,0,0,722.96,7,731468.16,11,1,0,10,True
5190861,1288,0,451,7598,949035958,1,0,0,723.09,7,730745.07,24,3,23,10,False
5340922,1197,3,25,5028,949035958,1,0,0,723.02,8,730022.05,24,5,1,11,True
5369805,689,0,451,8056,949035958,1,0,0,723.11,7,729298.94,24,5,1,12,True
6045013,433,4,451,5946,949035958,1,0,0,722.82,7,728576.12,24,3,11,1,True
6049961,35,2,30,7598,949035958,1,0,0,722.86,8,727853.26,11,0,2,2,True
6172453,1288,0,25,9405,949035958,1,0,0,722.84,8,727130.42,24,2,21,2,True
6511298,318,0,10,4683,949035958,1,0,0,723.08,6,727853.5,11,3,14,3,True
6546333,42,2,20,7753,949035958,1,0,0,723.13,5,727130.37,24,4,1,3,True
6564284,689,0,30,9338,949035958,1,0,0,722.99,8,726407.38,24,4,11,3,True
6631712,1429,0,10,4080,949035958,1,0,0,722.95,6,727130.33,24,2,10,5,True
6878138,689,0,25,1974,949035958,1,0,0,722.93,8,726407.4,24,5,17,5,False
7051783,689,0,25,1858,949035958,1,0,0,722.9,8,725684.5,24,6,13,5,True
7318924,1197,3,451,6253,949035958,1,0,0,723.16,7,724961.34,24,5,10,5,True
7518904,433,4,30,4543,949035958,1,0,0,723.14,8,724238.2,24,1,7,6,True
7690130,689,0,451,4543,949035958,1,0,0,723.02,7,723515.18,24,6,17,6,False
7798672,785,0,20,5731,949035958,1,0,0,723.09,5,722792.09,14,2,1,7,True
7917386,1197,3,-1,1081,949035958,1,1,0,722.97,4,722792.09,24,3,20,7,True
7974972,1197,3,25,7240,949035958,1,0,0,722.63,8,722069.46,24,4,6,7,True
8058964,1288,0,-1,9338,949035958,1,1,0,722.97,4,722069.46,24,4,15,8,True
8913592,1288,0,30,6949,949035958,1,0,0,722.95,8,721346.51,24,6,7,9,True
9146607,35,2,451,6949,949035958,1,0,0,723.13,7,720623.38,11,4,15,10,True
9169185,35,2,25,2619,949035958,1,0,0,722.79,8,719900.59,11,2,11,10,True
9197099,689,0,451,1308,949035958,1,0,0,722.89,7,719177.7,24,3,2,11,True
9252340,848,2,20,1745,949035958,1,0,0,723.19,5,718454.51,5,3,15,11,True
9468140,85,2,20,1745,949035958,1,0,0,722.98,5,717731.53,1,3,3,11,True
1150367,1082,3,451,8433,159179437,0,0,0,739.89,7,892642.11,18,1,13,1,True
1242295,27,0,25,1687,159179437,0,0,0,739.97,8,891902.14,11,5,22,4,True
1337011,228,0,451,9377,159179437,0,0,0,740.38,7,891161.76,26,0,14,4,True
1652589,132,2,20,6963,159179437,0,0,0,740.06,5,890421.7,18,2,15,4,True
1806801,641,0,10,4339,159179437,0,0,0,739.95,6,891161.65,24,5,21,5,True
1828356,385,1,25,6221,159179437,0,0,0,740.01,8,890421.64,25,0,7,5,True
1903028,1103,4,-1,8433,159179437,0,1,0,740.29,4,890421.64,0,5,19,5,True
1995896,385,1,30,6221,159179437,0,0,0,740.11,8,889681.53,25,5,18,6,True
2042594,385,1,30,8433,159179437,0,0,0,739.94,8,888941.59,25,6,7,6,True
2326670,411,2,20,4190,159179437,0,0,0,739.87,5,888201.72,18,3,13,6,True
2676618,27,0,30,4190,159179437,0,0,0,739.92,8,887461.8,11,4,20,7,True
2690744,644,0,20,4339,159179437,0,0,0,740.12,5,886721.68,24,6,23,7,True
2802704,411,2,25,4469,159179437,0,0,0,739.93,8,885981.75,18,4,16,8,True
2937143,1082,3,30,1687,159179437,0,0,0,740.06,8,885241.69,18,6,2,8,True
3034016,228,0,30,7178,159179437,0,0,0,740.04,8,884501.65,26,5,11,9,True
3099114,1451,1,10,7178,159179437,0,0,0,739.86,6,885241.51,11,2,1,12,True
3445048,254,0,451,1262,159179437,0,0,0,739.77,7,884501.74,6,4,15,12,True
3539816,147,0,10,7178,159179437,0,0,0,739.85,6,885241.59,18,1,22,12,True
3772845,254,0,30,1956,159179437,0,0,0,740.14,8,884501.45,6,1,9,1,True
3806011,411,2,451,7178,159179437,0,0,0,740.03,7,883761.42,18,4,1,1,True
4340027,228,0,451,4339,159179437,0,0,0,739.95,7,883021.47,26,6,19,2,True
4744519,1103,4,30,1687,159179437,0,0,0,740.14,8,882281.33,0,3,16,2,True
4828300,254,0,451,4190,159179437,0,0,0,740.14,7,881541.19,6,1,16,3,True
4846135,1103,4,25,7178,159179437,0,0,0,740.28,8,880800.91,0,1,13,4,True
4962438,254,0,-1,5628,159179437,0,1,0,739.98,4,880800.91,6,5,11,5,True
4995363,385,1,25,5628,159179437,0,0,0,739.95,8,880060.96,25,4,16,5,True
5068537,1103,4,-1,5628,159179437,0,1,0,740.08,4,880060.96,0,4,20,6,True
5079775,376,0,20,7178,159179437,0,0,0,739.87,3,879321.09,25,6,23,6,True
5446065,385,1,451,1262,159179437,0,0,0,739.8,7,878581.29,25,5,21,7,True
5598919,27,0,30,1687,159179437,0,0,0,739.88,8,877841.41,11,3,4,8,True
6010153,1103,4,30,6221,159179437,0,0,0,739.98,8,877101.43,0,0,22,8,True
6188128,580,0,20,4469,159179437,0,0,0,740.29,5,876361.14,11,4,0,10,True
6236899,228,0,-1,6963,159179437,0,1,0,740.02,1,876361.14,26,4,9,10,True
6484029,385,1,25,4190,159179437,0,0,0,740.0,8,875621.14,25,1,16,10,True
6638591,411,2,30,1956,159179437,0,0,0,739.99,8,874881.15,18,0,1,11,True
6673324,254,0,451,4339,159179437,0,0,0,739.95,7,874141.2,6,6,4,11,True
6952690,385,1,-1,7178,159179437,0,1,0,740.11,4,874141.2,25,1,22,11,True
7101361,228,0,451,4469,159179437,0,0,0,739.92,7,873401.28,26,5,17,12,True
7176180,385,1,25,4339,159179437,0,0,0,740.23,8,872661.05,25,0,3,1,False
7597007,726,0,20,6963,159179437,0,0,0,739.96,5,871921.09,11,4,14,1,True
7744611,1103,4,-1,7178,159179437,0,1,0,739.8,1,871921.09,0,1,1,2,True
7752405,1103,4,451,6963,159179437,0,0,0,740.03,7,871181.06,0,2,23,4,True
7760412,1082,3,451,4190,159179437,0,0,0,740.41,7,870440.65,18,0,19,5,True
8031651,411,2,451,8433,159179437,0,0,0,739.85,7,869700.8,18,2,21,5,True
8160481,98,0,10,8704,159179437,0,0,0,740.13,6,870440.93,3,0,6,5,False
8339721,1166,2,20,7178,159179437,0,0,0,739.88,3,869701.05,24,2,7,5,True
8479342,385,1,30,1262,159179437,0,0,0,739.77,8,868961.28,25,1,9,6,True
8660336,343,1,10,1262,159179437,0,0,0,739.91,6,869701.19,24,3,7,6,True
8753257,411,2,451,9377,159179437,0,0,0,739.97,7,868961.22,18,1,12,7,True
8870206,385,1,451,1262,159179437,0,0,0,740.01,7,868221.21,25,3,9,7,True
8937675,1103,4,30,5628,159179437,0,0,0,739.89,8,867481.32,0,6,23,7,True
9041721,1082,3,30,2652,159179437,0,0,0,739.62,8,866741.7,18,2,22,8,True
9305644,228,0,-1,7178,159179437,0,1,0,739.95,4,866741.7,26,6,19,9,True
9350825,376,0,10,4339,159179437,0,0,0,740.02,6,867481.72,25,0,1,9,True
9576869,385,1,30,6221,159179437,0,0,0,740.05,8,866741.67,25,4,11,9,False
9736317,27,0,-1,4190,159179437,0,1,0,739.98,4,866741.67,11,4,19,10,True
9915641,81,0,10,7178,159179437,0,0,0,739.94,6,867481.61,1,4,20,11,True
1314556,292,1,25,2698,204950471,0,0,0,213.9,8,864536.1,4,5,9,1,True
1804559,882,0,20,3332,204950471,0,0,0,214.03,5,864322.07,27,3,13,1,True
2001309,168,0,451,8778,204950471,0,0,0,214.08,7,864107.99,24,6,14,2,True
2229134,727,0,30,6444,204950471,0,0,0,214.34,8,863893.65,11,2,16,3,True
2244778,403,0,451,9256,204950471,0,0,0,214.1,7,863679.55,10,1,21,5,True
2327366,1482,3,451,3569,204950471,0,0,0,213.95,7,863465.6,24,6,4,6,True
2413921,727,0,451,3808,204950471,0,0,0,214.12,7,863251.48,11,2,19,8,True
2476676,1380,0,10,6408,204950471,0,0,0,213.99,6,863465.47,16,0,12,9,True
2550918,59,0,10,3609,204950471,0,0,0,213.9,6,863679.37,20,1,11,11,True
2715062,403,0,-1,4974,204950471,0,1,0,214.01,4,863679.37,10,2,13,11,True
2898433,759,0,10,5497,204950471,0,0,0,214.08,6,863893.45,24,6,13,12,True
3088612,403,0,30,6444,204950471,0,0,0,213.81,8,863679.64,10,3,7,1,True
3323225,234,0,20,2698,204950471,0,0,0,213.97,5,863465.67,26,4,10,1,True
3427249,292,1,30,7772,204950471,0,0,0,214.15,8,863251.52,4,0,23,2,True
3689157,1383,4,-1,2018,204950471,0,1,0,213.98,4,863251.52,16,3,7,2,True
3712060,238,0,10,5057,204950471,0,0,0,214.05,6,863465.57,26,5,13,3,True
4035480,632,4,451,3370,204950471,0,0,0,213.98,7,863251.59,11,3,14,3,True
4287419,318,0,451,3332,204950471,0,0,0,214.15,7,863037.44,11,3,17,3,True
4396274,687,0,20,5057,204950471,0,0,0,213.85,3,862823.59,24,2,1,5,True
4987095,403,0,-1,6408,204950471,0,1,0,213.83,1,862823.59,10,2,5,5,True
5022518,23,0,20,3332,204950471,0,0,0,214.01,5,862609.58,11,4,20,5,True
5035040,1383,4,30,4405,204950471,0,0,0,214.05,8,862395.53,16,6,22,6,False
5165578,348,0,20,2698,204950471,0,0,0,213.81,3,862181.72,24,6,17,6,True
5418777,1482,3,25,4405,204950471,0,0,0,213.96,8,861967.76,24,3,2,6,True
5483210,292,1,451,1735,204950471,0,0,0,214.07,7,861753.69,4,2,22,7,True
5552404,569,4,-1,6444,204950471,0,1,0,213.81,4,861753.69,11,2,11,7,True
5637116,538,0,20,1906,204950471,0,0,0,214.0,5,861539.69,18,3,23,7,True
5638907,1181,2,20,7276,204950471,0,0,0,213.65,3,861326.04,24,6,4,7,True
5651104,632,4,-1,3808,204950471,0,1,0,213.72,4,861326.04,11,5,4,10,True
5758631,529,2,20,4974,204950471,0,0,0,213.73,5,861112.31,18,3,7,11,True
5772813,937,0,20,2018,204950471,0,0,0,213.76,5,860898.55,24,3,16,11,True
5878802,1383,4,25,4405,204950471,0,0,0,214.07,8,860684.48,16,6,3,11,True
5961662,168,0,-1,6408,204950471,0,1,0,213.7,1,860684.48,24,6,8,12,True
6074712,328,0,20,7952,204950471,0,0,0,213.71,5,860470.77,11,6,8,12,True
6148175,114,0,10,6408,204950471,0,0,0,214.21,6,860684.98,3,0,16,1,True
6149818,1426,1,10,6444,204950471,0,0,0,214.01,6,860898.99,24,0,11,2,True
6156978,1307,0,10,7276,204950471,0,0,0,213.79,0,861112.78,5,4,4,2,True
6481815,318,0,-1,8778,204950471,0,1,0,214.02,4,861112.78,11,2,17,3,True
6653726,1383,4,-1,6444,204950471,0,2,0,213.87,4,861112.78,16,6,2,3,True
6725410,204,0,20,5806,204950471,0,0,0,213.76,5,860899.02,9,6,2,4,True
6749800,318,0,451,1477,204950471,0,0,0,213.69,7,860685.33,11,3,6,4,True
7279232,727,0,451,4974,204950471,0,0,0,214.54,7,860470.79,11,2,2,5,True
7365031,168,0,451,5806,204950471,0,0,0,214.15,7,860256.64,24,6,15,5,True
7492176,1267,2,20,3370,204950471,0,0,0,213.94,5,860042.7,23,6,5,5,True
7628016,211,0,10,2018,204950471,0,0,0,214.11,6,860256.81,9,0,23,5,True
7911263,403,0,451,2018,204950471,0,0,0,213.81,7,860043.0,10,0,12,6,True
7988336,569,4,451,1477,204950471,0,0,0,214.27,7,859828.73,11,6,5,6,True
8172890,727,0,30,4405,204950471,0,0,0,213.94,8,859614.79,11,3,11,6,True
8731393,337,1,10,1906,204950471,0,0,0,214.25,6,859829.04,11,2,20,7,True
8758445,1123,2,20,6408,204950471,0,0,0,213.92,3,859615.12,24,0,9,8,True
8826938,292,1,-1,3370,204950471,0,1,0,213.95,4,859615.12,4,0,15,8,True
8966351,378,0,10,3370,204950471,0,0,0,213.97,0,859829.09,25,6,8,9,True
9192278,318,0,451,3609,204950471,0,0,0,214.05,7,859615.04,11,2,0,9,True
9492072,168,0,-1,1906,204950471,0,1,0,214.05,4,859615.04,24,1,8,10,True
9510214,403,0,451,2698,204950471,0,0,0,213.99,7,859401.05,10,2,9,10,False
9763689,569,4,451,6406,204950471,0,0,0,213.99,7,859187.06,11,6,12,11,True
9987696,1486,2,20,4974,204950471,0,0,0,213.76,3,858973.3,24,1,16,11,True
1188089,1007,2,20,9906,418776351,1,0,0,126.84,5,360169.16,26,5,18,1,True
1267004,44,4,-1,9959,418776351,1,1,0,127.03,1,360169.16,24,6,8,1,True
1288827,63,3,25,1549,418776351,1,0,0,126.7,8,360042.46,20,1,14,3,True
1524571,1387,1,10,2669,418776351,1,0,0,126.83,6,360169.29,24,4,15,4,True
1595913,44,4,-1,1073,418776351,1,1,0,127.09,4,360169.29,24,1,6,4,True
1619390,1303,0,30,5867,418776351,1,0,0,127.2,8,360042.09,5,2,4,4,True
1671753,1146,2,20,5024,418776351,1,0,0,126.83,3,359915.26,15,0,6,5,True
1777798,503,0,25,8056,418776351,1,0,0,126.95,8,359788.31,12,1,13,5,True
1780692,1303,0,451,8056,418776351,1,0,0,126.8,7,359661.51,5,4,15,5,True
1788369,20,0,20,3309,418776351,1,0,0,127.16,5,359534.35,24,4,8,7,True
1980213,1303,0,25,3306,418776351,1,0,0,127.07,8,359407.28,5,1,0,8,True
1995605,350,0,10,4631,418776351,1,0,0,126.97,0,359534.25,24,5,1,8,True
2103549,1303,0,30,8056,418776351,1,0,0,126.77,8,359407.48,5,6,0,8,True
2130465,44,4,451,3670,418776351,1,0,0,126.88,7,359280.6,24,3,3,9,True
2171608,799,2,451,3306,418776351,1,0,0,127.0,7,359153.6,11,4,9,10,True
2198202,799,2,30,1289,418776351,1,0,0,127.15,8,359026.45,11,0,10,11,True
2274348,1303,0,30,9959,418776351,1,0,0,127.13,8,358899.32,5,4,14,11,True
2498016,63,3,30,3187,418776351,1,0,0,127.22,8,358772.1,20,5,0,11,True
2971444,198,0,10,3309,418776351,1,0,0,126.86,6,358898.96,18,1,15,11,True
3085447,299,1,10,2669,418776351,1,0,0,126.96,0,359025.92,4,1,13,12,True
3297852,503,0,25,3309,418776351,1,0,0,126.76,8,358899.16,12,0,22,1,False
3386936,403,0,20,1549,418776351,1,0,0,127.15,5,358772.01,10,3,4,1,True
3406596,1411,0,-1,3187,418776351,1,1,0,126.88,1,358772.01,24,6,15,1,True
3515555,1411,0,451,7530,418776351,1,0,0,127.0,7,358645.01,24,1,21,2,True
4110569,503,0,25,8056,418776351,1,0,0,126.81,8,358518.2,12,6,1,2,True
4308527,63,3,30,5867,418776351,1,0,0,127.01,8,358391.19,20,1,21,2,True
4315840,155,1,10,5008,418776351,1,0,0,126.81,6,358518.0,18,4,11,3,True
5646858,44,4,-1,2669,418776351,1,1,0,127.09,4,358518.0,24,1,2,3,False
5688818,1303,0,451,5746,418776351,1,0,0,126.96,7,358391.04,5,0,8,3,True
6056594,1076,1,10,5024,418776351,1,0,0,126.78,0,358517.82,18,5,10,4,True
6088608,44,4,25,3670,418776351,1,0,0,127.15,8,358390.67,24,3,6,5,True
6395374,1278,0,20,3621,418776351,1,0,0,126.97,3,358263.7,24,0,5,6,True
6513624,1411,0,451,4631,418776351,1,0,0,126.93,7,358136.77,24,4,4,6,True
6519631,1029,0,20,2669,418776351,1,0,0,126.89,5,358009.88,11,6,1,6,True
6590938,1089,0,20,1073,418776351,1,0,0,126.97,5,357882.91,18,4,18,6,True
6632233,44,4,451,1289,418776351,1,0,0,127.19,7,357755.72,24,0,18,8,True
6762959,503,0,30,5024,418776351,1,0,0,127.09,8,357628.63,12,5,4,8,True
6764402,635,2,20,8645,418776351,1,0,0,127.23,5,357501.4,24,6,12,9,True
6782952,44,4,25,9959,418776351,1,0,0,126.99,8,357374.41,24,6,8,11,True
6956882,1303,0,451,6526,418776351,1,0,0,127.17,7,357247.24,5,3,6,11,True
7527744,1411,0,-1,3187,418776351,1,1,0,126.79,4,357247.24,24,3,21,1,True
7579186,63,3,30,6526,418776351,1,0,0,126.89,8,357120.35,20,4,16,2,True
7672514,799,2,25,5008,418776351,1,0,0,127.14,8,356993.21,11,0,7,3,True
7742188,1303,0,25,3187,418776351,1,0,0,126.84,8,356866.37,5,2,4,3,True
7999512,203,0,20,7530,418776351,1,0,0,126.76,5,356739.61,9,6,7,3,True
8157401,799,2,451,1549,418776351,1,0,0,127.0,7,356612.61,11,4,2,3,True
8318955,799,2,-1,2669,418776351,1,1,0,127.18,4,356612.61,11,1,7,3,True
8387269,63,3,30,8645,418776351,1,0,0,126.98,8,356485.63,20,5,23,3,True
8892568,1277,2,20,5024,418776351,1,0,0,127.29,5,356358.34,24,0,14,7,True
9122554,44,4,25,5867,418776351,1,0,0,127.05,8,356231.29,24,0,15,8,True
9395018,44,4,30,9959,418776351,1,0,0,126.91,8,356104.38,24,0,10,8,True
9512341,465,0,10,4631,418776351,1,0,0,127.18,6,356231.56,13,2,4,9,True
9654962,503,0,30,6526,418776351,1,0,0,126.87,8,356104.69,12,2,15,9,True
9729677,503,0,30,5746,418776351,1,0,0,126.85,8,355977.84,12,5,3,10,True
9951509,1411,0,30,4929,418776351,1,0,0,127.16,8,355850.68,24,1,6,11,True
9965486,799,2,451,5008,418776351,1,0,0,127.03,7,355723.65,11,0,19,11,True
1004493,376,0,10,8646,628239029,0,0,0,141.17,6,386395.17,25,4,0,2,True
1011750,1266,4,25,9895,628239029,0,0,0,140.8,8,386254.37,23,0,8,2,True
1116727,972,3,451,6448,628239029,0,0,0,141.19,7,386113.18,13,5,6,3,True
1157538,247,4,25,4052,628239029,0,0,0,141.02,8,385972.16,6,0,23,3,True
1438124,1170,0,25,3160,628239029,0,0,0,140.81,8,385831.35,24,2,23,3,True
1508355,247,4,30,6565,628239029,0,0,0,140.75,8,385690.6,6,4,20,5,True
1646283,481,3,30,2589,628239029,0,0,0,141.12,8,385549.48,5,2,21,6,True
1689452,715,0,20,4052,628239029,0,0,0,141.0,5,385408.48,18,0,21,6,True
1745059,1170,0,30,6448,628239029,0,0,0,141.02,8,385267.46,24,6,13,6,True
1927353,95,2,20,8787,628239029,0,0,0,141.29,5,385126.17,1,2,14,7,False
2280011,1266,4,451,9792,628239029,0,0,0,141.07,7,384985.1,23,2,22,8,True
2378333,1170,0,451,9032,628239029,0,0,0,140.68,7,384844.42,24,1,8,10,False
2539747,549,1,10,7192,628239029,0,0,0,141.08,6,384985.5,17,3,22,11,True
2808941,1170,0,30,9792,628239029,0,0,0,140.79,8,384844.71,24,3,20,11,True
2907943,1298,0,10,3518,628239029,0,0,0,140.98,0,384985.69,5,5,5,12,True
3103403,1181,2,20,7408,628239029,0,0,0,141.09,3,384844.6,24,2,13,2,True
3371075,247,4,451,7408,628239029,0,0,0,140.91,7,384703.69,6,5,4,4,True
3470371,247,4,25,7192,628239029,0,0,0,141.21,8,384562.48,6,3,9,6,True
3561882,247,4,-1,9895,628239029,0,1,0,141.12,4,384562.48,6,0,5,6,True
3592466,1266,4,451,9895,628239029,0,0,0,141.1,7,384421.38,23,5,12,7,True
4068221,130,0,20,1779,628239029,0,0,0,141.13,3,384280.25,18,6,9,7,True
4177630,972,3,451,3434,628239029,0,0,0,141.25,7,384139.0,13,0,20,7,True
4186721,972,3,451,1628,628239029,0,0,0,141.25,7,383997.75,13,4,1,8,True
4353668,816,0,10,6685,628239029,0,0,0,140.97,0,384138.72,18,5,1,8,True
4459803,1170,0,25,1628,628239029,0,0,0,140.86,8,383997.86,24,0,7,8,True
5281438,800,0,10,1708,628239029,0,0,0,140.99,6,384138.85,11,5,15,10,True
5307839,247,4,30,7363,628239029,0,0,0,141.2,8,383997.65,6,1,17,11,True
5387056,204,0,451,8646,628239029,0,0,0,140.97,7,383856.68,9,4,22,12,False
5657496,1266,4,451,6685,628239029,0,0,0,141.01,7,383715.67,23,0,14,1,False
5939307,1155,0,10,2214,628239029,0,0,0,140.88,6,383856.55,15,4,19,1,True
6633828,257,1,10,3160,628239029,0,0,0,141.1,6,383997.65,6,6,3,1,True
6778290,1170,0,25,2214,628239029,0,0,0,140.81,8,383856.84,24,5,0,2,True
6886577,53,0,20,6685,628239029,0,0,0,141.07,3,383715.77,20,5,3,3,True
6960096,972,3,30,7408,628239029,0,0,0,141.1,8,383574.67,13,2,7,3,True
6972275,481,3,30,9895,628239029,0,0,0,140.95,8,383433.72,5,2,14,4,True
7028837,1266,4,25,2214,628239029,0,0,0,140.98,8,383292.74,23,6,19,4,True
7117182,1127,0,20,1628,628239029,0,0,0,141.13,5,383151.61,24,4,21,4,True
7350835,1170,0,-1,3434,628239029,0,1,0,140.96,1,383151.61,24,3,13,5,False
7691187,247,4,-1,1396,628239029,0,2,0,140.77,4,383151.61,6,5,10,5,True
7995416,972,3,30,7408,628239029,0,0,0,140.94,8,383010.67,13,5,6,6,True
8180605,677,0,20,3434,628239029,0,0,0,140.83,3,382869.84,24,6,11,7,True
8777979,1266,4,451,9895,628239029,0,0,0,141.2,7,382728.64,23,2,16,7,True
8863899,1266,4,-1,2535,628239029,0,1,0,141.08,4,382728.64,23,4,22,8,True
9286769,650,3,25,7032,628239029,0,0,0,141.01,8,382587.63,24,6,10,9,True
9374688,1111,0,20,9672,628239029,0,0,0,140.92,3,382446.71,0,6,16,10,True
9387582,1101,2,20,8650,628239029,0,0,0,140.87,3,382305.84,0,2,14,10,True
9536575,650,3,25,9032,628239029,0,0,0,141.08,8,382164.76,24,0,18,10,True
9539662,481,3,30,6448,628239029,0,0,0,140.97,8,382023.79,5,2,9,10,True
9896465,1063,0,10,7032,628239029,0,0,0,141.25,6,382165.04,11,2,9,10,True
9900235,1266,4,-1,8126,628239029,0,1,0,141.0,4,382165.04,23,5,16,11,True
1150420,1103,4,-1,9762,485047679,1,1,0,1058.1,4,318729.0,0,5,21,1,True
1164931,824,2,20,1230,485047679,1,0,0,1058.35,3,317670.65,18,4,14,1,True
1458342,1350,4,451,7247,485047679,1,0,0,1058.26,7,316612.39,24,6,18,4,True
1620123,303,0,20,2071,485047679,1,0,0,1058.15,3,315554.24,4,3,14,4,True
1890345,563,4,25,3028,485047679,1,0,0,1057.77,8,314496.47,17,2,1,4,True
1915196,1041,0,25,6591,485047679,1,0,0,1057.78,8,313438.69,11,4,10,4,True
1917636,1393,3,451,3400,485047679,1,0,0,1058.05,7,312380.64,24,0,12,5,True
1933542,563,4,451,2251,485047679,1,0,0,1057.82,7,311322.82,17,4,6,5,True
2125738,1350,4,25,4105,485047679,1,0,0,1057.91,8,310264.91,24,4,16,6,True
2173106,145,0,10,3400,485047679,1,0,0,1057.88,6,311322.79,18,1,7,6,True
2270353,767,0,20,3219,485047679,1,0,0,1058.21,5,310264.58,14,0,6,7,True
2528816,1436,0,20,3243,485047679,1,0,0,1057.99,5,309206.59,24,3,4,8,True
2711730,1350,4,25,6780,485047679,1,0,0,1058.29,8,308148.3,24,5,14,10,True
2772483,1103,4,451,6591,485047679,1,0,0,1057.97,7,307090.33,0,0,18,12,True
2775018,1041,0,25,9762,485047679,1,0,0,1058.1,8,306032.23,11,1,16,12,True
2924586,1393,3,30,3243,485047679,1,0,0,1057.94,8,304974.29,24,2,18,1,True
3312983,1103,4,451,3028,485047679,1,0,0,1057.9,7,303916.39,0,3,13,1,True
3362505,324,4,25,7264,485047679,1,0,0,1057.98,8,302858.41,11,3,13,2,True
3581830,1393,3,-1,3028,485047679,1,1,0,1057.85,4,302858.41,24,5,17,2,True
3691882,1041,0,25,9762,485047679,1,0,0,1057.87,8,301800.54,11,5,14,2,True
4004169,563,4,451,7969,485047679,1,0,0,1057.75,7,300742.79,17,2,3,2,True
4090104,324,4,25,6226,485047679,1,0,0,1058.07,8,299684.72,11,4,9,3,True
4156051,591,0,20,2251,485047679,1,0,0,1057.72,3,298627.0,24,1,13,3,True
4199309,1305,2,20,5024,485047679,1,0,0,1058.03,5,297568.97,5,6,18,4,True
4328665,1103,4,30,3028,485047679,1,0,0,1058.04,8,296510.93,0,0,12,4,True
4373018,991,1,10,3120,485047679,1,0,0,1058.06,6,297568.99,22,2,8,5,True
4782815,180,0,10,4105,485047679,1,0,0,1057.83,6,298626.82,18,6,11,5,True
4832484,324,4,451,3028,485047679,1,0,0,1057.81,7,297569.01,11,6,3,6,True
4859772,563,4,-1,2251,485047679,1,1,0,1057.93,4,297569.01,17,4,13,6,True
5872980,1103,4,451,1012,485047679,1,0,0,1058.07,7,296510.94,0,5,15,7,True
6020677,198,0,20,5217,485047679,1,0,0,1057.93,5,295453.01,18,6,20,7,True
6088659,1350,4,25,7502,485047679,1,0,0,1058.08,8,294394.93,24,5,17,8,True
6091221,1127,0,20,8595,485047679,1,0,0,1058.16,3,293336.77,24,1,4,9,True
6351033,1103,4,30,6226,485047679,1,0,0,1057.89,8,292278.88,0,1,8,10,True
6476447,98,0,20,9762,485047679,1,0,0,1057.94,3,291220.94,3,4,23,12,True
6661167,1041,0,30,6112,485047679,1,0,0,1058.06,8,290162.88,11,6,11,12,True
6667160,1103,4,30,2251,485047679,1,0,0,1058.34,8,289104.54,0,6,11,1,True
6727870,1041,0,-1,1665,485047679,1,1,0,1057.99,4,289104.54,11,6,4,2,True
6755375,1041,0,-1,5024,485047679,1,2,0,1057.98,1,289104.54,11,0,7,3,True
6934896,1350,4,25,7247,485047679,1,0,0,1057.83,8,288046.71,24,0,8,3,True
6989974,1017,2,20,3028,485047679,1,0,0,1058.03,3,286988.68,26,0,4,3,True
7384250,1393,3,25,7264,485047679,1,0,0,1057.85,8,285930.83,24,5,1,4,True
7762601,1041,0,30,8707,485047679,1,0,0,1057.99,8,284872.84,11,2,16,5,True
7770693,1393,3,25,3610,485047679,1,0,0,1058.07,8,283814.77,24,4,17,5,True
7906465,1103,4,451,4105,485047679,1,0,0,1057.74,7,282757.03,0,0,18,7,True
8125984,234,0,20,1230,485047679,1,0,0,1058.08,5,281698.95,26,1,0,7,True
8153288,1350,4,30,3120,485047679,1,0,0,1058.18,8,280640.77,24,2,15,8,True
8343503,907,0,10,6591,485047679,1,0,0,1058.11,6,281698.88,2,2,23,8,True
8703943,97,0,10,8707,485047679,1,0,0,1057.85,6,282756.73,3,4,3,8,True
8962486,297,0,20,7502,485047679,1,0,0,1058.17,5,281698.56,4,5,2,8,True
9223753,324,4,451,1665,485047679,1,0,0,1057.79,7,280640.77,11,6,11,10,True
9287801,1350,4,25,4105,485047679,1,0,0,1057.89,8,279582.88,24,5,9,10,True
9422638,1350,4,451,1230,485047679,1,0,0,1058.01,7,278524.87,24,6,17,10,False
9550013,563,4,-1,6112,485047679,1,1,0,1057.9,1,278524.87,17,1,19,10,True
9581448,148,1,10,3028,485047679,1,0,0,1057.94,0,279582.81,18,2,9,10,True
9618037,1041,0,-1,9762,485047679,1,1,0,1058.23,4,279582.81,11,4,16,11,True
1199218,126,1,-1,7698,568822861,1,1,0,383.97,1,553133.0,18,4,19,1,True
1316378,342,0,20,8700,568822861,1,0,0,383.97,5,552749.03,24,0,3,2,True
1353476,1423,3,25,9246,568822861,1,0,0,383.89,8,552365.14,24,1,19,3,False
1356657,1183,4,30,5913,568822861,1,0,0,384.03,8,551981.11,24,1,14,3,True
1405043,126,1,-1,9170,568822861,1,1,0,384.2,4,551981.11,18,0,1,3,True
1511089,1076,1,10,7626,568822861,1,0,0,383.7,0,552364.81,18,4,9,3,True
1620913,783,0,-1,5352,568822861,1,1,0,383.93,4,552364.81,14,0,7,4,True
1760978,102,4,451,7698,568822861,1,0,0,384.1,7,551980.71,3,0,21,4,True
1811996,783,0,451,9625,568822861,1,0,0,384.07,7,551596.64,14,0,1,4,True
2285626,189,4,451,9625,568822861,1,0,0,384.08,7,551212.56,18,4,23,5,True
2285858,1262,0,10,1782,568822861,1,0,0,384.09,6,551596.65,23,1,5,5,True
2519297,1232,1,10,3472,568822861,1,0,0,384.21,6,551980.86,18,1,9,7,True
2566548,102,4,-1,2050,568822861,1,1,0,384.2,4,551980.86,3,5,22,7,True
2655625,783,0,-1,7698,568822861,1,2,0,384.34,4,551980.86,14,3,21,9,True
2912104,340,4,25,7698,568822861,1,0,0,384.06,8,551596.8,24,0,6,9,True
3403343,1183,4,451,7212,568822861,1,0,0,384.01,7,551212.79,24,5,5,9,True
3716008,736,1,30,2581,568822861,1,0,0,384.03,8,550828.76,11,5,22,10,True
3764699,126,1,451,1782,568822861,1,0,0,383.77,7,550444.99,18,2,14,10,True
3952965,126,1,451,5913,568822861,1,0,0,383.73,7,550061.26,18,6,6,10,True
4004909,736,1,451,9170,568822861,1,0,0,383.92,7,549677.34,11,2,20,11,True
4065632,126,1,451,4667,568822861,1,0,0,384.05,7,549293.29,18,1,22,1,True
4206974,993,0,10,7698,568822861,1,0,0,384.06,0,549677.35,22,2,16,1,True
4291451,189,4,25,7572,568822861,1,0,0,383.99,8,549293.36,18,1,5,1,True
4472902,1183,4,30,5352,568822861,1,0,0,384.09,8,548909.27,24,6,20,2,True
4693603,736,1,-1,7698,568822861,1,1,0,383.97,1,548909.27,11,4,18,3,True
5253278,340,4,25,4667,568822861,1,0,0,383.94,8,548525.33,24,0,3,3,True
5357193,102,4,-1,2581,568822861,1,1,0,384.11,4,548525.33,3,4,7,3,True
5889471,1388,1,10,8700,568822861,1,0,0,384.12,6,548909.45,24,4,19,4,True
5928405,1411,0,20,2329,568822861,1,0,0,383.85,3,548525.6,24,4,8,5,True
6023245,1423,3,25,9170,568822861,1,0,0,384.05,8,548141.55,24,5,10,5,True
6252420,1271,0,451,1801,568822861,1,0,0,383.81,7,547757.74,23,5,2,5,False
6401306,783,0,30,5913,568822861,1,0,0,384.02,8,547373.72,14,3,1,6,False
6641365,1423,3,451,5352,568822861,1,0,0,383.87,7,546989.85,24,3,4,7,True
6713732,1423,3,25,9397,568822861,1,0,0,383.85,8,546606.0,24,4,21,7,True
6931878,1255,0,10,1782,568822861,1,0,0,384.07,0,546990.07,23,5,22,7,True
7083793,854,0,20,2674,568822861,1,0,0,383.86,5,546606.21,24,1,0,8,True
7206510,126,1,25,2050,568822861,1,0,0,384.22,8,546221.99,18,0,4,8,True
7255233,126,1,30,2050,568822861,1,0,0,384.17,8,545837.82,18,3,1,8,True
7939394,126,1,30,2050,568822861,1,0,0,383.93,8,545453.89,18,0,21,9,False
7981412,783,0,451,5913,568822861,1,0,0,383.84,7,545070.05,14,3,3,10,True
8190554,189,4,451,7572,568822861,1,0,0,384.21,7,544685.84,18,0,21,11,True
8554011,102,4,25,7572,568822861,1,0,0,383.85,8,544301.99,3,6,11,11,True
8690061,1423,3,451,5352,568822861,1,0,0,384.16,7,543917.83,24,4,7,12,True
8771934,168,0,10,2674,568822861,1,0,0,384.07,6,544301.9,24,0,1,12,True
8792922,59,0,20,5913,568822861,1,0,0,383.99,5,543917.91,20,3,17,1,True
8872726,1036,1,10,9413,568822861,1,0,0,383.81,0,544301.72,11,1,1,1,True
8891652,1201,0,20,2050,568822861,1,0,0,384.09,3,543917.63,24,4,3,1,True
8994709,1271,0,451,2329,568822861,1,0,0,384.06,7,543533.57,23,2,23,2,True
9134343,189,4,451,3472,568822861,1,0,0,384.04,7,543149.53,18,3,5,4,True
9321361,736,1,451,6643,568822861,1,0,0,384.09,7,542765.44,11,6,22,6,True
9406260,205,0,20,8700,568822861,1,0,0,384.16,3,542381.28,9,0,8,6,True
9427976,126,1,-1,9170,568822861,1,1,0,384.13,4,542381.28,18,5,12,6,True
9436754,1399,0,20,7698,568822861,1,0,0,383.82,3,541997.46,24,6,17,6,True
9650317,1423,3,25,1801,568822861,1,0,0,383.59,8,541613.87,24,6,22,6,True
9759248,1183,4,-1,7572,568822861,1,1,0,384.19,1,541613.87,24,5,22,9,True
9777335,714,2,20,5913,568822861,1,0,0,384.33,5,541229.54,18,5,18,10,True
1028962,130,0,30,5215,794988181,0,0,0,281.99,8,137156.01,18,0,6,2,True
1031967,511,1,451,7612,794988181,0,0,0,281.87,7,136874.14,12,2,17,3,True
1178796,1391,2,-1,3151,794988181,0,1,0,282.11,4,136874.14,24,3,6,4,True
1264759,1321,0,451,5215,794988181,0,0,0,282.11,7,136592.03,18,5,22,5,True
1332734,1482,3,-1,8928,794988181,0,1,0,281.94,4,136592.03,24,5,3,6,True
1446580,130,0,25,1333,794988181,0,0,0,282.0,8,136310.03,18,1,21,7,True
1457760,1378,3,-1,7209,794988181,0,1,0,281.98,1,136310.03,16,4,11,7,True
1608257,1316,3,25,2324,794988181,0,0,0,281.86,8,136028.17,5,5,3,8,True
1684854,130,0,451,1572,794988181,0,0,0,281.97,7,135746.2,18,0,16,8,True
1734497,1482,3,30,9242,794988181,0,0,0,281.85,8,135464.35,24,5,7,9,True
1962409,1482,3,30,7280,794988181,0,0,0,281.96,8,135182.39,24,3,8,9,True
1992111,1321,0,30,1572,794988181,0,0,0,282.03,8,134900.36,18,4,2,9,True
1993735,108,2,451,2993,794988181,0,0,0,282.18,7,134618.18,3,4,5,9,True
2856032,511,1,25,7434,794988181,0,0,0,281.88,8,134336.3,12,1,7,1,True
2921189,1391,2,-1,7434,794988181,0,1,0,282.17,1,134336.3,24,4,19,2,True
2953477,1316,3,25,7209,794988181,0,0,0,281.95,8,134054.35,5,5,17,2,True
3033638,1321,0,451,1488,794988181,0,0,0,281.95,7,133772.4,18,4,2,3,True
3328302,1378,3,-1,8928,794988181,0,1,0,281.72,4,133772.4,16,1,22,4,True
3378288,108,2,30,5215,794988181,0,0,0,281.95,8,133490.45,3,2,22,5,True
3847732,588,0,20,4793,794988181,0,0,0,281.42,3,133209.03,24,0,22,5,True
4335613,327,0,20,3162,794988181,0,0,0,282.05,3,132926.98,11,6,8,6,True
4400306,511,1,10,3162,794988181,0,0,0,282.25,0,133209.23,12,0,14,9,True
4413468,1321,0,451,7612,794988181,0,0,0,281.88,7,132927.35,18,4,6,11,True
4537295,1321,0,451,2083,794988181,0,0,0,282.11,7,132645.24,18,6,16,11,True
4582187,108,2,30,7612,794988181,0,0,0,282.14,8,132363.1,3,6,18,12,True
4596007,511,1,25,2083,794988181,0,0,0,282.22,8,132080.88,12,0,10,12,True
4733714,511,1,30,7280,794988181,0,0,0,281.98,8,131798.9,12,1,5,1,True
4827045,1316,3,451,3162,794988181,0,0,0,281.86,7,131517.04,5,3,16,2,True
4959925,573,0,20,1333,794988181,0,0,0,282.05,3,131234.99,11,6,15,3,False
5294080,228,0,10,9242,794988181,0,0,0,281.87,6,131516.86,26,6,23,4,True
5408523,1482,3,-1,2993,794988181,0,1,0,281.7,1,131516.86,24,6,2,5,True
5484213,1482,3,-1,5953,794988181,0,2,0,281.69,1,131516.86,24,0,2,6,True
5662258,1482,3,-1,8801,794988181,0,3,1,282.13,4,0.0,24,4,7,7,True
1142250,942,0,30,6998,114878881,1,0,0,301.84,8,211599.16,24,4,20,1,True
1265598,925,4,30,7115,114878881,1,0,0,302.02,8,211297.14,18,0,16,1,True
1480523,445,0,-1,6998,114878881,1,1,0,302.01,1,211297.14,13,3,7,2,True
1514528,787,0,10,3259,114878881,1,0,0,301.83,0,211598.97,14,2,8,3,True
1569827,79,4,451,6392,114878881,1,0,0,301.81,7,211297.16,1,4,21,3,True
1867011,599,0,451,6392,114878881,1,0,0,301.72,7,210995.44,24,6,7,3,True
2240823,599,0,25,3676,114878881,1,0,0,301.98,8,210693.46,24,0,3,4,True
2265769,238,0,10,9026,114878881,1,0,0,301.92,6,210995.38,26,5,12,4,True
3390374,220,0,20,9026,114878881,1,0,0,302.04,5,210693.34,26,6,1,5,True
3470273,599,0,451,6327,114878881,1,0,0,302.22,7,210391.12,24,3,23,6,True
3885952,1408,1,-1,6327,114878881,1,1,0,301.98,4,210391.12,24,1,1,8,True
4095962,445,0,451,9026,114878881,1,0,0,301.9,7,210089.22,13,4,4,8,True
4389538,393,1,10,3676,114878881,1,0,0,301.84,6,210391.06,10,5,22,8,True
4614451,925,4,-1,6998,114878881,1,1,0,302.39,4,210391.06,18,1,0,9,True
4638678,1408,1,-1,4783,114878881,1,2,0,301.72,1,210391.06,24,5,2,10,True
4674264,79,4,25,7241,114878881,1,0,0,302.14,8,210088.92,1,4,6,11,True
4790763,79,4,451,8004,114878881,1,0,0,302.16,7,209786.76,1,3,22,11,True
4926371,925,4,25,3592,114878881,1,0,0,302.04,8,209484.72,18,4,22,12,True
4989047,599,0,30,2623,114878881,1,0,0,301.93,8,209182.79,24,2,7,12,True
5005928,1408,1,451,6998,114878881,1,0,0,302.22,7,208880.57,24,3,14,1,True
5047115,1408,1,451,3592,114878881,1,0,0,301.8,7,208578.77,24,6,4,2,True
5131007,925,4,30,4783,114878881,1,0,0,302.18,8,208276.59,18,2,2,2,True
5210223,844,1,10,3592,114878881,1,0,0,302.14,6,208578.73,5,5,3,4,True
5256055,1116,0,10,7241,114878881,1,0,0,301.98,0,208880.71,24,3,14,5,True
5409118,1125,1,10,4783,114878881,1,0,0,302.06,0,209182.77,24,1,9,5,True
5478748,238,0,10,2623,114878881,1,0,0,302.03,6,209484.8,26,2,12,5,True
5529406,599,0,30,3676,114878881,1,0,0,302.09,8,209182.71,24,6,19,5,True
5596535,942,0,25,2623,114878881,1,0,0,301.76,8,208880.95,24,3,22,5,True
5662850,445,0,451,3676,114878881,1,0,0,302.05,7,208578.9,13,1,5,5,True
6025969,605,0,20,6392,114878881,1,0,0,302.12,5,208276.78,24,4,14,6,True
6170018,925,4,451,1230,114878881,1,0,0,302.33,7,207974.45,18,5,16,6,True
6267870,599,0,451,4783,114878881,1,0,0,301.69,7,207672.76,24,3,4,6,True
6417435,79,4,30,7241,114878881,1,0,0,302.17,8,207370.59,1,5,15,7,True
6471060,1408,1,451,7241,114878881,1,0,0,302.21,7,207068.38,24,4,12,7,True
6549210,599,0,30,7241,114878881,1,0,0,301.99,8,206766.39,24,6,21,8,True
6573247,925,4,30,4783,114878881,1,0,0,302.06,8,206464.33,18,4,11,8,True
6732362,1179,0,20,7824,114878881,1,0,0,302.0,3,206162.33,24,6,21,9,True
6891078,79,4,-1,8004,114878881,1,1,0,302.04,4,206162.33,1,0,7,9,True
7110399,1363,0,10,3592,114878881,1,0,0,302.13,6,206464.46,16,3,22,11,True
7239248,942,0,-1,5161,114878881,1,1,0,302.32,4,206464.46,24,5,23,11,True
7498683,445,0,-1,6327,114878881,1,2,0,302.01,1,206464.46,13,2,19,12,True
7738453,479,2,20,1717,114878881,1,0,0,302.03,5,206162.43,5,5,1,12,True
7855097,219,0,20,4783,114878881,1,0,0,302.1,5,205860.33,9,6,17,1,True
8380621,79,4,25,9026,114878881,1,0,0,302.07,8,205558.26,1,1,2,1,True
8527490,1272,0,10,7133,114878881,1,0,0,302.2,0,205860.46,24,3,12,3,True
8611461,79,4,25,8004,114878881,1,0,0,301.98,8,205558.48,1,0,6,4,True
8851451,942,0,451,5161,114878881,1,0,0,302.11,7,205256.37,24,0,23,5,True
9062031,942,0,25,7133,114878881,1,0,0,302.01,8,204954.36,24,2,11,5,True
9174444,942,0,25,3259,114878881,1,0,0,302.09,8,204652.27,24,1,23,5,True
9308863,599,0,451,7824,114878881,1,0,0,301.98,7,204350.29,24,6,21,8,True
9520269,1408,1,-1,2623,114878881,1,1,0,302.12,1,204350.29,24,2,19,9,True
9601802,599,0,30,4783,114878881,1,0,0,302.12,8,204048.17,24,5,18,9,True
9814969,649,0,10,6392,114878881,1,0,0,302.22,0,204350.39,24,5,1,11,True
9920013,334,0,20,6392,114878881,1,0,0,302.07,5,204048.32,11,4,6,11,True
9946149,1408,1,451,4783,114878881,1,0,0,301.81,7,203746.51,24,5,10,11,True
1014863,52,4,30,6035,359855333,0,0,0,626.2,8,738395.8,20,4,12,3,True
1071077,52,4,451,2248,359855333,0,0,0,626.41,7,737769.39,20,2,20,5,True
1481935,184,0,30,7000,359855333,0,0,0,625.92,8,737143.47,18,3,6,5,True
1483037,184,0,451,8767,359855333,0,0,0,625.65,7,736517.82,18,2,14,5,True
1938387,641,0,10,4899,359855333,0,0,0,625.95,6,737143.77,24,2,13,6,True
2591924,184,0,-1,2623,359855333,0,1,0,625.99,4,737143.77,18,1,0,6,True
2780073,1208,4,25,7483,359855333,0,0,0,625.99,8,736517.78,24,1,1,6,True
2964153,1224,4,30,3780,359855333,0,0,0,625.97,8,735891.81,24,3,9,9,True
3041842,641,0,10,2935,359855333,0,0,0,626.12,0,736517.93,24,4,13,10,False
3203537,1208,4,-1,5266,359855333,0,1,0,625.77,4,736517.93,24,5,2,11,True
3503044,429,0,10,3780,359855333,0,0,0,626.05,0,737143.98,24,2,17,12,True
3687404,52,4,451,5361,359855333,0,0,0,626.07,7,736517.91,20,2,11,1,True
3713610,184,0,30,6532,359855333,0,0,0,625.98,8,735891.93,18,4,8,1,True
3967563,1208,4,30,6532,359855333,0,0,0,625.75,8,735266.18,24,5,6,2,True
3990196,1224,4,25,2634,359855333,0,0,0,626.03,8,734640.15,24,6,20,2,True
4068852,871,0,10,3228,359855333,0,0,0,626.03,6,735266.18,24,1,9,3,True
4117407,249,0,20,4899,359855333,0,0,0,626.07,5,734640.11,6,3,15,3,True
4159065,1224,4,30,3780,359855333,0,0,0,625.83,8,734014.28,24,0,8,4,True
4344750,343,1,451,7155,359855333,0,0,0,625.98,7,733388.3,24,3,5,5,True
4793344,1226,2,20,7155,359855333,0,0,0,625.92,3,732762.38,18,5,14,6,True
4804836,588,0,25,2634,359855333,0,0,0,626.28,8,732136.1,24,1,7,6,True
5194936,184,0,25,7371,359855333,0,0,0,626.21,8,731509.89,18,4,17,7,True
5227426,1167,4,451,5266,359855333,0,0,0,626.17,7,730883.72,24,6,15,7,True
5298711,824,2,20,3780,359855333,0,0,0,626.13,5,730257.59,18,2,15,8,True
5823251,588,0,25,2137,359855333,0,0,0,625.81,8,729631.78,24,2,5,8,True
6247947,1015,0,10,7079,359855333,0,0,0,625.84,6,730257.62,26,1,17,9,True
6847571,1167,4,451,7371,359855333,0,0,0,625.65,7,729631.97,24,4,10,10,True
6872872,1224,4,-1,7155,359855333,0,1,0,626.25,4,729631.97,24,2,7,11,True
6961606,1167,4,25,4899,359855333,0,0,0,626.19,8,729005.78,24,2,3,12,True
6988348,343,1,-1,1076,359855333,0,1,0,626.06,4,729005.78,24,4,0,12,True
7158768,1208,4,-1,8767,359855333,0,2,0,625.8,4,729005.78,24,5,13,12,True
7383211,1249,2,20,1749,359855333,0,0,0,625.81,3,728379.97,23,4,3,1,True
7416420,130,0,20,6802,359855333,0,0,0,625.87,5,727754.1,18,4,5,1,True
7607381,184,0,-1,8767,359855333,0,1,0,626.3,4,727754.1,18,0,7,1,True
7937709,1224,4,25,3228,359855333,0,0,0,626.06,8,727128.04,24,4,12,1,True
8018034,1167,4,30,2368,359855333,0,0,0,626.14,8,726501.9,24,3,18,1,True
8166745,1208,4,451,7155,359855333,0,0,0,625.9,7,725876.0,24,1,16,2,True
8847619,342,0,10,7155,359855333,0,0,0,625.89,6,726501.89,24,2,4,2,True
8877679,184,0,25,6802,359855333,0,0,0,626.04,8,725875.85,18,1,13,3,True
8959203,1208,4,451,2368,359855333,0,0,0,626.24,7,725249.61,24,0,18,4,True
8992602,1208,4,451,4899,359855333,0,0,0,626.14,7,724623.47,24,0,2,4,True
9009986,184,0,451,6532,359855333,0,0,0,625.87,7,723997.6,18,1,8,4,True
9133847,887,2,20,6532,359855333,0,0,0,626.01,5,723371.59,27,2,5,6,True
9228891,1208,4,25,2634,359855333,0,0,0,625.89,8,722745.7,24,1,17,6,True
9441670,588,0,451,1076,359855333,0,0,0,625.85,7,722119.85,24,6,21,9,True
9460811,343,1,25,2634,359855333,0,0,0,626.18,8,721493.67,24,4,18,9,True
9588678,184,0,25,1076,359855333,0,0,0,626.18,8,720867.49,18,0,23,10,False
9599765,1208,4,-1,4056,359855333,0,1,0,626.09,4,720867.49,24,2,8,10,True
9615415,52,4,25,8767,359855333,0,0,0,626.1,8,720241.39,20,2,6,10,True
9687176,1224,4,30,2905,359855333,0,0,0,625.87,8,719615.52,24,0,7,11,True
9691090,184,0,-1,1076,359855333,0,1,0,625.76,4,719615.52,18,1,15,11,True
1002031,1449,0,25,7048,661294494,0,0,0,523.07,8,863760.93,11,6,6,1,False
1325693,422,4,30,2744,661294494,0,0,0,523.15,8,863237.78,18,5,21,1,True
1329632,302,1,10,4663,661294494,0,0,0,522.77,6,863760.55,4,5,20,2,True
1379715,1278,0,20,9602,661294494,0,0,0,522.99,5,863237.56,24,3,0,3,True
1627668,422,4,30,6783,661294494,0,0,0,523.05,8,862714.51,18,3,4,5,True
1709842,1064,0,10,2997,661294494,0,0,0,523.24,6,863237.75,11,5,12,5,True
1912287,266,2,20,6257,661294494,0,0,0,523.02,3,862714.73,6,5,16,6,True
1975744,911,3,30,9602,661294494,0,0,0,523.0,8,862191.73,18,4,6,6,True
2128255,645,0,20,2601,661294494,0,0,0,522.62,5,861669.11,24,0,21,7,True
2160069,420,4,30,3322,661294494,0,0,0,523.05,8,861146.06,18,1,16,9,True
2312358,485,1,451,2744,661294494,0,0,0,523.32,7,860622.74,5,3,9,9,True
2331747,1449,0,25,9298,661294494,0,0,0,522.91,8,860099.83,11,1,21,9,True
2404582,420,4,-1,4987,661294494,0,1,0,523.22,1,860099.83,18,2,10,9,True
2722816,422,4,25,4730,661294494,0,0,0,523.03,8,859576.8,18,0,16,10,True
2723871,787,0,10,4392,661294494,0,0,0,522.99,6,860099.79,14,5,9,12,True
2977478,1377,0,10,2997,661294494,0,0,0,522.79,6,860622.58,16,3,2,1,True
3240244,911,3,-1,6997,661294494,0,1,0,523.02,1,860622.58,18,0,18,1,True
3316111,1449,0,451,4987,661294494,0,0,0,523.11,7,860099.47,11,6,13,2,True
3408063,712,0,20,4392,661294494,0,0,0,522.89,5,859576.58,18,3,23,3,True
3661970,485,1,30,5734,661294494,0,0,0,523.02,8,859053.56,5,4,20,3,True
4356675,512,0,451,5488,661294494,0,0,0,523.18,7,858530.38,12,5,12,4,True
4508225,422,4,-1,1327,661294494,0,1,0,522.83,4,858530.38,18,2,9,4,True
4667739,911,3,451,8418,661294494,0,0,0,523.0,7,858007.38,18,1,15,5,True
4723785,911,3,451,4730,661294494,0,0,0,523.02,7,857484.36,18,0,9,6,True
5066607,420,4,451,4730,661294494,0,0,0,522.84,7,856961.52,18,0,21,7,False
5079281,662,1,10,4730,661294494,0,0,0,523.18,6,857484.7,18,3,7,8,True
5271776,420,4,-1,6469,661294494,0,1,0,523.05,4,857484.7,18,2,23,8,True
5300054,512,0,30,3322,661294494,0,0,0,523.19,8,856961.51,12,0,8,9,True
5325974,1449,0,451,1327,661294494,0,0,0,522.97,7,856438.54,11,3,6,10,True
5860839,422,4,30,8418,661294494,0,0,0,523.18,8,855915.36,18,2,20,10,True
6054352,1175,2,20,2450,661294494,0,0,0,523.0,5,855392.36,24,5,15,11,True
6217427,1455,2,20,6997,661294494,0,0,0,522.63,3,854869.73,11,3,0,11,True
6265622,420,4,451,2601,661294494,0,0,0,523.03,7,854346.7,18,4,6,12,True
6750994,1449,0,30,2744,661294494,0,0,0,523.0,8,853823.7,11,0,22,1,True
6763125,485,1,451,6097,661294494,0,0,0,522.86,7,853300.84,5,0,10,2,True
7176534,512,0,25,6257,661294494,0,0,0,523.19,8,852777.65,12,2,1,2,True
7312607,512,0,451,4663,661294494,0,0,0,522.91,7,852254.74,12,0,16,3,True
7453571,1150,0,10,2450,661294494,0,0,0,523.1,0,852777.84,15,3,7,3,True
7986586,420,4,-1,9602,661294494,0,1,0,522.92,1,852777.84,18,4,6,3,True
8259421,422,4,-1,7997,661294494,0,2,0,522.74,4,852777.84,18,0,20,4,True
8276136,168,0,10,4392,661294494,0,0,0,523.1,0,853300.94,24,1,4,4,True
8363997,1476,0,20,2744,661294494,0,0,0,522.73,5,852778.21,24,6,10,5,True
8644120,422,4,451,6783,661294494,0,0,0,523.31,7,852254.9,18,4,19,7,True
8893762,1159,0,20,2744,661294494,0,0,0,522.95,5,851731.95,15,3,9,7,True
9025727,420,4,-1,4987,661294494,0,1,0,522.85,4,851731.95,18,0,22,8,True
9239981,1449,0,451,4392,661294494,0,0,0,523.01,7,851208.94,11,2,17,8,True
9543201,422,4,-1,2601,661294494,0,1,0,522.83,1,851208.94,18,4,11,8,True
9687319,512,0,-1,1575,661294494,0,2,0,522.9,1,851208.94,12,6,8,9,True
9710603,420,4,451,5488,661294494,0,0,0,522.81,7,850686.13,18,3,1,9,True
9780022,1164,0,10,5734,661294494,0,0,0,523.13,0,851209.26,24,2,23,10,True
9882048,422,4,30,3322,661294494,0,0,0,523.14,8,850686.12,18,5,18,11,True
1007751,180,0,-1,6329,217703991,1,1,0,786.91,1,729256.0,18,0,19,2,True
1204979,509,0,-1,5681,217703991,1,2,0,786.7,4,729256.0,12,2,17,3,True
1441391,509,0,451,6466,217703991,1,0,0,786.87,7,728469.13,12,5,10,5,True
1752211,509,0,25,6782,217703991,1,0,0,787.23,8,727681.9,12,3,6,5,True
1894173,538,0,20,6782,217703991,1,0,0,786.68,3,726895.22,18,5,16,6,True
2720913,1186,2,20,8285,217703991,1,0,0,787.24,5,726107.98,24,3,15,7,True
2827732,381,4,30,1953,217703991,1,0,0,787.13,8,725320.85,25,3,0,8,True
2971719,1121,3,30,6466,217703991,1,0,0,787.01,8,724533.84,24,4,19,8,True
3152703,381,4,30,8121,217703991,1,0,0,786.9,8,723746.94,25,1,0,8,True
3321399,1446,1,10,3645,217703991,1,0,0,786.95,6,724533.89,24,1,6,8,False
3380572,509,0,451,3487,217703991,1,0,0,787.02,7,723746.87,12,5,2,8,True
3510622,1076,1,10,1147,217703991,1,0,0,787.11,6,724533.98,18,6,17,9,True
4296317,945,1,-1,4820,217703991,1,1,0,787.08,1,724533.98,24,2,3,9,True
4311816,945,1,-1,1483,217703991,1,2,0,787.1,4,724533.98,24,2,11,10,True
4335903,114,0,20,6329,217703991,1,0,0,787.03,3,723746.95,3,0,22,10,True
4848040,129,0,20,3645,217703991,1,0,0,786.92,3,722960.03,18,1,9,12,True
5019387,509,0,-1,1589,217703991,1,1,0,786.97,1,722960.03,12,2,4,12,True
5054466,381,4,451,5268,217703991,1,0,0,786.87,7,722173.16,25,2,21,1,True
5066320,509,0,-1,2049,217703991,1,1,0,787.03,4,722173.16,12,1,11,1,True
5137105,509,0,25,1257,217703991,1,0,0,786.96,8,721386.2,12,2,12,2,True
5420307,180,0,30,7200,217703991,1,0,0,787.28,8,720598.92,18,3,16,3,True
5420902,194,1,10,5268,217703991,1,0,0,787.33,6,721386.25,18,4,7,3,True
5458485,945,1,30,1589,217703991,1,0,0,786.83,8,720599.42,24,4,7,4,True
5708492,1121,3,-1,3269,217703991,1,1,0,786.81,1,720599.42,24,5,9,4,True
5803926,381,4,451,4820,217703991,1,0,0,786.97,7,719812.45,25,5,19,5,True
6173083,509,0,451,1257,217703991,1,0,0,787.02,7,719025.43,12,1,0,6,False
6323322,898,1,10,8317,217703991,1,0,0,787.09,6,719812.52,24,5,18,6,True
6376492,945,1,-1,1953,217703991,1,1,0,786.95,4,719812.52,24,0,8,6,True
6400528,945,1,451,6329,217703991,1,0,0,786.89,7,719025.63,24,0,3,7,True
6436971,727,0,20,4820,217703991,1,0,0,786.79,5,718238.84,11,1,2,7,True
6444851,945,1,451,7200,217703991,1,0,0,787.36,7,717451.48,24,4,9,7,True
6585952,1121,3,25,5268,217703991,1,0,0,787.06,8,716664.42,24,6,11,7,True
6679102,180,0,-1,8317,217703991,1,1,0,787.07,4,716664.42,18,5,2,7,True
7004625,381,4,30,6388,217703991,1,0,0,786.99,8,715877.43,25,0,17,7,True
7033147,381,4,451,1589,217703991,1,0,0,786.79,7,715090.64,25,0,2,8,True
7224311,1121,3,451,6388,217703991,1,0,0,786.93,7,714303.71,24,3,16,8,True
7266360,945,1,-1,1483,217703991,1,1,0,786.93,4,714303.71,24,0,7,10,True
7297228,1121,3,30,7681,217703991,1,0,0,787.06,8,713516.65,24,2,22,11,True
7394346,381,4,451,4820,217703991,1,0,0,786.68,7,712729.97,25,0,10,12,True
7468772,945,1,451,5681,217703991,1,0,0,786.94,7,711943.03,24,6,12,12,True
7502190,509,0,-1,6782,217703991,1,1,0,787.07,4,711943.03,12,0,6,1,True
7652621,1382,0,10,5442,217703991,1,0,0,786.83,6,712729.86,16,1,5,1,True
7671853,254,0,10,6388,217703991,1,0,0,787.01,6,713516.87,6,1,8,2,True
7714824,381,4,451,8890,217703991,1,0,0,786.76,7,712730.11,25,5,2,2,True
7733910,509,0,451,8285,217703991,1,0,0,786.98,7,711943.13,12,0,13,3,True
7977176,945,1,25,1589,217703991,1,0,0,786.81,8,711156.32,24,0,10,4,True
8209370,1312,0,10,6782,217703991,1,0,0,787.05,6,711943.37,5,4,17,4,False
8262202,945,1,30,1483,217703991,1,0,0,786.96,8,711156.41,24,5,12,5,True
8456158,180,0,451,2049,217703991,1,0,0,786.92,7,710369.49,18,3,5,5,True
8629141,509,0,25,8121,217703991,1,0,0,787.11,8,709582.38,12,0,15,7,True
8699305,1121,3,-1,8890,217703991,1,1,0,786.95,4,709582.38,24,0,22,8,True
9009515,509,0,25,3487,217703991,1,0,0,787.1,8,708795.28,12,5,23,8,False
9060539,1272,0,10,3487,217703991,1,0,0,787.12,6,709582.4,24,6,12,9,True
9387206,1140,0,20,3943,217703991,1,0,0,787.15,5,708795.25,15,2,20,9,False
9424269,509,0,451,5268,217703991,1,0,0,787.12,7,708008.13,12,3,13,10,True
9807328,180,0,451,7681,217703991,1,0,0,786.79,7,707221.34,18,4,23,10,True
9817836,381,4,30,1953,217703991,1,0,0,786.9,8,706434.44,25,4,15,10,True
9896578,945,1,451,8573,217703991,1,0,0,786.86,7,705647.58,24,1,22,11,True
1209952,1137,1,10,2308,208632978,1,0,0,1149.87,6,170962.87,24,3,17,1,True
1565747,1408,1,25,8092,208632978,1,0,0,1150.01,8,169812.86,24,1,13,1,True
1572028,1140,0,20,7066,208632978,1,0,0,1149.81,5,168663.05,15,3,10,6,True
1743226,1137,1,10,4252,208632978,1,0,0,1149.6,6,169812.65,24,1,2,7,True
1860115,1072,0,10,9332,208632978,1,0,0,1150.06,0,170962.71,18,4,7,8,True
1866633,422,4,451,7605,208632978,1,0,0,1150.03,7,169812.68,18,4,21,9,True
1955856,1454,1,10,9094,208632978,1,0,0,1149.97,6,170962.65,11,4,6,10,False
2031492,1408,1,30,8013,208632978,1,0,0,1150.02,8,169812.63,24,5,19,1,True
2070359,792,1,25,7857,208632978,1,0,0,1149.85,8,168662.78,11,3,2,2,True
2106863,37,3,30,1890,208632978,1,0,0,1150.0,8,167512.78,11,3,18,3,True
2140632,63,3,30,1270,208632978,1,0,0,1150.05,8,166362.73,20,4,9,6,True
2242854,1041,0,30,2037,208632978,1,0,0,1150.2,8,165212.53,11,1,4,2,True
2520250,792,1,451,6347,208632978,1,0,0,1150.22,7,164062.31,11,5,5,3,True
2572878,1041,0,-1,1329,208632978,1,1,0,1150.12,4,164062.31,11,3,14,5,True
2807699,422,4,-1,9208,208632978,1,2,0,1149.82,4,164062.31,18,5,1,6,False
2819998,744,4,-1,8013,208632978,1,3,1,1150.04,1,164062.31,24,0,2,6,True
1187175,1029,0,30,2022,233726460,0,0,0,970.0,8,895211.0,11,5,17,1,True
1202129,366,0,20,7911,233726460,0,0,0,969.68,5,894241.32,25,1,6,2,True
1773128,254,0,20,1592,233726460,0,0,0,970.07,5,893271.25,6,5,20,2,True
1802642,794,2,451,9786,233726460,0,0,0,970.05,7,892301.2,11,3,7,3,True
1823603,1112,1,451,6126,233726460,0,0,0,970.18,7,891331.02,0,3,4,4,True
1965620,794,2,451,9786,233726460,0,0,0,969.96,7,890361.06,11,1,18,4,True
2372632,358,4,25,3228,233726460,0,0,0,969.74,8,889391.32,24,6,6,5,True
2768519,824,2,20,1096,233726460,0,0,0,970.23,5,888421.09,18,5,18,5,True
2862495,794,2,-1,5870,233726460,0,1,0,970.0,4,888421.09,11,6,10,5,True
2919806,1029,0,30,4053,233726460,0,0,0,970.08,8,887451.01,11,4,6,6,True
2983242,358,4,30,1096,233726460,0,0,0,970.09,8,886480.92,24,5,23,6,True
3081861,106,4,30,5343,233726460,0,0,0,969.86,8,885511.06,3,5,6,6,True
3260469,199,0,10,6656,233726460,0,0,0,970.07,6,886481.13,18,2,0,7,True
3341632,1270,1,10,5888,233726460,0,0,0,970.27,6,887451.4,23,1,8,7,True
3747885,1029,0,451,2022,233726460,0,0,0,969.79,7,886481.61,11,3,20,8,True
3968512,1315,0,10,1096,233726460,0,0,0,970.1,6,887451.71,5,4,18,9,True
4309198,794,2,30,6656,233726460,0,0,0,969.83,8,886481.88,11,0,23,11,True
4527559,358,4,451,7911,233726460,0,0,0,969.86,7,885512.02,24,2,16,3,True
4683768,358,4,25,2474,233726460,0,0,0,969.94,8,884542.08,24,2,16,3,True
5054005,1029,0,451,7770,233726460,0,0,0,969.61,7,883572.47,11,6,1,4,False
5080493,106,4,451,1096,233726460,0,0,0,969.86,7,882602.61,3,4,21,4,True
5217180,358,4,451,1096,233726460,0,0,0,970.04,7,881632.57,24,6,3,4,True
5408153,645,0,10,9786,233726460,0,0,0,970.34,6,882602.91,24,2,2,4,True
5600941,1272,0,10,4053,233726460,0,0,0,970.02,6,883572.93,24,3,11,4,True
5674573,358,4,25,3228,233726460,0,0,0,969.77,8,882603.16,24,6,18,5,True
5774034,1112,1,451,9786,233726460,0,0,0,970.16,7,881633.0,0,1,18,5,True
5968818,1112,1,30,9270,233726460,0,0,0,970.15,8,880662.85,0,5,12,6,True
5999705,1112,1,-1,9270,233726460,0,1,0,969.92,1,880662.85,0,0,5,7,True
6067098,358,4,30,7770,233726460,0,0,0,969.95,8,879692.9,24,1,8,8,True
6086987,1112,1,451,7911,233726460,0,0,0,969.87,7,878723.03,0,3,13,9,True
6125324,358,4,25,2022,233726460,0,0,0,969.79,8,877753.24,24,0,7,10,True
6443042,1112,1,25,2022,233726460,0,0,0,969.96,8,876783.28,0,4,8,10,True
6457861,794,2,451,4462,233726460,0,0,0,969.95,7,875813.33,11,6,5,10,True
6593749,1029,0,25,7770,233726460,0,0,0,969.92,8,874843.41,11,5,10,12,True
6713888,580,0,20,3228,233726460,0,0,0,970.3,5,873873.11,11,5,21,1,True
7001553,106,4,30,3228,233726460,0,0,0,969.96,8,872903.15,3,5,20,3,True
7142262,1150,0,20,3228,233726460,0,0,0,969.92,3,871933.23,15,2,3,4,True
7225882,106,4,451,9030,233726460,0,0,0,970.02,7,870963.21,3,5,19,4,True
7351484,1112,1,451,4462,233726460,0,0,0,969.99,7,869993.22,0,2,0,5,True
7796911,794,2,30,3228,233726460,0,0,0,970.42,8,869022.8,11,3,6,5,True
7961426,358,4,-1,2022,233726460,0,1,0,969.73,1,869022.8,24,1,22,7,True
8025211,794,2,-1,4462,233726460,0,2,0,970.11,4,869022.8,11,0,19,8,True
8154135,106,4,451,5895,233726460,0,0,0,970.19,7,868052.61,3,1,22,8,True
8195076,794,2,25,6126,233726460,0,0,0,970.05,8,867082.56,11,1,14,8,True
8253024,106,4,25,4053,233726460,0,0,0,970.03,8,866112.53,3,0,16,8,True
8340921,794,2,25,6126,233726460,0,0,0,970.09,8,865142.44,11,3,12,9,True
8384516,794,2,25,1592,233726460,0,0,0,969.95,8,864172.49,11,1,23,10,True
8519762,1406,0,10,6126,233726460,0,0,0,969.85,6,865142.34,24,2,9,10,True
8638913,106,4,30,1096,233726460,0,0,0,970.02,8,864172.32,3,1,2,11,True
8675487,1029,0,25,3228,233726460,0,0,0,970.21,8,863202.11,11,3,12,11,True
8688387,794,2,451,5343,233726460,0,0,0,970.15,7,862231.96,11,6,19,11,True
9271426,1112,1,30,9786,233726460,0,0,0,969.91,8,861262.05,0,2,17,11,True
9864822,1029,0,25,2022,233726460,0,0,0,969.9,8,860292.15,11,2,15,11,True
1125917,675,2,30,7553,357617827,0,0,0,563.82,8,753357.18,24,6,1,1,True
1339168,16,4,451,5780,357617827,0,0,0,564.08,7,752793.1,24,3,13,1,True
1347477,14,2,-1,5780,357617827,0,1,0,564.35,4,752793.1,24,2,9,1,True
1433078,670,0,20,6383,357617827,0,0,0,563.82,5,752229.28,18,5,16,2,True
1477090,122,3,451,8050,357617827,0,0,0,564.13,7,751665.15,18,6,17,4,True
1563303,909,2,20,1318,357617827,0,0,0,564.0,5,751101.15,18,0,22,4,True
1680103,145,0,20,1888,357617827,0,0,0,564.11,3,750537.04,18,3,5,5,True
1793899,550,0,10,8990,357617827,0,0,0,564.01,0,751101.05,17,6,15,5,True
1817316,1044,0,10,7225,357617827,0,0,0,564.33,6,751665.38,11,6,6,7,True
1896191,16,4,25,7707,357617827,0,0,0,564.02,8,751101.36,24,2,22,7,True
1912879,1318,0,-1,9824,357617827,0,1,0,563.88,4,751101.36,18,5,6,7,True
1973601,1318,0,-1,8535,357617827,0,2,0,563.89,1,751101.36,18,2,0,10,True
1996990,605,0,10,8830,357617827,0,0,0,563.95,6,751665.31,24,2,0,11,True
2165307,1249,2,20,3526,357617827,0,0,0,564.38,5,751100.93,23,3,11,12,True
2229958,448,0,20,6802,357617827,0,0,0,563.97,5,750536.96,13,6,5,1,True
2363851,16,4,451,4208,357617827,0,0,0,563.92,7,749973.04,24,0,12,1,True
2454750,14,2,30,4208,357617827,0,0,0,563.97,8,749409.07,24,4,23,2,True
2661010,675,2,30,3382,357617827,0,0,0,564.0,8,748845.07,24,1,1,2,True
2744874,273,4,30,7553,357617827,0,0,0,564.0,8,748281.07,24,2,21,2,True
2988272,14,2,30,3526,357617827,0,0,0,564.0,8,747717.07,24,6,8,3,True
3324311,122,3,451,7704,357617827,0,0,0,564.12,7,747152.95,18,1,19,3,True
3352291,122,3,451,7707,357617827,0,0,0,563.74,7,746589.21,18,2,1,3,True
3467972,122,3,25,7164,357617827,0,0,0,564.21,8,746025.0,18,3,19,3,True
3544842,532,4,30,1888,357617827,0,0,0,564.02,8,745460.98,18,1,22,4,True
3708570,1036,1,10,5780,357617827,0,0,0,564.1,6,746025.08,11,4,8,5,True
4484014,16,4,451,1318,357617827,0,0,0,563.89,7,745461.19,24,6,13,6,True
4948238,376,0,10,7707,357617827,0,0,0,563.99,0,746025.18,25,1,10,6,True
5072833,16,4,30,2826,357617827,0,0,0,564.23,8,745460.95,24,1,13,7,True
5131634,273,4,30,7553,357617827,0,0,0,563.91,8,744897.04,24,4,17,7,True
5171319,532,4,451,7704,357617827,0,0,0,563.91,7,744333.13,18,5,17,7,True
5269981,122,3,451,7704,357617827,0,0,0,564.29,7,743768.84,18,0,1,8,True
5374574,532,4,451,7704,357617827,0,0,0,563.96,7,743204.88,18,6,21,9,True
5604661,14,2,25,3382,357617827,0,0,0,563.91,8,742640.97,24,3,8,10,True
5634229,532,4,30,9824,357617827,0,0,0,563.79,8,742077.18,18,6,6,10,True
6435654,273,4,-1,3382,357617827,0,1,0,563.97,4,742077.18,24,6,11,12,True
6447576,675,2,25,1384,357617827,0,0,0,564.28,8,741512.9,24,4,14,1,True
6527098,532,4,30,8535,357617827,0,0,0,563.87,8,740949.03,18,4,22,1,True
6593385,532,4,25,4208,357617827,0,0,0,563.98,8,740385.05,18,3,13,2,True
6735832,675,2,451,5190,357617827,0,0,0,564.26,7,739820.79,24,1,16,2,True
6757291,233,4,30,1202,357617827,0,0,0,563.86,8,739256.93,26,4,14,3,True
6775078,353,1,10,4704,357617827,0,0,0,564.19,6,739821.12,24,5,9,4,True
6847859,233,4,451,3382,357617827,0,0,0,563.96,7,739257.16,26,2,8,5,True
6971917,16,4,451,2826,357617827,0,0,0,564.06,7,738693.1,24,0,7,5,True
7002681,584,0,20,5190,357617827,0,0,0,563.99,3,738129.11,11,6,6,5,True
7239939,16,4,-1,7553,357617827,0,1,0,564.05,1,738129.11,24,6,7,5,True
7639727,761,2,20,7164,357617827,0,0,0,564.07,5,737565.04,24,4,2,6,True
7685761,14,2,451,1318,357617827,0,0,0,563.95,7,737001.09,24,1,21,6,True
8119234,122,3,451,5190,357617827,0,0,0,564.15,7,736436.94,18,5,3,7,True
8179086,239,1,10,7704,357617827,0,0,0,563.85,6,737000.79,26,1,1,7,True
8552727,273,4,451,3526,357617827,0,0,0,564.05,7,736436.74,24,3,4,7,True
8631281,675,2,30,3164,357617827,0,0,0,563.92,8,735872.82,24,6,9,7,True
8811342,14,2,30,8050,357617827,0,0,0,563.9,8,735308.92,24,2,10,9,True
9424922,127,1,10,8990,357617827,0,0,0,564.08,0,735873.0,18,3,15,9,True
9748726,233,4,-1,2826,357617827,0,1,0,564.07,4,735873.0,26,4,18,11,True
1407354,1250,1,10,8830,113666551,0,0,0,1027.14,6,581901.14,23,6,2,1,True
1555008,755,3,451,9702,113666551,0,0,0,1027.0,7,580874.14,24,0,7,1,True
1791362,755,3,25,2521,113666551,0,0,0,1026.86,8,579847.28,24,0,18,1,True
2075710,900,1,10,4660,113666551,0,0,0,1026.99,6,580874.27,24,3,17,1,True
2263692,1379,3,451,8803,113666551,0,0,0,1027.15,7,579847.12,16,4,18,2,True
2319878,1205,0,10,5743,113666551,0,0,0,1026.94,6,580874.06,24,0,16,2,True
2355860,428,0,10,2988,113666551,0,0,0,1026.93,6,581900.99,18,5,8,3,True
2506047,297,0,10,6424,113666551,0,0,0,1027.09,0,582928.08,4,2,11,3,True
2512631,1399,0,20,6424,113666551,0,0,0,1027.0,3,581901.08,24,6,2,3,True
2536334,1076,1,10,5297,113666551,0,0,0,1026.91,6,582927.99,18,4,8,3,True
2704207,1281,3,451,6735,113666551,0,0,0,1027.07,7,581900.92,24,1,10,4,True
2916909,1388,1,30,6735,113666551,0,0,0,1027.33,8,580873.59,24,5,4,5,True
3168089,950,0,10,4620,113666551,0,0,0,1027.08,6,581900.67,24,5,17,6,True
3373887,860,1,10,6424,113666551,0,0,0,1027.09,6,582927.76,24,3,10,6,True
3392207,350,0,20,2521,113666551,0,0,0,1027.13,5,581900.63,24,1,7,6,True
3534589,1281,3,-1,1242,113666551,0,1,0,1027.13,4,581900.63,24,5,17,6,True
3580914,1281,3,451,5297,113666551,0,0,0,1026.95,7,580873.68,24,5,20,6,True
3704136,260,0,20,4598,113666551,0,0,0,1027.03,5,579846.65,6,6,10,6,True
3713771,919,4,451,7065,113666551,0,0,0,1027.19,7,578819.46,18,1,15,7,True
3815322,1388,1,25,9939,113666551,0,0,0,1026.93,8,577792.53,24,2,2,8,True
3941729,755,3,25,1035,113666551,0,0,0,1027.11,8,576765.42,24,5,21,8,True
4191834,1014,1,10,9702,113666551,0,0,0,1027.07,6,577792.49,26,3,18,9,True
4217836,776,3,25,6735,113666551,0,0,0,1027.16,8,576765.33,14,1,11,9,True
4866614,327,0,20,1035,113666551,0,0,0,1026.94,5,575738.39,11,2,13,9,True
4928618,776,3,25,9702,113666551,0,0,0,1027.0,8,574711.39,14,1,4,10,True
4933374,1379,3,451,1242,113666551,0,0,0,1026.88,7,573684.51,16,5,12,10,True
5486981,919,4,25,6735,113666551,0,0,0,1026.88,8,572657.63,18,4,8,11,True
5501142,524,1,10,9427,113666551,0,0,0,1026.97,0,573684.6,18,2,10,2,True
5514586,776,3,30,6424,113666551,0,0,0,1027.11,8,572657.49,14,5,23,3,True
5686962,755,3,451,8600,113666551,0,0,0,1026.74,7,571630.75,24,3,19,3,True
5739789,776,3,-1,8600,113666551,0,1,0,1027.03,1,571630.75,14,4,16,3,True
5745450,738,2,20,5743,113666551,0,0,0,1027.03,5,570603.72,11,0,2,5,True
5773832,865,0,10,8830,113666551,0,0,0,1026.92,6,571630.64,24,6,10,6,True
6030826,1388,1,30,2988,113666551,0,0,0,1027.05,8,570603.59,24,0,4,7,True
6045986,919,4,25,1035,113666551,0,0,0,1027.23,8,569576.36,18,1,16,7,True
6293013,1281,3,30,4660,113666551,0,0,0,1027.03,8,568549.33,24,3,5,7,True
6388054,1281,3,451,2988,113666551,0,0,0,1026.88,7,567522.45,24,3,17,7,True
7571311,919,4,451,2521,113666551,0,0,0,1027.24,7,566495.21,18,6,4,8,True
7876776,776,3,25,4475,113666551,0,0,0,1027.07,8,565468.14,14,4,6,9,True
7930641,1377,0,20,9427,113666551,0,0,0,1027.1,3,564441.04,16,6,2,10,False
8006275,919,4,451,5261,113666551,0,0,0,1026.82,7,563414.22,18,1,20,11,True
8036410,866,0,20,2374,113666551,0,0,0,1027.04,3,562387.18,24,2,23,12,True
8183118,703,0,10,1242,113666551,0,0,0,1027.09,0,563414.27,18,0,14,1,True
8599682,1170,0,10,3511,113666551,0,0,0,1026.9,0,564441.17,24,3,22,2,False
8621027,919,4,-1,8803,113666551,0,1,0,1027.09,1,564441.17,18,2,22,2,True
8799701,1123,2,20,2988,113666551,0,0,0,1026.99,5,563414.18,24,2,12,3,True
8851763,1325,0,20,1242,113666551,0,0,0,1026.9,5,562387.28,18,2,13,3,True
8923009,776,3,-1,5743,113666551,0,1,0,1027.11,4,562387.28,14,0,0,4,True
9293679,919,4,25,8600,113666551,0,0,0,1026.63,8,561360.65,18,4,20,4,True
9361425,605,0,10,2521,113666551,0,0,0,1027.09,6,562387.74,24,6,1,6,True
9398234,1169,0,451,4475,113666551,0,0,0,1026.62,7,561361.12,24,4,6,6,False
9424718,1379,3,-1,8830,113666551,0,1,0,1026.92,4,561361.12,16,6,15,6,True
9587474,96,0,20,8600,113666551,0,0,0,1026.87,5,560334.25,1,0,0,7,True
9663115,1388,1,-1,8830,113666551,0,1,0,1026.76,4,560334.25,24,3,12,7,True
9714291,1281,3,451,3511,113666551,0,0,0,1027.11,7,559307.14,24,3,13,7,True
9821851,755,3,451,9702,113666551,0,0,0,1027.42,7,558279.72,24,3,1,8,True
9958933,919,4,451,4660,113666551,0,0,0,1026.88,7,557252.84,18,3,23,10,True
1014615,117,1,10,4717,765571752,0,0,0,1157.09,6,213957.09,18,2,16,2,True
1015926,1247,0,25,7852,765571752,0,0,0,1157.22,8,212799.87,23,3,17,2,True
1076184,1449,0,10,8603,765571752,0,0,0,1157.02,0,213956.89,11,0,0,3,True
1235914,417,3,451,1096,765571752,0,0,0,1157.02,7,212799.87,18,4,17,3,True
1389989,1247,0,25,1096,765571752,0,0,0,1156.94,8,211642.93,23,6,13,7,True
1505806,1086,0,20,1241,765571752,0,0,0,1156.96,5,210485.97,18,3,7,8,True
1842960,413,4,25,7852,765571752,0,0,0,1156.94,8,209329.03,18,6,8,9,True
2026962,1184,4,451,9558,765571752,0,0,0,1156.96,7,208172.07,24,3,23,10,False
2094604,424,1,10,4418,765571752,0,0,0,1157.1,6,209329.17,18,4,8,10,True
2374475,413,4,25,4717,765571752,0,0,0,1157.07,8,208172.1,18,1,20,11,True
2441257,711,2,20,8603,765571752,0,0,0,1156.99,5,207015.11,18,0,21,11,True
2830367,703,0,-1,9558,765571752,0,1,0,1156.89,4,207015.11,18,4,21,11,True
2859353,1247,0,451,9733,765571752,0,0,0,1157.04,7,205858.07,23,3,5,12,True
3084652,27,0,25,7013,765571752,0,0,0,1156.92,8,204701.15,11,0,13,12,False
3232705,1247,0,451,4418,765571752,0,0,0,1156.81,7,203544.34,23,3,16,2,True
3566240,825,2,451,2486,765571752,0,0,0,1156.65,7,202387.69,18,5,5,2,True
4397740,27,0,-1,3214,765571752,0,1,0,1156.88,4,202387.69,11,4,16,3,True
4413635,27,0,451,7013,765571752,0,0,0,1157.21,7,201230.48,11,0,4,3,True
4456722,701,2,20,4418,765571752,0,0,0,1157.21,3,200073.27,18,3,1,4,True
4539020,1247,0,451,8603,765571752,0,0,0,1156.9,7,198916.37,23,2,3,5,True
4693507,142,4,25,2486,765571752,0,0,0,1156.8,8,197759.57,18,3,17,5,True
4745732,1184,4,30,1294,765571752,0,0,0,1156.94,8,196602.63,24,5,0,6,True
4768905,142,4,-1,8603,765571752,0,1,0,1156.93,1,196602.63,18,5,13,6,True
4769226,27,0,30,7013,765571752,0,0,0,1156.91,8,195445.72,11,0,13,6,True
4937839,1247,0,451,7058,765571752,0,0,0,1156.85,7,194288.87,23,1,15,6,True
5254470,703,0,25,1294,765571752,0,0,0,1156.91,8,193131.96,18,3,9,7,True
5601004,413,4,30,1074,765571752,0,0,0,1156.96,8,191975.0,18,0,2,7,True
5666754,1247,0,25,2486,765571752,0,0,0,1156.88,8,190818.12,23,6,14,7,True
5862684,417,3,451,8603,765571752,0,0,0,1157.06,7,189661.06,18,0,12,9,True
5954027,866,0,20,9558,765571752,0,0,0,1157.07,3,188503.99,24,6,15,10,True
6164115,703,0,25,7013,765571752,0,0,0,1157.0,8,187346.99,18,2,12,10,True
6172792,1255,0,20,1096,765571752,0,0,0,1156.98,3,186190.01,23,3,13,10,True
6218770,1247,0,30,5113,765571752,0,0,0,1157.19,8,185032.82,23,0,21,11,True
6254512,1184,4,451,3214,765571752,0,0,0,1156.79,7,183876.03,24,6,0,11,False
6336212,1377,0,20,9940,765571752,0,0,0,1156.93,5,182719.1,16,4,10,12,True
6504331,413,4,451,9733,765571752,0,0,0,1156.94,7,181562.16,18,0,22,12,True
7249829,703,0,30,9940,765571752,0,0,0,1156.91,8,180405.25,18,1,22,1,True
7833053,825,2,25,5113,765571752,0,0,0,1157.15,8,179248.1,18,6,5,1,True
8071768,739,1,10,7013,765571752,0,0,0,1156.67,6,180404.77,24,5,20,1,True
8117514,463,1,10,1241,765571752,0,0,0,1157.18,0,181561.95,13,2,20,1,True
8123422,417,3,451,4418,765571752,0,0,0,1156.61,7,180405.34,18,1,15,2,True
8233273,1025,1,10,9558,765571752,0,0,0,1157.25,6,181562.59,11,4,11,2,True
8400389,825,2,451,7058,765571752,0,0,0,1156.95,7,180405.64,18,3,2,2,True
8543836,1314,2,20,3214,765571752,0,0,0,1156.9,5,179248.74,5,2,7,3,True
8576129,1338,0,20,5766,765571752,0,0,0,1156.86,3,178091.88,18,6,18,4,True
8696299,1247,0,30,4717,765571752,0,0,0,1157.1,8,176934.78,23,4,8,4,True
8715855,27,0,30,4418,765571752,0,0,0,1157.21,8,175777.57,11,1,18,4,False
9031699,1090,0,10,2486,765571752,0,0,0,1157.28,6,176934.85,18,6,0,5,True
9050921,1184,4,30,7013,765571752,0,0,0,1157.21,8,175777.64,24,0,0,6,True
9058751,27,0,30,1241,765571752,0,0,0,1156.92,8,174620.72,11,6,18,6,True
9248386,703,0,-1,4717,765571752,0,1,0,1157.04,4,174620.72,18,3,15,8,False
9284203,1485,0,10,7013,765571752,0,0,0,1156.95,6,175777.67,24,3,23,9,True
9300726,879,1,10,2486,765571752,0,0,0,1157.05,6,176934.72,27,2,22,10,True
9514372,825,2,451,4717,765571752,0,0,0,1157.46,7,175777.26,18,2,3,10,True
9920142,29,0,10,5113,765571752,0,0,0,1156.92,6,176934.18,11,4,4,11,True
1134967,1305,2,20,3788,858165343,1,0,0,432.97,3,167463.03,5,5,14,3,True
1177407,802,2,30,9312,858165343,1,0,0,433.15,8,167029.88,11,4,9,5,False
1446233,1155,0,10,3335,858165343,1,0,0,433.07,0,167462.95,15,1,6,10,True
1599083,448,0,451,2990,858165343,1,0,0,432.86,7,167030.09,13,0,2,11,True
1754073,802,2,30,5949,858165343,1,0,0,433.11,8,166596.98,11,0,1,12,True
1844662,1152,0,20,5949,858165343,1,0,0,432.81,5,166164.17,15,2,12,2,True
2393263,712,0,20,5840,858165343,1,0,0,432.66,3,165731.51,18,1,6,5,True
2408803,802,2,451,3788,858165343,1,0,0,433.16,7,165298.35,11,1,19,6,True
2414450,448,0,25,5949,858165343,1,0,0,432.93,8,164865.42,13,6,14,7,True
2663226,448,0,451,1280,858165343,1,0,0,433.14,7,164432.28,13,2,8,8,True
2863861,708,2,20,5949,858165343,1,0,0,433.02,3,163999.26,18,3,7,8,True
2926211,596,3,-1,9312,858165343,1,1,0,433.02,4,163999.26,24,6,1,9,True
2973820,176,3,30,9312,858165343,1,0,0,432.9,8,163566.36,24,0,7,10,True
3001395,802,2,30,1859,858165343,1,0,0,433.06,8,163133.3,11,6,7,11,False
3057723,612,4,30,6041,858165343,1,0,0,432.78,8,162700.52,11,4,14,11,True
3134659,842,2,20,6041,858165343,1,0,0,433.04,5,162267.48,5,0,1,12,True
3470406,1354,0,10,9312,858165343,1,0,0,432.9,6,162700.38,24,5,6,12,True
3512658,596,3,451,1280,858165343,1,0,0,433.16,7,162267.22,24,4,6,12,True
3664681,802,2,451,3335,858165343,1,0,0,433.13,7,161834.09,11,3,14,12,True
3778539,1425,0,20,1280,858165343,1,0,0,433.03,5,161401.06,24,5,0,1,True
3828947,286,1,10,5840,858165343,1,0,0,432.95,6,161834.01,24,1,21,4,True
4007664,333,1,10,6647,858165343,1,0,0,433.2,0,162267.21,11,0,16,5,True
4427310,1210,0,10,5840,858165343,1,0,0,433.01,0,162700.22,24,3,17,7,True
4793921,612,4,-1,9333,858165343,1,1,0,432.99,4,162700.22,11,6,16,8,True
4913878,596,3,451,1859,858165343,1,0,0,433.25,7,162266.97,24,2,10,8,True
5327529,448,0,25,3335,858165343,1,0,0,433.14,8,161833.83,13,3,12,8,True
5390432,126,1,451,6041,858165343,1,0,0,433.16,7,161400.67,18,2,2,9,True
5492201,176,3,451,9974,858165343,1,0,0,433.05,7,160967.62,24,0,19,9,True
5527006,612,4,-1,3788,858165343,1,1,0,432.82,4,160967.62,11,5,23,10,True
5693462,802,2,-1,5840,858165343,1,2,0,433.02,4,160967.62,11,1,22,10,True
6265347,596,3,-1,3335,858165343,1,3,1,433.14,4,160967.62,24,5,6,10,False
1005398,53,0,20,1322,730611846,0,0,0,525.64,3,807910.36,20,3,19,1,True
1268311,257,1,10,1322,730611846,0,0,0,526.1,6,808436.46,6,6,6,1,True
1322682,1180,1,10,5246,730611846,0,0,0,526.04,6,808962.5,24,5,20,2,True
1325747,120,4,25,9664,730611846,0,0,0,526.0,8,808436.5,18,2,1,3,True
1411840,120,4,451,6957,730611846,0,0,0,526.0,7,807910.5,18,6,11,3,True
1438824,120,4,25,1733,730611846,0,0,0,526.03,8,807384.47,18,1,22,4,True
1537680,254,0,25,5275,730611846,0,0,0,526.09,8,806858.38,6,2,3,4,True
1856185,245,4,451,2204,730611846,0,0,0,525.84,7,806332.54,26,5,14,4,True
1887234,120,4,25,7290,730611846,0,0,0,525.94,8,805806.6,18,0,18,5,True
1934834,998,0,20,1490,730611846,0,0,0,525.9,3,805280.7,26,6,10,6,True
1962929,245,4,-1,3880,730611846,0,1,0,526.02,4,805280.7,26,2,4,6,True
2040839,254,0,30,1452,730611846,0,0,0,526.11,8,804754.59,6,2,12,7,True
2231515,254,0,30,6512,730611846,0,0,0,525.81,8,804228.78,6,4,4,7,True
2408136,726,0,30,6957,730611846,0,0,0,526.08,8,803702.7,11,0,1,7,True
2542170,120,4,30,6957,730611846,0,0,0,526.07,8,803176.63,18,6,14,9,True
2872903,990,0,451,4690,730611846,0,0,0,525.83,7,802650.8,22,2,0,10,True
3047758,254,0,-1,6441,730611846,0,1,0,526.06,4,802650.8,6,6,20,10,True
3081261,120,4,-1,6869,730611846,0,2,0,525.88,1,802650.8,18,0,15,10,True
3153188,275,0,10,5246,730611846,0,0,0,526.01,6,803176.81,24,1,4,10,True
3422895,767,0,10,5275,730611846,0,0,0,526.12,6,803702.93,14,2,21,11,True
3791050,120,4,30,1490,730611846,0,0,0,526.03,8,803176.9,18,3,1,12,True
3893974,245,4,451,6421,730611846,0,0,0,526.19,7,802650.71,26,4,14,1,True
4005495,990,0,30,6327,730611846,0,0,0,526.24,8,802124.47,22,3,22,1,True
4130643,929,0,10,9845,730611846,0,0,0,526.21,6,802650.68,18,2,14,2,True
4218759,990,0,451,6935,730611846,0,0,0,526.13,7,802124.55,22,3,5,2,True
4317407,990,0,30,2634,730611846,0,0,0,526.04,8,801598.51,22,6,19,3,True
4565575,428,0,20,1490,730611846,0,0,0,525.79,3,801072.72,18,0,1,3,True
4696571,572,0,20,7488,730611846,0,0,0,525.92,5,800546.8,11,4,5,5,True
5154157,245,4,451,9617,730611846,0,0,0,525.86,7,800020.94,26,6,1,6,False
5316733,120,4,-1,1452,730611846,0,1,0,525.9,1,800020.94,18,0,7,6,True
5732641,245,4,30,5277,730611846,0,0,0,526.14,8,799494.8,26,4,16,6,True
6081658,726,0,451,2204,730611846,0,0,0,526.05,7,798968.75,11,1,4,7,True
6152905,865,0,10,5275,730611846,0,0,0,525.98,0,799494.73,24,6,7,7,True
6314127,245,4,25,5275,730611846,0,0,0,526.07,8,798968.66,26,0,7,9,True
6629814,211,0,20,9906,730611846,0,0,0,525.84,5,798442.82,9,6,5,10,True
6838593,245,4,30,1490,730611846,0,0,0,526.12,8,797916.7,26,6,9,10,True
6936208,120,4,-1,6441,730611846,0,1,0,526.3,1,797916.7,18,4,12,1,True
7301963,990,0,451,7109,730611846,0,0,0,525.86,7,797390.84,22,4,9,2,True
7595218,757,0,10,8384,730611846,0,0,0,525.8,0,797916.64,24,6,7,2,True
7710807,990,0,451,2204,730611846,0,0,0,526.03,7,797390.61,22,2,8,3,True
7794652,245,4,451,6441,730611846,0,0,0,525.94,7,796864.67,26,6,6,3,True
7828663,990,0,30,9617,730611846,0,0,0,525.99,8,796338.68,22,6,1,4,True
7877421,990,0,451,6327,730611846,0,0,0,526.12,7,795812.56,22,0,3,4,True
7952801,726,0,30,6935,730611846,0,0,0,526.1,8,795286.46,11,2,8,5,True
8175761,245,4,451,1322,730611846,0,0,0,525.98,7,794760.48,26,2,19,5,True
8219382,1132,0,10,5902,730611846,0,0,0,525.82,6,795286.3,24,5,2,5,True
8469512,726,0,-1,5277,730611846,0,1,0,525.97,1,795286.3,11,5,5,5,True
8580318,538,0,10,7290,730611846,0,0,0,526.08,6,795812.38,18,0,16,6,True
8704880,120,4,-1,6869,730611846,0,1,0,525.88,1,795812.38,18,6,1,6,True
8876085,990,0,25,7109,730611846,0,0,0,525.93,8,795286.45,22,1,9,7,True
9125787,990,0,451,1322,730611846,0,0,0,526.01,7,794760.44,22,4,2,8,True
9485630,726,0,451,9617,730611846,0,0,0,526.04,7,794234.4,11,2,7,8,True
9612956,726,0,451,5902,730611846,0,0,0,525.99,7,793708.41,11,2,14,10,True
9656549,297,0,20,7290,730611846,0,0,0,525.95,3,793182.46,4,5,12,11,True
9982938,990,0,25,2204,730611846,0,0,0,525.95,8,792656.51,22,0,9,11,True
1083879,216,4,25,1612,684764952,1,0,0,928.14,8,806425.86,9,0,0,1,True
1146627,607,2,451,1612,684764952,1,0,0,928.13,7,805497.73,24,3,20,1,True
1316580,91,4,25,9428,684764952,1,0,0,928.31,8,804569.42,1,5,4,1,True
1327601,880,1,10,1612,684764952,1,0,0,927.85,6,805497.27,27,5,15,2,True
1560988,91,4,30,6187,684764952,1,0,0,927.97,8,804569.3,1,5,6,2,True
1882135,607,2,30,4423,684764952,1,0,0,927.87,8,803641.43,24,6,19,2,True
1911886,1164,0,10,6187,684764952,1,0,0,928.05,0,804569.48,24,5,13,4,True
1990997,91,4,451,8462,684764952,1,0,0,927.98,7,803641.5,1,5,11,5,True
1994595,216,4,451,7746,684764952,1,0,0,927.98,7,802713.52,9,6,7,5,True
2139274,1212,0,451,7899,684764952,1,0,0,928.15,7,801785.37,24,3,1,7,True
2400525,1220,3,-1,3719,684764952,1,1,0,928.11,4,801785.37,24,4,5,7,True
2495029,1212,0,30,7507,684764952,1,0,0,928.2,8,800857.17,24,6,22,7,True
2747136,607,2,-1,4423,684764952,1,1,0,928.2,4,800857.17,24,2,16,9,True
2851207,1220,3,451,1772,684764952,1,0,0,928.02,7,799929.15,24,6,7,9,True
3056504,607,2,-1,3896,684764952,1,1,0,928.0,4,799929.15,24,6,9,10,True
3112925,1220,3,451,2865,684764952,1,0,0,928.16,7,799000.99,24,1,0,12,True
3198735,1220,3,-1,2730,684764952,1,1,0,927.94,4,799000.99,24,1,3,12,True
3357732,607,2,30,4312,684764952,1,0,0,928.0,8,798072.99,24,0,15,12,True
3719475,607,2,-1,5637,684764952,1,1,0,928.0,1,798072.99,24,4,3,2,True
3941602,607,2,-1,2098,684764952,1,2,0,927.82,1,798072.99,24,5,16,4,True
4148915,607,2,451,6187,684764952,1,0,0,927.86,7,797145.13,24,6,7,4,True
4240963,216,4,451,9243,684764952,1,0,0,928.09,7,796217.04,9,2,22,5,True
4478481,1212,0,30,7507,684764952,1,0,0,927.96,8,795289.08,24,3,1,5,True
4480623,216,4,451,4312,684764952,1,0,0,928.17,7,794360.91,9,5,9,5,True
4529699,465,0,20,8978,684764952,1,0,0,928.04,5,793432.87,13,1,4,5,True
4723760,607,2,451,9243,684764952,1,0,0,927.82,7,792505.05,24,4,19,6,True
4757131,1212,0,451,6187,684764952,1,0,0,927.87,7,791577.18,24,2,1,7,True
5002327,91,4,-1,9428,684764952,1,1,0,928.19,4,791577.18,1,5,16,7,True
5196085,918,2,20,7899,684764952,1,0,0,928.12,5,790649.06,18,4,15,7,True
5649492,1220,3,25,6187,684764952,1,0,0,927.83,8,789721.23,24,3,6,8,True
6091680,215,0,20,5894,684764952,1,0,0,928.04,5,788793.19,9,1,6,9,True
6150524,1220,3,25,5637,684764952,1,0,0,927.9,8,787865.29,24,1,22,9,True
6219954,607,2,451,1167,684764952,1,0,0,927.96,7,786937.33,24,1,2,10,True
6322668,1220,3,451,9428,684764952,1,0,0,927.86,7,786009.47,24,3,2,11,True
6570045,607,2,451,7169,684764952,1,0,0,927.9,7,785081.57,24,4,15,12,True
7397301,1093,0,10,1772,684764952,1,0,0,928.15,6,786009.72,18,1,5,12,True
7510863,216,4,30,2143,684764952,1,0,0,927.95,8,785081.77,9,2,10,12,True
7515713,1212,0,25,6427,684764952,1,0,0,927.95,8,784153.82,24,3,18,2,True
7523916,607,2,-1,7746,684764952,1,1,0,927.81,1,784153.82,24,2,18,2,True
7670623,1035,0,20,5894,684764952,1,0,0,928.11,3,783225.71,11,5,0,2,True
7717210,1000,0,10,2730,684764952,1,0,0,927.75,0,784153.46,26,3,7,2,True
7720544,1212,0,30,2730,684764952,1,0,0,927.94,8,783225.52,24,5,16,3,True
7774661,1212,0,-1,4423,684764952,1,1,0,927.91,4,783225.52,24,2,0,3,True
8731504,1247,0,20,7507,684764952,1,0,0,928.06,3,782297.46,23,3,19,3,True
9334317,91,4,451,2098,684764952,1,0,0,928.08,7,781369.38,1,3,12,4,True
9344035,216,4,451,7507,684764952,1,0,0,927.98,7,780441.4,9,2,2,4,True
9508778,1212,0,-1,3896,684764952,1,1,0,927.84,4,780441.4,24,0,1,4,True
9534386,607,2,30,2730,684764952,1,0,0,927.98,8,779513.42,24,0,3,5,True
9541292,257,1,10,2098,684764952,1,0,0,927.95,6,780441.37,6,3,22,5,True
9541363,607,2,-1,7746,684764952,1,1,0,928.15,4,780441.37,24,6,13,7,True
9622882,1212,0,30,9243,684764952,1,0,0,927.92,8,779513.45,24,0,19,11,True
9918921,216,4,30,1612,684764952,1,0,0,928.34,8,778585.11,9,3,13,11,True
1029680,224,3,30,3203,459364252,0,0,0,908.05,8,750293.95,26,4,5,1,True
1030856,142,4,451,9525,459364252,0,0,0,907.88,7,749386.07,18,1,8,1,True
1347442,142,4,25,5827,459364252,0,0,0,908.05,8,748478.02,18,6,14,1,True
1363904,142,4,30,5827,459364252,0,0,0,908.23,8,747569.79,18,3,16,3,True
1375038,142,4,451,9525,459364252,0,0,0,907.87,7,746661.92,18,2,6,4,True
1399795,1207,4,25,5827,459364252,0,0,0,907.83,8,745754.09,24,1,3,5,True
1550969,811,0,451,8338,459364252,0,0,0,908.06,7,744846.03,18,5,9,5,True
1649166,1205,0,-1,2931,459364252,0,1,0,907.84,1,744846.03,24,3,21,9,True
2161690,68,0,20,4273,459364252,0,0,0,908.24,5,743937.79,20,3,2,9,False
2242172,811,0,25,3714,459364252,0,0,0,907.94,8,743029.85,18,3,9,11,True
2446491,909,2,20,3808,459364252,0,0,0,907.74,3,742122.11,18,2,12,11,True
2796980,1207,4,25,3879,459364252,0,0,0,907.76,8,741214.35,24,5,3,12,True
3062164,811,0,-1,8338,459364252,0,1,0,908.0,4,741214.35,18,5,20,12,False
3080031,1124,0,10,6534,459364252,0,0,0,908.06,0,742122.41,24,6,15,2,True
3086183,269,0,20,2931,459364252,0,0,0,907.97,3,741214.44,24,0,3,2,False
3714373,142,4,25,5827,459364252,0,0,0,908.02,8,740306.42,18,5,23,3,True
3837014,955,4,451,3808,459364252,0,0,0,907.98,7,739398.44,13,6,17,3,True
4018041,471,0,20,5351,459364252,0,0,0,908.09,5,738490.35,5,1,15,3,True
4128342,1065,0,20,5351,459364252,0,0,0,908.06,5,737582.29,11,2,8,3,True
4305705,512,0,30,9049,459364252,0,0,0,908.05,8,736674.24,12,4,7,3,True
4315629,142,4,30,3808,459364252,0,0,0,907.96,8,735766.28,18,6,17,4,True
4597824,512,0,-1,3879,459364252,0,1,0,907.94,4,735766.28,12,1,19,5,True
4633464,28,1,10,3203,459364252,0,0,0,907.91,6,736674.19,11,4,7,6,True
4835279,1207,4,-1,5827,459364252,0,1,0,907.81,1,736674.19,24,6,20,6,True
4893981,224,3,451,5351,459364252,0,0,0,907.93,7,735766.26,26,0,0,6,True
5089588,257,1,451,9049,459364252,0,0,0,907.99,7,734858.27,6,2,6,6,True
5125533,512,0,25,1044,459364252,0,0,0,907.83,8,733950.44,12,5,22,8,True
5139703,142,4,-1,6534,459364252,0,1,0,907.93,4,733950.44,18,6,2,8,True
5207696,142,4,25,8338,459364252,0,0,0,908.03,8,733042.41,18,6,10,8,True
5244730,811,0,-1,7357,459364252,0,1,0,908.14,4,733042.41,18,4,14,10,True
5850330,257,1,25,3879,459364252,0,0,0,908.09,8,732134.32,6,6,12,10,True
5862127,1027,0,10,3203,459364252,0,0,0,907.94,6,733042.26,11,5,22,1,True
6113900,257,1,451,5351,459364252,0,0,0,907.99,7,732134.27,6,2,0,1,True
6259523,955,4,451,6534,459364252,0,0,0,907.98,7,731226.29,13,0,0,2,True
6717367,1207,4,451,2180,459364252,0,0,0,907.91,7,730318.38,24,3,13,2,True
7035073,512,0,451,7153,459364252,0,0,0,907.87,7,729410.51,12,6,7,3,True
7077881,811,0,451,3714,459364252,0,0,0,907.97,7,728502.54,18,6,12,5,True
7186948,512,0,25,3879,459364252,0,0,0,907.99,8,727594.55,12,1,10,5,True
7251161,1205,0,25,8833,459364252,0,0,0,907.98,8,726686.57,24,2,2,5,True
7257129,1205,0,-1,2931,459364252,0,1,0,907.89,1,726686.57,24,4,6,6,False
7528721,512,0,25,3808,459364252,0,0,0,907.82,8,725778.75,12,1,11,6,True
7560127,1207,4,451,3808,459364252,0,0,0,907.91,7,724870.84,24,4,14,6,True
7768869,1207,4,25,1044,459364252,0,0,0,908.01,8,723962.83,24,3,10,7,False
7777422,897,0,10,2180,459364252,0,0,0,908.01,0,724870.84,24,4,16,7,True
7813756,811,0,-1,1044,459364252,0,1,0,908.04,4,724870.84,18,6,16,7,True
7832883,1207,4,25,2180,459364252,0,0,0,908.28,8,723962.56,24,2,17,7,True
7853319,955,4,30,2931,459364252,0,0,0,908.05,8,723054.51,13,4,8,7,True
7858415,883,0,20,7357,459364252,0,0,0,907.85,5,722146.66,24,0,22,7,True
7888700,1207,4,30,8507,459364252,0,0,0,908.23,8,721238.43,24,3,22,8,True
7992120,811,0,451,4273,459364252,0,0,0,907.92,7,720330.51,18,2,2,8,True
8538556,512,0,451,2180,459364252,0,0,0,907.85,7,719422.66,12,5,21,8,True
8603362,883,0,20,8338,459364252,0,0,0,907.94,3,718514.72,24,0,9,9,True
8735151,512,0,30,8833,459364252,0,0,0,907.75,8,717606.97,12,2,3,9,True
8849137,1207,4,25,8009,459364252,0,0,0,907.92,8,716699.05,24,5,2,9,True
9335069,512,0,451,9049,459364252,0,0,0,908.1,7,715790.95,12,0,7,10,True
9996619,512,0,30,4273,459364252,0,0,0,907.95,8,714883.0,12,5,8,11,True
1016665,685,3,451,4883,853086289,1,0,0,907.65,7,446920.35,24,0,23,1,True
1136633,1258,3,30,4218,853086289,1,0,0,907.86,8,446012.49,23,5,12,1,True
1197670,848,2,30,9410,853086289,1,0,0,907.87,8,445104.62,5,6,5,1,False
1334240,490,4,451,6128,853086289,1,0,0,907.91,7,444196.71,12,3,14,2,True
1354250,509,0,10,5113,853086289,1,0,0,907.77,6,445104.48,12,3,2,3,True
1461808,679,0,20,9410,853086289,1,0,0,907.86,3,444196.62,24,2,1,4,True
1656859,1226,2,-1,2835,853086289,1,1,0,908.19,4,444196.62,18,3,23,5,True
1824827,424,1,10,4290,853086289,1,0,0,907.91,0,445104.53,18,6,6,5,True
1980606,316,2,20,9624,853086289,1,0,0,908.08,3,444196.45,4,6,9,5,True
2081828,1064,0,20,5315,853086289,1,0,0,908.15,3,443288.3,11,2,6,7,True
2274346,917,0,20,7169,853086289,1,0,0,908.05,5,442380.25,18,1,18,7,True
2381581,1110,0,20,4290,853086289,1,0,0,908.04,5,441472.21,0,0,16,9,True
2397020,53,0,10,2835,853086289,1,0,0,907.91,6,442380.12,20,2,21,9,True
2483268,1258,3,451,9180,853086289,1,0,0,908.15,7,441471.97,23,4,7,11,True
2534551,1201,0,20,7169,853086289,1,0,0,908.14,5,440563.83,24,6,1,1,True
2664865,1258,3,451,4218,853086289,1,0,0,908.03,7,439655.8,23,4,14,2,True
3587128,1460,2,20,5315,853086289,1,0,0,907.83,3,438747.97,11,3,7,2,True
3740885,916,0,10,5834,853086289,1,0,0,907.93,0,439655.9,18,6,12,3,True
3849783,685,3,451,4290,853086289,1,0,0,908.02,7,438747.88,24,6,15,4,True
4953166,1258,3,30,4290,853086289,1,0,0,907.96,8,437839.92,23,6,3,4,True
5318336,1226,2,30,4290,853086289,1,0,0,908.05,8,436931.87,18,1,0,4,True
5327431,1226,2,30,4290,853086289,1,0,0,907.89,8,436023.98,18,3,12,6,True
5523525,490,4,25,9624,853086289,1,0,0,907.99,8,435115.99,12,5,16,6,True
5809570,115,2,20,1031,853086289,1,0,0,907.99,5,434208.0,3,0,22,7,True
5997585,685,3,-1,4218,853086289,1,1,0,907.66,4,434208.0,24,3,0,7,True
6176813,1226,2,25,2835,853086289,1,0,0,907.72,8,433300.28,18,5,19,7,True
6568098,130,0,20,1031,853086289,1,0,0,908.22,5,432392.06,18,6,11,8,True
7012455,685,3,25,4218,853086289,1,0,0,908.11,8,431483.95,24,3,18,8,True
7097225,159,2,20,9624,853086289,1,0,0,908.02,3,430575.93,24,2,18,8,True
7255513,685,3,30,1157,853086289,1,0,0,908.07,8,429667.86,24,2,12,8,True
7309398,1258,3,-1,5315,853086289,1,1,0,908.1,4,429667.86,23,1,0,9,True
7363502,1150,0,10,7169,853086289,1,0,0,907.82,0,430575.68,15,3,20,9,True
7497280,757,0,10,3512,853086289,1,0,0,907.86,6,431483.54,24,2,19,9,True
7843434,1258,3,25,3512,853086289,1,0,0,908.03,8,430575.51,23,2,0,9,True
7863135,685,3,451,9624,853086289,1,0,0,908.05,7,429667.46,24,6,15,10,True
8103447,627,0,20,9180,853086289,1,0,0,908.01,5,428759.45,11,0,13,10,True
8457289,1258,3,30,3512,853086289,1,0,0,908.2,8,427851.25,23,1,1,10,True
8475764,1258,3,-1,3512,853086289,1,1,0,907.81,4,427851.25,23,6,12,11,True
8490424,490,4,-1,6128,853086289,1,2,0,907.95,1,427851.25,12,3,16,11,True
8614606,490,4,451,6179,853086289,1,0,0,907.98,7,426943.27,12,4,1,11,True
8739948,490,4,25,6128,853086289,1,0,0,907.95,8,426035.32,12,0,14,12,True
8776814,848,2,25,7169,853086289,1,0,0,907.83,8,425127.49,5,1,3,1,True
8867663,1226,2,30,2835,853086289,1,0,0,907.53,8,424219.96,18,1,21,1,True
8903621,1169,0,20,2835,853086289,1,0,0,908.06,3,423311.9,24,4,4,3,True
8906688,1258,3,-1,1157,853086289,1,1,0,908.23,1,423311.9,23,4,15,4,True
9082790,685,3,-1,3512,853086289,1,2,0,908.07,1,423311.9,24,3,1,5,True
9327873,1233,0,20,7169,853086289,1,0,0,908.31,5,422403.59,18,5,4,6,True
9338417,129,0,20,5113,853086289,1,0,0,908.34,5,421495.25,18,6,15,9,True
9367340,490,4,25,6128,853086289,1,0,0,908.12,8,420587.13,12,0,15,9,True
9719714,685,3,30,4290,853086289,1,0,0,908.08,8,419679.05,24,6,4,9,True
1053972,889,0,20,8431,132879023,0,0,0,481.99,5,449462.01,27,0,2,2,True
1314380,398,0,451,9253,132879023,0,0,0,482.09,7,448979.92,10,2,18,2,True
1432548,611,0,10,8340,132879023,0,0,0,481.89,6,449461.81,11,3,11,2,True
1462330,605,0,451,8492,132879023,0,0,0,481.98,7,448979.83,24,5,15,2,True
1698666,398,0,451,9330,132879023,0,0,0,482.07,7,448497.76,10,3,16,3,True
1711747,104,4,-1,9962,132879023,0,1,0,482.03,4,448497.76,3,2,18,5,True
1716992,1273,0,20,5847,132879023,0,0,0,481.94,5,448015.82,24,1,5,5,False
1914071,1400,3,30,8340,132879023,0,0,0,481.75,8,447534.07,24,5,23,5,True
2470371,1400,3,25,9330,132879023,0,0,0,481.95,8,447052.12,24,4,19,7,True
2730487,605,0,451,8340,132879023,0,0,0,482.04,7,446570.08,24,0,22,9,True
2887280,1400,3,451,6670,132879023,0,0,0,481.85,7,446088.23,24,1,8,9,True
2918458,728,1,25,2695,132879023,0,0,0,482.29,8,445605.94,11,5,1,9,True
3021461,728,1,30,4763,132879023,0,0,0,481.62,8,445124.32,11,5,5,9,True
3033977,480,0,20,9330,132879023,0,0,0,481.93,3,444642.39,5,5,16,10,True
3274706,81,0,10,6056,132879023,0,0,0,481.67,0,445124.06,1,6,9,11,True
3366286,1352,1,10,8431,132879023,0,0,0,482.01,6,445606.07,24,6,8,11,True
3703763,328,0,20,6670,132879023,0,0,0,482.11,3,445123.96,11,3,17,12,True
3721296,759,0,20,4763,132879023,0,0,0,482.37,5,444641.59,24,4,14,12,True
3809824,104,4,25,5847,132879023,0,0,0,482.04,8,444159.55,3,4,23,12,True
3846871,200,0,20,4394,132879023,0,0,0,482.13,3,443677.42,9,4,4,12,True
3891581,728,1,30,8431,132879023,0,0,0,481.82,8,443195.6,11,5,18,1,True
3958791,728,1,30,6670,132879023,0,0,0,481.8,8,442713.8,11,1,16,2,True
4005518,104,4,30,7133,132879023,0,0,0,481.79,8,442232.01,3,3,11,2,True
4061092,104,4,25,8492,132879023,0,0,0,482.2,8,441749.81,3,4,20,3,True
4154530,353,1,30,8431,132879023,0,0,0,481.94,8,441267.87,24,1,8,3,True
4213836,76,0,10,8070,132879023,0,0,0,482.09,0,441749.96,20,1,9,3,True
4729997,1400,3,25,4394,132879023,0,0,0,482.03,8,441267.93,24,1,0,4,True
5137536,104,4,30,6670,132879023,0,0,0,481.83,8,440786.1,3,2,11,4,True
5322966,353,1,-1,8492,132879023,0,1,0,482.01,1,440786.1,24,5,8,5,True
5338992,1023,2,20,9253,132879023,0,0,0,481.89,5,440304.21,11,3,5,6,True
5686612,1400,3,-1,8431,132879023,0,1,0,482.13,1,440304.21,24,0,19,6,True
5707607,398,0,25,4394,132879023,0,0,0,482.15,8,439822.06,10,3,11,8,True
5739530,531,0,10,8340,132879023,0,0,0,481.65,0,440303.71,18,1,1,9,True
5843057,728,1,30,5847,132879023,0,0,0,481.95,8,439821.76,11,2,15,10,True
5995850,511,1,10,6056,132879023,0,0,0,482.05,6,440303.81,12,6,5,11,True
6615899,104,4,30,7133,132879023,0,0,0,481.98,8,439821.83,3,3,23,11,True
6819678,605,0,-1,8492,132879023,0,1,0,481.98,4,439821.83,24,5,4,12,True
7018916,728,1,25,3653,132879023,0,0,0,481.98,8,439339.85,11,4,1,12,True
7268705,398,0,-1,5847,132879023,0,1,0,482.31,4,439339.85,10,2,13,1,True
7380359,353,1,451,6670,132879023,0,0,0,481.96,7,438857.89,24,4,20,1,True
7469707,104,4,30,8340,132879023,0,0,0,482.08,8,438375.81,3,3,16,2,False
7709802,398,0,25,9962,132879023,0,0,0,482.0,8,437893.81,10,6,2,3,True
7779058,728,1,-1,8492,132879023,0,1,0,481.74,4,437893.81,11,1,4,4,True
8373353,605,0,25,4394,132879023,0,0,0,482.08,8,437411.73,24,2,2,4,True
8400904,312,0,20,3653,132879023,0,0,0,481.88,5,436929.85,4,2,20,5,True
8481028,341,0,20,8070,132879023,0,0,0,481.81,5,436448.04,24,0,0,5,True
8536085,398,0,-1,9330,132879023,0,1,0,481.96,4,436448.04,10,0,10,5,True
8540533,728,1,451,6056,132879023,0,0,0,482.02,7,435966.02,11,3,0,6,True
8574267,353,1,451,6670,132879023,0,0,0,481.7,7,435484.32,24,3,5,7,True
8711871,398,0,25,6670,132879023,0,0,0,482.37,8,435001.95,10,4,11,7,True
8794395,353,1,25,6056,132879023,0,0,0,481.81,8,434520.14,24,0,13,8,True
9150470,1110,0,10,6670,132879023,0,0,0,482.12,6,435002.26,0,5,18,8,True
9314673,353,1,-1,9962,132879023,0,1,0,481.98,1,435002.26,24,4,19,9,True
9362553,297,0,20,2695,132879023,0,0,0,482.13,5,434520.13,4,1,20,10,True
9493737,104,4,451,3653,132879023,0,0,0,481.99,7,434038.14,3,2,14,10,True
9508407,325,0,10,8431,132879023,0,0,0,482.02,6,434520.16,11,3,17,10,True
9928879,353,1,30,8340,132879023,0,0,0,481.85,8,434038.31,24,6,16,11,True
1115524,736,1,10,1849,598141203,1,0,0,627.67,6,271894.67,11,2,1,1,True
1117505,335,4,-1,8503,598141203,1,1,0,628.16,4,271894.67,11,4,22,1,True
1151294,963,4,30,2509,598141203,1,0,0,628.03,8,271266.64,13,1,22,2,False
1690847,1114,1,10,2151,598141203,1,0,0,627.98,0,271894.62,0,2,13,2,True
1952662,963,4,-1,2509,598141203,1,1,0,627.87,4,271894.62,13,5,10,3,True
2122033,549,1,10,1690,598141203,1,0,0,627.95,0,272522.57,17,6,15,3,True
2301399,309,0,30,3436,598141203,1,0,0,628.28,8,271894.29,4,1,20,5,True
2470770,89,3,-1,1849,598141203,1,1,0,627.94,1,271894.29,1,2,21,5,False
2708283,309,0,-1,8503,598141203,1,2,0,627.92,1,271894.29,4,1,5,5,True
2739744,147,0,10,8503,598141203,1,0,0,628.0,0,272522.29,18,4,19,5,True
3325091,522,0,451,1690,598141203,1,0,0,628.13,7,271894.16,18,3,5,5,True
3325678,1156,1,-1,2151,598141203,1,1,0,628.06,1,271894.16,15,2,14,5,False
3395431,522,0,451,1086,598141203,1,0,0,628.06,7,271266.1,18,5,6,6,True
3737331,20,0,10,1849,598141203,1,0,0,627.88,0,271893.98,24,5,7,7,True
3827803,309,0,30,7063,598141203,1,0,0,627.99,8,271265.99,4,5,11,7,True
4178710,309,0,451,4022,598141203,1,0,0,627.96,7,270638.03,4,4,18,8,True
4316441,783,0,20,3517,598141203,1,0,0,627.71,3,270010.32,14,1,21,11,True
4347628,89,3,451,5344,598141203,1,0,0,628.05,7,269382.27,1,0,7,12,True
4510903,95,2,20,7063,598141203,1,0,0,627.94,3,268754.33,1,2,23,12,True
4650993,728,1,10,2151,598141203,1,0,0,627.7,6,269382.03,11,4,19,12,True
4715965,1064,0,25,5344,598141203,1,0,0,627.81,8,268754.22,11,6,6,1,True
4931271,963,4,451,1086,598141203,1,0,0,627.81,7,268126.41,13,2,16,2,True
5020977,1459,1,10,1849,598141203,1,0,0,628.09,6,268754.5,11,3,8,2,True
5183765,522,0,25,7063,598141203,1,0,0,627.9,8,268126.6,18,5,21,2,True
5256654,459,1,10,5344,598141203,1,0,0,628.03,6,268754.63,13,0,18,3,True
5309579,147,0,20,1849,598141203,1,0,0,628.16,5,268126.47,18,1,0,3,True
5750048,522,0,25,1086,598141203,1,0,0,627.98,8,267498.49,18,6,2,3,True
5766259,335,4,451,4022,598141203,1,0,0,627.95,7,266870.54,11,3,11,3,True
5833210,89,3,451,2722,598141203,1,0,0,627.77,7,266242.77,1,0,15,3,True
5837882,373,1,-1,2722,598141203,1,1,0,627.85,4,266242.77,25,6,14,4,True
5895898,309,0,30,4022,598141203,1,0,0,627.93,8,265614.84,4,1,8,4,True
5934056,373,1,25,7038,598141203,1,0,0,627.94,8,264986.9,25,4,17,5,True
6176768,183,1,10,3517,598141203,1,0,0,627.98,0,265614.88,18,6,14,5,True
6291180,471,0,20,2722,598141203,1,0,0,628.16,5,264986.72,5,3,1,6,True
6370489,410,4,451,1849,598141203,1,0,0,627.94,7,264358.78,18,1,4,6,True
6394364,335,4,25,1086,598141203,1,0,0,627.93,8,263730.85,11,1,19,6,True
6607300,410,4,25,1086,598141203,1,0,0,628.22,8,263102.63,18,6,5,9,True
6651201,373,1,25,1849,598141203,1,0,0,628.07,8,262474.56,25,6,23,10,True
6660756,373,1,451,3517,598141203,1,0,0,628.19,7,261846.37,25,2,20,10,True
7216875,522,0,30,3517,598141203,1,0,0,628.06,8,261218.31,18,3,3,10,True
7350887,89,3,30,3517,598141203,1,0,0,628.11,8,260590.2,1,2,19,10,True
7372282,410,4,25,4022,598141203,1,0,0,627.99,8,259962.21,18,4,3,11,True
7468679,1064,0,-1,2722,598141203,1,1,0,627.97,4,259962.21,11,5,15,12,True
7546952,309,0,451,7063,598141203,1,0,0,628.05,7,259334.16,4,1,18,12,True
7736117,373,1,-1,7880,598141203,1,1,0,628.13,1,259334.16,25,3,23,1,True
7739971,98,0,10,7822,598141203,1,0,0,628.07,0,259962.23,3,1,1,2,True
7934486,537,0,20,4022,598141203,1,0,0,628.08,5,259334.15,18,1,11,4,True
8125631,335,4,25,7822,598141203,1,0,0,628.14,8,258706.01,11,2,10,5,True
8247120,234,0,10,1849,598141203,1,0,0,628.11,6,259334.12,26,4,5,6,True
8654651,963,4,-1,2151,598141203,1,1,0,627.89,4,259334.12,13,3,16,7,True
8703315,1227,0,20,8503,598141203,1,0,0,628.15,3,258705.97,18,1,15,8,True
8797358,309,0,451,2509,598141203,1,0,0,627.8,7,258078.17,4,2,1,8,True
8802854,1064,0,30,5344,598141203,1,0,0,627.99,8,257450.18,11,1,14,9,True
8888044,522,0,451,8503,598141203,1,0,0,628.08,7,256822.1,18,4,22,9,True
9319956,587,2,20,3517,598141203,1,0,0,627.96,5,256194.14,24,5,4,9,True
9586007,734,0,20,5344,598141203,1,0,0,628.0,5,255566.14,11,3,7,10,True
9667510,448,0,20,2151,598141203,1,0,0,628.02,3,254938.12,13,3,1,10,True
9947607,842,2,20,1690,598141203,1,0,0,628.1,5,254310.02,5,1,11,11,True
9980415,963,4,451,1690,598141203,1,0,0,628.07,7,253681.95,13,0,14,11,True
1023557,776,3,451,4519,168141784,1,0,0,917.01,7,869413.99,14,5,3,1,True
1255910,776,3,451,9792,168141784,1,0,0,917.25,7,868496.74,14,3,5,1,True
1259700,807,0,20,6903,168141784,1,0,0,916.78,5,867579.96,11,1,20,3,True
1343734,1270,1,10,4587,168141784,1,0,0,917.17,6,868497.13,23,4,12,3,True
1469667,669,2,-1,9875,168141784,1,1,0,917.12,4,868497.13,18,5,14,3,True
1624384,669,2,25,3798,168141784,1,0,0,916.96,8,867580.17,18,3,1,3,True
1760512,178,4,25,9875,168141784,1,0,0,916.66,8,866663.51,24,6,14,4,True
1867814,669,2,30,7410,168141784,1,0,0,916.71,8,865746.8,18,3,3,4,True
2265547,642,0,20,9433,168141784,1,0,0,917.24,5,864829.56,24,5,6,5,True
2341006,776,3,25,1221,168141784,1,0,0,917.1,8,863912.46,14,1,3,5,True
2663828,695,2,20,1221,168141784,1,0,0,916.97,5,862995.49,24,2,18,6,True
2955215,776,3,-1,2250,168141784,1,1,0,916.83,4,862995.49,14,3,21,7,True
3174413,1069,1,10,9401,168141784,1,0,0,916.95,0,863912.44,18,6,2,8,True
3197578,366,0,20,4587,168141784,1,0,0,917.07,3,862995.37,25,2,22,8,True
3470685,1063,0,20,8517,168141784,1,0,0,917.16,3,862078.21,11,4,8,9,True
3528696,669,2,25,5492,168141784,1,0,0,917.13,8,861161.08,18,4,0,10,True
3617406,776,3,451,9401,168141784,1,0,0,916.79,7,860244.29,14,0,8,11,True
3650472,776,3,30,6808,168141784,1,0,0,916.88,8,859327.41,14,1,1,11,True
3994644,669,2,451,4519,168141784,1,0,0,917.25,7,858410.16,18,6,9,11,True
4293263,889,0,-1,3950,168141784,1,1,0,916.95,4,858410.16,27,6,2,1,True
4424243,178,4,451,6808,168141784,1,0,0,917.23,7,857492.93,24,5,23,2,True
4468081,572,0,10,6766,168141784,1,0,0,917.17,6,858410.1,11,4,19,2,True
4872122,669,2,451,6903,168141784,1,0,0,917.11,7,857492.99,18,6,1,2,True
4882524,1422,1,10,9433,168141784,1,0,0,917.25,6,858410.24,24,2,16,3,True
5053408,1169,0,20,4597,168141784,1,0,0,916.91,5,857493.33,24,5,14,3,True
5237181,889,0,25,9433,168141784,1,0,0,916.75,8,856576.58,27,1,4,3,True
5718201,669,2,451,3798,168141784,1,0,0,917.1,7,855659.48,18,6,3,4,True
5728090,816,0,20,8517,168141784,1,0,0,916.88,3,854742.6,18,6,3,4,True
5745714,980,1,10,6502,168141784,1,0,0,917.16,6,855659.76,22,3,22,6,True
5876286,776,3,451,7410,168141784,1,0,0,917.02,7,854742.74,14,6,7,6,True
6125543,776,3,25,5492,168141784,1,0,0,917.03,8,853825.71,14,1,7,7,True
6276563,889,0,451,3798,168141784,1,0,0,916.69,7,852909.02,27,0,7,8,True
6431749,669,2,451,2250,168141784,1,0,0,916.85,7,851992.17,18,0,8,8,True
6554845,669,2,451,8517,168141784,1,0,0,916.81,7,851075.36,18,4,4,9,True
6955281,1110,0,20,6808,168141784,1,0,0,917.09,5,850158.27,0,3,15,10,True
7122200,889,0,451,6766,168141784,1,0,0,917.12,7,849241.15,27,3,16,10,False
7214061,178,4,-1,6903,168141784,1,1,0,917.24,4,849241.15,24,4,3,10,True
7227905,776,3,25,5492,168141784,1,0,0,916.97,8,848324.18,14,2,1,12,False
7364772,178,4,30,6766,168141784,1,0,0,917.02,8,847407.16,24,1,8,2,True
7425019,889,0,-1,6808,168141784,1,1,0,916.94,1,847407.16,27,5,4,3,True
8118211,1264,0,10,2250,168141784,1,0,0,917.13,0,848324.29,23,3,3,4,True
8694117,100,4,451,9401,168141784,1,0,0,917.13,7,847407.16,3,3,3,4,True
8787605,443,2,20,4587,168141784,1,0,0,916.99,5,846490.17,24,3,11,6,True
8796414,909,2,20,1221,168141784,1,0,0,917.01,5,845573.16,18,2,19,7,True
8840877,178,4,30,1221,168141784,1,0,0,917.16,8,844656.0,24,0,7,7,True
8929055,1246,0,20,6903,168141784,1,0,0,916.97,5,843739.03,23,0,16,7,True
9526772,889,0,451,8517,168141784,1,0,0,917.18,7,842821.85,27,5,5,7,True
9660044,100,4,30,3874,168141784,1,0,0,917.03,8,841904.82,3,3,14,8,True
9661032,100,4,25,2648,168141784,1,0,0,917.19,8,840987.63,3,1,6,8,True
9676347,100,4,25,4587,168141784,1,0,0,917.13,8,840070.5,3,5,2,11,True
9818749,652,0,10,9875,168141784,1,0,0,917.08,0,840987.58,24,0,3,11,True
9854259,96,0,20,4519,168141784,1,0,0,917.03,5,840070.55,1,2,2,11,True
1150882,857,1,30,7021,468316659,1,0,0,477.9,8,397398.1,24,3,17,1,True
1241467,83,4,30,5104,468316659,1,0,0,477.88,8,396920.22,1,0,18,2,True
1250867,857,1,25,2602,468316659,1,0,0,477.76,8,396442.46,24,4,8,3,True
1356142,579,0,20,2960,468316659,1,0,0,478.0,5,395964.46,11,6,13,3,True
1586847,83,4,25,4726,468316659,1,0,0,478.04,8,395486.42,1,6,7,4,True
1645948,715,0,451,3805,468316659,1,0,0,478.05,7,395008.37,18,3,21,4,True
2263201,961,4,451,9961,468316659,1,0,0,477.88,7,394530.49,13,4,3,4,True
2725919,83,4,-1,9449,468316659,1,1,0,478.03,4,394530.49,1,0,6,4,True
2758588,83,4,451,7578,468316659,1,0,0,478.03,7,394052.46,1,2,15,5,True
3122678,1180,1,10,9645,468316659,1,0,0,477.99,0,394530.45,24,5,5,6,True
3255514,961,4,-1,7021,468316659,1,1,0,477.83,1,394530.45,13,5,18,6,True
3541869,1255,0,-1,3654,468316659,1,2,0,478.21,4,394530.45,23,3,15,8,True
3618543,97,0,20,7021,468316659,1,0,0,478.1,3,394052.35,3,5,9,8,False
3652786,857,1,-1,8449,468316659,1,1,0,477.95,1,394052.35,24,4,23,9,True
3796301,1436,0,10,9449,468316659,1,0,0,478.15,0,394530.5,24,6,4,9,True
3898519,207,4,25,9961,468316659,1,0,0,478.09,8,394052.41,9,5,14,10,True
3989565,1488,0,10,7578,468316659,1,0,0,478.15,6,394530.56,24,6,14,12,True
4168001,937,0,10,2960,468316659,1,0,0,478.06,6,395008.62,24,1,13,12,True
4440997,715,0,451,4726,468316659,1,0,0,477.84,7,394530.78,18,4,13,1,True
4569430,1255,0,451,9386,468316659,1,0,0,478.26,7,394052.52,23,2,22,1,True
4834784,961,4,-1,2602,468316659,1,1,0,478.13,4,394052.52,13,5,13,3,True
4906191,1410,1,10,2602,468316659,1,0,0,477.93,6,394530.45,24,3,22,3,True
4972494,1411,0,10,3090,468316659,1,0,0,477.94,6,395008.39,24,0,13,4,False
5056085,83,4,30,7021,468316659,1,0,0,477.76,8,394530.63,1,1,23,4,True
5123790,1219,1,451,2602,468316659,1,0,0,477.96,7,394052.67,24,4,16,4,True
5210254,961,4,30,2602,468316659,1,0,0,478.01,8,393574.66,13,5,17,5,True
5261186,715,0,25,3737,468316659,1,0,0,477.87,8,393096.79,18,4,21,5,True
5628921,715,0,451,3805,468316659,1,0,0,478.26,7,392618.53,18,4,12,6,True
5909221,177,4,30,7531,468316659,1,0,0,477.93,8,392140.6,24,3,9,6,True
6001747,83,4,-1,4726,468316659,1,1,0,478.01,4,392140.6,1,6,7,7,True
6165365,123,0,20,6590,468316659,1,0,0,478.11,3,391662.49,18,1,5,8,True
6221179,207,4,30,4794,468316659,1,0,0,477.83,8,391184.66,9,2,13,8,True
6230822,177,4,451,2979,468316659,1,0,0,477.83,7,390706.83,24,0,14,9,True
6283884,1219,1,25,6526,468316659,1,0,0,478.0,8,390228.83,24,3,4,9,True
6323918,642,0,20,7021,468316659,1,0,0,478.3,5,389750.53,24,0,10,10,True
6979114,207,4,30,6139,468316659,1,0,0,477.87,8,389272.66,9,2,14,10,True
7018817,83,4,25,3805,468316659,1,0,0,478.0,8,388794.66,1,6,11,10,True
7044268,1219,1,451,1516,468316659,1,0,0,477.77,7,388316.89,24,2,18,11,True
7096715,1219,1,30,6526,468316659,1,0,0,477.85,8,387839.04,24,2,3,11,True
7335216,207,4,25,1516,468316659,1,0,0,478.18,8,387360.86,9,4,8,12,True
7412916,1434,0,20,4314,468316659,1,0,0,478.03,5,386882.83,24,2,11,2,True
7439192,715,0,-1,1516,468316659,1,1,0,478.08,4,386882.83,18,1,22,3,True
7503593,783,0,20,7531,468316659,1,0,0,478.19,3,386404.64,14,3,7,4,True
7523686,961,4,451,9449,468316659,1,0,0,478.04,7,385926.6,13,6,12,4,True
7881295,882,0,10,9449,468316659,1,0,0,477.9,6,386404.5,27,2,18,4,True
8266676,27,0,20,6590,468316659,1,0,0,477.72,5,385926.78,11,6,18,4,True
8363734,177,4,25,8449,468316659,1,0,0,477.88,8,385448.9,24,6,23,5,True
8571595,177,4,451,6768,468316659,1,0,0,478.12,7,384970.78,24,3,2,5,True
8761417,728,1,10,7283,468316659,1,0,0,478.01,6,385448.79,11,3,23,6,True
8832023,961,4,25,3737,468316659,1,0,0,478.3,8,384970.49,13,4,20,6,True
8912943,1219,1,451,2594,468316659,1,0,0,478.07,7,384492.42,24,4,21,6,True
8963678,199,0,10,6768,468316659,1,0,0,477.56,6,384969.98,18,0,12,7,True
9090400,1227,0,20,8868,468316659,1,0,0,477.88,3,384492.1,18,0,23,9,True
9139815,715,0,30,9645,468316659,1,0,0,478.04,8,384014.06,18,3,11,9,True
9432307,1303,0,20,4099,468316659,1,0,0,478.01,5,383536.05,5,2,11,9,True
9520289,715,0,-1,4794,468316659,1,1,0,477.84,1,383536.05,18,0,20,9,True
9668667,857,1,25,7283,468316659,1,0,0,477.83,8,383058.22,24,4,21,10,True
9888537,857,1,-1,7531,468316659,1,1,0,478.05,1,383058.22,24,3,10,10,True
9934021,200,0,10,7374,468316659,1,0,0,478.17,6,383536.39,9,5,9,11,False
1035745,1447,4,30,1347,809031486,1,0,0,510.17,8,881798.83,24,5,9,1,True
1168003,147,0,20,7303,809031486,1,0,0,509.93,5,881288.9,18,5,0,2,True
1550211,160,0,451,1347,809031486,1,0,0,509.55,7,880779.35,24,0,4,2,False
1599912,876,4,451,4475,809031486,1,0,0,510.21,7,880269.14,24,6,22,2,False
1610286,329,1,30,8895,809031486,1,0,0,509.99,8,879759.15,11,4,6,3,True
1871670,234,0,20,3377,809031486,1,0,0,509.95,5,879249.2,26,5,18,3,True
1966834,1403,4,25,4854,809031486,1,0,0,509.89,8,878739.31,24,5,14,4,False
2483308,294,3,25,9087,809031486,1,0,0,509.96,8,878229.35,4,5,9,5,True
2608089,1361,2,20,5115,809031486,1,0,0,510.02,3,877719.33,16,6,12,5,True
2843424,1239,1,10,2888,809031486,1,0,0,509.96,0,878229.29,18,6,23,6,True
3088895,1403,4,451,5690,809031486,1,0,0,509.97,7,877719.32,24,3,18,6,True
3645234,448,0,10,4674,809031486,1,0,0,510.02,6,878229.34,13,1,19,6,False
3788161,1403,4,25,3015,809031486,1,0,0,510.0,8,877719.34,24,0,8,7,False
3829380,1403,4,451,5115,809031486,1,0,0,509.97,7,877209.37,24,3,7,8,True
4616423,1403,4,25,7303,809031486,1,0,0,510.13,8,876699.24,24,5,12,10,True
4727491,1403,4,-1,1347,809031486,1,1,0,509.88,4,876699.24,24,1,20,10,True
4756909,327,0,20,7303,809031486,1,0,0,510.14,3,876189.1,11,1,1,10,False
5059961,302,1,10,5690,809031486,1,0,0,509.89,6,876698.99,4,4,17,11,True
5181746,1447,4,451,9087,809031486,1,0,0,509.93,7,876189.06,24,1,19,11,True
5259147,876,4,451,4854,809031486,1,0,0,510.03,7,875679.03,24,0,13,12,True
5279378,1121,3,30,5115,809031486,1,0,0,510.19,8,875168.84,24,4,16,1,True
5338885,876,4,451,1079,809031486,1,0,0,510.03,7,874658.81,24,6,8,1,True
5584388,876,4,451,6491,809031486,1,0,0,510.11,7,874148.7,24,5,9,2,True
5629098,1447,4,451,2888,809031486,1,0,0,510.06,7,873638.64,24,6,13,2,True
5798677,876,4,30,4475,809031486,1,0,0,510.04,8,873128.6,24,2,4,3,True
5996878,876,4,451,8164,809031486,1,0,0,510.12,7,872618.48,24,5,0,4,False
6044089,160,0,30,9087,809031486,1,0,0,510.03,8,872108.45,24,6,11,4,False
6048289,294,3,25,5690,809031486,1,0,0,510.11,8,871598.34,4,4,13,4,True
6065679,1246,0,20,1079,809031486,1,0,0,510.13,5,871088.21,23,1,0,4,False
6144053,1403,4,451,4475,809031486,1,0,0,509.78,7,870578.43,24,2,1,5,True
6286481,876,4,25,2888,809031486,1,0,0,509.77,8,870068.66,24,1,21,6,True
6379878,1447,4,25,1347,809031486,1,0,0,510.22,8,869558.44,24,6,1,6,True
6428253,876,4,30,7300,809031486,1,0,0,510.23,8,869048.21,24,5,12,6,True
6660708,1447,4,451,6527,809031486,1,0,0,510.08,7,868538.13,24,0,6,6,True
6780572,876,4,-1,7300,809031486,1,1,0,510.01,4,868538.13,24,5,5,7,True
7310702,876,4,25,1347,809031486,1,0,0,509.88,8,868028.25,24,0,14,8,True
7314473,350,0,20,8164,809031486,1,0,0,509.91,3,867518.34,24,4,12,8,True
7907114,294,3,-1,1347,809031486,1,1,0,509.89,4,867518.34,4,5,6,11,True
8003669,1092,1,10,4475,809031486,1,0,0,509.81,6,868028.15,18,6,17,12,True
8082353,114,0,10,9226,809031486,1,0,0,510.02,0,868538.17,3,4,5,12,True
8251000,876,4,451,8085,809031486,1,0,0,510.06,7,868028.11,24,4,23,2,True
8257513,1447,4,30,3377,809031486,1,0,0,510.09,8,867518.02,24,0,23,2,True
8333854,1403,4,30,9087,809031486,1,0,0,509.97,8,867008.05,24,3,13,3,True
8450340,1121,3,451,4674,809031486,1,0,0,509.82,7,866498.23,24,2,20,4,True
8840604,1447,4,451,1079,809031486,1,0,0,510.35,7,865987.88,24,6,18,7,True
8887952,329,1,30,1347,809031486,1,0,0,509.78,8,865478.1,11,5,17,8,True
8939274,329,1,25,4674,809031486,1,0,0,510.03,8,864968.07,11,2,7,9,True
8964510,427,2,20,8895,809031486,1,0,0,510.09,5,864457.98,18,1,1,9,True
9241566,1169,0,20,1079,809031486,1,0,0,509.98,3,863948.0,24,0,9,9,True
9344869,1121,3,-1,8085,809031486,1,1,0,509.72,1,863948.0,24,5,5,9,True
9491121,385,1,10,9226,809031486,1,0,0,510.06,6,864458.06,25,5,15,9,True
1352779,1111,0,20,6924,224623414,0,0,0,101.73,5,301569.27,0,2,7,1,True
1420982,930,3,451,7819,224623414,0,0,0,102.15,7,301467.12,18,0,2,1,True
1640836,118,2,451,2641,224623414,0,0,0,101.94,7,301365.18,18,4,13,1,True
2031337,976,4,25,5460,224623414,0,0,0,101.81,8,301263.37,22,6,14,1,True
2065416,1249,2,20,6924,224623414,0,0,0,101.85,3,301161.52,23,1,4,2,True
2130443,1094,0,10,2077,224623414,0,0,0,101.99,6,301263.51,0,0,10,2,True
2144509,1029,0,451,5726,224623414,0,0,0,102.22,7,301161.29,11,0,7,2,True
2198345,1265,4,30,4822,224623414,0,0,0,101.9,8,301059.39,23,6,6,2,True
2538729,594,0,20,7819,224623414,0,0,0,102.14,5,300957.25,24,1,18,3,True
2589765,129,0,10,1400,224623414,0,0,0,102.17,0,301059.42,18,2,21,3,True
2681333,1265,4,25,6924,224623414,0,0,0,102.11,8,300957.31,23,2,23,3,True
2724307,1406,0,10,1070,224623414,0,0,0,102.24,6,301059.55,24,6,21,3,True
2725020,1029,0,-1,2742,224623414,0,1,0,102.17,1,301059.55,11,4,11,4,True
2828157,895,0,30,9780,224623414,0,0,0,102.12,8,300957.43,24,0,0,4,True
2853634,895,0,-1,7819,224623414,0,1,0,102.06,1,300957.43,24,1,10,4,True
2979701,1303,0,20,6446,224623414,0,0,0,101.96,5,300855.47,5,6,12,5,True
3296809,950,0,20,2373,224623414,0,0,0,101.96,3,300753.51,24,3,10,6,True
3298244,1092,1,-1,2641,224623414,0,1,0,101.89,4,300753.51,18,3,22,6,True
3366423,366,0,20,1724,224623414,0,0,0,102.04,3,300651.47,25,5,1,6,True
3372644,930,3,-1,1070,224623414,0,1,0,102.02,4,300651.47,18,3,22,6,True
3612471,1092,1,451,4822,224623414,0,0,0,101.9,7,300549.57,18,0,11,7,True
3627365,509,0,20,5293,224623414,0,0,0,102.07,5,300447.5,12,3,0,7,True
3812081,463,1,10,2373,224623414,0,0,0,101.79,0,300549.29,13,0,18,8,True
3864567,976,4,30,5293,224623414,0,0,0,102.01,8,300447.28,22,4,17,9,True
3916578,518,2,20,2373,224623414,0,0,0,102.2,3,300345.08,18,6,18,9,False
4096511,129,0,30,6446,224623414,0,0,0,101.88,8,300243.2,18,6,23,11,True
4193647,687,0,10,2641,224623414,0,0,0,102.11,6,300345.31,24,5,16,11,True
4400524,144,1,10,2742,224623414,0,0,0,101.99,6,300447.3,18,0,13,11,False
5155177,1092,1,25,1438,224623414,0,0,0,102.17,8,300345.13,18,3,0,11,True
5501256,1092,1,451,6924,224623414,0,0,0,101.73,7,300243.4,18,3,6,1,True
5565374,1150,0,30,8624,224623414,0,0,0,101.91,8,300141.49,15,4,17,1,True
5612150,129,0,451,5293,224623414,0,0,0,101.98,7,300039.51,18,2,4,3,True
5657904,1029,0,30,5726,224623414,0,0,0,101.88,8,299937.63,11,2,4,3,True
6031397,1488,0,10,3605,224623414,0,0,0,101.93,6,300039.56,24,6,18,4,True
6133904,895,0,451,1724,224623414,0,0,0,102.08,7,299937.48,24,4,3,5,True
6294518,1092,1,451,4822,224623414,0,0,0,102.08,7,299835.4,18,0,21,5,True
6298629,785,0,20,4822,224623414,0,0,0,102.0,3,299733.4,14,6,8,6,True
6373053,895,0,451,3605,224623414,0,0,0,102.07,7,299631.33,24,3,18,7,True
6397009,282,2,20,5460,224623414,0,0,0,102.32,3,299529.01,24,1,4,7,True
6587206,930,3,30,2373,224623414,0,0,0,102.12,8,299426.89,18,3,21,7,True
7023794,1029,0,30,1438,224623414,0,0,0,102.27,8,299324.62,11,2,23,1,True
7151193,930,3,30,1070,224623414,0,0,0,102.1,8,299222.52,18,6,3,1,True
7357279,1150,0,30,6446,224623414,0,0,0,101.95,8,299120.57,15,2,8,2,True
7641508,1233,0,10,6446,224623414,0,0,0,101.96,6,299222.53,18,0,2,3,True
7652199,1029,0,30,5460,224623414,0,0,0,102.04,8,299120.49,11,4,11,4,True
7759601,895,0,30,2077,224623414,0,0,0,102.0,8,299018.49,24,1,20,4,True
8062066,930,3,-1,2641,224623414,0,1,0,102.03,1,299018.49,18,5,13,5,True
8118572,1092,1,-1,2077,224623414,0,2,0,102.14,1,299018.49,18,2,21,5,True
8379537,895,0,451,1438,224623414,0,0,0,101.88,7,298916.61,24,1,3,5,True
8590784,883,0,20,1724,224623414,0,0,0,101.76,3,298814.85,24,0,7,6,True
8822320,509,0,20,2641,224623414,0,0,0,102.23,3,298712.62,12,6,2,6,True
9341918,1265,4,451,6924,224623414,0,0,0,101.83,7,298610.79,23,6,20,9,True
9415513,930,3,25,8624,224623414,0,0,0,102.24,8,298508.55,18,1,14,9,True
9661700,603,0,10,3605,224623414,0,0,0,102.06,6,298610.61,24,1,17,10,True
9741062,703,0,10,1070,224623414,0,0,0,102.22,6,298712.83,18,1,3,10,True
9798077,1029,0,30,7491,224623414,0,0,0,101.86,8,298610.97,11,3,10,10,True
9951915,129,0,30,8624,224623414,0,0,0,101.98,8,298508.99,18,5,18,11,True
9981353,1150,0,25,8624,224623414,0,0,0,101.89,8,298407.1,15,3,21,11,True
1156671,1105,2,25,7971,183026126,1,0,0,856.12,8,144725.88,0,4,23,1,True
1220917,357,4,451,3005,183026126,1,0,0,856.13,7,143869.75,24,5,9,1,True
1537364,105,3,451,9506,183026126,1,0,0,855.77,7,143013.98,3,3,5,2,True
1586857,1041,0,10,3917,183026126,1,0,0,856.34,6,143870.32,11,5,5,2,True
1796846,105,3,451,3005,183026126,1,0,0,855.97,7,143014.35,3,4,11,2,True
1855909,628,0,20,6972,183026126,1,0,0,855.77,5,142158.58,11,1,17,3,False
2269604,357,4,25,2753,183026126,1,0,0,856.03,8,141302.55,24,1,20,3,True
2568746,105,3,451,6659,183026126,1,0,0,855.86,7,140446.69,3,4,3,4,True
2831118,715,0,30,7971,183026126,1,0,0,856.09,8,139590.6,18,6,11,4,True
2870059,681,2,20,3917,183026126,1,0,0,856.08,5,138734.52,24,4,19,4,True
3683593,129,0,451,6305,183026126,1,0,0,856.17,7,137878.35,18,0,9,5,True
3769658,129,0,451,7308,183026126,1,0,0,856.15,7,137022.2,18,2,9,7,True
3778125,105,3,-1,8856,183026126,1,1,0,855.9,4,137022.2,3,6,9,9,True
3815430,715,0,-1,5510,183026126,1,2,0,856.11,4,137022.2,18,1,15,10,True
4194967,715,0,30,6305,183026126,1,0,0,856.36,8,136165.84,18,3,3,11,True
4209628,689,0,10,6659,183026126,1,0,0,856.13,6,137021.97,24,6,4,11,True
4309427,715,0,451,9506,183026126,1,0,0,855.84,7,136166.13,18,1,9,11,True
4792553,1363,0,20,6330,183026126,1,0,0,856.2,3,135309.93,16,6,4,11,True
5294902,105,3,30,7373,183026126,1,0,0,855.81,8,134454.12,3,2,16,12,True
5326998,105,3,-1,6305,183026126,1,1,0,856.09,4,134454.12,3,3,1,1,True
5448980,1314,2,20,4204,183026126,1,0,0,855.81,5,133598.31,5,3,20,1,True
5670401,1105,2,451,3005,183026126,1,0,0,856.21,7,132742.1,0,3,18,2,True
5674217,105,3,451,8856,183026126,1,0,0,856.08,7,131886.02,3,6,18,3,True
5712295,715,0,25,5420,183026126,1,0,0,856.06,8,131029.96,18,0,13,3,True
5821710,105,3,451,5510,183026126,1,0,0,856.04,7,130173.92,3,4,18,4,True
6081755,129,0,30,1637,183026126,1,0,0,856.2,8,129317.72,18,4,13,4,True
6115433,727,0,10,2753,183026126,1,0,0,856.01,0,130173.73,11,0,19,5,True
6139319,1260,0,20,3917,183026126,1,0,0,856.17,3,129317.56,23,6,21,5,True
6372909,1272,0,20,4348,183026126,1,0,0,855.94,5,128461.62,24,1,18,5,True
6637149,129,0,451,6659,183026126,1,0,0,856.0,7,127605.62,18,6,4,6,True
6873653,1105,2,25,3917,183026126,1,0,0,856.08,8,126749.54,0,1,23,8,True
6961516,297,0,20,4517,183026126,1,0,0,856.08,3,125893.46,4,0,5,8,True
7154526,137,2,20,3917,183026126,1,0,0,856.17,5,125037.29,18,1,4,8,True
7340990,1144,2,20,6330,183026126,1,0,0,856.04,3,124181.25,15,3,10,9,True
7351868,715,0,-1,4348,183026126,1,1,0,855.84,4,124181.25,18,2,8,9,True
7492591,357,4,451,1630,183026126,1,0,0,856.19,7,123325.06,24,5,17,9,True
7556947,357,4,25,3005,183026126,1,0,0,855.98,8,122469.08,24,5,10,10,True
7646794,130,0,10,4517,183026126,1,0,0,856.17,6,123325.25,18,3,16,10,True
7733046,129,0,25,3917,183026126,1,0,0,855.98,8,122469.27,18,4,9,11,True
7804992,105,3,25,3917,183026126,1,0,0,856.03,8,121613.24,3,5,3,11,True
7833489,105,3,30,9506,183026126,1,0,0,855.84,8,120757.4,3,0,16,12,True
7848634,1105,2,30,5510,183026126,1,0,0,856.02,8,119901.38,0,4,8,1,True
8253488,129,0,451,7373,183026126,1,0,0,855.82,7,119045.56,18,4,16,1,True
8419238,105,3,-1,6659,183026126,1,1,0,855.85,4,119045.56,3,4,7,3,True
8517662,715,0,451,7373,183026126,1,0,0,856.06,7,118189.5,18,0,19,4,True
8661756,1105,2,451,8760,183026126,1,0,0,856.19,7,117333.31,0,3,8,4,True
8677241,715,0,451,9506,183026126,1,0,0,855.82,7,116477.49,18,4,3,4,True
8725511,715,0,-1,3005,183026126,1,1,0,855.96,4,116477.49,18,3,6,6,True
8857261,105,3,25,1630,183026126,1,0,0,856.03,8,115621.46,3,4,21,6,True
9019687,129,0,451,4849,183026126,1,0,0,856.06,7,114765.4,18,4,23,6,True
9334752,1105,2,-1,4348,183026126,1,1,0,856.3,4,114765.4,0,4,23,6,True
9586799,357,4,451,4849,183026126,1,0,0,856.06,7,113909.34,24,3,12,7,True
9609388,715,0,451,5420,183026126,1,0,0,855.85,7,113053.49,18,2,1,10,True
9829001,129,0,25,8760,183026126,1,0,0,856.03,8,112197.46,18,4,10,10,False
9904472,1243,2,20,8760,183026126,1,0,0,855.9,5,111341.56,18,4,8,10,True
1520333,1127,0,10,4620,588359116,1,0,0,399.05,6,817518.05,24,0,10,1,True
1653008,592,4,451,2522,588359116,1,0,0,399.19,7,817118.86,24,5,12,1,False
1770699,592,4,451,7025,588359116,1,0,0,399.39,7,816719.47,24,6,1,2,True
1866349,695,2,20,5677,588359116,1,0,0,399.13,5,816320.34,24,4,20,4,True
1907698,1338,0,20,4659,588359116,1,0,0,398.94,5,815921.4,18,1,20,4,True
2013933,647,4,-1,7967,588359116,1,1,0,398.68,1,815921.4,24,3,7,4,True
2197304,320,1,25,7967,588359116,1,0,0,398.71,8,815522.69,11,4,23,6,True
2583395,502,0,25,5677,588359116,1,0,0,398.98,8,815123.71,12,4,4,7,True
2599067,454,1,10,2917,588359116,1,0,0,398.99,6,815522.7,13,5,23,7,True
2684105,592,4,30,3707,588359116,1,0,0,399.02,8,815123.68,24,1,4,7,True
2731820,809,3,30,6394,588359116,1,0,0,399.01,8,814724.67,11,6,13,8,True
2832370,950,0,20,7025,588359116,1,0,0,398.91,3,814325.76,24,5,5,9,True
2945521,303,0,20,2561,588359116,1,0,0,398.98,3,813926.78,4,3,4,10,True
3636643,254,0,-1,7773,588359116,1,1,0,399.07,1,813926.78,6,1,6,10,True
3692211,672,4,-1,4659,588359116,1,2,0,399.24,1,813926.78,18,3,17,10,True
4122628,502,0,25,2917,588359116,1,0,0,399.19,8,813527.59,12,2,16,10,True
4723458,592,4,451,4953,588359116,1,0,0,399.07,7,813128.52,24,3,19,10,True
4804919,647,4,25,1182,588359116,1,0,0,399.07,8,812729.45,24,0,10,10,True
4965609,254,0,451,8789,588359116,1,0,0,398.97,7,812330.48,6,4,19,11,True
5016482,809,3,451,1182,588359116,1,0,0,398.99,7,811931.49,11,5,10,12,True
5165679,320,1,451,6394,588359116,1,0,0,398.99,7,811532.5,11,5,14,1,True
5226614,297,0,20,7967,588359116,1,0,0,399.12,5,811133.38,4,3,0,2,True
5424039,809,3,30,6730,588359116,1,0,0,398.94,8,810734.44,11,0,7,2,True
5468526,647,4,451,4953,588359116,1,0,0,399.07,7,810335.37,24,5,5,2,True
5518171,672,4,30,4620,588359116,1,0,0,399.11,8,809936.26,18,1,0,3,True
5578270,672,4,451,4659,588359116,1,0,0,398.74,7,809537.52,18,6,9,4,True
5781769,672,4,451,2917,588359116,1,0,0,399.22,7,809138.3,18,2,5,4,True
5824949,672,4,25,7140,588359116,1,0,0,399.14,8,808739.16,18,5,12,4,True
5840849,320,1,-1,7025,588359116,1,1,0,399.04,4,808739.16,11,2,5,5,True
5883063,254,0,451,7025,588359116,1,0,0,398.96,7,808340.2,6,1,19,6,True
6051049,320,1,30,4659,588359116,1,0,0,398.93,8,807941.27,11,2,2,6,True
6532898,809,3,25,4953,588359116,1,0,0,398.87,8,807542.4,11,3,14,6,True
6854267,647,4,30,1182,588359116,1,0,0,399.08,8,807143.32,24,1,20,7,True
7258835,1015,0,451,6394,588359116,1,0,0,399.02,7,806744.3,26,2,12,7,True
7550881,1015,0,30,7967,588359116,1,0,0,399.24,8,806345.06,26,2,22,9,True
7702958,757,0,10,5677,588359116,1,0,0,398.8,6,806743.86,24,5,14,9,True
7808919,329,1,10,5654,588359116,1,0,0,399.08,0,807142.94,11,1,22,10,True
7836737,652,0,30,3102,588359116,1,0,0,398.8,8,806744.14,24,4,20,10,True
7879871,254,0,451,7140,588359116,1,0,0,398.94,7,806345.2,6,1,10,11,True
8057801,1246,0,10,7967,588359116,1,0,0,398.91,6,806744.11,23,4,12,1,True
8182931,809,3,451,3707,588359116,1,0,0,399.06,7,806345.05,11,1,1,2,True
8286903,809,3,25,2522,588359116,1,0,0,398.87,8,805946.18,11,5,19,5,True
8357994,502,0,451,3707,588359116,1,0,0,398.95,7,805547.23,12,5,9,5,True
8553787,254,0,-1,2917,588359116,1,1,0,398.94,4,805547.23,6,6,1,6,True
8730133,672,4,451,2561,588359116,1,0,0,398.91,7,805148.32,18,6,19,6,True
8912560,592,4,451,4953,588359116,1,0,0,399.13,7,804749.19,24,5,10,7,True
9220666,476,1,10,3707,588359116,1,0,0,399.14,0,805148.33,5,4,3,8,True
9275889,68,0,10,2522,588359116,1,0,0,398.99,6,805547.32,20,3,15,9,True
9289583,269,0,20,5654,588359116,1,0,0,399.06,5,805148.26,24,5,23,11,True
9419583,502,0,451,7773,588359116,1,0,0,399.08,7,804749.18,12,6,8,11,True
9428284,502,0,451,6394,588359116,1,0,0,398.97,7,804350.21,12,2,14,11,True
1173924,669,2,20,7671,416701917,0,0,0,769.18,5,525805.82,18,5,16,1,True
1183856,958,2,-1,2751,416701917,0,1,0,769.09,4,525805.82,13,2,3,1,True
1486792,1240,4,30,1485,416701917,0,0,0,769.0,8,525036.82,18,5,1,1,True
1873733,569,4,-1,9923,416701917,0,1,0,768.92,4,525036.82,11,6,21,2,True
2014578,1119,0,10,3027,416701917,0,0,0,769.08,6,525805.9,24,0,22,2,False
2138895,1481,4,-1,5876,416701917,0,1,0,768.89,4,525805.9,24,2,7,4,True
2931214,958,2,30,6722,416701917,0,0,0,769.3,8,525036.6,13,2,4,5,True
2970984,1240,4,30,9860,416701917,0,0,0,768.93,8,524267.67,18,2,15,5,True
3356309,958,2,30,5777,416701917,0,0,0,768.94,8,523498.73,13,4,13,7,True
3416938,1289,1,451,9923,416701917,0,0,0,768.95,7,522729.78,24,2,10,7,True
3637545,1481,4,25,7369,416701917,0,0,0,769.02,8,521960.76,24,4,14,7,True
3677772,169,4,30,3980,416701917,0,0,0,769.22,8,521191.54,24,2,23,9,True
3844270,1232,1,10,3027,416701917,0,0,0,769.03,6,521960.57,18,3,15,11,True
3894482,1481,4,30,5673,416701917,0,0,0,768.99,8,521191.58,24,1,5,11,True
3975312,616,1,-1,7369,416701917,0,1,0,769.16,4,521191.58,11,1,3,12,True
4165651,958,2,451,3361,416701917,0,0,0,769.08,7,520422.5,13,3,0,12,True
4300430,1431,4,30,2751,416701917,0,0,0,768.89,8,519653.61,24,1,14,1,True
4563600,950,0,20,3980,416701917,0,0,0,768.98,5,518884.63,24,4,21,1,True
4794746,1431,4,30,2751,416701917,0,0,0,768.94,8,518115.69,24,2,22,2,True
4889995,616,1,25,6722,416701917,0,0,0,768.71,8,517346.98,11,0,2,2,True
4933987,1255,0,20,3980,416701917,0,0,0,769.05,5,516577.93,23,1,10,3,True
5190946,650,3,30,2175,416701917,0,0,0,768.93,8,515809.0,24,3,7,4,True
5276398,785,0,20,6722,416701917,0,0,0,769.06,3,515039.94,14,1,1,5,True
5503535,958,2,451,3027,416701917,0,0,0,768.89,7,514271.05,13,3,9,6,True
5645713,1125,1,10,9923,416701917,0,0,0,768.93,0,515039.98,24,1,12,7,True
5714408,958,2,30,8483,416701917,0,0,0,769.1,8,514270.88,13,2,9,8,True
5733453,650,3,25,2175,416701917,0,0,0,768.9,8,513501.98,24,1,8,9,True
5998530,1240,4,30,7671,416701917,0,0,0,769.17,8,512732.81,18,3,14,9,True
6044425,329,1,10,7369,416701917,0,0,0,768.85,0,513501.66,11,1,16,10,True
6136365,616,1,-1,8124,416701917,0,1,0,769.07,1,513501.66,11,4,11,10,True
6233258,958,2,30,6722,416701917,0,0,0,769.07,8,512732.59,13,5,13,11,True
6234911,650,3,451,8124,416701917,0,0,0,768.82,7,511963.77,24,1,21,11,True
6533996,1240,4,451,8124,416701917,0,0,0,768.99,7,511194.78,18,4,14,11,True
6998933,897,0,10,9923,416701917,0,0,0,769.2,0,511963.98,24,1,4,11,True
7007997,616,1,30,5876,416701917,0,0,0,768.93,8,511195.05,11,6,14,12,True
7050074,616,1,451,3075,416701917,0,0,0,768.95,7,510426.1,11,3,18,12,True
7157589,1481,4,451,5777,416701917,0,0,0,769.02,7,509657.08,24,2,2,2,True
7504407,958,2,30,2751,416701917,0,0,0,768.97,8,508888.11,13,3,18,3,True
7637222,169,4,25,1485,416701917,0,0,0,768.87,8,508119.24,24,5,4,3,True
8126095,1289,1,30,7369,416701917,0,0,0,769.0,8,507350.24,24,2,1,5,True
8145520,1410,1,10,5210,416701917,0,0,0,769.1,6,508119.34,24,4,19,5,True
8169586,1273,0,10,7671,416701917,0,0,0,769.1,0,508888.44,24,0,23,6,True
8256811,958,2,30,5777,416701917,0,0,0,768.73,8,508119.71,13,2,21,7,True
8562241,1356,2,20,2175,416701917,0,0,0,769.19,5,507350.52,24,0,20,8,True
8665328,1481,4,451,5876,416701917,0,0,0,768.9,7,506581.62,24,2,7,9,True
8675556,1289,1,-1,8483,416701917,0,1,0,769.12,4,506581.62,24,0,0,10,True
9011874,169,4,25,6722,416701917,0,0,0,768.75,8,505812.87,24,6,3,10,True
9027027,569,4,451,5210,416701917,0,0,0,768.85,7,505044.02,11,0,21,10,True
9076772,1431,4,451,3980,416701917,0,0,0,768.91,7,504275.11,24,6,10,11,True
9431248,1481,4,30,5210,416701917,0,0,0,768.96,8,503506.15,24,6,11,11,True
9684866,1481,4,30,9923,416701917,0,0,0,768.92,8,502737.23,24,3,21,11,True
9786783,1289,1,451,6722,416701917,0,0,0,769.27,7,501967.96,24,4,22,11,True
1298484,835,4,451,3517,649224361,1,0,0,616.12,7,826210.88,5,4,7,1,True
1328851,798,4,30,3125,649224361,1,0,0,615.85,8,825595.03,11,6,5,1,True
1366988,835,4,451,4091,649224361,1,0,0,615.96,7,824979.07,5,6,4,1,True
1454119,385,1,451,5458,649224361,1,0,0,615.84,7,824363.23,25,0,21,2,True
1667997,835,4,25,9211,649224361,1,0,0,615.9,8,823747.33,5,1,16,2,True
1875994,1334,3,30,5458,649224361,1,0,0,615.95,8,823131.38,18,4,10,2,True
1972849,1113,1,30,7253,649224361,1,0,0,616.12,8,822515.26,0,1,13,3,True
2091793,1044,0,10,8662,649224361,1,0,0,616.26,6,823131.52,11,4,11,3,True
2100789,253,2,20,1614,649224361,1,0,0,615.9,5,822515.62,6,2,10,3,True
2163161,858,1,451,9116,649224361,1,0,0,616.23,7,821899.39,24,0,0,4,True
2278192,388,3,451,5458,649224361,1,0,0,615.73,7,821283.66,10,6,6,5,True
2400209,168,0,30,5324,649224361,1,0,0,616.12,8,820667.54,24,3,4,5,True
2507819,611,0,20,9211,649224361,1,0,0,616.06,3,820051.48,11,1,4,5,True
2569865,858,1,30,9697,649224361,1,0,0,616.0,8,819435.48,24,1,6,6,True
2611291,858,1,451,4091,649224361,1,0,0,616.07,7,818819.41,24,6,19,7,True
2770203,798,4,30,1614,649224361,1,0,0,616.11,8,818203.3,11,6,8,7,True
2877324,388,3,30,9328,649224361,1,0,0,615.62,8,817587.68,10,4,9,7,True
3035668,616,1,10,3125,649224361,1,0,0,615.75,6,818203.43,11,1,2,9,True
3756181,388,3,30,8662,649224361,1,0,0,615.87,8,817587.56,10,6,18,9,True
4017698,168,0,-1,4091,649224361,1,1,0,615.92,4,817587.56,24,2,20,3,True
4064168,385,1,30,6383,649224361,1,0,0,616.0,8,816971.56,25,0,0,4,True
4411413,388,3,-1,9697,649224361,1,1,0,615.94,1,816971.56,10,6,14,4,True
4510311,522,0,20,9116,649224361,1,0,0,616.13,3,816355.43,18,5,12,5,True
4572724,1264,0,20,9211,649224361,1,0,0,615.99,3,815739.44,23,1,18,6,True
4627993,858,1,25,8353,649224361,1,0,0,616.11,8,815123.33,24,5,23,6,True
5217733,835,4,451,5324,649224361,1,0,0,615.95,7,814507.38,5,1,21,6,True
5243661,388,3,25,9614,649224361,1,0,0,615.93,8,813891.45,10,4,11,7,True
5428284,388,3,-1,9614,649224361,1,1,0,616.05,4,813891.45,10,3,5,8,True
5540826,798,4,451,4734,649224361,1,0,0,615.93,7,813275.52,11,6,7,8,True
5694866,168,0,30,9697,649224361,1,0,0,616.26,8,812659.26,24,3,1,8,True
5724666,385,1,451,3517,649224361,1,0,0,615.97,7,812043.29,25,0,13,10,True
5797833,642,0,20,5458,649224361,1,0,0,616.14,5,811427.15,24,2,3,10,True
5883394,385,1,451,5324,649224361,1,0,0,616.07,7,810811.08,25,0,2,11,True
5914324,858,1,451,9876,649224361,1,0,0,615.97,7,810195.11,24,2,3,12,True
6065032,1113,1,451,3125,649224361,1,0,0,616.14,7,809578.97,0,0,3,2,True
6173768,858,1,30,9876,649224361,1,0,0,616.04,8,808962.93,24,1,15,3,True
6356319,249,0,10,3125,649224361,1,0,0,616.15,6,809579.08,6,1,22,3,True
6390967,168,0,25,4091,649224361,1,0,0,616.04,8,808963.04,24,0,2,3,True
6754710,168,0,30,9211,649224361,1,0,0,616.19,8,808346.85,24,3,16,4,True
6781760,1113,1,-1,3125,649224361,1,1,0,615.95,4,808346.85,0,3,3,5,True
6845166,385,1,451,6383,649224361,1,0,0,615.98,7,807730.87,25,5,23,5,True
7009872,1113,1,25,4734,649224361,1,0,0,615.78,8,807115.09,0,3,6,5,True
7141399,1364,0,10,9116,649224361,1,0,0,616.02,6,807731.11,16,3,19,5,True
7249227,1347,4,451,5324,649224361,1,0,0,616.22,7,807114.89,24,5,9,5,True
7557046,858,1,30,4091,649224361,1,0,0,615.99,8,806498.9,24,3,13,5,False
7600400,168,0,451,9328,649224361,1,0,0,616.02,7,805882.88,24,0,12,7,True
7677686,350,0,20,5458,649224361,1,0,0,616.33,3,805266.55,24,6,22,7,True
7824689,1391,2,20,5324,649224361,1,0,0,615.85,3,804650.7,24,6,6,8,True
7976031,388,3,-1,4734,649224361,1,1,0,616.06,4,804650.7,10,0,22,8,True
8088648,599,0,10,9723,649224361,1,0,0,615.78,6,805266.48,24,3,19,8,True
8343757,1485,0,20,4186,649224361,1,0,0,616.14,3,804650.34,24,0,12,8,True
8353985,835,4,25,9723,649224361,1,0,0,616.19,8,804034.15,5,3,6,8,True
8514116,653,1,10,4091,649224361,1,0,0,616.02,6,804650.17,24,3,21,10,True
8643334,825,2,20,9723,649224361,1,0,0,616.23,5,804033.94,18,5,21,10,True
9055568,1113,1,30,5324,649224361,1,0,0,616.04,8,803417.9,0,3,12,10,True
9220205,438,1,10,5019,649224361,1,0,0,616.06,6,804033.96,24,6,3,10,False
9674312,649,0,20,9328,649224361,1,0,0,615.99,5,803417.97,24,2,8,10,True
9712594,732,0,20,9211,649224361,1,0,0,615.85,5,802802.12,11,4,2,11,True
1072551,1007,2,451,2045,167036221,1,0,0,554.99,7,539093.01,26,5,21,1,True
1439873,1235,1,10,4617,167036221,1,0,0,554.78,6,539647.79,18,4,6,1,True
1446741,898,1,30,6995,167036221,1,0,0,554.81,8,539092.98,24,4,3,3,True
1463546,914,2,20,2055,167036221,1,0,0,554.68,3,538538.3,18,2,4,3,False
1585301,1007,2,-1,1192,167036221,1,1,0,554.73,1,538538.3,26,5,13,4,True
1662139,457,0,20,1121,167036221,1,0,0,554.64,3,537983.66,13,4,8,5,True
2064435,482,1,10,4104,167036221,1,0,0,555.09,6,538538.75,5,5,3,7,True
2071677,1007,2,451,8800,167036221,1,0,0,554.97,7,537983.78,26,2,23,7,True
2114787,1212,0,20,1192,167036221,1,0,0,555.11,5,537428.67,24,4,13,7,True
2243774,550,0,10,1173,167036221,1,0,0,554.82,0,537983.49,17,2,8,9,True
2372528,820,1,10,6415,167036221,1,0,0,555.06,0,538538.55,18,5,3,9,True
2470731,305,1,10,1121,167036221,1,0,0,555.36,6,539093.91,4,0,8,10,True
2520031,448,0,451,4948,167036221,1,0,0,554.87,7,538539.04,13,4,6,10,True
2668762,448,0,451,2055,167036221,1,0,0,554.96,7,537984.08,13,2,15,12,True
3011899,944,2,451,7721,167036221,1,0,0,555.06,7,537429.02,24,5,3,1,True
3054178,1061,2,-1,7062,167036221,1,1,0,554.92,1,537429.02,11,4,7,1,True
3576525,269,0,20,4948,167036221,1,0,0,554.93,3,536874.09,24,5,17,1,True
3662749,1217,0,20,4104,167036221,1,0,0,555.39,5,536318.7,24,6,5,1,True
3900777,898,1,-1,2055,167036221,1,1,0,554.93,4,536318.7,24,2,20,3,True
4024674,1459,1,10,7341,167036221,1,0,0,555.07,6,536873.77,11,3,18,4,True
4242707,1007,2,451,2164,167036221,1,0,0,554.84,7,536318.93,26,4,21,4,True
4362343,944,2,25,7062,167036221,1,0,0,555.04,8,535763.89,24,4,3,4,True
4390260,429,0,451,2055,167036221,1,0,0,555.25,7,535208.64,24,6,0,4,True
4405005,429,0,25,2045,167036221,1,0,0,554.99,8,534653.65,24,1,10,5,True
4822918,1405,4,30,4130,167036221,1,0,0,555.14,8,534098.51,24,6,7,5,True
5366218,1061,2,30,1173,167036221,1,0,0,554.92,8,533543.59,11,4,9,6,True
5422462,1061,2,451,4104,167036221,1,0,0,555.06,7,532988.53,11,2,15,7,True
5708075,1061,2,-1,6471,167036221,1,1,0,554.72,4,532988.53,11,5,23,9,True
5742004,1405,4,30,1192,167036221,1,0,0,555.1,8,532433.43,24,3,7,11,True
5893066,942,0,20,1173,167036221,1,0,0,554.81,5,531878.62,24,0,15,11,True
5894901,994,4,25,3673,167036221,1,0,0,555.06,8,531323.56,22,0,11,11,True
5961705,429,0,25,1987,167036221,1,0,0,555.02,8,530768.54,24,2,10,12,True
5971871,994,4,451,7721,167036221,1,0,0,554.91,7,530213.63,22,5,11,12,True
7030850,530,0,20,7341,167036221,1,0,0,554.91,3,529658.72,18,2,21,1,True
7167983,429,0,-1,7341,167036221,1,1,0,555.25,1,529658.72,24,1,14,1,True
7487785,1377,0,10,1987,167036221,1,0,0,555.13,6,530213.85,16,3,10,1,True
7509626,1007,2,451,7341,167036221,1,0,0,555.02,7,529658.83,26,4,11,4,True
7575784,1061,2,25,2045,167036221,1,0,0,555.22,8,529103.61,11,5,8,4,True
7735906,994,4,451,1173,167036221,1,0,0,554.97,7,528548.64,22,2,5,4,True
7963497,848,2,20,6471,167036221,1,0,0,555.31,5,527993.33,5,0,22,4,True
8024581,429,0,-1,7721,167036221,1,1,0,555.19,4,527993.33,24,5,12,4,True
8066811,421,3,25,1987,167036221,1,0,0,554.87,8,527438.46,18,2,2,5,True
8183480,956,1,10,4617,167036221,1,0,0,554.84,0,527993.3,13,4,21,5,True
8383739,448,0,451,6995,167036221,1,0,0,554.97,7,527438.33,13,5,15,7,True
8421980,421,3,25,4617,167036221,1,0,0,555.01,8,526883.32,18,5,21,7,True
8863004,429,0,451,1224,167036221,1,0,0,555.03,7,526328.29,24,1,5,7,True
8916854,429,0,25,1192,167036221,1,0,0,555.14,8,525773.15,24,2,11,7,True
8983079,882,0,20,1121,167036221,1,0,0,554.81,5,525218.34,27,1,9,7,True
9050494,448,0,30,6415,167036221,1,0,0,555.14,8,524663.2,13,2,8,8,True
9413370,1061,2,25,6471,167036221,1,0,0,555.06,8,524108.14,11,5,17,9,True
9448011,994,4,451,8800,167036221,1,0,0,555.02,7,523553.12,22,1,10,10,True
9777529,898,1,25,6995,167036221,1,0,0,554.94,8,522998.18,24,0,10,10,True
9945694,994,4,25,4617,167036221,1,0,0,555.03,8,522443.15,22,5,4,11,True
9951494,1122,1,10,4104,167036221,1,0,0,554.72,0,522997.87,24,3,2,11,True
1000714,149,2,30,3921,709279006,1,0,0,1137.73,8,648198.27,18,5,8,1,True
1288818,917,0,30,2240,709279006,1,0,0,1138.06,8,647060.21,18,3,7,2,True
1607876,917,0,30,1787,709279006,1,0,0,1138.13,8,645922.08,18,0,0,3,True
1742625,819,2,30,5939,709279006,1,0,0,1138.3,8,644783.78,18,0,6,3,True
1768464,746,4,25,5939,709279006,1,0,0,1138.27,8,643645.51,24,0,22,3,True
2135706,239,1,10,3492,709279006,1,0,0,1138.18,0,644783.69,26,5,9,5,True
2293222,819,2,-1,2525,709279006,1,1,0,1138.04,4,644783.69,18,1,9,5,False
2418400,1336,2,20,1532,709279006,1,0,0,1138.16,5,643645.53,18,6,22,6,False
2806807,1036,1,10,3492,709279006,1,0,0,1137.97,6,644783.5,11,1,3,7,True
3037436,456,4,-1,2240,709279006,1,1,0,1138.08,4,644783.5,13,6,6,7,True
3043271,819,2,30,7624,709279006,1,0,0,1138.09,8,643645.41,18,2,5,7,True
3141652,917,0,25,3921,709279006,1,0,0,1138.16,8,642507.25,18,3,14,7,True
3272762,1019,0,10,2240,709279006,1,0,0,1138.45,6,643645.7,26,4,17,9,True
3446756,200,0,10,2184,709279006,1,0,0,1137.96,6,644783.66,9,4,2,9,True
4006171,1421,0,451,6425,709279006,1,0,0,1138.02,7,643645.64,24,0,8,10,True
4106809,1421,0,-1,5443,709279006,1,1,0,1138.09,4,643645.64,24,2,5,10,True
4229221,456,4,-1,9124,709279006,1,2,0,1137.79,1,643645.64,13,0,17,10,True
4399309,917,0,30,9841,709279006,1,0,0,1138.05,8,642507.59,18,1,1,11,True
4439158,205,0,10,5939,709279006,1,0,0,1137.99,6,643645.58,9,1,4,1,True
4895177,1421,0,30,5443,709279006,1,0,0,1137.77,8,642507.81,24,2,7,1,True
4924563,149,2,30,4544,709279006,1,0,0,1138.15,8,641369.66,18,6,16,4,True
5222413,746,4,451,2240,709279006,1,0,0,1137.98,7,640231.68,24,5,15,4,True
5579697,1175,2,20,1787,709279006,1,0,0,1138.01,3,639093.67,24,2,2,7,True
5751483,844,1,10,2525,709279006,1,0,0,1138.02,0,640231.69,5,5,22,7,True
5771242,1092,1,10,7180,709279006,1,0,0,1137.77,0,641369.46,18,5,2,8,True
5989207,149,2,25,9651,709279006,1,0,0,1138.01,8,640231.45,18,5,0,9,True
6217101,21,0,20,1787,709279006,1,0,0,1138.07,3,639093.38,11,3,22,10,True
6352061,746,4,30,1532,709279006,1,0,0,1138.21,8,637955.17,24,6,9,10,True
6694912,694,2,25,8963,709279006,1,0,0,1138.06,8,636817.11,24,3,3,11,True
6773939,819,2,451,9841,709279006,1,0,0,1138.07,7,635679.04,18,1,20,11,True
6890307,1094,0,20,2240,709279006,1,0,0,1138.03,5,634541.01,0,0,6,12,True
6981181,465,0,10,9433,709279006,1,0,0,1137.99,6,635679.0,13,6,0,1,True
7253259,456,4,-1,2240,709279006,1,1,0,1138.09,1,635679.0,13,2,15,1,True
7680056,1421,0,30,2525,709279006,1,0,0,1137.81,8,634541.19,24,1,14,2,True
7805393,1421,0,30,2184,709279006,1,0,0,1137.89,8,633403.3,24,4,21,3,True
7904650,456,4,451,9841,709279006,1,0,0,1138.01,7,632265.29,13,6,14,3,True
8019485,456,4,30,6755,709279006,1,0,0,1138.47,8,631126.82,13,1,9,3,True
8116691,917,0,30,6425,709279006,1,0,0,1138.08,8,629988.74,18,3,0,4,True
8323433,1101,2,20,9124,709279006,1,0,0,1138.03,5,628850.71,0,3,22,5,True
8393067,1428,1,10,7234,709279006,1,0,0,1138.13,6,629988.84,24,3,19,5,True
8408119,456,4,30,5939,709279006,1,0,0,1137.9,8,628850.94,13,5,17,6,True
8601387,456,4,25,1532,709279006,1,0,0,1137.96,8,627712.98,13,1,20,6,True
8685065,97,0,10,9170,709279006,1,0,0,1138.29,6,628851.27,3,0,3,7,True
9008824,149,2,25,9981,709279006,1,0,0,1138.09,8,627713.18,18,5,0,7,True
9124401,149,2,-1,1524,709279006,1,1,0,1138.04,4,627713.18,18,0,6,8,True
9233345,1410,1,10,8410,709279006,1,0,0,1137.92,0,628851.1,24,4,19,9,True
9395363,573,0,10,9124,709279006,1,0,0,1137.91,6,629989.01,11,4,0,9,True
9547083,149,2,451,7180,709279006,1,0,0,1138.19,7,628850.82,18,2,2,9,True
9674085,694,2,30,1787,709279006,1,0,0,1137.84,8,627712.98,24,4,8,10,True
9851669,1454,1,10,8410,709279006,1,0,0,1138.27,0,628851.25,11,3,23,11,True
1079899,375,4,451,1924,883619905,0,0,0,539.13,7,506770.87,25,4,22,1,True
1577480,980,1,25,7046,883619905,0,0,0,538.95,8,506231.92,22,0,9,1,True
1595046,1297,0,25,1945,883619905,0,0,0,538.82,8,505693.1,5,2,17,2,True
1664296,1297,0,-1,5551,883619905,0,1,0,539.04,4,505693.1,5,5,3,2,True
1827805,276,0,-1,5069,883619905,0,2,0,538.87,1,505693.1,24,4,7,2,True
1861989,741,3,451,3167,883619905,0,0,0,539.02,7,505154.08,24,5,21,2,True
1980115,741,3,25,9124,883619905,0,0,0,538.93,8,504615.15,24,4,22,3,True
2079136,741,3,30,4226,883619905,0,0,0,538.83,8,504076.32,24,4,23,3,True
2330092,741,3,-1,5069,883619905,0,1,0,538.91,1,504076.32,24,1,16,4,True
2522465,644,0,10,7798,883619905,0,0,0,539.17,0,504615.49,24,2,11,4,True
2631229,741,3,25,8274,883619905,0,0,0,539.04,8,504076.45,24,6,22,6,True
2746094,276,0,30,2284,883619905,0,0,0,539.09,8,503537.36,24,0,2,7,True
2815364,1485,0,10,3358,883619905,0,0,0,538.99,6,504076.35,24,6,20,7,True
2940953,741,3,-1,6554,883619905,0,1,0,539.21,4,504076.35,24,4,3,8,True
3015414,25,3,25,5551,883619905,0,0,0,539.05,8,503537.3,11,1,20,10,True
3390654,882,0,20,3165,883619905,0,0,0,539.03,3,502998.27,27,6,9,10,True
3392929,1282,2,-1,5551,883619905,0,1,0,539.18,4,502998.27,24,2,8,11,True
3649521,1297,0,451,3358,883619905,0,0,0,538.77,7,502459.5,5,3,4,11,True
3746229,1053,1,10,5314,883619905,0,0,0,538.88,6,502998.38,11,3,13,11,True
4103630,276,0,25,4745,883619905,0,0,0,539.01,8,502459.37,24,2,5,1,True
4294355,1282,2,25,5551,883619905,0,0,0,539.15,8,501920.22,24,4,9,2,True
4438725,276,0,451,5137,883619905,0,0,0,539.37,7,501380.85,24,0,11,2,True
4679693,375,4,451,1945,883619905,0,0,0,539.15,7,500841.7,25,4,16,3,True
4822596,25,3,451,1924,883619905,0,0,0,539.14,7,500302.56,11,1,19,3,True
5057175,1297,0,451,3186,883619905,0,0,0,538.88,7,499763.68,5,0,19,4,True
5289580,1017,2,20,2284,883619905,0,0,0,538.88,5,499224.8,26,6,16,4,True
5710303,318,0,20,7750,883619905,0,0,0,538.99,5,498685.81,11,4,22,6,True
5731739,375,4,451,1127,883619905,0,0,0,539.07,7,498146.74,25,6,21,7,True
5738911,276,0,451,3165,883619905,0,0,0,539.0,7,497607.74,24,4,18,8,True
5752995,130,0,10,1127,883619905,0,0,0,539.07,6,498146.81,18,1,8,10,True
6205791,1282,2,-1,9124,883619905,0,1,0,539.14,4,498146.81,24,3,4,10,True
6287872,276,0,451,4745,883619905,0,0,0,539.04,7,497607.77,24,0,13,10,True
6396083,1288,0,10,4745,883619905,0,0,0,539.05,6,498146.82,24,1,18,11,True
6415564,1282,2,451,7750,883619905,0,0,0,539.07,7,497607.75,24,1,22,12,True
6497309,980,1,30,1945,883619905,0,0,0,539.01,8,497068.74,22,6,22,12,True
6641764,741,3,25,2378,883619905,0,0,0,538.82,8,496529.92,24,5,20,12,True
6988268,375,4,25,7798,883619905,0,0,0,539.21,8,495990.71,25,0,6,12,True
7115448,882,0,10,3167,883619905,0,0,0,539.03,0,496529.74,27,4,21,12,True
7454271,375,4,-1,9300,883619905,0,1,0,539.28,1,496529.74,25,0,13,1,True
7522832,741,3,451,3165,883619905,0,0,0,539.01,7,495990.73,24,5,23,1,True
7708502,1282,2,451,3165,883619905,0,0,0,538.92,7,495451.81,24,4,10,1,True
7940977,20,0,10,6980,883619905,0,0,0,539.25,0,495991.06,24,4,8,2,True
8048725,404,1,10,4226,883619905,0,0,0,539.26,0,496530.32,10,2,14,3,True
8058130,25,3,451,4226,883619905,0,0,0,539.08,7,495991.24,11,0,8,4,True
8362377,980,1,25,9124,883619905,0,0,0,538.95,8,495452.29,22,4,15,4,True
8428360,741,3,25,5314,883619905,0,0,0,538.92,8,494913.37,24,4,16,5,True
8587900,375,4,25,9768,883619905,0,0,0,538.74,8,494374.63,25,1,4,5,True
8822942,741,3,451,9427,883619905,0,0,0,538.91,7,493835.72,24,4,1,5,True
8842456,1471,0,10,1060,883619905,0,0,0,538.66,6,494374.38,24,2,7,6,True
8847849,375,4,-1,6554,883619905,0,1,0,539.3,4,494374.38,25,5,23,6,True
9111502,25,3,451,6980,883619905,0,0,0,539.2,7,493835.18,11,3,11,6,True
9273874,375,4,451,2284,883619905,0,0,0,538.97,7,493296.21,25,3,2,7,True
9283153,375,4,30,3167,883619905,0,0,0,538.87,8,492757.34,25,3,21,7,True
9433187,980,1,10,3167,883619905,0,0,0,538.89,6,493296.23,22,5,18,8,True
9596862,1297,0,451,9427,883619905,0,0,0,538.9,7,492757.33,5,1,11,8,True
9655809,375,4,-1,1369,883619905,0,1,0,539.13,1,492757.33,25,5,4,9,True
9909424,319,0,20,3358,883619905,0,0,0,539.05,3,492218.28,11,6,17,10,True
1068031,583,2,30,9009,589801094,0,0,0,494.17,8,153212.83,11,2,15,1,True
1132019,739,1,10,9532,589801094,0,0,0,493.86,6,153706.69,24,4,22,2,True
1376576,1105,2,20,5585,589801094,0,0,0,493.92,5,153212.77,0,5,13,2,True
1411018,583,2,451,8475,589801094,0,0,0,494.0,7,152718.77,11,1,13,2,True
1448909,1155,0,10,4803,589801094,0,0,0,493.94,6,153212.71,15,1,16,2,True
1616869,281,1,10,7322,589801094,0,0,0,493.88,0,153706.59,24,6,12,3,True
1790693,1243,2,451,2711,589801094,0,0,0,494.08,7,153212.51,18,0,4,5,True
2093049,1211,4,451,7133,589801094,0,0,0,493.87,7,152718.64,24,0,17,6,True
2197596,1243,2,30,8583,589801094,0,0,0,494.0,8,152224.64,18,1,14,6,True
2312374,257,1,10,6223,589801094,0,0,0,494.07,0,152718.71,6,4,14,7,True
3671490,583,2,25,8583,589801094,0,0,0,493.79,8,152224.92,11,3,18,9,False
4184637,583,2,25,6537,589801094,0,0,0,494.17,8,151730.75,11,3,17,9,True
4513757,1243,2,30,7133,589801094,0,0,0,494.01,8,151236.74,18,4,16,9,False
4609954,1159,0,10,9532,589801094,0,0,0,494.18,6,151730.92,15,2,14,10,False
4635651,1243,2,30,7133,589801094,0,0,0,494.17,8,151236.75,18,0,9,10,False
4648426,583,2,25,6436,589801094,0,0,0,493.91,8,150742.84,11,2,10,11,True
4752093,1377,0,20,6943,589801094,0,0,0,493.73,3,150249.11,16,0,1,12,True
5032756,1243,2,451,6921,589801094,0,0,0,494.28,7,149754.83,18,2,1,12,True
5336218,583,2,30,6376,589801094,0,0,0,494.04,8,149260.79,11,2,23,1,True
5668894,558,0,20,6921,589801094,0,0,0,494.11,3,148766.68,17,3,1,1,True
5730777,583,2,451,8671,589801094,0,0,0,493.77,7,148272.91,11,6,11,1,True
5938897,1211,4,30,9170,589801094,0,0,0,494.26,8,147778.65,24,4,5,1,True
6001993,1243,2,25,9992,589801094,0,0,0,493.97,8,147284.68,18,2,19,2,True
6037508,463,1,10,8671,589801094,0,0,0,494.11,6,147778.79,13,1,9,2,True
6072726,1086,0,20,9532,589801094,0,0,0,494.06,5,147284.73,18,3,15,3,True
6141949,583,2,451,4803,589801094,0,0,0,493.93,7,146790.8,11,4,20,3,True
6250099,1304,0,10,2026,589801094,0,0,0,494.05,6,147284.85,5,3,9,4,False
6548209,1243,2,30,8475,589801094,0,0,0,494.32,8,146790.53,18,2,15,4,True
6735264,1379,3,30,8475,589801094,0,0,0,493.97,8,146296.56,16,3,7,6,True
6911661,1379,3,30,9018,589801094,0,0,0,493.73,8,145802.83,16,4,3,6,True
6929836,1243,2,30,7757,589801094,0,0,0,494.02,8,145308.81,18,2,1,7,True
7142379,1101,2,-1,8671,589801094,0,1,0,493.84,4,145308.81,0,4,22,8,True
7282480,444,2,20,9009,589801094,0,0,0,493.96,5,144814.85,24,2,6,8,True
7521384,1101,2,30,2711,589801094,0,0,0,494.03,8,144320.82,0,1,18,9,True
7630573,583,2,-1,2026,589801094,0,1,0,494.14,4,144320.82,11,5,21,10,True
8333795,1379,3,25,6376,589801094,0,0,0,494.0,8,143826.82,16,0,9,10,True
8334482,1379,3,451,2411,589801094,0,0,0,494.21,7,143332.61,16,0,1,10,True
8342682,1243,2,451,4803,589801094,0,0,0,494.0,7,142838.61,18,2,3,10,True
8405878,1211,4,451,7322,589801094,0,0,0,494.0,7,142344.61,24,4,5,10,True
8433769,1379,3,30,9170,589801094,0,0,0,493.97,8,141850.64,16,0,21,12,True
8647072,583,2,451,6376,589801094,0,0,0,494.13,7,141356.51,11,2,18,12,True
8717817,1243,2,30,2026,589801094,0,0,0,493.87,8,140862.64,18,5,7,3,True
8775167,562,1,10,2411,589801094,0,0,0,494.32,0,141356.96,17,1,14,3,True
8866666,1379,3,451,2711,589801094,0,0,0,494.05,7,140862.91,16,4,16,4,True
8940211,1243,2,25,2231,589801094,0,0,0,493.9,8,140369.01,18,0,8,4,True
8969143,1101,2,25,7207,589801094,0,0,0,494.14,8,139874.87,0,5,10,5,True
9123139,497,0,10,4803,589801094,0,0,0,494.18,6,140369.05,12,0,12,6,True
9226228,1211,4,451,6436,589801094,0,0,0,493.85,7,139875.2,24,0,16,6,True
9241194,1243,2,30,8475,589801094,0,0,0,493.8,8,139381.4,18,4,1,7,True
9429857,1211,4,25,6155,589801094,0,0,0,493.84,8,138887.56,24,3,20,8,True
9515821,939,0,20,9018,589801094,0,0,0,494.01,5,138393.55,24,4,6,8,True
9516324,1243,2,-1,6921,589801094,0,1,0,494.08,1,138393.55,18,4,14,8,True
9540043,1379,3,30,8671,589801094,0,0,0,494.11,8,137899.44,16,6,22,9,True
9567459,1101,2,451,6436,589801094,0,0,0,494.04,7,137405.4,0,5,2,9,True
9624296,1101,2,30,6155,589801094,0,0,0,493.71,8,136911.69,0,2,16,9,True
9720599,583,2,451,9018,589801094,0,0,0,493.98,7,136417.71,11,6,5,9,True
9807651,583,2,25,9009,589801094,0,0,0,493.84,8,135923.87,11,1,21,10,True
1031567,551,0,20,4107,853343039,0,0,0,290.91,3,905043.09,17,1,22,1,True
1127945,415,4,30,1812,853343039,0,0,0,290.91,8,904752.18,18,5,5,2,True
1269857,58,2,-1,2369,853343039,0,1,0,290.84,1,904752.18,20,6,8,3,True
1388700,879,1,25,1733,853343039,0,0,0,291.2,8,904460.98,27,5,14,5,True
1649029,918,2,20,3180,853343039,0,0,0,291.05,5,904169.93,18,6,3,5,True
2092746,879,1,30,1733,853343039,0,0,0,290.71,8,903879.22,27,3,7,5,True
2192988,512,0,10,9562,853343039,0,0,0,290.81,6,904170.03,12,4,15,8,True
2284504,587,2,451,3557,853343039,0,0,0,290.95,7,903879.08,24,0,16,10,True
2798134,1212,0,20,2369,853343039,0,0,0,290.86,5,903588.22,24,0,19,10,True
2883958,774,2,20,4107,853343039,0,0,0,290.84,5,903297.38,14,1,11,11,True
2999117,1103,4,30,8856,853343039,0,0,0,290.76,8,903006.62,0,1,7,12,True
3170412,879,1,451,9629,853343039,0,0,0,290.89,7,902715.73,27,3,14,1,True
3251853,879,1,451,4415,853343039,0,0,0,290.9,7,902424.83,27,6,2,4,True
3476103,415,4,30,5409,853343039,0,0,0,291.1,8,902133.73,18,3,11,5,True
3543596,1103,4,451,4982,853343039,0,0,0,290.81,7,901842.92,0,6,15,5,True
3807694,1103,4,30,8856,853343039,0,0,0,290.85,8,901552.07,0,4,5,6,True
3837507,587,2,30,4415,853343039,0,0,0,291.05,8,901261.02,24,2,1,6,True
3856192,1103,4,451,5409,853343039,0,0,0,291.0,7,900970.02,0,3,15,6,True
4013245,879,1,-1,4415,853343039,0,1,0,290.9,4,900970.02,27,6,0,7,True
4059456,1103,4,-1,9629,853343039,0,2,0,290.94,4,900970.02,0,3,11,7,True
4145857,879,1,30,5959,853343039,0,0,0,291.16,8,900678.86,27,1,9,7,True
4235822,887,2,20,5409,853343039,0,0,0,291.16,5,900387.7,27,1,12,8,True
4466206,58,2,-1,2369,853343039,0,1,0,291.04,1,900387.7,20,2,20,11,True
4484655,58,2,30,9562,853343039,0,0,0,291.1,8,900096.6,20,2,3,11,True
4639451,58,2,25,2854,853343039,0,0,0,291.16,8,899805.44,20,4,21,11,True
4658896,309,0,20,5006,853343039,0,0,0,291.23,5,899514.21,4,2,20,12,True
4917651,415,4,30,2854,853343039,0,0,0,291.2,8,899223.01,18,1,12,12,True
4968584,879,1,25,2369,853343039,0,0,0,290.79,8,898932.22,27,3,10,1,True
5168572,415,4,-1,1812,853343039,0,1,0,290.99,4,898932.22,18,0,11,6,True
5380466,415,4,-1,4982,853343039,0,2,0,291.11,1,898932.22,18,0,15,7,True
5402826,58,2,-1,1733,853343039,0,3,1,290.83,4,0.0,20,3,3,7,True
1164332,711,2,30,6613,397583634,1,0,0,444.87,8,268207.13,18,1,21,1,True
1182647,1101,2,451,5991,397583634,1,0,0,444.84,7,267762.29,0,3,2,2,True
1188298,958,2,451,6613,397583634,1,0,0,445.33,7,267316.96,13,4,20,2,True
1430361,665,2,451,6038,397583634,1,0,0,445.03,7,266871.93,18,2,5,2,True
1526378,711,2,30,6763,397583634,1,0,0,444.99,8,266426.94,18,5,14,3,True
1597719,837,3,30,3620,397583634,1,0,0,444.96,8,265981.98,5,4,18,3,True
1846115,837,3,-1,6226,397583634,1,1,0,445.08,1,265981.98,5,0,1,3,True
1880357,1110,0,10,4069,397583634,1,0,0,444.7,6,266426.68,0,6,9,4,True
1990748,445,0,10,4069,397583634,1,0,0,444.92,0,266871.6,13,6,19,6,True
2644382,958,2,451,4816,397583634,1,0,0,445.0,7,266426.6,13,4,17,7,True
2798672,312,0,20,5953,397583634,1,0,0,445.06,5,265981.54,4,0,3,8,True
2824739,711,2,451,8261,397583634,1,0,0,445.11,7,265536.43,18,4,14,8,True
3200095,385,1,10,5373,397583634,1,0,0,444.9,6,265981.33,25,1,6,8,True
3287002,711,2,451,8261,397583634,1,0,0,445.24,7,265536.09,18,2,16,8,True
3480433,804,0,20,1638,397583634,1,0,0,444.89,5,265091.2,11,0,1,9,True
3682657,837,3,-1,1416,397583634,1,1,0,444.95,4,265091.2,5,4,7,11,True
3809683,958,2,30,6763,397583634,1,0,0,445.29,8,264645.91,13,3,22,11,True
4023882,711,2,451,5373,397583634,1,0,0,445.12,7,264200.79,18,6,13,11,True
4194844,711,2,30,5260,397583634,1,0,0,445.13,8,263755.66,18,3,18,12,True
4205433,665,2,30,5260,397583634,1,0,0,445.06,8,263310.6,18,6,12,12,False
4258506,268,2,20,7466,397583634,1,0,0,445.07,3,262865.53,24,3,13,12,True
4355596,665,2,25,6763,397583634,1,0,0,444.97,8,262420.56,18,4,23,1,True
4364843,562,1,10,6226,397583634,1,0,0,444.91,6,262865.47,17,6,21,2,False
4694485,1312,0,10,5143,397583634,1,0,0,445.03,0,263310.5,5,5,20,3,False
4921534,711,2,30,5953,397583634,1,0,0,445.08,8,262865.42,18,6,16,3,True
5079792,1101,2,451,3284,397583634,1,0,0,445.01,7,262420.41,0,3,11,3,True
5096274,1101,2,30,4069,397583634,1,0,0,444.9,8,261975.51,0,3,1,3,True
5220519,1101,2,30,3620,397583634,1,0,0,444.9,8,261530.61,0,6,20,5,True
5941241,299,1,10,9215,397583634,1,0,0,444.83,6,261975.44,4,0,18,6,True
6163908,958,2,-1,6763,397583634,1,1,0,445.06,4,261975.44,13,0,15,6,True
6319292,837,3,30,3284,397583634,1,0,0,445.25,8,261530.19,5,1,4,6,True
6401894,369,1,10,2810,397583634,1,0,0,445.31,0,261975.5,25,6,19,7,False
6616155,712,0,10,1416,397583634,1,0,0,445.27,6,262420.77,18,1,10,9,True
6657367,665,2,451,3698,397583634,1,0,0,444.86,7,261975.91,18,5,9,9,False
6963001,913,0,20,6402,397583634,1,0,0,444.91,5,261531.0,18,1,12,10,True
6977772,958,2,-1,4123,397583634,1,1,0,444.72,1,261531.0,13,0,15,10,True
7048889,711,2,451,3698,397583634,1,0,0,445.4,7,261085.6,18,4,13,11,True
7065566,553,1,10,7540,397583634,1,0,0,444.66,0,261530.26,17,1,1,12,True
7281083,713,0,10,6226,397583634,1,0,0,444.84,0,261975.1,18,4,3,1,True
7532907,711,2,451,5953,397583634,1,0,0,444.9,7,261530.2,18,4,23,1,True
7693781,837,3,451,3620,397583634,1,0,0,444.94,7,261085.26,5,0,11,2,True
7813658,837,3,30,1638,397583634,1,0,0,445.03,8,260640.23,5,5,7,4,False
7920678,711,2,25,7466,397583634,1,0,0,445.08,8,260195.15,18,6,6,4,True
8319771,958,2,30,8261,397583634,1,0,0,444.76,8,259750.39,13,5,17,5,True
8582226,711,2,30,9993,397583634,1,0,0,445.08,8,259305.31,18,3,13,5,True
8762878,958,2,-1,2166,397583634,1,1,0,445.14,4,259305.31,13,5,13,6,True
8881679,837,3,25,7466,397583634,1,0,0,444.95,8,258860.36,5,5,8,6,True
8906745,711,2,451,5143,397583634,1,0,0,444.66,7,258415.7,18,2,15,7,True
9097777,711,2,25,5143,397583634,1,0,0,445.08,8,257970.62,18,6,16,7,True
9200316,837,3,30,5991,397583634,1,0,0,445.11,8,257525.51,5,4,23,8,True
9363420,665,2,-1,5904,397583634,1,1,0,444.8,4,257525.51,18,4,16,8,True
9371744,958,2,25,9993,397583634,1,0,0,444.93,8,257080.58,13,4,7,9,True
9436592,665,2,25,4816,397583634,1,0,0,445.05,8,256635.53,18,6,4,9,True
9632191,711,2,30,6763,397583634,1,0,0,445.2,8,256190.33,18,5,4,10,True
9646043,665,2,30,6402,397583634,1,0,0,444.93,8,255745.4,18,0,22,10,True
9696724,711,2,30,8872,397583634,1,0,0,444.93,8,255300.47,18,4,8,10,True
9809043,471,0,10,1638,397583634,1,0,0,445.19,6,255745.66,5,0,5,11,True
1015801,182,1,10,1272,178753471,0,0,0,963.98,0,425556.98,18,6,19,1,True
1396955,1389,4,-1,2705,178753471,0,1,0,963.89,4,425556.98,24,2,23,2,True
1535570,911,3,30,3512,178753471,0,0,0,963.94,8,424593.04,18,5,4,3,True
1577992,1389,4,451,5233,178753471,0,0,0,964.13,7,423628.91,24,6,10,3,True
1726310,1094,0,451,2812,178753471,0,0,0,964.08,7,422664.83,0,4,15,5,True
2042599,269,0,30,1551,178753471,0,0,0,963.9,8,421700.93,24,4,9,5,True
2165319,260,0,10,8062,178753471,0,0,0,964.21,6,422665.14,6,4,12,8,True
2475226,463,1,-1,1936,178753471,0,1,0,963.95,4,422665.14,13,4,11,9,True
3151531,971,4,451,7941,178753471,0,0,0,964.01,7,421701.13,13,0,20,10,True
3276670,269,0,-1,6118,178753471,0,1,0,963.83,4,421701.13,24,4,4,10,True
3352405,911,3,30,7941,178753471,0,0,0,963.7,8,420737.43,18,0,3,12,True
3419353,971,4,30,7941,178753471,0,0,0,963.74,8,419773.69,13,0,11,12,True
3456104,967,1,10,6134,178753471,0,0,0,963.92,6,420737.61,13,6,9,1,True
4377545,1317,4,451,8062,178753471,0,0,0,963.75,7,419773.86,18,1,18,1,True
4542962,309,0,10,6134,178753471,0,0,0,964.06,6,420737.92,4,0,1,1,True
4579369,442,3,30,3573,178753471,0,0,0,963.52,8,419774.4,24,0,22,1,True
4647662,1317,4,451,6134,178753471,0,0,0,964.13,7,418810.27,18,2,23,1,True
4756308,476,1,10,5130,178753471,0,0,0,963.95,0,419774.22,5,3,10,2,True
4775844,1389,4,451,1272,178753471,0,0,0,963.98,7,418810.24,24,0,22,3,True
4854012,463,1,451,2871,178753471,0,0,0,963.75,7,417846.49,13,2,14,3,True
5054298,1317,4,30,7941,178753471,0,0,0,964.09,8,416882.4,18,6,19,4,True
5068347,497,0,10,1551,178753471,0,0,0,963.93,0,417846.33,12,1,14,4,True
5999343,130,0,10,6118,178753471,0,0,0,963.93,6,418810.26,18,5,19,5,True
6624121,1172,3,451,2812,178753471,0,0,0,963.99,7,417846.27,24,5,1,5,True
6788648,1389,4,451,7941,178753471,0,0,0,964.14,7,416882.13,24,6,8,8,True
7029589,442,3,30,5233,178753471,0,0,0,964.08,8,415918.05,24,5,22,8,True
7114133,269,0,451,5888,178753471,0,0,0,964.21,7,414953.84,24,1,7,9,True
7196088,463,1,-1,3512,178753471,0,1,0,963.7,1,414953.84,13,2,9,9,True
7455600,463,1,25,2871,178753471,0,0,0,963.67,8,413990.17,13,0,17,10,True
7652090,463,1,451,1272,178753471,0,0,0,963.93,7,413026.24,13,4,15,10,True
7820812,325,0,10,3580,178753471,0,0,0,963.93,6,413990.17,11,2,1,11,True
7837005,1429,0,20,5888,178753471,0,0,0,963.99,3,413026.18,24,2,20,11,True
7960985,732,0,20,2812,178753471,0,0,0,963.92,3,412062.26,11,1,15,12,True
8190078,1172,3,-1,3580,178753471,0,1,0,963.77,4,412062.26,24,4,13,1,True
8253050,325,0,20,1272,178753471,0,0,0,963.95,5,411098.31,11,6,22,2,True
8276514,1389,4,-1,1551,178753471,0,1,0,964.05,1,411098.31,24,5,1,2,True
8546806,1389,4,30,1551,178753471,0,0,0,964.12,8,410134.19,24,3,5,2,True
8643485,442,3,30,2705,178753471,0,0,0,964.11,8,409170.08,24,2,14,3,True
8727755,1317,4,30,6134,178753471,0,0,0,964.12,8,408205.96,18,3,5,3,True
8748858,911,3,30,6134,178753471,0,0,0,964.12,8,407241.84,18,5,1,4,True
8850002,1172,3,25,5888,178753471,0,0,0,964.12,8,406277.72,24,1,19,4,True
8889615,1389,4,-1,5233,178753471,0,1,0,963.69,4,406277.72,24,0,11,5,True
8986938,900,1,10,5233,178753471,0,0,0,963.96,6,407241.68,24,0,18,5,True
9114235,463,1,451,8062,178753471,0,0,0,964.08,7,406277.6,13,0,23,5,True
9133462,911,3,451,3580,178753471,0,0,0,963.99,7,405313.61,18,5,15,7,True
9147139,1317,4,25,8062,178753471,0,0,0,963.93,8,404349.68,18,6,19,7,True
9159060,463,1,10,5233,178753471,0,0,0,963.98,0,405313.66,13,3,16,8,True
9196192,1317,4,451,6134,178753471,0,0,0,964.2,7,404349.46,18,6,4,8,True
9505155,911,3,451,3580,178753471,0,0,0,964.07,7,403385.39,18,4,2,8,False
9556623,269,0,25,8062,178753471,0,0,0,964.05,8,402421.34,24,1,5,8,True
9690455,971,4,-1,5888,178753471,0,1,0,963.89,1,402421.34,13,0,6,10,True
9944425,442,3,30,3580,178753471,0,0,0,964.12,8,401457.22,24,0,7,10,True
1081392,1227,0,451,7632,821697781,1,0,0,583.98,7,126799.02,18,0,14,1,True
1129212,21,0,10,3492,821697781,1,0,0,584.12,0,127383.14,11,2,15,2,True
1135156,425,4,30,5536,821697781,1,0,0,583.85,8,126799.29,18,2,13,2,True
1191271,329,1,10,9973,821697781,1,0,0,583.91,0,127383.2,11,3,2,4,True
1244188,1227,0,-1,7494,821697781,1,1,0,583.98,4,127383.2,18,6,2,4,True
1244733,1325,0,20,3241,821697781,1,0,0,584.13,5,126799.07,18,0,16,5,True
1286540,142,4,30,7494,821697781,1,0,0,583.77,8,126215.3,18,0,5,6,True
1309585,531,0,10,5390,821697781,1,0,0,583.99,6,126799.29,18,5,23,7,True
2009962,914,2,30,3824,821697781,1,0,0,583.85,8,126215.44,18,2,22,7,True
2770294,914,2,-1,5038,821697781,1,1,0,584.07,1,126215.44,18,5,21,8,True
2809093,503,0,20,4633,821697781,1,0,0,584.2,5,125631.24,12,1,12,8,True
2891479,914,2,451,6413,821697781,1,0,0,583.79,7,125047.45,18,2,12,9,True
3482426,142,4,25,1143,821697781,1,0,0,583.99,8,124463.46,18,5,15,10,True
3689251,287,0,20,7279,821697781,1,0,0,583.82,3,123879.64,24,0,0,10,True
3992191,142,4,451,5222,821697781,1,0,0,583.77,7,123295.87,18,1,20,10,True
4207509,142,4,451,5038,821697781,1,0,0,584.07,7,122711.8,18,5,11,11,True
4216488,1227,0,451,2083,821697781,1,0,0,583.74,7,122128.06,18,0,22,12,True
4407307,914,2,25,3241,821697781,1,0,0,584.18,8,121543.88,18,4,16,12,True
4576163,962,0,10,1143,821697781,1,0,0,584.08,6,122127.96,13,5,0,12,True
4576645,914,2,451,4633,821697781,1,0,0,584.1,7,121543.86,18,5,9,1,True
4620565,525,0,10,6059,821697781,1,0,0,583.93,6,122127.79,18,6,16,2,True
5172096,796,2,20,3492,821697781,1,0,0,584.05,5,121543.74,11,1,12,3,True
5198024,1351,4,25,7632,821697781,1,0,0,584.14,8,120959.6,24,1,17,3,True
5323434,1227,0,451,7632,821697781,1,0,0,584.02,7,120375.58,18,2,19,4,True
5396601,142,4,451,6413,821697781,1,0,0,583.9,7,119791.68,18,0,21,5,True
5427077,914,2,30,6059,821697781,1,0,0,584.03,8,119207.65,18,3,4,7,True
5861597,1405,4,451,7494,821697781,1,0,0,583.9,7,118623.75,24,5,22,8,True
5952283,1206,0,10,5830,821697781,1,0,0,584.15,6,119207.9,24,0,2,8,True
6055614,1351,4,451,7494,821697781,1,0,0,583.84,7,118624.06,24,5,15,8,True
6083042,914,2,451,9269,821697781,1,0,0,583.91,7,118040.15,18,0,10,9,True
6102876,914,2,25,5536,821697781,1,0,0,583.81,8,117456.34,18,5,2,10,True
6205149,914,2,451,3824,821697781,1,0,0,583.92,7,116872.42,18,1,8,1,True
6437170,1227,0,451,3824,821697781,1,0,0,583.72,7,116288.7,18,0,13,1,True
6858172,673,0,20,3492,821697781,1,0,0,583.77,5,115704.93,18,1,2,2,True
7100761,914,2,25,6413,821697781,1,0,0,583.73,8,115121.2,18,3,0,2,True
7366393,1065,0,451,1143,821697781,1,0,0,584.06,7,114537.14,11,5,4,3,True
7424199,1405,4,-1,1163,821697781,1,1,0,584.11,4,114537.14,24,2,0,3,True
7438069,1065,0,30,3492,821697781,1,0,0,583.97,8,113953.17,11,3,2,3,True
7445319,914,2,-1,7989,821697781,1,1,0,583.92,4,113953.17,18,3,23,3,True
7663731,1351,4,451,9973,821697781,1,0,0,584.2,7,113368.97,24,4,18,3,True
7831990,914,2,451,9269,821697781,1,0,0,584.07,7,112784.9,18,6,0,3,True
7879579,425,4,451,3492,821697781,1,0,0,584.03,7,112200.87,18,2,14,4,True
8192283,1227,0,451,3492,821697781,1,0,0,584.08,7,111616.79,18,5,5,4,True
8199193,1351,4,30,3824,821697781,1,0,0,584.08,8,111032.71,24,4,20,6,True
8278825,1351,4,25,1143,821697781,1,0,0,584.15,8,110448.56,24,4,3,6,True
8284453,142,4,30,7989,821697781,1,0,0,583.95,8,109864.61,18,5,21,6,True
8338657,1227,0,451,4633,821697781,1,0,0,583.72,7,109280.89,18,1,10,7,True
8542269,445,0,20,6413,821697781,1,0,0,584.1,3,108696.79,13,3,20,7,True
8687985,123,0,10,7632,821697781,1,0,0,584.02,6,109280.81,18,0,12,7,True
8832176,550,0,20,3241,821697781,1,0,0,584.05,3,108696.76,17,1,18,8,True
8847522,1351,4,30,7632,821697781,1,0,0,584.26,8,108112.5,24,3,15,8,True
9273014,142,4,451,7279,821697781,1,0,0,583.96,7,107528.54,18,4,7,11,True
9284483,1065,0,25,6413,821697781,1,0,0,584.02,8,106944.52,11,0,14,11,True
9751257,1065,0,25,9269,821697781,1,0,0,584.08,8,106360.44,11,2,15,11,True
9837830,616,1,10,3241,821697781,1,0,0,583.55,6,106943.99,11,6,5,11,True
9838710,425,4,25,5038,821697781,1,0,0,583.72,8,106360.27,18,0,16,11,True
1077206,994,4,30,5516,820320751,0,0,0,1095.88,8,376078.12,22,2,18,1,True
1324920,1284,2,25,8835,820320751,0,0,0,1095.87,8,374982.25,24,4,0,1,True
1712230,1284,2,30,7061,820320751,0,0,0,1095.95,8,373886.3,24,4,3,1,True
1805042,202,4,-1,9810,820320751,0,1,0,1096.32,4,373886.3,9,4,18,1,True
1884375,1284,2,25,8257,820320751,0,0,0,1096.07,8,372790.23,24,0,3,1,True
2063888,1352,1,10,5516,820320751,0,0,0,1095.95,0,373886.18,24,1,12,3,True
2625416,1060,1,451,9810,820320751,0,0,0,1096.05,7,372790.13,11,6,19,3,True
2785865,909,2,451,8110,820320751,0,0,0,1095.96,7,371694.17,18,2,8,3,True
2981405,1217,0,20,7061,820320751,0,0,0,1096.45,3,370597.72,24,3,0,4,True
3000344,809,3,25,8257,820320751,0,0,0,1095.84,8,369501.88,11,0,16,5,True
3272464,202,4,-1,8855,820320751,0,1,0,1096.09,4,369501.88,9,3,13,6,True
3521719,1445,2,20,8257,820320751,0,0,0,1095.83,3,368406.05,24,2,10,6,True
3548846,1140,0,20,1762,820320751,0,0,0,1096.18,3,367309.87,15,6,15,7,True
3771260,994,4,-1,3675,820320751,0,1,0,1095.9,4,367309.87,22,0,2,8,True
3928218,463,1,451,4159,820320751,0,0,0,1096.4,7,366213.47,13,4,4,9,True
4040647,994,4,451,3164,820320751,0,0,0,1095.78,7,365117.69,22,5,8,9,True
4117507,909,2,25,9810,820320751,0,0,0,1095.89,8,364021.8,18,0,4,11,True
4125162,1060,1,25,3380,820320751,0,0,0,1095.97,8,362925.83,11,0,12,11,True
4498533,167,2,20,8855,820320751,0,0,0,1095.76,3,361830.07,24,1,12,12,True
4625616,1284,2,451,4159,820320751,0,0,0,1095.76,7,360734.31,24,5,9,12,True
4632442,997,3,30,5893,820320751,0,0,0,1095.84,8,359638.47,26,5,7,1,True
5753395,767,0,20,8855,820320751,0,0,0,1095.84,5,358542.63,14,5,22,2,True
5946632,909,2,30,8769,820320751,0,0,0,1095.86,8,357446.77,18,0,5,2,True
6025349,1072,0,20,5239,820320751,0,0,0,1095.98,5,356350.79,18,1,15,2,True
6063819,997,3,-1,8769,820320751,0,1,0,1095.97,4,356350.79,26,3,21,2,True
6095740,809,3,451,5239,820320751,0,0,0,1095.68,7,355255.11,11,2,7,5,True
6435313,22,3,451,4341,820320751,0,0,0,1096.01,7,354159.1,11,3,21,5,True
6577689,202,4,30,4130,820320751,0,0,0,1096.01,8,353063.09,9,3,22,6,False
6739502,997,3,451,8110,820320751,0,0,0,1096.28,7,351966.81,26,6,18,8,True
6831299,909,2,-1,5516,820320751,0,1,0,1095.88,4,351966.81,18,6,8,8,True
6831964,376,0,10,7061,820320751,0,0,0,1095.99,6,353062.8,25,4,2,9,True
6912354,202,4,451,3675,820320751,0,0,0,1096.14,7,351966.66,9,5,5,9,True
7282897,1284,2,451,4130,820320751,0,0,0,1095.99,7,350870.67,24,5,14,10,True
7312838,1284,2,30,8769,820320751,0,0,0,1096.18,8,349774.49,24,4,14,10,True
7749833,463,1,25,4130,820320751,0,0,0,1095.98,8,348678.51,13,2,13,11,True
7989386,127,1,10,8769,820320751,0,0,0,1095.84,0,349774.35,18,2,21,11,True
8076850,149,2,20,8110,820320751,0,0,0,1095.92,3,348678.43,18,3,10,11,True
8100568,809,3,25,8110,820320751,0,0,0,1095.79,8,347582.64,11,1,16,12,True
8240670,809,3,451,3380,820320751,0,0,0,1096.06,7,346486.58,11,2,16,12,True
8257156,1284,2,25,8769,820320751,0,0,0,1096.02,8,345390.56,24,6,13,12,True
8361629,118,2,20,4130,820320751,0,0,0,1095.92,5,344294.64,18,4,7,12,True
8427554,1017,2,20,9395,820320751,0,0,0,1095.95,3,343198.69,26,4,14,12,True
8494200,463,1,25,8855,820320751,0,0,0,1096.23,8,342102.46,13,1,22,2,True
8498172,1101,2,20,8769,820320751,0,0,0,1096.04,5,341006.42,0,5,12,3,True
8502413,909,2,451,3380,820320751,0,0,0,1095.83,7,339910.59,18,4,14,3,True
8519754,463,1,25,4130,820320751,0,0,0,1095.8,8,338814.79,13,6,7,3,True
8531181,809,3,451,4130,820320751,0,0,0,1096.24,7,337718.55,11,3,20,3,True
8622481,463,1,451,8835,820320751,0,0,0,1096.03,7,336622.52,13,4,20,7,True
8945880,909,2,451,4159,820320751,0,0,0,1095.86,7,335526.66,18,0,2,7,True
9730740,1060,1,451,9395,820320751,0,0,0,1095.99,7,334430.67,11,5,19,8,True
9771078,1284,2,-1,9810,820320751,0,1,0,1095.64,4,334430.67,24,4,15,8,True
9784384,530,0,10,1762,820320751,0,0,0,1095.87,6,335526.54,18,6,1,10,True
9993178,909,2,-1,8110,820320751,0,1,0,1096.26,4,335526.54,18,3,3,10,True
1045534,362,0,451,4042,493618293,1,0,0,626.83,7,461840.17,24,2,4,1,True
1140435,192,2,30,5937,493618293,1,0,0,627.2,8,461212.97,18,6,17,1,True
1240401,362,0,451,4604,493618293,1,0,0,627.2,7,460585.77,24,0,22,2,True
1267634,218,0,20,9794,493618293,1,0,0,626.8,5,459958.97,9,3,17,2,True
1444937,1476,0,-1,9794,493618293,1,1,0,626.93,4,459958.97,24,5,6,2,True
1531258,1058,4,25,9324,493618293,1,0,0,627.09,8,459331.88,11,0,13,2,True
1672177,94,3,30,1421,493618293,1,0,0,626.94,8,458704.94,1,0,6,3,True
1757882,130,0,10,3219,493618293,1,0,0,626.84,0,459331.78,18,5,4,4,True
1983843,1476,0,30,9324,493618293,1,0,0,626.94,8,458704.84,24,4,9,4,True
2101424,1215,3,-1,5937,493618293,1,1,0,627.01,4,458704.84,24,1,8,5,True
2287503,192,2,451,3520,493618293,1,0,0,627.12,7,458077.72,18,4,14,5,True
2417227,1029,0,20,1948,493618293,1,0,0,627.12,5,457450.6,11,2,21,5,True
2454221,1215,3,25,5612,493618293,1,0,0,626.85,8,456823.75,24,1,2,5,True
2744530,94,3,451,4192,493618293,1,0,0,626.93,7,456196.82,1,2,2,6,True
3020633,300,0,10,4042,493618293,1,0,0,627.04,0,456823.86,4,1,19,6,True
3460649,411,2,20,4604,493618293,1,0,0,627.07,5,456196.79,18,3,10,6,True
3523979,362,0,30,1948,493618293,1,0,0,626.93,8,455569.86,24,4,14,8,True
3670253,278,1,-1,4042,493618293,1,1,0,626.88,4,455569.86,24,5,20,8,True
3834096,278,1,-1,8158,493618293,1,2,0,626.8,4,455569.86,24,4,9,8,False
3860487,967,1,10,3219,493618293,1,0,0,627.16,6,456197.02,13,2,0,8,True
3882249,94,3,25,4042,493618293,1,0,0,627.07,8,455569.95,1,5,1,9,False
3887213,192,2,25,4604,493618293,1,0,0,626.85,8,454943.1,18,5,11,10,True
4022076,1476,0,-1,9324,493618293,1,1,0,626.96,4,454943.1,24,4,14,12,True
4048278,1058,4,30,1421,493618293,1,0,0,626.96,8,454316.14,11,4,18,12,True
4087317,1476,0,25,4604,493618293,1,0,0,627.23,8,453688.91,24,1,13,12,True
4251990,1476,0,25,3219,493618293,1,0,0,627.1,8,453061.81,24,3,21,1,True
4590502,1058,4,25,1421,493618293,1,0,0,626.88,8,452434.93,11,1,4,1,True
4834346,1476,0,451,4604,493618293,1,0,0,626.85,7,451808.08,24,1,0,2,True
4857932,362,0,25,4192,493618293,1,0,0,627.2,8,451180.88,24,1,13,2,True
4894424,94,3,451,4199,493618293,1,0,0,626.95,7,450553.93,1,1,10,3,True
4916045,278,1,-1,4042,493618293,1,1,0,627.13,4,450553.93,24,1,3,3,True
4978581,1476,0,30,4199,493618293,1,0,0,626.95,8,449926.98,24,4,13,4,True
4989305,278,1,451,9324,493618293,1,0,0,626.83,7,449300.15,24,0,3,4,True
5255868,278,1,30,9937,493618293,1,0,0,627.16,8,448672.99,24,1,10,4,True
5703577,1215,3,-1,8158,493618293,1,1,0,627.03,4,448672.99,24,0,19,5,True
5848738,362,0,25,3520,493618293,1,0,0,626.97,8,448046.02,24,1,5,5,False
5921063,1476,0,451,3520,493618293,1,0,0,627.25,7,447418.77,24,5,14,8,True
6005699,1391,2,20,1421,493618293,1,0,0,626.84,3,446791.93,24,4,22,8,False
6061634,939,0,10,5150,493618293,1,0,0,626.95,6,447418.88,24,0,15,8,True
6351340,278,1,451,4192,493618293,1,0,0,627.2,7,446791.68,24,0,7,8,True
6451422,192,2,30,1948,493618293,1,0,0,626.99,8,446164.69,18,3,3,9,False
6617694,278,1,451,2244,493618293,1,0,0,627.01,7,445537.68,24,4,9,10,True
6637385,94,3,30,3219,493618293,1,0,0,626.84,8,444910.84,1,5,2,10,False
6771100,192,2,25,4192,493618293,1,0,0,627.46,8,444283.38,18,3,15,10,True
6984798,689,0,20,9324,493618293,1,0,0,626.95,3,443656.43,24,0,4,10,True
7206255,918,2,20,9324,493618293,1,0,0,626.81,3,443029.62,18,2,16,11,True
7266119,1215,3,451,9937,493618293,1,0,0,626.84,7,442402.78,24,2,11,12,True
7911027,560,2,20,4042,493618293,1,0,0,627.3,5,441775.48,17,4,16,1,True
8029377,1476,0,-1,9937,493618293,1,1,0,626.85,4,441775.48,24,4,14,2,True
8055829,998,0,20,8158,493618293,1,0,0,626.89,5,441148.59,26,4,3,3,True
8239656,1058,4,451,3219,493618293,1,0,0,626.76,7,440521.83,11,2,11,3,True
8877461,910,0,20,9794,493618293,1,0,0,626.63,5,439895.2,18,5,14,3,True
8977911,192,2,451,3520,493618293,1,0,0,627.01,7,439268.19,18,2,12,4,True
9132055,1215,3,30,1421,493618293,1,0,0,626.89,8,438641.3,24,5,0,5,True
9134828,537,0,10,4199,493618293,1,0,0,627.08,6,439268.38,18,6,7,7,True
9726162,362,0,451,1948,493618293,1,0,0,627.22,7,438641.16,24,5,11,8,True
9797801,739,1,10,5937,493618293,1,0,0,626.97,6,439268.13,24,1,21,11,True
1108218,357,4,451,7311,370075089,0,0,0,466.84,7,533495.16,24,0,10,1,True
1264827,1267,2,30,9488,370075089,0,0,0,467.13,8,533028.03,23,3,2,1,True
1719208,211,0,20,1821,370075089,0,0,0,467.18,3,532560.85,9,5,18,1,True
1722810,1429,0,30,7860,370075089,0,0,0,467.17,8,532093.68,24,0,5,1,True
1869487,147,0,10,3822,370075089,0,0,0,466.96,6,532560.64,18,6,16,2,True
1920831,373,1,25,1951,370075089,0,0,0,467.06,8,532093.58,25,4,14,3,True
2000580,291,3,451,1209,370075089,0,0,0,466.9,7,531626.68,24,1,23,3,True
2162086,357,4,451,9037,370075089,0,0,0,467.0,7,531159.68,24,3,16,3,True
2178853,357,4,451,6680,370075089,0,0,0,467.08,7,530692.6,24,5,5,4,True
2293879,860,1,25,3357,370075089,0,0,0,466.71,8,530225.89,24,1,13,4,True
2469875,291,3,30,1951,370075089,0,0,0,467.02,8,529758.87,24,2,4,4,True
2585599,1267,2,451,2683,370075089,0,0,0,467.12,7,529291.75,23,4,3,4,True
2657406,357,4,451,9037,370075089,0,0,0,466.91,7,528824.84,24,5,8,5,True
2753946,1429,0,25,6088,370075089,0,0,0,467.4,8,528357.44,24,1,9,5,True
3039611,1017,2,20,6680,370075089,0,0,0,466.78,5,527890.66,26,6,0,6,True
3123201,357,4,-1,1209,370075089,0,1,0,466.98,4,527890.66,24,4,18,6,True
3181827,1429,0,-1,1821,370075089,0,2,0,467.08,4,527890.66,24,6,7,7,True
3717130,860,1,25,7311,370075089,0,0,0,466.94,8,527423.72,24,4,5,7,True
3813764,962,0,20,8568,370075089,0,0,0,467.13,3,526956.59,13,1,0,8,True
3852905,373,1,-1,6521,370075089,0,1,0,466.95,1,526956.59,25,0,6,8,True
3970699,1429,0,30,6680,370075089,0,0,0,467.05,8,526489.54,24,4,12,9,True
4051850,1267,2,-1,8568,370075089,0,1,0,466.83,4,526489.54,23,4,18,10,True
4157861,348,0,10,3719,370075089,0,0,0,466.79,6,526956.33,24,6,11,12,True
4262876,889,0,20,6088,370075089,0,0,0,467.32,5,526489.01,27,0,12,12,True
4552668,1429,0,30,5064,370075089,0,0,0,466.97,8,526022.04,24,4,1,1,True
4827956,630,0,20,8165,370075089,0,0,0,467.18,3,525554.86,11,6,22,1,True
4867773,1429,0,25,1209,370075089,0,0,0,466.99,8,525087.87,24,5,8,2,True
4919812,373,1,451,7860,370075089,0,0,0,466.97,7,524620.9,25,3,12,3,True
5099138,732,0,10,1875,370075089,0,0,0,466.96,6,525087.86,11,0,4,4,True
5157518,1122,1,10,6521,370075089,0,0,0,466.8,6,525554.66,24,1,17,4,True
5365364,220,0,20,6254,370075089,0,0,0,467.13,3,525087.53,26,1,0,7,False
6374212,1180,1,10,1209,370075089,0,0,0,466.9,6,525554.43,24,1,4,7,True
6600697,275,0,20,3453,370075089,0,0,0,466.89,5,525087.54,24,4,0,7,True
6913581,860,1,451,8568,370075089,0,0,0,466.8,7,524620.74,24,2,10,8,True
6962097,860,1,25,9488,370075089,0,0,0,466.96,8,524153.78,24,4,19,8,True
7114310,373,1,25,7860,370075089,0,0,0,467.18,8,523686.6,25,0,17,8,True
7192002,538,0,20,1875,370075089,0,0,0,467.02,5,523219.58,18,0,9,10,True
7559791,860,1,-1,8165,370075089,0,1,0,466.94,4,523219.58,24,5,5,10,True
7668513,860,1,25,7860,370075089,0,0,0,467.14,8,522752.44,24,2,22,10,True
7881764,1429,0,25,6088,370075089,0,0,0,467.08,8,522285.36,24,0,8,11,True
8297254,1267,2,451,6521,370075089,0,0,0,466.97,7,521818.39,23,5,4,12,True
8367590,1267,2,25,6680,370075089,0,0,0,466.77,8,521351.62,23,5,23,12,True
8372602,727,0,10,8165,370075089,0,0,0,467.06,0,521818.68,11,1,14,2,True
8723024,882,0,10,1209,370075089,0,0,0,466.94,0,522285.62,27,2,10,2,True
8741068,1267,2,-1,3719,370075089,0,1,0,466.85,4,522285.62,23,2,16,4,True
8914206,603,0,10,6680,370075089,0,0,0,467.09,0,522752.71,24,6,21,5,True
9009049,860,1,25,5064,370075089,0,0,0,466.79,8,522285.92,24,0,12,6,True
9358861,818,1,10,3453,370075089,0,0,0,467.11,6,522753.03,18,6,16,6,True
9394936,1111,0,20,7860,370075089,0,0,0,467.23,5,522285.8,0,4,20,8,True
9454631,1461,0,20,8568,370075089,0,0,0,466.79,3,521819.01,11,6,17,8,True
9668086,1267,2,30,1875,370075089,0,0,0,466.88,8,521352.13,23,1,15,9,True
9668472,1436,0,10,6254,370075089,0,0,0,466.98,6,521819.11,24,1,8,10,True
9706069,1429,0,30,2683,370075089,0,0,0,466.83,8,521352.28,24,1,0,10,True
9889444,113,4,30,9037,370075089,0,0,0,467.01,8,520885.27,3,3,15,11,True
9961391,1089,0,10,9488,370075089,0,0,0,466.9,0,521352.17,18,3,14,11,True
1024014,1374,4,451,4982,810027619,0,0,0,176.4,7,743849.6,16,3,16,1,True
1028241,1123,2,30,9223,810027619,0,0,0,176.16,8,743673.44,24,6,5,3,True
1282263,1374,4,25,4330,810027619,0,0,0,175.83,8,743497.61,16,4,21,4,True
1665558,673,0,10,4728,810027619,0,0,0,176.04,6,743673.65,18,5,19,5,True
1677326,708,2,20,8295,810027619,0,0,0,175.93,3,743497.72,18,4,13,5,True
1746974,548,2,20,8965,810027619,0,0,0,176.14,3,743321.58,17,5,14,7,True
2117769,1363,0,20,5116,810027619,0,0,0,176.04,3,743145.54,16,5,13,8,True
2444417,1039,1,25,5624,810027619,0,0,0,176.01,8,742969.53,11,4,1,9,True
2452130,1123,2,-1,5713,810027619,0,1,0,176.23,4,742969.53,24,6,21,9,True
2493107,1123,2,-1,5713,810027619,0,2,0,175.93,1,742969.53,24,0,8,10,True
2511843,1039,1,451,4982,810027619,0,0,0,176.03,7,742793.5,11,0,14,10,True
2559734,611,0,10,2258,810027619,0,0,0,176.06,0,742969.56,11,5,8,10,True
2951298,267,0,30,4680,810027619,0,0,0,175.9,8,742793.66,6,6,5,10,True
3002291,1127,0,10,6594,810027619,0,0,0,176.14,0,742969.8,24,4,10,11,True
3166454,14,2,451,3430,810027619,0,0,0,176.04,7,742793.76,24,3,19,12,True
3302889,267,0,451,3359,810027619,0,0,0,175.8,7,742617.96,6,4,6,12,True
3482070,14,2,451,5722,810027619,0,0,0,175.86,7,742442.1,24,6,14,12,True
3613978,267,0,451,5598,810027619,0,0,0,176.21,7,742265.89,6,3,4,2,True
3752892,267,0,451,4680,810027619,0,0,0,176.05,7,742089.84,6,3,8,3,True
3791293,1039,1,451,3863,810027619,0,0,0,176.27,7,741913.57,11,5,13,3,True
4048310,297,0,10,4327,810027619,0,0,0,176.0,6,742089.57,4,4,3,4,True
4362127,267,0,-1,8295,810027619,0,1,0,175.99,1,742089.57,6,0,7,5,True
4792809,1039,1,451,8295,810027619,0,0,0,175.94,7,741913.63,11,2,8,5,True
5127439,1123,2,451,4327,810027619,0,0,0,175.9,7,741737.73,24,1,3,6,True
5176585,267,0,30,5624,810027619,0,0,0,176.08,8,741561.65,6,6,1,6,True
5226229,1123,2,451,4767,810027619,0,0,0,175.96,7,741385.69,24,0,15,8,True
5371849,1039,1,451,3035,810027619,0,0,0,175.72,7,741209.97,11,1,19,8,True
5657830,1039,1,25,8872,810027619,0,0,0,176.1,8,741033.87,11,6,15,8,True
5734300,369,1,10,4330,810027619,0,0,0,175.98,6,741209.85,25,0,3,8,True
5991787,1039,1,30,8872,810027619,0,0,0,176.04,8,741033.81,11,0,6,8,True
6157223,1123,2,30,5713,810027619,0,0,0,176.11,8,740857.7,24,4,22,9,True
6608029,799,2,20,3359,810027619,0,0,0,176.35,3,740681.35,11,1,2,9,True
6785472,496,1,10,6594,810027619,0,0,0,175.96,0,740857.31,12,2,23,10,True
7037897,1374,4,451,7164,810027619,0,0,0,175.98,7,740681.33,16,3,18,11,True
7124974,1123,2,451,2258,810027619,0,0,0,176.04,7,740505.29,24,2,13,11,True
7206526,1374,4,25,7164,810027619,0,0,0,176.05,8,740329.24,16,4,8,12,True
7370550,14,2,25,8872,810027619,0,0,0,175.95,8,740153.29,24,4,9,12,True
7781850,851,1,10,2583,810027619,0,0,0,176.17,6,740329.46,5,3,13,12,True
7832332,1039,1,30,2049,810027619,0,0,0,176.42,8,740153.04,11,3,17,12,True
7880314,1374,4,30,6594,810027619,0,0,0,175.95,8,739977.09,16,0,21,1,True
8250294,1374,4,-1,5598,810027619,0,1,0,175.87,1,739977.09,16,5,17,1,True
8397581,267,0,451,5129,810027619,0,0,0,176.09,7,739801.0,6,3,23,3,True
8449393,267,0,30,2436,810027619,0,0,0,175.96,8,739625.04,6,0,1,3,True
8485119,1039,1,25,5713,810027619,0,0,0,175.95,8,739449.09,11,1,15,5,True
8575206,1075,0,10,8733,810027619,0,0,0,175.98,6,739625.07,18,5,0,5,True
8620880,1374,4,-1,6594,810027619,0,1,0,175.86,4,739625.07,16,3,12,5,True
8780459,1374,4,-1,8904,810027619,0,2,0,176.08,4,739625.07,16,1,23,6,False
9062791,1374,4,451,5129,810027619,0,0,0,175.97,7,739449.1,16,3,18,6,True
9487687,267,0,30,8965,810027619,0,0,0,176.03,8,739273.07,6,0,7,6,True
9499532,267,0,451,3035,810027619,0,0,0,176.26,7,739096.81,6,6,6,7,True
9599657,14,2,30,2258,810027619,0,0,0,175.77,8,738921.04,24,2,12,7,True
9726780,1123,2,25,5722,810027619,0,0,0,176.07,8,738744.97,24,0,5,10,True
9797341,394,0,10,8965,810027619,0,0,0,176.17,0,738921.14,10,1,22,10,True
9862176,1374,4,-1,4330,810027619,0,1,0,176.09,4,738921.14,16,1,19,11,True
9965393,530,0,10,2049,810027619,0,0,0,176.11,6,739097.25,18,2,3,11,True
1449801,1039,1,451,6837,662630695,0,0,0,389.0,7,477039.0,11,2,22,1,True
1452260,1026,4,30,7291,662630695,0,0,0,389.23,8,476649.77,11,4,1,2,True
1644706,1297,0,30,5877,662630695,0,0,0,389.01,8,476260.76,5,0,12,2,True
2173491,749,4,25,8317,662630695,0,0,0,389.06,8,475871.7,24,3,12,6,True
2563838,1297,0,451,6368,662630695,0,0,0,389.11,7,475482.59,5,5,10,6,True
2598374,1474,0,-1,5961,662630695,0,1,0,389.27,1,475482.59,24,4,9,6,True
2659315,1039,1,451,6853,662630695,0,0,0,388.89,7,475093.7,11,1,21,7,True
2723088,35,2,20,2296,662630695,0,0,0,388.99,5,474704.71,11,5,10,7,True
2841966,106,4,30,5961,662630695,0,0,0,388.91,8,474315.8,3,5,11,8,True
3195335,1474,0,30,9540,662630695,0,0,0,389.08,8,473926.72,24,0,16,8,True
3485831,812,0,10,2747,662630695,0,0,0,389.02,6,474315.74,18,3,12,9,True
3506996,1233,0,10,3551,662630695,0,0,0,389.3,6,474705.04,18,4,17,9,True
3813859,749,4,25,4868,662630695,0,0,0,388.78,8,474316.26,24,1,9,9,True
3836961,819,2,451,5059,662630695,0,0,0,389.19,7,473927.07,18,0,21,10,True
3969712,96,0,10,6368,662630695,0,0,0,389.1,6,474316.17,1,4,9,10,True
4132339,1039,1,25,6368,662630695,0,0,0,388.69,8,473927.48,11,6,18,12,True
4348482,444,2,20,5961,662630695,0,0,0,389.01,5,473538.47,24,4,6,12,True
4365065,580,0,10,6712,662630695,0,0,0,389.19,0,473927.66,11,3,9,1,True
4384266,115,2,20,5961,662630695,0,0,0,388.89,3,473538.77,3,3,15,3,True
4683890,433,4,451,6837,662630695,0,0,0,389.13,7,473149.64,24,4,0,4,True
4764762,749,4,451,6368,662630695,0,0,0,388.97,7,472760.67,24,5,4,6,False
4824522,1039,1,25,8317,662630695,0,0,0,388.93,8,472371.74,11,1,8,6,False
5105272,106,4,451,6837,662630695,0,0,0,389.02,7,471982.72,3,6,23,6,True
5269840,106,4,25,4167,662630695,0,0,0,388.91,8,471593.81,3,2,12,6,True
5301587,819,2,451,4167,662630695,0,0,0,389.05,7,471204.76,18,5,3,7,True
5359513,804,0,20,6853,662630695,0,0,0,389.15,5,470815.61,11,2,2,7,True
5708374,785,0,20,5059,662630695,0,0,0,389.08,3,470426.53,14,0,1,8,True
5730026,810,4,30,9540,662630695,0,0,0,389.04,8,470037.49,18,4,7,9,True
6058592,1212,0,10,8317,662630695,0,0,0,389.01,6,470426.5,24,3,18,10,True
6238597,749,4,30,8317,662630695,0,0,0,389.08,8,470037.42,24,3,4,11,True
6437065,749,4,-1,9540,662630695,0,1,0,388.99,4,470037.42,24,3,8,12,True
6554489,1039,1,30,8317,662630695,0,0,0,388.83,8,469648.59,11,4,16,12,True
6561014,1382,0,20,7291,662630695,0,0,0,388.93,5,469259.66,16,4,7,12,True
6577303,1039,1,451,8317,662630695,0,0,0,389.02,7,468870.64,11,2,14,1,True
6591183,433,4,30,5059,662630695,0,0,0,388.82,8,468481.82,24,0,5,2,True
6658045,376,0,10,4868,662630695,0,0,0,389.11,6,468870.93,25,0,8,2,True
6788956,1014,1,10,9540,662630695,0,0,0,389.06,0,469259.99,26,4,12,2,True
6795376,222,2,20,6853,662630695,0,0,0,389.07,5,468870.92,26,1,7,4,True
6815304,433,4,451,3551,662630695,0,0,0,388.84,7,468482.08,24,5,18,5,True
6828854,1297,0,451,6712,662630695,0,0,0,388.89,7,468093.19,5,0,12,5,True
7022522,219,0,20,6368,662630695,0,0,0,388.96,5,467704.23,9,3,18,5,True
7475104,42,2,20,5059,662630695,0,0,0,388.93,5,467315.3,24,6,16,6,True
7503415,1026,4,-1,4167,662630695,0,1,0,389.33,1,467315.3,11,6,20,6,True
7650426,1039,1,451,3141,662630695,0,0,0,388.94,7,466926.36,11,2,7,7,True
7665094,819,2,30,6837,662630695,0,0,0,388.69,8,466537.67,18,0,15,7,True
7791094,429,0,10,5877,662630695,0,0,0,389.12,0,466926.79,24,2,13,7,True
7994502,1359,2,20,4868,662630695,0,0,0,388.99,5,466537.8,24,4,8,7,True
8488171,433,4,451,6368,662630695,0,0,0,388.92,7,466148.88,24,3,14,8,True
8542678,1474,0,25,4868,662630695,0,0,0,388.93,8,465759.95,24,2,14,9,True
8849023,819,2,451,3654,662630695,0,0,0,389.01,7,465370.94,18,1,23,10,True
8933057,1297,0,30,4167,662630695,0,0,0,388.96,8,464981.98,5,1,11,10,True
9050204,433,4,451,8317,662630695,0,0,0,388.73,7,464593.25,24,6,19,10,True
9162547,433,4,-1,6368,662630695,0,1,0,388.87,4,464593.25,24,0,12,11,True
9354644,1474,0,451,6368,662630695,0,0,0,388.64,7,464204.61,24,3,21,11,True
9357440,303,0,10,7419,662630695,0,0,0,389.07,6,464593.68,4,4,2,11,True
9386849,792,1,10,6368,662630695,0,0,0,388.98,6,464982.66,11,2,18,11,True
9699620,749,4,30,9540,662630695,0,0,0,388.84,8,464593.82,24,5,1,11,True
9782826,819,2,30,4868,662630695,0,0,0,388.98,8,464204.84,18,1,8,11,True
9958871,749,4,30,2508,662630695,0,0,0,388.96,8,463815.88,24,3,9,11,True
1277106,1360,4,451,3056,282565904,0,0,0,878.99,7,884830.01,24,0,5,1,True
1280354,260,0,20,5061,282565904,0,0,0,879.09,5,883950.92,6,6,8,1,True
1316733,179,4,-1,8019,282565904,0,1,0,879.14,1,883950.92,24,4,15,2,True
1386255,208,0,20,4009,282565904,0,0,0,879.11,5,883071.81,9,5,10,3,True
1482998,1246,0,10,4009,282565904,0,0,0,879.19,6,883951.0,23,6,22,3,True
1561264,1069,1,25,9215,282565904,0,0,0,879.03,8,883071.97,18,6,16,4,True
1581547,797,3,30,7644,282565904,0,0,0,879.06,8,882192.91,11,5,21,5,True
2253059,860,1,-1,4304,282565904,0,1,0,878.96,1,882192.91,24,0,16,5,True
2271126,1069,1,30,7101,282565904,0,0,0,878.92,8,881313.99,18,5,4,7,True
2435664,1069,1,451,8019,282565904,0,0,0,879.22,7,880434.77,18,4,2,7,True
2578690,204,0,451,7101,282565904,0,0,0,878.91,7,879555.86,9,0,3,7,True
2750349,797,3,-1,3831,282565904,0,1,0,878.95,4,879555.86,11,0,22,8,True
2759937,1228,4,451,6814,282565904,0,0,0,879.11,7,878676.75,18,1,10,9,True
2878689,467,0,20,6987,282565904,0,0,0,879.32,5,877797.43,5,1,17,9,True
2939578,1360,4,30,7101,282565904,0,0,0,878.81,8,876918.62,24,2,1,9,True
3101213,1069,1,-1,3682,282565904,0,1,0,879.02,4,876918.62,18,1,9,10,True
3112189,797,3,-1,2497,282565904,0,2,0,878.78,4,876918.62,11,4,2,11,True
3114383,1360,4,451,5061,282565904,0,0,0,879.17,7,876039.45,24,5,19,12,True
3242765,1228,4,451,4304,282565904,0,0,0,878.9,7,875160.55,18,6,6,1,True
3281317,860,1,30,7644,282565904,0,0,0,878.57,8,874281.98,24,3,9,2,True
3332469,1228,4,30,4304,282565904,0,0,0,878.97,8,873403.01,18,3,21,3,True
3437488,1228,4,451,6934,282565904,0,0,0,878.96,7,872524.05,18,6,10,3,True
3522146,860,1,451,8019,282565904,0,0,0,879.06,7,871644.99,24,3,2,4,True
3702737,179,4,30,3651,282565904,0,0,0,879.04,8,870765.95,24,4,19,4,True
3717352,204,0,25,6814,282565904,0,0,0,878.92,8,869887.03,9,4,7,6,False
3765140,179,4,451,2832,282565904,0,0,0,879.22,7,869007.81,24,6,16,6,True
4290284,204,0,451,2832,282565904,0,0,0,878.82,7,868128.99,9,5,3,7,True
4709622,97,0,20,5061,282565904,0,0,0,879.08,3,867249.91,3,0,20,7,False
4715428,179,4,-1,7644,282565904,0,1,0,879.04,1,867249.91,24,1,19,7,True
4727178,641,0,10,6048,282565904,0,0,0,879.02,0,868128.93,24,6,23,8,True
5026493,1228,4,25,5061,282565904,0,0,0,879.14,8,867249.79,18,3,13,11,True
5143865,218,0,20,6987,282565904,0,0,0,879.02,5,866370.77,9,0,18,12,True
5232133,797,3,451,4009,282565904,0,0,0,879.06,7,865491.71,11,2,1,12,True
5288636,204,0,30,9215,282565904,0,0,0,878.79,8,864612.92,9,4,2,12,True
5405948,860,1,30,3831,282565904,0,0,0,879.09,8,863733.83,24,1,10,1,True
5566396,860,1,25,4304,282565904,0,0,0,878.98,8,862854.85,24,3,3,2,True
6091712,1228,4,451,7101,282565904,0,0,0,879.12,7,861975.73,18,0,21,2,True
6280810,913,0,20,8019,282565904,0,0,0,878.84,5,861096.89,18,3,2,2,True
6854687,299,1,10,7101,282565904,0,0,0,879.2,0,861976.09,4,3,2,3,True
6875251,1360,4,30,4009,282565904,0,0,0,878.79,8,861097.3,24,6,3,3,True
7278784,304,0,20,9215,282565904,0,0,0,878.87,5,860218.43,4,5,6,4,True
7502713,860,1,-1,7101,282565904,0,1,0,879.14,1,860218.43,24,4,8,4,True
7963782,797,3,-1,4304,282565904,0,2,0,879.09,1,860218.43,11,3,13,5,True
8112217,701,2,20,8019,282565904,0,0,0,879.1,5,859339.33,18,5,5,5,True
8144025,204,0,451,5061,282565904,0,0,0,879.07,7,858460.26,9,2,2,6,True
8192102,860,1,-1,2832,282565904,0,1,0,878.99,1,858460.26,24,0,9,7,True
8809444,342,0,10,6987,282565904,0,0,0,879.01,6,859339.27,24,5,10,7,True
8815478,1089,0,10,4009,282565904,0,0,0,879.05,6,860218.32,18,5,4,8,False
9021137,1228,4,451,9215,282565904,0,0,0,879.13,7,859339.19,18,5,22,9,True
9043006,1069,1,30,8019,282565904,0,0,0,879.09,8,858460.1,18,2,1,9,True
9264427,204,0,451,6048,282565904,0,0,0,878.97,7,857581.13,9,4,5,9,True
9341478,179,4,30,8019,282565904,0,0,0,879.15,8,856701.98,24,2,23,10,True
9344695,860,1,30,3831,282565904,0,0,0,878.84,8,855823.14,24,4,7,10,True
9405817,736,1,10,3831,282565904,0,0,0,878.64,6,856701.78,11,2,5,10,True
9480693,918,2,20,4009,282565904,0,0,0,878.87,5,855822.91,18,4,14,10,True
9484320,1069,1,25,7644,282565904,0,0,0,878.88,8,854944.03,18,0,12,10,False
9867322,1228,4,30,4304,282565904,0,0,0,879.06,8,854064.97,18,0,0,11,True
1005236,1036,1,451,5940,313145901,0,0,0,298.82,7,582934.18,11,5,8,1,True
1139108,76,0,-1,7462,313145901,0,1,0,298.81,4,582934.18,20,5,3,1,True
1623306,971,4,25,8042,313145901,0,0,0,298.96,8,582635.22,13,1,11,1,True
1792764,192,2,20,4140,313145901,0,0,0,299.05,5,582336.17,18,2,8,2,True
2015738,1140,0,-1,5298,313145901,0,1,0,299.11,1,582336.17,15,3,5,2,True
2264197,365,0,10,8127,313145901,0,0,0,299.17,6,582635.34,25,2,18,2,True
2364901,971,4,451,9317,313145901,0,0,0,298.94,7,582336.4,13,4,22,2,True
2617733,216,4,25,7462,313145901,0,0,0,298.92,8,582037.48,9,2,4,2,True
2639759,1180,1,-1,4140,313145901,0,1,0,298.6,1,582037.48,24,4,11,2,True
2649297,216,4,30,2694,313145901,0,0,0,299.0,8,581738.48,9,2,19,4,True
2930042,1140,0,30,6548,313145901,0,0,0,299.21,8,581439.27,15,1,14,5,True
3360557,76,0,25,8042,313145901,0,0,0,299.24,8,581140.03,20,4,16,5,False
3585584,882,0,451,1062,313145901,0,0,0,299.43,7,580840.6,27,5,11,5,True
3591211,76,0,25,4140,313145901,0,0,0,298.97,8,580541.63,20,4,18,6,True
3591941,1206,0,451,9406,313145901,0,0,0,299.04,7,580242.59,24,5,18,6,True
3600157,228,0,20,6569,313145901,0,0,0,299.07,5,579943.52,26,4,9,7,False
3935638,1180,1,-1,1234,313145901,0,1,0,298.97,4,579943.52,24,5,16,7,True
4402404,297,0,20,9183,313145901,0,0,0,298.79,3,579644.73,4,4,3,9,True
4406199,971,4,451,5136,313145901,0,0,0,299.17,7,579345.56,13,5,13,10,True
4565805,1140,0,451,3001,313145901,0,0,0,299.36,7,579046.2,15,1,12,10,True
4696693,1140,0,451,9183,313145901,0,0,0,299.14,7,578747.06,15,5,14,10,True
4788009,1206,0,25,6656,313145901,0,0,0,299.05,8,578448.01,24,2,23,11,True
4901714,871,0,10,9183,313145901,0,0,0,298.95,0,578746.96,24,4,13,12,True
4926882,448,0,20,9317,313145901,0,0,0,299.01,5,578447.95,13,6,4,1,True
5181239,1206,0,25,9317,313145901,0,0,0,299.3,8,578148.65,24,2,3,1,True
5544699,971,4,30,4734,313145901,0,0,0,298.92,8,577849.73,13,2,23,2,True
5574145,76,0,30,4190,313145901,0,0,0,298.89,8,577550.84,20,2,13,3,True
5676778,1180,1,25,1534,313145901,0,0,0,299.06,8,577251.78,24,2,22,5,True
5730044,216,4,30,9317,313145901,0,0,0,298.91,8,576952.87,9,5,19,5,True
5814936,1180,1,-1,8127,313145901,0,1,0,299.26,4,576952.87,24,2,18,6,True
5847006,1235,1,10,5136,313145901,0,0,0,298.81,6,577251.68,18,1,17,7,True
6455867,216,4,451,4734,313145901,0,0,0,299.22,7,576952.46,9,1,18,7,False
6577551,1180,1,25,8674,313145901,0,0,0,299.06,8,576653.4,24,1,4,8,True
6785419,1140,0,451,2694,313145901,0,0,0,299.02,7,576354.38,15,6,7,8,False
6829562,1140,0,30,5940,313145901,0,0,0,298.87,8,576055.51,15,0,7,9,True
6917657,971,4,25,1534,313145901,0,0,0,299.0,8,575756.51,13,3,8,9,True
6945225,1036,1,451,5869,313145901,0,0,0,299.13,7,575457.38,11,0,7,10,True
7024545,971,4,451,4734,313145901,0,0,0,299.08,7,575158.3,13,6,4,11,True
7088292,1180,1,30,8127,313145901,0,0,0,298.87,8,574859.43,24,0,0,12,False
7411404,1036,1,451,5965,313145901,0,0,0,298.93,7,574560.5,11,1,0,12,True
7618667,1044,0,20,3831,313145901,0,0,0,298.87,5,574261.63,11,0,0,1,True
7808331,825,2,20,3163,313145901,0,0,0,299.04,5,573962.59,18,0,7,3,True
7851939,971,4,25,6548,313145901,0,0,0,298.95,8,573663.64,13,4,20,4,True
7852598,530,0,20,5136,313145901,0,0,0,299.25,3,573364.39,18,2,18,5,True
7870450,1036,1,-1,7462,313145901,0,1,0,298.97,1,573364.39,11,5,17,5,True
8004932,971,4,30,6548,313145901,0,0,0,299.28,8,573065.11,13,5,10,5,True
8172283,1036,1,451,4140,313145901,0,0,0,299.04,7,572766.07,11,3,12,5,True
8225438,1180,1,451,5721,313145901,0,0,0,298.73,7,572467.34,24,6,23,6,True
8277890,216,4,25,8674,313145901,0,0,0,298.98,8,572168.36,9,6,3,6,True
8308910,1206,0,25,9183,313145901,0,0,0,299.14,8,571869.22,24,0,19,8,True
8611568,687,0,20,4734,313145901,0,0,0,298.79,3,571570.43,24,6,7,9,True
8746222,1036,1,451,2694,313145901,0,0,0,298.87,7,571271.56,11,5,18,9,True
8876801,1140,0,25,7462,313145901,0,0,0,298.65,8,570972.91,15,5,12,9,True
8935230,971,4,-1,9406,313145901,0,1,0,298.95,1,570972.91,13,2,1,10,True
9466986,1036,1,-1,4666,313145901,0,2,0,299.29,1,570972.91,11,4,16,10,True
9571378,1180,1,451,3831,313145901,0,0,0,298.87,7,570674.04,24,1,19,10,True
9676449,806,1,10,5869,313145901,0,0,0,299.12,0,570973.16,11,0,5,11,True
9704988,1180,1,25,1234,313145901,0,0,0,298.78,8,570674.38,24,6,9,11,True
9883462,971,4,-1,5940,313145901,0,1,0,298.5,1,570674.38,13,6,21,11,True
1023457,184,0,10,4168,486840620,0,0,0,871.81,6,962902.81,18,2,14,1,True
1319029,1062,3,30,6783,486840620,0,0,0,872.03,8,962030.78,11,0,1,1,True
1408339,262,2,451,6658,486840620,0,0,0,871.77,7,961159.01,6,2,19,1,True
1608213,262,2,30,9957,486840620,0,0,0,871.98,8,960287.03,6,5,5,1,True
1738047,787,0,10,4337,486840620,0,0,0,872.14,6,961159.17,14,2,22,1,True
1876173,159,2,-1,3583,486840620,0,1,0,871.95,4,961159.17,24,5,2,3,True
1986472,889,0,20,4694,486840620,0,0,0,872.08,5,960287.09,27,2,1,3,True
2026373,1062,3,25,4392,486840620,0,0,0,872.06,8,959415.03,11,3,0,5,True
2189381,399,2,20,7943,486840620,0,0,0,871.62,5,958543.41,10,6,11,6,True
2271204,577,0,30,2298,486840620,0,0,0,872.13,8,957671.28,11,1,4,6,True
2340373,577,0,25,7548,486840620,0,0,0,872.04,8,956799.24,11,1,14,7,True
2547432,1406,0,20,6835,486840620,0,0,0,871.58,3,955927.66,24,2,17,8,True
2646577,159,2,30,8207,486840620,0,0,0,872.04,8,955055.62,24,3,10,8,True
2702781,577,0,-1,7943,486840620,0,1,0,871.74,1,955055.62,11,6,7,9,True
2795097,712,0,20,8207,486840620,0,0,0,871.99,5,954183.63,18,6,18,10,True
2877647,329,1,10,2284,486840620,0,0,0,871.93,6,955055.56,11,5,19,10,True
3121535,262,2,451,8884,486840620,0,0,0,871.94,7,954183.62,6,0,6,10,True
4130272,1062,3,30,4337,486840620,0,0,0,872.04,8,953311.58,11,0,8,11,True
4141051,1019,0,20,4850,486840620,0,0,0,872.08,3,952439.5,26,2,2,11,True
4223036,159,2,30,4850,486840620,0,0,0,872.08,8,951567.42,24,4,4,12,True
4224204,262,2,-1,9758,486840620,0,1,0,871.89,4,951567.42,6,0,11,12,True
4297122,220,0,10,7520,486840620,0,0,0,871.91,0,952439.33,26,1,11,12,True
4367252,577,0,451,7548,486840620,0,0,0,871.94,7,951567.39,11,3,18,12,True
4466620,283,4,30,8207,486840620,0,0,0,871.88,8,950695.51,24,5,19,1,True
4570312,645,0,20,2298,486840620,0,0,0,871.59,5,949823.92,24,2,14,1,True
5024670,1062,3,-1,7693,486840620,0,1,0,872.03,4,949823.92,11,3,2,1,True
5354531,1062,3,30,3033,486840620,0,0,0,872.07,8,948951.85,11,5,19,4,True
5519285,283,4,451,3781,486840620,0,0,0,872.15,7,948079.7,24,1,5,4,True
5582237,262,2,-1,2284,486840620,0,1,0,872.14,4,948079.7,6,2,2,6,True
6034997,723,1,10,8207,486840620,0,0,0,871.87,6,948951.57,11,1,13,7,True
6164947,262,2,25,2298,486840620,0,0,0,871.85,8,948079.72,6,3,14,8,True
6266076,1062,3,30,4168,486840620,0,0,0,872.01,8,947207.71,11,5,0,9,True
6346436,535,0,10,7943,486840620,0,0,0,872.0,6,948079.71,18,5,18,9,True
6899796,1062,3,-1,7943,486840620,0,1,0,871.86,4,948079.71,11,1,13,10,True
7197244,898,1,10,1097,486840620,0,0,0,871.86,0,948951.57,24,5,22,11,True
7259414,218,0,20,8884,486840620,0,0,0,871.96,3,948079.61,9,1,1,1,True
7313275,577,0,30,6835,486840620,0,0,0,871.72,8,947207.89,11,6,1,3,True
7389938,1062,3,25,2298,486840620,0,0,0,872.06,8,946335.83,11,4,21,3,False
7421227,262,2,-1,5562,486840620,0,1,0,871.78,4,946335.83,6,6,3,5,True
7536800,1062,3,-1,4392,486840620,0,2,0,871.99,4,946335.83,11,5,20,6,True
7669922,1062,3,30,4119,486840620,0,0,0,872.0,8,945463.83,11,4,20,6,True
7737183,262,2,451,1097,486840620,0,0,0,872.12,7,944591.71,6,4,9,6,True
7873831,159,2,451,7670,486840620,0,0,0,871.91,7,943719.8,24,0,3,7,False
8029410,262,2,30,4168,486840620,0,0,0,871.86,8,942847.94,6,4,0,7,True
8369646,1062,3,25,4168,486840620,0,0,0,872.22,8,941975.72,11,1,19,7,False
8381299,159,2,25,8884,486840620,0,0,0,871.88,8,941103.84,24,4,6,7,True
8646662,577,0,-1,7742,486840620,0,1,0,872.01,4,941103.84,11,2,9,7,True
8983487,394,0,20,7670,486840620,0,0,0,871.93,5,940231.91,10,6,6,9,True
9114061,952,0,20,1097,486840620,0,0,0,872.22,5,939359.69,13,6,9,9,True
9428406,144,1,10,4850,486840620,0,0,0,871.83,6,940231.52,18,5,7,9,True
9876156,159,2,-1,3781,486840620,0,1,0,871.68,4,940231.52,24,5,22,10,True
9947847,457,0,10,1803,486840620,0,0,0,872.13,6,941103.65,13,1,19,11,False
1051677,523,2,20,2896,667781576,1,0,0,672.88,3,905913.12,18,6,14,1,False
1819583,1060,1,10,2896,667781576,1,0,0,672.91,6,906586.03,11,1,2,1,True
1929346,392,4,25,5047,667781576,1,0,0,672.84,8,905913.19,10,3,19,2,True
2083360,1090,0,10,7249,667781576,1,0,0,672.71,0,906585.9,18,4,2,2,True
2316294,1174,3,-1,6769,667781576,1,1,0,672.94,4,906585.9,24,0,5,3,True
2826468,1174,3,-1,8824,667781576,1,2,0,673.21,1,906585.9,24,3,10,3,False
2926016,1061,2,451,8354,667781576,1,0,0,673.21,7,905912.69,11,6,16,3,True
3066462,1164,0,10,9032,667781576,1,0,0,672.88,6,906585.57,24,4,16,5,True
3299900,1061,2,451,2045,667781576,1,0,0,672.92,7,905912.65,11,1,16,6,True
3378436,1406,0,10,7745,667781576,1,0,0,672.9,0,906585.55,24,4,3,6,True
3948181,1174,3,-1,7997,667781576,1,1,0,673.13,4,906585.55,24,0,23,8,True
4256016,96,0,20,4368,667781576,1,0,0,672.85,3,905912.7,1,4,21,8,True
4366367,169,4,25,1912,667781576,1,0,0,673.0,8,905239.7,24,0,5,9,True
4440310,907,0,20,8226,667781576,1,0,0,672.62,5,904567.08,2,4,22,10,True
4473379,727,0,20,8736,667781576,1,0,0,673.11,3,903893.97,11,5,6,10,True
4859322,392,4,-1,8226,667781576,1,1,0,673.1,1,903893.97,10,0,18,10,True
5011226,350,0,10,7997,667781576,1,0,0,672.98,0,904566.95,24,2,6,11,True
5232928,1174,3,25,9648,667781576,1,0,0,673.02,8,903893.93,24,5,4,11,True
5347053,116,0,10,9648,667781576,1,0,0,672.93,6,904566.86,3,5,4,12,True
5384794,392,4,25,9248,667781576,1,0,0,673.16,8,903893.7,10,3,16,12,True
5386681,1174,3,451,7079,667781576,1,0,0,672.7,7,903221.0,24,6,6,1,True
5467475,1174,3,25,1672,667781576,1,0,0,673.14,8,902547.86,24,4,3,2,True
5646930,392,4,451,9648,667781576,1,0,0,672.88,7,901874.98,10,4,8,2,True
5848640,1132,0,30,9032,667781576,1,0,0,673.08,8,901201.9,24,5,10,2,True
5971544,1132,0,451,8354,667781576,1,0,0,672.76,7,900529.14,24,6,7,2,True
6210660,169,4,30,1999,667781576,1,0,0,672.9,8,899856.24,24,2,7,3,True
6607299,81,0,-1,5837,667781576,1,1,0,673.03,4,899856.24,1,5,22,4,True
6928090,81,0,451,1912,667781576,1,0,0,672.91,7,899183.33,1,1,18,4,True
7205146,392,4,25,7291,667781576,1,0,0,672.86,8,898510.47,10,5,23,4,True
7352216,169,4,30,9032,667781576,1,0,0,672.74,8,897837.73,24,3,8,4,False
7406379,268,2,20,9660,667781576,1,0,0,673.06,3,897164.67,24,3,13,5,True
7533030,1132,0,451,8354,667781576,1,0,0,673.29,7,896491.38,24,1,2,5,True
7581762,713,0,10,5047,667781576,1,0,0,673.18,6,897164.56,18,4,11,5,True
7634549,1174,3,451,5047,667781576,1,0,0,673.17,7,896491.39,24,4,21,6,True
7687158,392,4,25,8226,667781576,1,0,0,673.02,8,895818.37,10,5,7,6,True
7692813,169,4,451,8226,667781576,1,0,0,673.08,7,895145.29,24,0,12,6,True
7704949,169,4,30,3130,667781576,1,0,0,673.05,8,894472.24,24,0,7,7,True
7727932,1132,0,25,1672,667781576,1,0,0,673.14,8,893799.1,24,4,14,8,True
7922326,909,2,20,8580,667781576,1,0,0,672.75,5,893126.35,18,5,21,11,True
8052219,292,1,10,7079,667781576,1,0,0,672.69,6,893799.04,4,6,18,11,True
8295810,1174,3,30,8226,667781576,1,0,0,673.02,8,893126.02,24,2,4,11,True
8369149,81,0,25,9660,667781576,1,0,0,672.72,8,892453.3,1,2,17,1,True
8407829,1132,0,451,1672,667781576,1,0,0,673.36,7,891779.94,24,1,2,1,True
8424171,1174,3,451,4368,667781576,1,0,0,673.09,7,891106.85,24,5,5,3,True
8473493,53,0,10,4651,667781576,1,0,0,672.9,6,891779.75,20,4,19,4,True
8633596,81,0,451,8736,667781576,1,0,0,672.97,7,891106.78,1,6,2,5,True
8815988,1132,0,-1,8580,667781576,1,1,0,673.11,1,891106.78,24,3,4,6,True
8887917,1174,3,30,8580,667781576,1,0,0,673.05,8,890433.73,24,0,21,7,True
8936985,183,1,10,6640,667781576,1,0,0,672.97,6,891106.7,18,1,14,7,True
9003626,1399,0,20,5047,667781576,1,0,0,672.88,3,890433.82,24,1,15,8,True
9434170,1132,0,30,9248,667781576,1,0,0,673.05,8,889760.77,24,2,12,9,True
9518370,81,0,451,6758,667781576,1,0,0,673.1,7,889087.67,1,0,13,11,True
9664462,182,1,10,2896,667781576,1,0,0,672.98,6,889760.65,18,3,15,11,True
9945567,1174,3,451,3130,667781576,1,0,0,672.71,7,889087.94,24,0,12,11,True
1542675,1493,4,30,5055,238851621,1,0,0,1021.39,8,668226.61,24,3,1,1,True
1673107,592,4,25,6310,238851621,1,0,0,1020.88,8,667205.73,24,6,18,2,True
1683589,168,0,451,5055,238851621,1,0,0,1020.55,7,666185.18,24,5,19,4,True
2349566,327,0,451,2933,238851621,1,0,0,1021.16,7,665164.02,11,2,3,5,True
2450414,1493,4,451,9523,238851621,1,0,0,1021.08,7,664142.94,24,1,2,5,True
2647266,327,0,451,8133,238851621,1,0,0,1020.99,7,663121.95,11,2,10,5,False
2844375,1283,2,-1,5055,238851621,1,1,0,1020.83,4,663121.95,24,2,19,6,True
3216003,222,2,-1,6310,238851621,1,2,0,1020.85,4,663121.95,26,3,16,6,True
3866507,1318,0,10,7726,238851621,1,0,0,1020.7,6,664142.65,18,4,8,6,True
3881347,1283,2,451,2933,238851621,1,0,0,1020.96,7,663121.69,24,4,21,6,True
3915594,592,4,30,2901,238851621,1,0,0,1020.9,8,662100.79,24,0,8,6,True
4385311,999,4,30,8884,238851621,1,0,0,1021.04,8,661079.75,26,6,10,7,True
4749697,605,0,10,8583,238851621,1,0,0,1021.25,0,662101.0,24,4,20,7,True
4779215,327,0,25,5235,238851621,1,0,0,1020.97,8,661080.03,11,1,12,7,True
5095613,592,4,-1,5611,238851621,1,1,0,1021.0,4,661080.03,24,0,6,8,True
5144232,27,0,10,7446,238851621,1,0,0,1021.14,0,662101.17,11,3,15,8,True
5151909,858,1,451,5055,238851621,1,0,0,1021.14,7,661080.03,24,6,11,8,True
5173179,42,2,20,9696,238851621,1,0,0,1020.97,3,660059.06,24,6,14,8,True
5238058,599,0,20,8583,238851621,1,0,0,1020.96,5,659038.1,24,4,11,9,True
5428041,424,1,10,1487,238851621,1,0,0,1020.92,6,660059.02,18,6,14,10,True
5447455,429,0,20,5235,238851621,1,0,0,1021.01,3,659038.01,24,6,3,11,True
5633544,168,0,25,2851,238851621,1,0,0,1021.04,8,658016.97,24,3,3,12,True
5696257,1029,0,20,1487,238851621,1,0,0,1021.11,5,656995.86,11,0,21,1,True
6571943,168,0,30,7446,238851621,1,0,0,1020.99,8,655974.87,24,1,11,1,True
6699062,999,4,30,5055,238851621,1,0,0,1021.02,8,654953.85,26,3,11,3,True
6837975,858,1,451,4309,238851621,1,0,0,1021.16,7,653932.69,24,1,11,5,True
7080256,1283,2,25,6310,238851621,1,0,0,1021.01,8,652911.68,24,2,18,8,True
7264319,168,0,451,7446,238851621,1,0,0,1021.15,7,651890.53,24,0,17,8,True
7475461,858,1,451,2323,238851621,1,0,0,1020.87,7,650869.66,24,4,17,9,True
7564411,1493,4,30,5235,238851621,1,0,0,1020.73,8,649848.93,24,0,0,9,True
7769753,999,4,451,2933,238851621,1,0,0,1020.89,7,648828.04,26,6,8,10,True
7840800,168,0,10,9696,238851621,1,0,0,1020.99,6,649849.03,24,5,20,10,True
7888963,168,0,30,8133,238851621,1,0,0,1021.14,8,648827.89,24,2,17,10,True
7956722,1493,4,25,8133,238851621,1,0,0,1021.3,8,647806.59,24,3,12,11,True
7988392,1493,4,451,8884,238851621,1,0,0,1021.19,7,646785.4,24,1,18,11,True
8071876,592,4,-1,8583,238851621,1,1,0,1020.93,4,646785.4,24,3,8,11,True
8235587,168,0,451,6310,238851621,1,0,0,1021.27,7,645764.13,24,0,3,2,True
8548394,1044,0,10,1487,238851621,1,0,0,1020.74,6,646784.87,11,2,12,2,True
8664161,999,4,451,5841,238851621,1,0,0,1021.14,7,645763.73,26,5,4,2,True
8913146,327,0,-1,1487,238851621,1,1,0,1020.92,4,645763.73,11,6,22,2,True
8963935,1493,4,-1,5055,238851621,1,2,0,1021.01,4,645763.73,24,5,10,3,True
9010969,858,1,30,9696,238851621,1,0,0,1021.09,8,644742.64,24,6,9,3,True
9115304,592,4,30,2933,238851621,1,0,0,1021.04,8,643721.6,24,6,4,5,True
9177415,913,0,20,9696,238851621,1,0,0,1020.94,5,642700.66,18,1,4,5,True
9291299,168,0,30,7726,238851621,1,0,0,1020.55,8,641680.11,24,3,20,5,True
9400486,27,0,10,1389,238851621,1,0,0,1020.9,6,642701.01,11,2,18,6,True
9402200,664,2,20,2851,238851621,1,0,0,1020.94,5,641680.07,18,1,15,6,True
9446773,168,0,451,3191,238851621,1,0,0,1021.09,7,640658.98,24,2,0,7,True
9682053,1283,2,-1,5611,238851621,1,1,0,1021.01,4,640658.98,24,4,11,10,True
9797430,1493,4,25,8884,238851621,1,0,0,1021.14,8,639637.84,24,3,13,10,False
9960106,219,0,10,2901,238851621,1,0,0,1020.92,6,640658.76,9,0,20,11,True
1226107,967,1,10,2535,264530503,1,0,0,513.04,6,160996.04,13,0,9,1,True
1285412,512,0,-1,1674,264530503,1,1,0,513.0,4,160996.04,12,3,21,1,True
1520479,965,4,451,4311,264530503,1,0,0,513.08,7,160482.96,13,5,21,2,True
1631986,663,4,25,1329,264530503,1,0,0,512.86,8,159970.1,18,3,13,3,True
2038280,673,0,10,1674,264530503,1,0,0,513.2,0,160483.3,18,1,14,3,False
2300131,883,0,25,1329,264530503,1,0,0,513.09,8,159970.21,24,3,17,3,True
2330329,512,0,30,2535,264530503,1,0,0,513.44,8,159456.77,12,4,23,4,True
2771374,663,4,30,4020,264530503,1,0,0,512.89,8,158943.88,18,2,14,4,True
2863005,589,1,25,1204,264530503,1,0,0,513.08,8,158430.8,24,4,13,4,True
3088975,965,4,451,3977,264530503,1,0,0,512.99,7,157917.81,13,6,1,4,True
3226042,589,1,451,2535,264530503,1,0,0,513.19,7,157404.62,24,3,6,6,True
3325176,663,4,25,3977,264530503,1,0,0,513.2,8,156891.42,18,1,18,6,True
3349822,965,4,25,3977,264530503,1,0,0,513.06,8,156378.36,13,1,16,7,False
3512174,208,0,451,7665,264530503,1,0,0,512.71,7,155865.65,9,3,14,7,True
3830787,1076,1,10,1674,264530503,1,0,0,513.08,6,156378.73,18,2,18,8,True
3943528,883,0,25,1310,264530503,1,0,0,512.94,8,155865.79,24,4,16,8,True
4049090,512,0,451,6795,264530503,1,0,0,513.1,7,155352.69,12,0,15,9,True
4114697,917,0,10,7418,264530503,1,0,0,513.11,6,155865.8,18,0,2,10,True
4279015,1116,0,20,1674,264530503,1,0,0,513.11,3,155352.69,24,0,22,11,True
4307134,664,2,20,2748,264530503,1,0,0,513.08,5,154839.61,18,4,20,11,True
4349856,589,1,25,2535,264530503,1,0,0,513.05,8,154326.56,24,2,13,1,True
4440087,965,4,25,1329,264530503,1,0,0,512.85,8,153813.71,13,4,21,1,True
4447825,589,1,25,2535,264530503,1,0,0,513.13,8,153300.58,24,2,1,2,True
4515693,965,4,30,2535,264530503,1,0,0,513.21,8,152787.37,13,0,10,3,True
5182961,834,0,10,3977,264530503,1,0,0,513.09,6,153300.46,5,0,11,3,True
5248485,148,1,10,1204,264530503,1,0,0,513.26,6,153813.72,18,3,10,4,True
5279385,965,4,-1,7418,264530503,1,1,0,512.86,1,153813.72,13,5,11,4,True
6005210,883,0,451,6846,264530503,1,0,0,513.02,7,153300.7,24,3,6,4,True
6356094,883,0,25,3977,264530503,1,0,0,513.25,8,152787.45,24,3,15,5,True
6380490,1114,1,10,4020,264530503,1,0,0,513.21,6,153300.66,0,5,5,5,True
6596490,589,1,-1,7665,264530503,1,1,0,513.04,4,153300.66,24,3,15,6,True
6650699,1255,0,10,1329,264530503,1,0,0,513.05,6,153813.71,23,3,6,7,True
6847094,663,4,25,1310,264530503,1,0,0,512.93,8,153300.78,18,2,17,7,True
6958897,589,1,25,4020,264530503,1,0,0,512.77,8,152788.01,24,5,13,7,True
7469140,883,0,451,2748,264530503,1,0,0,513.09,7,152274.92,24,5,15,7,True
7534056,883,0,451,1329,264530503,1,0,0,513.03,7,151761.89,24,3,3,8,True
7616599,208,0,451,1674,264530503,1,0,0,513.06,7,151248.83,9,5,2,8,True
7899699,208,0,451,7932,264530503,1,0,0,513.2,7,150735.63,9,2,3,8,True
8097005,900,1,10,4311,264530503,1,0,0,513.04,6,151248.67,24,3,0,8,True
8416731,965,4,-1,7665,264530503,1,1,0,512.76,1,151248.67,13,6,8,10,True
8524959,883,0,25,1310,264530503,1,0,0,513.39,8,150735.28,24,1,15,11,True
8577081,883,0,451,1329,264530503,1,0,0,513.11,7,150222.17,24,6,7,12,True
8603405,663,4,451,1329,264530503,1,0,0,512.8,7,149709.37,18,6,1,12,True
8618494,965,4,-1,6846,264530503,1,1,0,512.77,4,149709.37,13,0,5,1,True
8698516,663,4,-1,1204,264530503,1,2,0,513.22,1,149709.37,18,3,20,2,True
8872056,965,4,451,1310,264530503,1,0,0,513.1,7,149196.27,13,3,17,3,True
9034741,965,4,25,1310,264530503,1,0,0,512.97,8,148683.3,13,4,15,3,True
9098959,965,4,30,2535,264530503,1,0,0,513.07,8,148170.23,13,6,19,4,True
9133188,589,1,25,3977,264530503,1,0,0,512.92,8,147657.31,24,0,4,5,True
9210536,222,2,20,1204,264530503,1,0,0,512.81,5,147144.5,26,1,15,5,True
9310331,663,4,451,4311,264530503,1,0,0,512.94,7,146631.56,18,3,15,6,True
9345552,471,0,20,2535,264530503,1,0,0,513.07,5,146118.49,5,6,14,7,True
9403730,965,4,25,7665,264530503,1,0,0,513.0,8,145605.49,13,5,3,8,True
9535042,589,1,25,1357,264530503,1,0,0,513.03,8,145092.46,24,5,20,8,True
9789026,883,0,451,6846,264530503,1,0,0,513.13,7,144579.33,24,3,1,8,True
9865155,883,0,451,7665,264530503,1,0,0,513.36,7,144065.97,24,6,10,9,True
9884473,965,4,25,5111,264530503,1,0,0,512.85,8,143553.12,13,0,15,9,True
9967510,883,0,25,1357,264530503,1,0,0,512.95,8,143040.17,24,3,11,10,True
1152715,933,4,451,7159,650214627,1,0,0,1080.91,7,281331.09,24,0,13,1,True
1169202,282,2,20,7663,650214627,1,0,0,1080.92,5,280250.17,24,2,9,1,True
1291892,538,0,10,7663,650214627,1,0,0,1081.15,0,281331.32,18,5,14,2,True
1497868,1334,3,25,5259,650214627,1,0,0,1081.04,8,280250.28,18,4,19,2,True
1802797,1169,0,451,6995,650214627,1,0,0,1080.98,7,279169.3,24,6,23,3,True
1881270,411,2,20,4897,650214627,1,0,0,1081.33,5,278087.97,18,6,2,3,True
1930970,1027,0,20,5259,650214627,1,0,0,1081.22,3,277006.75,11,3,12,4,True
2057125,1169,0,25,1365,650214627,1,0,0,1080.79,8,275925.96,24,0,13,5,True
2250909,1334,3,451,9334,650214627,1,0,0,1080.88,7,274845.08,18,6,10,5,True
2270275,286,1,25,1897,650214627,1,0,0,1081.21,8,273763.87,24,4,18,5,True
2399671,952,0,10,3556,650214627,1,0,0,1080.74,6,274844.61,13,5,3,6,True
2425776,850,1,25,1365,650214627,1,0,0,1081.14,8,273763.47,5,5,19,7,True
2458754,100,4,25,6493,650214627,1,0,0,1081.14,8,272682.33,3,3,9,7,True
2562201,1471,0,20,5707,650214627,1,0,0,1080.96,3,271601.37,24,6,10,10,True
2805910,933,4,-1,4897,650214627,1,1,0,1081.2,4,271601.37,24,4,22,10,True
3154933,1474,0,10,5709,650214627,1,0,0,1080.99,6,272682.36,24,4,13,10,True
3234732,1169,0,451,1365,650214627,1,0,0,1080.89,7,271601.47,24,3,13,12,True
3497196,933,4,25,1365,650214627,1,0,0,1080.92,8,270520.55,24,4,1,12,True
3589067,1334,3,30,3556,650214627,1,0,0,1081.16,8,269439.39,18,4,19,12,True
3957132,850,1,30,9925,650214627,1,0,0,1080.93,8,268358.46,5,1,19,12,True
3960289,100,4,30,9925,650214627,1,0,0,1080.79,8,267277.67,3,6,7,12,True
4330785,1322,2,20,5709,650214627,1,0,0,1080.87,5,266196.8,18,1,9,1,True
4686281,1334,3,25,1717,650214627,1,0,0,1081.01,8,265115.79,18,2,18,1,True
4901807,211,0,20,1717,650214627,1,0,0,1081.2,5,264034.59,9,4,14,1,True
5281915,933,4,30,7097,650214627,1,0,0,1080.88,8,262953.71,24,0,14,1,True
5441349,1334,3,30,2403,650214627,1,0,0,1080.96,8,261872.75,18,4,4,3,True
5649758,558,0,10,7159,650214627,1,0,0,1080.76,6,262953.51,17,4,14,3,True
5859450,816,0,20,3556,650214627,1,0,0,1080.88,3,261872.63,18,2,21,3,True
6015459,286,1,25,5707,650214627,1,0,0,1081.14,8,260791.49,24,4,22,6,True
6059482,1169,0,-1,9021,650214627,1,1,0,1081.24,4,260791.49,24,4,20,6,True
6063986,1334,3,25,7663,650214627,1,0,0,1080.91,8,259710.58,18,3,22,7,True
6223536,509,0,10,9925,650214627,1,0,0,1081.15,6,260791.73,12,0,10,7,True
6328275,325,0,10,2403,650214627,1,0,0,1080.95,0,261872.68,11,3,10,8,True
6352638,1169,0,30,4897,650214627,1,0,0,1080.96,8,260791.72,24,5,7,9,True
6516148,1169,0,451,7159,650214627,1,0,0,1080.86,7,259710.86,24,3,8,9,True
6544529,1169,0,30,7097,650214627,1,0,0,1081.03,8,258629.83,24,0,22,10,True
6662102,933,4,451,1717,650214627,1,0,0,1081.15,7,257548.68,24,6,20,11,True
6680101,100,4,-1,5594,650214627,1,1,0,1080.7,4,257548.68,3,3,18,11,True
7127178,100,4,25,3556,650214627,1,0,0,1080.89,8,256467.79,3,6,1,12,True
7238321,1334,3,-1,9021,650214627,1,1,0,1081.21,4,256467.79,18,6,14,12,True
7656144,850,1,30,5710,650214627,1,0,0,1081.19,8,255386.6,5,0,14,1,True
7721799,286,1,25,1897,650214627,1,0,0,1080.82,8,254305.78,24,5,17,2,True
7791369,100,4,-1,1897,650214627,1,1,0,1080.64,4,254305.78,3,4,20,3,True
7805003,933,4,451,3556,650214627,1,0,0,1081.16,7,253224.62,24,3,20,3,True
8472127,850,1,25,2626,650214627,1,0,0,1081.04,8,252143.58,5,5,7,3,True
8501414,485,1,10,9987,650214627,1,0,0,1080.78,0,253224.36,5,5,4,4,True
8585313,360,0,20,1365,650214627,1,0,0,1081.1,5,252143.26,24,1,16,4,True
9141983,909,2,20,5594,650214627,1,0,0,1080.87,3,251062.39,18,5,8,7,True
9207888,1334,3,451,1365,650214627,1,0,0,1080.89,7,249981.5,18,3,13,8,True
9410876,850,1,25,2626,650214627,1,0,0,1081.08,8,248900.42,5,0,10,9,True
9670989,933,4,-1,7663,650214627,1,1,0,1080.83,1,248900.42,24,0,23,9,True
9712896,850,1,30,1897,650214627,1,0,0,1081.02,8,247819.4,5,5,3,9,True
9762778,850,1,30,3556,650214627,1,0,0,1081.02,8,246738.38,5,5,4,10,True
9805453,286,1,-1,7159,650214627,1,1,0,1081.22,1,246738.38,24,0,16,10,True
9821728,1044,0,10,2403,650214627,1,0,0,1081.15,6,247819.53,11,2,16,10,True
9978736,100,4,451,5710,650214627,1,0,0,1081.03,7,246738.5,3,2,22,11,False
1065551,231,4,-1,3358,626111495,0,1,0,416.05,4,524318.0,26,6,20,1,True
1384654,446,1,10,8985,626111495,0,0,0,415.66,6,524733.66,13,2,10,1,True
1549488,1105,2,30,8453,626111495,0,0,0,415.99,8,524317.67,0,0,2,2,True
2128893,780,0,10,1532,626111495,0,0,0,416.06,6,524733.73,14,2,17,3,True
2300799,1360,4,451,1830,626111495,0,0,0,415.77,7,524317.96,24,0,14,3,True
2376410,831,1,451,5061,626111495,0,0,0,415.95,7,523902.01,5,5,15,4,True
3042773,1105,2,25,1049,626111495,0,0,0,415.91,8,523486.1,0,6,2,6,True
3166303,1094,0,10,5381,626111495,0,0,0,415.8,0,523901.9,0,2,10,8,True
3351292,1105,2,451,7284,626111495,0,0,0,416.12,7,523485.78,0,5,4,8,True
3359626,1076,1,30,4092,626111495,0,0,0,416.08,8,523069.7,18,6,13,9,True
3372861,399,2,20,1060,626111495,0,0,0,416.04,5,522653.66,10,0,7,9,True
3581614,1076,1,25,4074,626111495,0,0,0,415.9,8,522237.76,18,2,13,11,True
4164643,1105,2,30,4664,626111495,0,0,0,416.03,8,521821.73,0,3,10,11,True
4315759,1360,4,30,6281,626111495,0,0,0,415.88,8,521405.85,24,6,15,11,True
4482101,567,1,10,7284,626111495,0,0,0,416.16,0,521822.01,11,6,0,11,True
4531849,831,1,30,5427,626111495,0,0,0,416.0,8,521406.01,5,5,19,12,False
4634826,728,1,10,6281,626111495,0,0,0,416.11,6,521822.12,11,2,11,12,True
4965190,498,0,20,9377,626111495,0,0,0,416.33,5,521405.79,12,6,8,1,True
4998344,1076,1,451,3358,626111495,0,0,0,415.85,7,520989.94,18,0,6,1,True
5554462,1076,1,-1,8985,626111495,0,1,0,416.08,4,520989.94,18,1,4,1,True
5561474,928,3,451,4806,626111495,0,0,0,415.86,7,520574.08,18,5,20,2,True
5711146,928,3,30,1476,626111495,0,0,0,415.88,8,520158.2,18,2,8,4,True
5913873,1271,0,10,1532,626111495,0,0,0,415.95,6,520574.15,23,0,1,6,True
5924399,580,0,10,8082,626111495,0,0,0,416.04,6,520990.19,11,2,0,7,True
6054974,989,1,10,8453,626111495,0,0,0,416.2,6,521406.39,22,1,15,8,True
6095429,1076,1,25,1830,626111495,0,0,0,415.94,8,520990.45,18,4,0,9,True
6185323,1076,1,451,8037,626111495,0,0,0,415.9,7,520574.55,18,4,9,9,True
6188664,1360,4,25,5381,626111495,0,0,0,416.05,8,520158.5,24,1,18,10,True
6219324,928,3,451,6967,626111495,0,0,0,415.98,7,519742.52,18,4,15,10,True
6369967,1076,1,451,2871,626111495,0,0,0,415.83,7,519326.69,18,1,21,10,True
6389542,502,0,10,2746,626111495,0,0,0,416.0,6,519742.69,12,4,22,10,True
6411680,183,1,10,4664,626111495,0,0,0,416.1,0,520158.79,18,5,7,11,True
6471864,1374,4,30,3358,626111495,0,0,0,416.04,8,519742.75,16,4,0,11,True
6822862,928,3,25,5381,626111495,0,0,0,415.91,8,519326.84,18,6,20,11,True
7021414,1360,4,451,7284,626111495,0,0,0,416.15,7,518910.69,24,2,7,11,True
7067249,349,2,20,4806,626111495,0,0,0,415.99,5,518494.7,24,0,21,12,True
7275047,831,1,451,7151,626111495,0,0,0,415.97,7,518078.73,5,1,14,12,True
7300175,599,0,20,8037,626111495,0,0,0,416.11,3,517662.62,24,6,2,1,True
7610217,201,1,10,4092,626111495,0,0,0,416.3,0,518078.92,9,2,23,3,True
7720117,300,0,20,3277,626111495,0,0,0,416.13,5,517662.79,4,5,5,3,True
7867670,928,3,-1,3348,626111495,0,1,0,415.89,4,517662.79,18,6,5,3,True
7925524,844,1,10,8453,626111495,0,0,0,415.83,6,518078.62,5,2,13,6,True
7942153,1105,2,25,8985,626111495,0,0,0,415.77,8,517662.85,0,4,15,7,True
8261914,831,1,25,1476,626111495,0,0,0,415.91,8,517246.94,5,5,13,7,True
8549493,1360,4,451,1830,626111495,0,0,0,416.08,7,516830.86,24,0,6,7,True
8719597,231,4,451,2457,626111495,0,0,0,416.11,7,516414.75,26,5,12,7,True
9077363,231,4,-1,8453,626111495,0,1,0,415.95,4,516414.75,26,3,2,8,True
9173226,727,0,20,5381,626111495,0,0,0,416.46,3,515998.29,11,0,14,9,True
9325849,503,0,20,8453,626111495,0,0,0,415.8,5,515582.49,12,3,8,9,True
9394804,465,0,10,1060,626111495,0,0,0,416.36,0,515998.85,13,5,3,9,True
9400946,1360,4,-1,1532,626111495,0,1,0,415.92,1,515998.85,24,2,7,10,True
9527072,1321,0,20,7151,626111495,0,0,0,415.83,3,515583.02,18,6,14,10,True
9813500,1374,4,25,1476,626111495,0,0,0,416.2,8,515166.82,16,3,15,11,True
9930884,231,4,25,4222,626111495,0,0,0,415.98,8,514750.84,26,3,22,11,True
1007414,1152,0,10,9990,913049567,1,0,0,344.09,6,543754.09,15,1,8,1,True
1292829,185,1,10,7963,913049567,1,0,0,344.14,6,544098.23,18,4,23,2,True
2038887,666,4,25,2753,913049567,1,0,0,343.99,8,543754.24,18,4,15,2,True
2149444,297,0,20,5007,913049567,1,0,0,343.9,5,543410.34,4,6,21,3,True
2498593,1454,1,30,2753,913049567,1,0,0,344.28,8,543066.06,11,4,7,4,True
2559453,474,4,25,5038,913049567,1,0,0,344.24,8,542721.82,5,0,15,5,False
2771025,869,2,20,7001,913049567,1,0,0,344.01,5,542377.81,24,3,1,6,True
2828616,666,4,-1,3220,913049567,1,1,0,343.79,4,542377.81,18,6,9,8,True
3048917,474,4,451,9947,913049567,1,0,0,343.98,7,542033.83,5,3,23,8,False
3367613,666,4,30,9947,913049567,1,0,0,344.14,8,541689.69,18,4,22,8,True
3391235,1012,0,-1,6101,913049567,1,1,0,344.09,1,541689.69,26,6,5,9,True
3519162,1454,1,451,5038,913049567,1,0,0,344.2,7,541345.49,11,6,15,9,True
4380717,1226,2,451,2416,913049567,1,0,0,343.89,7,541001.6,18,2,19,9,True
4811374,666,4,25,6341,913049567,1,0,0,343.96,8,540657.64,18,4,23,11,True
4832457,1454,1,-1,6341,913049567,1,1,0,343.83,4,540657.64,11,4,18,11,True
5094063,826,1,10,5007,913049567,1,0,0,344.06,0,541001.7,18,6,22,12,True
5258064,1226,2,-1,7963,913049567,1,1,0,344.1,4,541001.7,18,5,20,12,True
5339119,1012,0,451,4937,913049567,1,0,0,343.96,7,540657.74,26,4,0,12,True
5608908,1226,2,-1,2416,913049567,1,1,0,344.05,1,540657.74,18,0,13,2,True
5745570,757,0,20,7525,913049567,1,0,0,344.0,3,540313.74,24,6,8,3,True
5857996,1012,0,451,4937,913049567,1,0,0,343.83,7,539969.91,26,2,10,4,True
6037082,1454,1,451,3726,913049567,1,0,0,344.12,7,539625.79,11,1,20,4,True
6095447,1012,0,25,2416,913049567,1,0,0,344.16,8,539281.63,26,2,12,5,False
6221471,1226,2,451,7525,913049567,1,0,0,343.95,7,538937.68,18,6,14,5,True
6277207,1272,0,20,2753,913049567,1,0,0,343.98,5,538593.7,24,0,2,5,True
6471530,474,4,451,9990,913049567,1,0,0,344.02,7,538249.68,5,3,15,5,True
6788709,666,4,451,9288,913049567,1,0,0,344.15,7,537905.53,18,1,22,6,True
7052875,787,0,10,2416,913049567,1,0,0,344.02,6,538249.55,14,4,16,7,True
7276162,666,4,451,2682,913049567,1,0,0,344.22,7,537905.33,18,4,15,7,True
7366822,1304,0,20,2682,913049567,1,0,0,343.95,3,537561.38,5,0,1,8,True
7520708,1454,1,25,3754,913049567,1,0,0,343.96,8,537217.42,11,6,12,9,True
7581901,1012,0,451,3754,913049567,1,0,0,344.02,7,536873.4,26,2,4,10,True
7630637,752,0,20,3754,913049567,1,0,0,344.09,3,536529.31,24,4,19,11,True
7823053,1354,0,10,3754,913049567,1,0,0,344.01,6,536873.32,24,4,23,11,True
7850782,474,4,25,2682,913049567,1,0,0,344.06,8,536529.26,5,5,1,1,True
7914939,1012,0,451,9990,913049567,1,0,0,343.99,7,536185.27,26,3,16,3,True
7958834,348,0,20,7657,913049567,1,0,0,344.38,3,535840.89,24,3,13,3,True
8100710,1262,0,20,3220,913049567,1,0,0,343.91,5,535496.98,23,5,13,3,True
8149153,666,4,-1,5038,913049567,1,1,0,343.92,4,535496.98,18,5,4,4,True
8451901,666,4,451,6341,913049567,1,0,0,344.05,7,535152.93,18,4,21,5,False
8507765,428,0,10,9288,913049567,1,0,0,343.65,6,535496.58,18,5,8,5,True
8540395,666,4,25,2682,913049567,1,0,0,343.7,8,535152.88,18,1,22,6,True
8821256,1226,2,25,7963,913049567,1,0,0,344.19,8,534808.69,18,5,10,7,True
8942297,1226,2,25,7525,913049567,1,0,0,344.13,8,534464.56,18,6,7,7,True
8946326,195,1,10,7525,913049567,1,0,0,343.68,6,534808.24,18,4,22,8,True
9016292,666,4,-1,9990,913049567,1,1,0,343.72,1,534808.24,18,1,23,8,True
9299647,1012,0,30,1337,913049567,1,0,0,344.19,8,534464.05,26,5,14,9,True
9515716,1226,2,451,1337,913049567,1,0,0,344.03,7,534120.02,18,4,17,9,True
9544688,666,4,25,6101,913049567,1,0,0,344.02,8,533776.0,18,6,19,10,True
9730386,666,4,30,9288,913049567,1,0,0,343.91,8,533432.09,18,5,16,11,True
9856937,14,2,20,4937,913049567,1,0,0,344.11,5,533087.98,24,5,11,11,True
1080473,1325,0,10,4273,733108593,1,0,0,705.84,6,116564.84,18,0,8,1,True
1307419,996,0,10,8540,733108593,1,0,0,706.15,6,117270.99,26,0,9,1,True
1534691,204,0,-1,6745,733108593,1,1,0,705.87,1,117270.99,9,0,16,3,True
1540176,1209,4,451,2292,733108593,1,0,0,705.96,7,116565.03,24,2,21,4,True
1780226,51,0,10,3651,733108593,1,0,0,705.91,0,117270.94,20,0,15,6,True
1817087,859,2,20,9770,733108593,1,0,0,706.28,3,116564.66,24,5,4,6,True
2212367,935,1,451,7151,733108593,1,0,0,705.91,7,115858.75,24,3,0,9,True
2234953,518,2,20,8031,733108593,1,0,0,706.0,3,115152.75,18,1,2,9,True
2385658,53,0,10,5734,733108593,1,0,0,706.06,6,115858.81,20,2,19,9,True
2458476,1304,0,10,2047,733108593,1,0,0,706.12,6,116564.93,5,4,13,10,True
2580722,406,1,10,8031,733108593,1,0,0,705.99,6,117270.92,10,5,13,10,True
2884239,1406,0,20,9501,733108593,1,0,0,706.01,5,116564.91,24,5,11,11,True
3174506,1205,0,10,8031,733108593,1,0,0,706.34,0,117271.25,24,4,9,11,True
3175181,198,0,10,4451,733108593,1,0,0,705.87,6,117977.12,18,5,3,11,True
3224798,1105,2,30,1057,733108593,1,0,0,706.21,8,117270.91,0,5,14,1,True
3310974,269,0,10,9770,733108593,1,0,0,706.14,0,117977.05,24,2,1,1,True
3627662,1397,4,25,8582,733108593,1,0,0,706.09,8,117270.96,24,6,4,1,True
3788778,1488,0,20,7151,733108593,1,0,0,705.91,5,116565.05,24,3,20,2,True
3871911,238,0,30,3651,733108593,1,0,0,705.76,8,115859.29,26,3,0,3,True
4077881,1421,0,20,1194,733108593,1,0,0,706.15,3,115153.14,24,2,0,4,True
4284659,1241,3,-1,6952,733108593,1,1,0,705.88,1,115153.14,18,6,16,4,True
4319879,238,0,30,8554,733108593,1,0,0,705.79,8,114447.35,26,3,3,5,True
4723698,1241,3,451,9796,733108593,1,0,0,705.63,7,113741.72,18,4,9,5,True
4940980,1209,4,451,7151,733108593,1,0,0,706.29,7,113035.43,24,0,9,6,False
5116665,1241,3,451,2270,733108593,1,0,0,705.83,7,112329.6,18,4,19,7,True
5217567,1285,1,10,9770,733108593,1,0,0,706.07,6,113035.67,24,6,21,8,True
5343469,185,1,10,8031,733108593,1,0,0,706.19,0,113741.86,18,1,23,8,False
5497627,522,0,10,1741,733108593,1,0,0,705.84,6,114447.7,18,4,14,9,True
6263253,711,2,20,2270,733108593,1,0,0,706.19,5,113741.51,18,0,8,10,True
6283861,1349,3,25,8582,733108593,1,0,0,705.57,8,113035.94,24,2,10,10,True
6517793,1241,3,30,4273,733108593,1,0,0,706.01,8,112329.93,18,1,15,10,True
6659368,1209,4,451,4451,733108593,1,0,0,706.15,7,111623.78,24,1,10,11,True
6922517,238,0,30,8031,733108593,1,0,0,706.01,8,110917.77,26,5,13,11,True
6985934,1209,4,25,8540,733108593,1,0,0,705.93,8,110211.84,24,6,15,2,True
7082664,1065,0,20,2047,733108593,1,0,0,705.91,5,109505.93,11,0,11,3,True
7225823,238,0,25,1741,733108593,1,0,0,705.93,8,108800.0,26,3,13,3,True
7521778,644,0,10,2047,733108593,1,0,0,706.02,6,109506.02,24,1,16,4,True
7776879,1397,4,30,2601,733108593,1,0,0,706.05,8,108799.97,24,5,3,5,True
7820293,1349,3,30,5019,733108593,1,0,0,705.91,8,108094.06,24,3,5,6,True
7961585,935,1,25,2292,733108593,1,0,0,706.09,8,107387.97,24,1,23,7,True
8131840,1349,3,451,3037,733108593,1,0,0,706.04,7,106681.93,24,6,18,7,False
8192401,464,1,10,8554,733108593,1,0,0,705.85,0,107387.78,13,0,3,7,True
8290682,935,1,25,3588,733108593,1,0,0,706.12,8,106681.66,24,1,13,8,True
8688638,1209,4,25,2292,733108593,1,0,0,706.06,8,105975.6,24,3,1,8,True
8854515,1209,4,25,3918,733108593,1,0,0,705.83,8,105269.77,24,5,6,9,True
8855975,1397,4,451,4451,733108593,1,0,0,706.08,7,104563.69,24,2,18,10,True
9002731,1277,2,20,9501,733108593,1,0,0,706.24,3,103857.45,24,4,13,11,True
9504044,1209,4,25,3918,733108593,1,0,0,705.7,8,103151.75,24,2,12,11,True
9705023,348,0,10,1057,733108593,1,0,0,706.18,0,103857.93,24,4,12,11,True
9874521,204,0,-1,6952,733108593,1,1,0,705.86,4,103857.93,9,4,19,11,True
1056228,1278,0,20,2245,375595021,1,0,0,516.02,5,850928.98,24,2,23,1,True
1183102,1377,0,20,3085,375595021,1,0,0,516.09,3,850412.89,16,4,9,1,True
1501124,882,0,10,6126,375595021,1,0,0,516.34,6,850929.23,27,1,20,1,False
1887594,187,4,451,4151,375595021,1,0,0,515.88,7,850413.35,18,3,9,2,True
2025387,1062,3,25,1105,375595021,1,0,0,516.38,8,849896.97,11,2,14,2,True
2054370,928,3,451,1546,375595021,1,0,0,515.92,7,849381.05,18,6,17,2,True
2123299,195,1,10,9859,375595021,1,0,0,516.1,6,849897.15,18,3,16,3,True
2139889,903,3,451,4700,375595021,1,0,0,515.94,7,849381.21,2,4,20,3,True
2167034,1062,3,-1,1105,375595021,1,1,0,515.96,4,849381.21,11,0,11,5,True
2187043,903,3,25,4239,375595021,1,0,0,515.91,8,848865.3,2,5,23,5,True
2204778,1062,3,30,7623,375595021,1,0,0,516.33,8,848348.97,11,2,17,5,True
2284100,928,3,30,8365,375595021,1,0,0,516.11,8,847832.86,18,3,9,6,True
2292287,187,4,25,8271,375595021,1,0,0,515.91,8,847316.95,18,2,1,7,True
2462844,1213,2,20,4022,375595021,1,0,0,515.76,5,846801.19,24,6,22,7,True
2479665,114,0,20,9859,375595021,1,0,0,516.26,3,846284.93,3,5,5,9,True
2629955,1448,4,451,4044,375595021,1,0,0,515.86,7,845769.07,11,1,0,11,True
2665041,818,1,10,4239,375595021,1,0,0,516.0,0,846285.07,18,1,0,11,True
2675029,903,3,25,8365,375595021,1,0,0,515.9,8,845769.17,2,0,3,1,True
3081180,1390,0,20,4700,375595021,1,0,0,516.03,3,845253.14,24,3,3,2,True
3106867,950,0,20,1105,375595021,1,0,0,515.92,5,844737.22,24,2,0,4,True
3167786,187,4,-1,4239,375595021,1,1,0,515.68,4,844737.22,18,5,13,4,False
3795701,187,4,25,9591,375595021,1,0,0,515.87,8,844221.35,18,0,13,5,True
3839860,928,3,451,4826,375595021,1,0,0,516.47,7,843704.88,18,3,17,5,True
4146604,1374,4,30,6126,375595021,1,0,0,515.92,8,843188.96,16,6,18,5,True
4879497,929,0,20,8701,375595021,1,0,0,516.08,5,842672.88,18,1,2,6,True
5002748,1206,0,20,4340,375595021,1,0,0,515.78,5,842157.1,24,4,17,7,True
5006519,395,4,-1,9859,375595021,1,1,0,516.19,1,842157.1,10,5,17,7,False
5040821,1374,4,30,2245,375595021,1,0,0,515.98,8,841641.12,16,4,10,7,True
5120490,1062,3,30,1546,375595021,1,0,0,515.8,8,841125.32,11,2,4,8,False
5176530,1374,4,451,8271,375595021,1,0,0,516.04,7,840609.28,16,1,20,8,True
5541157,1374,4,30,8701,375595021,1,0,0,516.01,8,840093.27,16,4,19,9,True
5629374,903,3,30,4022,375595021,1,0,0,516.04,8,839577.23,2,3,19,9,True
6123175,1390,0,10,6556,375595021,1,0,0,516.04,0,840093.27,24,5,23,10,True
6151960,187,4,30,1546,375595021,1,0,0,516.06,8,839577.21,18,1,22,11,True
6217792,203,0,20,8701,375595021,1,0,0,515.83,3,839061.38,9,6,4,12,True
6606227,903,3,25,4826,375595021,1,0,0,515.86,8,838545.52,2,6,13,12,True
7006223,1448,4,451,6556,375595021,1,0,0,516.05,7,838029.47,11,2,3,12,True
7461082,1471,0,20,4340,375595021,1,0,0,515.94,5,837513.53,24,3,16,2,True
7578496,1062,3,451,9591,375595021,1,0,0,515.92,7,836997.61,11,5,0,2,True
7817918,476,1,10,4044,375595021,1,0,0,515.81,0,837513.42,5,4,17,3,True
8067016,928,3,451,4151,375595021,1,0,0,516.07,7,836997.35,18,5,16,3,True
8337051,395,4,30,7748,375595021,1,0,0,515.92,8,836481.43,10,0,8,3,True
8411965,1119,0,20,1390,375595021,1,0,0,515.93,5,835965.5,24,3,11,3,True
8505890,210,4,451,6126,375595021,1,0,0,516.06,7,835449.44,9,4,13,4,True
8562749,1448,4,25,8701,375595021,1,0,0,516.0,8,834933.44,11,5,9,4,True
8892023,318,0,20,8271,375595021,1,0,0,516.09,5,834417.35,11,2,5,4,True
8960575,550,0,20,4340,375595021,1,0,0,515.92,3,833901.43,17,0,11,5,True
9008972,85,2,20,9591,375595021,1,0,0,515.99,3,833385.44,1,2,16,6,True
9249997,928,3,30,3295,375595021,1,0,0,515.95,8,832869.49,18,5,15,10,True
9316360,187,4,30,9591,375595021,1,0,0,516.03,8,832353.46,18,1,19,10,True
9750384,210,4,25,4022,375595021,1,0,0,516.05,8,831837.41,9,4,14,11,True
9978109,254,0,20,8701,375595021,1,0,0,516.14,3,831321.27,6,6,1,11,True
1012213,867,0,20,3108,476962367,1,0,0,654.97,3,504878.03,24,5,14,2,True
1038076,1063,0,10,7232,476962367,1,0,0,654.97,6,505533.0,11,4,18,2,True
1681329,1308,3,451,5773,476962367,1,0,0,654.98,7,504878.02,5,0,1,2,True
1780546,1033,4,30,9824,476962367,1,0,0,655.19,8,504222.83,11,1,0,3,True
1869699,825,2,20,5591,476962367,1,0,0,655.13,5,503567.7,18,2,13,3,True
2093624,1308,3,451,7232,476962367,1,0,0,655.29,7,502912.41,5,1,6,4,True
2124832,1308,3,-1,3225,476962367,1,1,0,655.04,4,502912.41,5,2,9,4,True
2360658,677,0,-1,6111,476962367,1,2,0,654.84,4,502912.41,24,0,15,4,True
2433279,664,2,30,6703,476962367,1,0,0,655.21,8,502257.2,18,1,15,4,True
2585343,303,0,-1,1189,476962367,1,1,0,654.97,1,502257.2,4,5,1,5,True
2856088,720,4,30,6325,476962367,1,0,0,654.97,8,501602.23,11,1,19,7,True
2896612,720,4,451,1351,476962367,1,0,0,654.96,7,500947.27,11,2,20,8,True
3076528,677,0,25,9538,476962367,1,0,0,655.01,8,500292.26,24,6,19,8,True
3164407,1485,0,20,5935,476962367,1,0,0,654.88,5,499637.38,24,2,18,8,True
3255037,677,0,30,6325,476962367,1,0,0,654.92,8,498982.46,24,1,7,8,True
3489703,677,0,30,6703,476962367,1,0,0,655.13,8,498327.33,24,1,16,9,True
3542653,677,0,451,5773,476962367,1,0,0,655.19,7,497672.14,24,1,6,10,True
3609331,1115,1,10,5773,476962367,1,0,0,655.17,6,498327.31,0,4,9,11,True
3691148,303,0,451,5773,476962367,1,0,0,655.2,7,497672.11,4,2,3,12,True
3769471,168,0,20,7525,476962367,1,0,0,654.68,5,497017.43,24,3,7,12,True
4025502,720,4,30,3090,476962367,1,0,0,655.14,8,496362.29,11,5,12,12,True
4229858,677,0,451,5935,476962367,1,0,0,655.24,7,495707.05,24,6,3,2,True
4342616,677,0,451,1189,476962367,1,0,0,654.89,7,495052.16,24,0,2,3,True
4581626,797,3,-1,1629,476962367,1,1,0,655.14,4,495052.16,11,0,19,3,True
4726631,1033,4,451,8824,476962367,1,0,0,654.67,7,494397.49,11,6,21,3,True
4821980,705,1,10,3090,476962367,1,0,0,654.63,0,495052.12,18,4,16,5,True
4916866,677,0,30,6714,476962367,1,0,0,655.02,8,494397.1,24,6,21,6,True
4928309,720,4,451,5773,476962367,1,0,0,655.02,7,493742.08,11,2,4,7,True
5083822,664,2,30,4421,476962367,1,0,0,654.75,8,493087.33,18,0,1,7,True
5121530,303,0,-1,9824,476962367,1,1,0,654.96,1,493087.33,4,2,16,9,True
5125442,1033,4,451,5210,476962367,1,0,0,655.09,7,492432.24,11,0,9,10,True
5293281,303,0,451,9824,476962367,1,0,0,655.14,7,491777.1,4,2,1,10,True
5577566,1474,0,10,3090,476962367,1,0,0,654.83,6,492431.93,24,1,2,11,True
5615649,498,0,10,6714,476962367,1,0,0,655.19,6,493087.12,12,4,11,12,True
6000074,1227,0,10,8824,476962367,1,0,0,655.14,6,493742.26,18,0,19,12,True
6087168,1061,2,20,4780,476962367,1,0,0,655.02,5,493087.24,11,2,18,12,True
6087220,720,4,30,5591,476962367,1,0,0,655.05,8,492432.19,11,1,15,1,True
6560693,1264,0,20,7232,476962367,1,0,0,654.87,3,491777.32,23,5,4,1,True
6712196,664,2,30,5210,476962367,1,0,0,655.16,8,491122.16,18,1,17,1,True
6874942,1308,3,451,8824,476962367,1,0,0,655.08,7,490467.08,5,6,0,3,True
6941592,677,0,30,5935,476962367,1,0,0,655.09,8,489811.99,24,1,1,3,True
7070450,1033,4,30,6545,476962367,1,0,0,654.81,8,489157.18,11,6,5,3,True
7269049,720,4,-1,3797,476962367,1,1,0,655.03,1,489157.18,11,0,10,4,True
7605481,594,0,20,6714,476962367,1,0,0,655.08,5,488502.1,24,1,16,5,True
7663297,1033,4,30,3516,476962367,1,0,0,655.06,8,487847.04,11,3,11,6,True
7852277,797,3,451,7232,476962367,1,0,0,655.05,7,487191.99,11,6,20,7,True
7944377,1029,0,10,7232,476962367,1,0,0,654.94,6,487846.93,11,4,17,8,True
7985335,664,2,451,6879,476962367,1,0,0,655.26,7,487191.67,18,3,13,8,True
8012549,1033,4,-1,6879,476962367,1,1,0,654.78,4,487191.67,11,6,6,8,True
8510148,802,2,20,6111,476962367,1,0,0,655.01,3,486536.66,11,6,8,8,True
8713808,696,2,20,4780,476962367,1,0,0,655.01,5,485881.65,24,2,17,9,True
8821097,664,2,-1,8787,476962367,1,1,0,655.08,4,485881.65,18,3,8,9,True
9170670,1308,3,451,3225,476962367,1,0,0,655.27,7,485226.38,5,1,9,9,True
9831173,720,4,25,7232,476962367,1,0,0,655.01,8,484571.37,11,5,7,10,True
1000952,373,1,10,9883,729508089,1,0,0,244.83,6,103715.83,25,1,15,3,True
1219078,892,4,25,6848,729508089,1,0,0,244.96,8,103470.87,24,3,12,3,True
1342021,1476,0,20,2778,729508089,1,0,0,245.5,3,103225.37,24,4,6,3,True
1476893,116,0,10,2778,729508089,1,0,0,244.98,6,103470.35,3,2,23,4,True
1506074,346,0,20,8849,729508089,1,0,0,245.1,5,103225.25,24,1,9,4,True
1524167,892,4,25,1485,729508089,1,0,0,245.04,8,102980.21,24,3,8,5,True
1625344,76,0,10,2620,729508089,1,0,0,244.96,0,103225.17,20,6,5,5,True
1952570,1213,2,451,3567,729508089,1,0,0,245.14,7,102980.03,24,1,5,5,True
2174273,1213,2,25,6699,729508089,1,0,0,244.86,8,102735.17,24,6,8,6,True
2200803,530,0,-1,4317,729508089,1,1,0,244.82,1,102735.17,18,2,23,7,True
2467737,1090,0,20,3567,729508089,1,0,0,245.1,5,102490.07,18,0,2,8,True
2474700,1387,1,25,8849,729508089,1,0,0,245.12,8,102244.95,24,0,23,8,True
2497325,608,4,30,7048,729508089,1,0,0,244.97,8,101999.98,24,2,3,8,True
2855394,812,0,10,3567,729508089,1,0,0,244.87,6,102244.85,18,2,8,9,True
3160115,309,0,10,9883,729508089,1,0,0,244.9,6,102489.75,4,2,19,10,True
3171522,1278,0,20,8938,729508089,1,0,0,245.24,3,102244.51,24,4,6,10,True
3280534,530,0,10,6699,729508089,1,0,0,245.01,6,102489.52,18,4,20,10,True
3331014,569,4,30,3567,729508089,1,0,0,244.88,8,102244.64,11,5,19,11,True
3347168,599,0,10,7048,729508089,1,0,0,244.96,6,102489.6,24,4,20,12,True
3457293,1069,1,-1,1485,729508089,1,1,0,244.97,4,102489.6,18,2,15,1,True
3491280,892,4,451,9883,729508089,1,0,0,245.1,7,102244.5,24,4,9,2,True
3520832,1213,2,-1,4317,729508089,1,1,0,245.2,4,102244.5,24,6,14,3,True
3566039,569,4,451,4097,729508089,1,0,0,244.9,7,101999.6,11,6,6,4,True
3633997,569,4,451,2810,729508089,1,0,0,244.99,7,101754.61,11,5,5,5,True
3696347,1069,1,30,4097,729508089,1,0,0,245.06,8,101509.55,18,5,17,5,True
3913435,1356,2,20,6699,729508089,1,0,0,244.79,5,101264.76,24,5,21,6,True
4263048,530,0,25,9883,729508089,1,0,0,245.09,8,101019.67,18,6,4,8,True
4543265,255,2,20,2620,729508089,1,0,0,244.57,5,100775.1,6,6,0,9,True
4779347,608,4,451,8938,729508089,1,0,0,245.11,7,100529.99,24,5,14,11,True
4838917,608,4,30,8467,729508089,1,0,0,244.91,8,100285.08,24,4,15,12,True
4959592,689,0,20,7542,729508089,1,0,0,245.01,5,100040.07,24,0,12,1,True
5110826,996,0,10,6699,729508089,1,0,0,244.66,6,100284.73,26,0,22,1,True
5627748,1213,2,451,2810,729508089,1,0,0,245.12,7,100039.61,24,6,9,5,True
5780563,892,4,451,6848,729508089,1,0,0,245.05,7,99794.56,24,2,8,6,True
5894182,1213,2,451,3567,729508089,1,0,0,244.99,7,99549.57,24,1,3,7,True
6422732,892,4,30,9883,729508089,1,0,0,245.05,8,99304.52,24,6,5,7,True
6488460,652,0,20,4097,729508089,1,0,0,244.87,5,99059.65,24,5,5,8,True
6665810,892,4,30,9883,729508089,1,0,0,245.14,8,98814.51,24,3,3,8,True
6825610,1213,2,451,7048,729508089,1,0,0,244.94,7,98569.57,24,3,22,8,True
7135397,1069,1,-1,7542,729508089,1,1,0,245.09,4,98569.57,18,6,1,9,True
7875278,530,0,-1,6699,729508089,1,2,0,245.35,4,98569.57,18,3,23,9,True
7955346,1213,2,-1,8849,729508089,1,3,1,244.91,4,98569.57,24,3,1,10,False
1016233,240,4,451,8678,739648982,1,0,0,237.13,7,806461.87,26,2,19,2,True
1059325,952,0,10,9167,739648982,1,0,0,237.07,6,806698.94,13,0,6,3,True
1142882,443,2,20,9077,739648982,1,0,0,236.9,5,806462.04,24,4,1,4,True
1561290,435,4,-1,9436,739648982,1,1,0,236.8,1,806462.04,24,5,18,4,True
1620506,1467,0,20,3331,739648982,1,0,0,237.13,5,806224.91,11,6,14,5,True
1743385,435,4,25,6246,739648982,1,0,0,236.9,8,805988.01,24,4,8,5,True
1986653,263,3,25,6074,739648982,1,0,0,236.94,8,805751.07,6,0,2,6,True
2231011,551,0,20,6330,739648982,1,0,0,237.02,5,805514.05,17,1,15,6,True
2673671,240,4,451,9436,739648982,1,0,0,236.94,7,805277.11,26,4,13,6,True
2742000,687,0,20,4763,739648982,1,0,0,236.66,5,805040.45,24,0,4,7,True
2792843,1423,3,-1,2716,739648982,1,1,0,237.1,4,805040.45,24,3,20,7,True
2799361,240,4,25,9436,739648982,1,0,0,236.9,8,804803.55,26,2,0,8,True
3080447,435,4,-1,5798,739648982,1,1,0,237.14,1,804803.55,24,0,5,8,True
3438409,435,4,451,5798,739648982,1,0,0,236.98,7,804566.57,24,3,13,8,True
3492136,1132,0,451,4763,739648982,1,0,0,236.72,7,804329.85,24,2,13,8,True
3807935,435,4,30,9664,739648982,1,0,0,237.0,8,804092.85,24,4,9,9,False
3869951,1132,0,-1,2803,739648982,1,1,0,236.85,4,804092.85,24,1,2,11,True
3996168,263,3,30,3331,739648982,1,0,0,237.13,8,803855.72,6,6,3,12,True
4115559,177,4,30,6851,739648982,1,0,0,237.33,8,803618.39,24,4,20,1,True
4223904,240,4,30,3425,739648982,1,0,0,236.97,8,803381.42,26,5,20,1,True
4251971,1423,3,-1,2093,739648982,1,1,0,236.97,4,803381.42,24,1,7,2,True
4314349,1205,0,20,7995,739648982,1,0,0,237.17,5,803144.25,24,6,21,2,True
4379520,240,4,451,6330,739648982,1,0,0,237.29,7,802906.96,26,3,3,3,True
4817772,1132,0,30,8148,739648982,1,0,0,236.98,8,802669.98,24,0,8,4,True
4935777,1423,3,-1,6330,739648982,1,1,0,236.95,1,802669.98,24,2,12,4,True
4993753,263,3,-1,7995,739648982,1,2,0,236.85,1,802669.98,6,0,12,5,True
5279884,825,2,20,3905,739648982,1,0,0,236.99,5,802432.99,18,1,8,5,True
5321700,1205,0,20,9188,739648982,1,0,0,237.14,5,802195.85,24,4,12,5,True
5417986,1423,3,451,8813,739648982,1,0,0,236.74,7,801959.11,24,2,13,6,True
5757073,263,3,25,3905,739648982,1,0,0,237.08,8,801722.03,6,3,11,7,True
5878702,263,3,30,9436,739648982,1,0,0,236.96,8,801485.07,6,2,16,7,True
5957685,1423,3,30,8813,739648982,1,0,0,236.92,8,801248.15,24,2,18,10,True
6050850,240,4,451,6074,739648982,1,0,0,237.13,7,801011.02,26,1,23,11,True
6075571,930,3,451,6074,739648982,1,0,0,236.77,7,800774.25,18,2,19,11,True
6346624,1010,0,20,4763,739648982,1,0,0,237.3,3,800536.95,26,5,10,11,True
6542250,263,3,451,3027,739648982,1,0,0,237.1,7,800299.85,6,0,17,11,True
6708144,1423,3,451,3199,739648982,1,0,0,237.2,7,800062.65,24,2,21,12,True
6840858,1132,0,30,2716,739648982,1,0,0,237.4,8,799825.25,24,3,13,12,True
6874734,435,4,25,7995,739648982,1,0,0,236.79,8,799588.46,24,5,11,12,True
6972420,177,4,-1,9664,739648982,1,1,0,237.06,1,799588.46,24,2,6,1,True
6986526,1423,3,451,2093,739648982,1,0,0,237.02,7,799351.44,24,1,8,2,True
7039616,1423,3,25,9664,739648982,1,0,0,237.06,8,799114.38,24,0,15,4,False
7490893,355,1,10,6246,739648982,1,0,0,237.13,6,799351.51,24,5,7,4,True
7951829,263,3,451,6074,739648982,1,0,0,236.98,7,799114.53,6,4,3,6,True
8152702,703,0,20,9188,739648982,1,0,0,236.78,3,798877.75,18,1,4,6,True
8319895,177,4,30,9167,739648982,1,0,0,237.03,8,798640.72,24,1,14,6,True
8633350,81,0,10,8813,739648982,1,0,0,237.26,6,798877.98,1,1,4,7,True
8727354,930,3,451,7995,739648982,1,0,0,236.95,7,798641.03,18,4,15,7,True
8863218,177,4,451,9077,739648982,1,0,0,237.07,7,798403.96,24,5,15,8,True
8881614,1164,0,20,2803,739648982,1,0,0,237.01,3,798166.95,24,5,7,9,True
8966789,1423,3,-1,8813,739648982,1,1,0,237.07,4,798166.95,24,1,13,10,True
9579838,177,4,30,9664,739648982,1,0,0,236.94,8,797930.01,24,4,9,10,True
9839081,263,3,-1,6074,739648982,1,1,0,236.81,4,797930.01,6,1,1,11,True
9939933,1132,0,-1,3331,739648982,1,2,0,236.98,1,797930.01,24,2,10,11,True
1078950,1196,4,25,5750,356110300,1,0,0,1186.06,8,155308.94,24,4,21,1,True
1143966,831,1,10,4905,356110300,1,0,0,1185.98,6,156494.92,5,3,6,1,True
1151509,105,3,30,3986,356110300,1,0,0,1185.86,8,155309.06,3,6,18,1,True
1642721,166,4,451,6786,356110300,1,0,0,1186.17,7,154122.89,24,0,3,1,True
1797869,820,1,10,1218,356110300,1,0,0,1185.89,6,155308.78,18,4,16,2,True
1858598,588,0,20,5750,356110300,1,0,0,1185.98,5,154122.8,24,0,0,3,True
1923533,958,2,20,4905,356110300,1,0,0,1185.95,3,152936.85,13,1,22,3,True
2073196,694,2,20,4421,356110300,1,0,0,1186.0,5,151750.85,24,5,10,4,True
2177545,1238,0,25,5034,356110300,1,0,0,1185.8,8,150565.05,18,6,7,4,True
2639695,398,0,10,2391,356110300,1,0,0,1185.75,6,151750.8,10,2,1,5,True
2796161,790,0,20,1198,356110300,1,0,0,1185.88,3,150564.92,11,2,22,5,True
2982296,1196,4,30,2006,356110300,1,0,0,1186.2,8,149378.72,24,4,12,5,True
2991156,1238,0,451,4905,356110300,1,0,0,1185.9,7,148192.82,18,1,11,6,True
3135289,476,1,10,2356,356110300,1,0,0,1186.14,0,149378.96,5,1,3,7,True
3254563,42,2,20,1396,356110300,1,0,0,1186.02,3,148192.94,24,2,5,7,True
3310000,105,3,30,3986,356110300,1,0,0,1185.88,8,147007.06,3,2,8,9,True
3320686,1196,4,25,4905,356110300,1,0,0,1185.87,8,145821.19,24,2,20,10,True
3584310,482,1,30,7921,356110300,1,0,0,1185.8,8,144635.39,5,1,7,10,True
3658620,193,1,10,9393,356110300,1,0,0,1186.02,6,145821.41,18,3,18,11,True
3773869,105,3,30,6722,356110300,1,0,0,1186.06,8,144635.35,3,0,6,12,True
3963206,482,1,-1,6722,356110300,1,1,0,1185.81,4,144635.35,5,6,13,12,True
3969058,166,4,451,2356,356110300,1,0,0,1185.9,7,143449.45,24,2,21,12,True
3982034,105,3,25,5034,356110300,1,0,0,1185.88,8,142263.57,3,5,0,12,True
4394487,1116,0,10,1396,356110300,1,0,0,1186.22,6,143449.79,24,5,7,12,True
4454746,1061,2,20,1218,356110300,1,0,0,1185.96,3,142263.83,11,4,0,2,True
4499566,1155,0,30,6831,356110300,1,0,0,1186.06,8,141077.77,15,6,6,2,True
4573936,1260,0,10,6786,356110300,1,0,0,1185.97,0,142263.74,23,1,3,4,True
4606518,1155,0,451,6831,356110300,1,0,0,1186.11,7,141077.63,15,6,2,4,True
4790564,818,1,10,3986,356110300,1,0,0,1185.84,6,142263.47,18,4,6,6,True
4927681,1196,4,30,5294,356110300,1,0,0,1186.34,8,141077.13,24,5,5,7,True
5097269,1155,0,25,6587,356110300,1,0,0,1185.79,8,139891.34,15,1,12,7,True
5199082,696,2,20,6377,356110300,1,0,0,1186.37,5,138704.97,24,0,12,7,True
5301708,503,0,10,9373,356110300,1,0,0,1186.07,6,139891.04,12,1,1,7,True
5435081,166,4,451,2525,356110300,1,0,0,1186.13,7,138704.91,24,3,21,9,True
5472670,1196,4,25,8518,356110300,1,0,0,1186.1,8,137518.81,24,4,11,9,True
5546719,759,0,10,9373,356110300,1,0,0,1185.9,0,138704.71,24,2,4,10,True
5768310,860,1,30,2356,356110300,1,0,0,1185.84,8,137518.87,24,6,3,10,True
5824276,1390,0,10,1623,356110300,1,0,0,1186.04,6,138704.91,24,5,8,10,True
6218450,166,4,-1,2006,356110300,1,1,0,1186.24,4,138704.91,24,0,15,10,True
6565678,1155,0,25,9373,356110300,1,0,0,1186.13,8,137518.78,15,1,22,10,True
6642740,1128,2,20,5294,356110300,1,0,0,1185.53,3,136333.25,24,2,14,11,True
7016797,482,1,30,8024,356110300,1,0,0,1186.1,8,135147.15,5,2,18,11,True
7092108,918,2,20,2006,356110300,1,0,0,1185.92,5,133961.23,18,4,23,1,True
7096392,966,4,25,1396,356110300,1,0,0,1185.89,8,132775.34,13,0,9,3,True
7339687,860,1,25,6831,356110300,1,0,0,1186.0,8,131589.34,24,6,9,4,True
7391613,860,1,25,9373,356110300,1,0,0,1185.9,8,130403.44,24,0,13,5,True
7593289,1238,0,25,5034,356110300,1,0,0,1186.01,8,129217.43,18,1,16,5,True
7629002,966,4,25,6831,356110300,1,0,0,1186.04,8,128031.39,13,1,17,5,True
7664653,1411,0,10,6821,356110300,1,0,0,1186.25,0,129217.64,24,4,12,6,True
7689626,299,1,10,5812,356110300,1,0,0,1186.1,6,130403.74,4,6,11,6,True
7937624,105,3,451,6722,356110300,1,0,0,1186.01,7,129217.73,3,4,9,6,True
8112819,966,4,451,2356,356110300,1,0,0,1186.02,7,128031.71,13,0,7,8,True
8278056,105,3,451,1198,356110300,1,0,0,1185.95,7,126845.76,3,5,7,8,True
8364907,105,3,25,2356,356110300,1,0,0,1186.1,8,125659.66,3,6,5,8,True
8451860,1196,4,451,1396,356110300,1,0,0,1185.99,7,124473.67,24,0,5,9,True
8769403,594,0,20,8024,356110300,1,0,0,1186.13,3,123287.54,24,5,18,10,True
9260579,1155,0,30,6786,356110300,1,0,0,1186.1,8,122101.44,15,6,13,10,True
9703777,1196,4,30,1623,356110300,1,0,0,1185.83,8,120915.61,24,2,23,11,True
9762534,860,1,-1,1198,356110300,1,1,0,1186.06,4,120915.61,24,1,17,11,True
1297106,1151,4,25,1763,981736567,1,0,0,688.91,8,655014.09,15,6,21,1,True
1371868,327,0,451,6580,981736567,1,0,0,688.92,7,654325.17,11,6,2,1,False
1501808,965,4,451,9276,981736567,1,0,0,688.9,7,653636.27,13,6,16,1,True
2038444,1265,4,451,8943,981736567,1,0,0,689.06,7,652947.21,23,5,21,2,True
2123132,327,0,25,6580,981736567,1,0,0,688.91,8,652258.3,11,4,19,4,True
2356191,1476,0,-1,6580,981736567,1,1,0,689.26,4,652258.3,24,3,3,5,True
2617899,613,4,-1,5417,981736567,1,2,0,688.75,4,652258.3,11,2,21,5,True
2660198,1142,2,451,1763,981736567,1,0,0,689.04,7,651569.26,15,3,3,5,True
2748699,1265,4,451,1763,981736567,1,0,0,689.0,7,650880.26,23,5,17,6,True
3442821,81,0,20,3073,981736567,1,0,0,688.79,5,650191.47,1,0,13,6,True
3481040,1151,4,30,3073,981736567,1,0,0,689.06,8,649502.41,15,4,17,7,True
3545603,1476,0,25,9276,981736567,1,0,0,689.14,8,648813.27,24,2,6,7,True
3794328,1439,4,451,9837,981736567,1,0,0,688.91,7,648124.36,24,2,0,7,True
3887811,1476,0,451,1074,981736567,1,0,0,689.14,7,647435.22,24,1,15,7,True
4146719,965,4,30,8657,981736567,1,0,0,688.98,8,646746.24,13,4,12,8,True
4175987,613,4,25,7302,981736567,1,0,0,688.87,8,646057.37,11,0,18,9,True
4197788,1044,0,10,3634,981736567,1,0,0,688.92,6,646746.29,11,1,13,9,True
4322268,675,2,20,4361,981736567,1,0,0,689.1,3,646057.19,24,2,4,9,True
4573675,635,2,20,7302,981736567,1,0,0,688.74,5,645368.45,24,1,1,10,True
4593728,1439,4,30,1074,981736567,1,0,0,688.93,8,644679.52,24,0,6,12,True
4619230,1151,4,30,9837,981736567,1,0,0,688.92,8,643990.6,15,3,15,12,True
4706762,1151,4,25,9024,981736567,1,0,0,688.92,8,643301.68,15,0,13,12,True
4788787,965,4,-1,8564,981736567,1,1,0,689.13,1,643301.68,13,6,15,1,True
4967427,1146,2,20,3634,981736567,1,0,0,688.88,5,642612.8,15,6,1,1,True
4968665,1439,4,30,4361,981736567,1,0,0,688.77,8,641924.03,24,3,14,1,True
4978356,1476,0,-1,1829,981736567,1,1,0,688.77,4,641924.03,24,4,9,4,True
5261382,1439,4,25,2403,981736567,1,0,0,688.68,8,641235.35,24,1,3,4,True
5285831,1142,2,30,6580,981736567,1,0,0,689.04,8,640546.31,15,3,16,5,True
5404846,965,4,451,9837,981736567,1,0,0,688.95,7,639857.36,13,4,2,8,True
5456298,774,2,20,4683,981736567,1,0,0,689.1,5,639168.26,14,6,12,8,True
5501935,613,4,25,3415,981736567,1,0,0,689.07,8,638479.19,11,0,2,8,True
5531576,1439,4,30,5318,981736567,1,0,0,689.01,8,637790.18,24,3,21,8,True
5754693,1476,0,451,6580,981736567,1,0,0,688.95,7,637101.23,24,2,11,9,True
6131066,1476,0,30,7302,981736567,1,0,0,688.74,8,636412.49,24,1,5,9,True
6421730,1265,4,25,7302,981736567,1,0,0,689.04,8,635723.45,23,4,3,10,True
6739241,1391,2,20,5417,981736567,1,0,0,688.78,5,635034.67,24,2,18,12,True
6784878,262,2,20,6409,981736567,1,0,0,688.85,3,634345.82,6,6,23,1,True
6940275,613,4,25,9963,981736567,1,0,0,688.98,8,633656.84,11,1,20,1,True
7040389,1439,4,25,5107,981736567,1,0,0,688.86,8,632967.98,24,6,12,3,True
7045835,327,0,-1,2405,981736567,1,1,0,688.97,1,632967.98,11,3,16,5,True
7081208,327,0,-1,9039,981736567,1,2,0,689.06,1,632967.98,11,2,18,5,True
7093145,1267,2,20,4683,981736567,1,0,0,689.05,3,632278.93,23,6,5,5,True
7337121,613,4,451,9963,981736567,1,0,0,688.87,7,631590.06,11,5,20,7,False
7460040,613,4,30,2403,981736567,1,0,0,689.08,8,630900.98,11,2,0,7,True
7497883,669,2,20,4683,981736567,1,0,0,688.8,3,630212.18,18,1,16,8,True
7558838,1304,0,20,8943,981736567,1,0,0,688.88,5,629523.3,5,6,18,8,True
7748779,613,4,451,8943,981736567,1,0,0,689.22,7,628834.08,11,4,21,10,True
7999905,327,0,451,5417,981736567,1,0,0,689.08,7,628145.0,11,3,15,10,True
8484489,512,0,10,2403,981736567,1,0,0,689.08,6,628834.08,12,2,14,10,False
8540211,965,4,-1,5318,981736567,1,1,0,688.93,4,628834.08,13,3,12,10,True
9551650,1439,4,25,8657,981736567,1,0,0,689.37,8,628144.71,24,5,19,11,False
9705970,1461,0,20,1074,981736567,1,0,0,688.78,5,627455.93,11,0,14,11,True
1108152,274,1,10,6060,834912187,0,0,0,226.04,0,157297.04,24,4,12,1,True
1303613,35,2,30,9244,834912187,0,0,0,226.19,8,157070.85,11,1,9,3,True
1336425,909,2,451,7843,834912187,0,0,0,225.9,7,156844.95,18,1,15,3,True
1810583,1262,0,10,6801,834912187,0,0,0,226.09,6,157071.04,23,2,11,3,True
1974998,1151,4,-1,6060,834912187,0,1,0,226.1,4,157071.04,15,6,16,5,True
2087338,1210,0,10,4591,834912187,0,0,0,226.03,6,157297.07,24,1,22,6,True
2396844,424,1,10,4014,834912187,0,0,0,226.37,6,157523.44,18,4,18,6,True
2575079,455,4,451,1685,834912187,0,0,0,225.89,7,157297.55,13,0,3,6,True
2577035,663,4,-1,1685,834912187,0,1,0,226.23,1,157297.55,18,1,23,7,True
2640712,1447,4,-1,2359,834912187,0,2,0,226.04,4,157297.55,24,2,12,7,True
2686918,1169,0,10,2017,834912187,0,0,0,226.08,0,157523.63,24,2,4,9,True
3231515,35,2,30,2359,834912187,0,0,0,225.9,8,157297.73,11,6,8,9,True
3250650,1390,0,20,2359,834912187,0,0,0,226.11,5,157071.62,24,3,0,10,True
3426401,1447,4,451,6060,834912187,0,0,0,225.92,7,156845.7,24,0,20,10,True
3495399,1333,4,451,4014,834912187,0,0,0,225.92,7,156619.78,18,4,2,12,True
3497094,35,2,-1,4014,834912187,0,1,0,225.97,4,156619.78,11,0,20,12,True
3590519,1455,2,20,6801,834912187,0,0,0,226.11,5,156393.67,11,2,9,12,True
3755204,909,2,25,1685,834912187,0,0,0,226.09,8,156167.58,18,0,14,1,True
4112822,1333,4,30,6079,834912187,0,0,0,226.16,8,155941.42,18,2,0,2,True
4331824,577,0,20,3954,834912187,0,0,0,226.05,5,155715.37,11,1,18,2,True
4339350,909,2,451,1685,834912187,0,0,0,226.06,7,155489.31,18,1,19,3,True
4363253,1151,4,-1,7843,834912187,0,1,0,225.96,1,155489.31,15,5,7,4,True
4413054,1273,0,10,3954,834912187,0,0,0,226.0,6,155715.31,24,3,0,4,True
4469078,455,4,-1,2767,834912187,0,1,0,226.25,4,155715.31,13,6,3,4,True
4856048,1363,0,20,8261,834912187,0,0,0,225.84,3,155489.47,16,6,8,5,True
4856746,518,2,20,1685,834912187,0,0,0,226.04,5,155263.43,18,2,4,5,True
4858044,1260,0,20,1685,834912187,0,0,0,225.62,3,155037.81,23,4,17,6,True
4908613,1260,0,10,1685,834912187,0,0,0,225.93,0,155263.74,23,5,8,9,True
5004635,1333,4,25,5511,834912187,0,0,0,226.09,8,155037.65,18,3,17,10,True
5213706,208,0,10,4014,834912187,0,0,0,225.84,6,155263.49,9,2,14,11,True
5281356,1447,4,-1,2767,834912187,0,1,0,225.88,4,155263.49,24,2,16,11,True
5355580,588,0,20,7843,834912187,0,0,0,226.03,5,155037.46,24,2,18,11,False
5454052,909,2,25,2165,834912187,0,0,0,226.22,8,154811.24,18,3,3,11,False
5648941,498,0,10,2017,834912187,0,0,0,226.15,6,155037.39,12,0,13,12,True
5686058,880,1,10,6205,834912187,0,0,0,226.15,6,155263.54,27,2,11,1,False
6206017,137,2,20,4014,834912187,0,0,0,226.05,5,155037.49,18,4,15,2,False
6349160,1151,4,451,6205,834912187,0,0,0,226.02,7,154811.47,15,3,18,2,False
6657527,35,2,451,5511,834912187,0,0,0,225.97,7,154585.5,11,0,17,2,True
7415152,1151,4,451,1685,834912187,0,0,0,226.27,7,154359.23,15,1,13,3,False
7442655,129,0,20,4591,834912187,0,0,0,225.92,5,154133.31,18,5,18,6,False
7706250,220,0,10,2165,834912187,0,0,0,226.09,6,154359.4,26,3,5,6,True
8049967,35,2,25,5248,834912187,0,0,0,225.83,8,154133.57,11,2,8,7,True
8244070,1151,4,451,6079,834912187,0,0,0,225.81,7,153907.76,15,6,9,7,True
8273994,1101,2,20,3954,834912187,0,0,0,226.08,5,153681.68,0,6,9,7,True
8378574,1447,4,30,2165,834912187,0,0,0,226.22,8,153455.46,24,0,19,7,True
8863040,663,4,25,5248,834912187,0,0,0,226.07,8,153229.39,18,1,9,8,True
8969252,867,0,10,6801,834912187,0,0,0,225.87,6,153455.26,24,2,2,8,True
9067511,757,0,10,4134,834912187,0,0,0,226.06,0,153681.32,24,2,5,8,True
9095032,35,2,-1,3954,834912187,0,1,0,226.03,1,153681.32,11,6,11,10,True
9128020,1447,4,451,8578,834912187,0,0,0,226.34,7,153454.98,24,4,12,11,True
1094368,618,3,451,3394,881992474,0,0,0,882.0,7,545359.0,11,0,12,1,True
1188044,438,1,10,1265,881992474,0,0,0,882.09,6,546241.09,24,4,10,2,True
1360578,1421,0,10,9044,881992474,0,0,0,882.2,0,547123.29,24,2,13,2,False
1434963,618,3,451,1963,881992474,0,0,0,881.72,7,546241.57,11,5,12,4,True
1478635,703,0,10,2599,881992474,0,0,0,882.26,6,547123.83,18,5,3,4,True
1532477,993,0,20,6397,881992474,0,0,0,881.69,3,546242.14,22,6,6,5,True
1766584,534,4,-1,1265,881992474,0,1,0,882.13,4,546242.14,18,3,2,6,False
1782170,404,1,451,9456,881992474,0,0,0,882.02,7,545360.12,10,1,18,7,True
1858757,509,0,20,3486,881992474,0,0,0,882.01,3,544478.11,12,2,11,8,False
1916624,534,4,25,2097,881992474,0,0,0,882.08,8,543596.03,18,1,19,9,True
2016932,653,1,-1,4104,881992474,0,1,0,881.76,4,543596.03,24,6,0,9,True
2032734,653,1,25,3394,881992474,0,0,0,881.85,8,542714.18,24,6,13,10,True
2223829,702,4,25,2538,881992474,0,0,0,881.94,8,541832.24,18,1,10,10,True
2321864,534,4,451,1265,881992474,0,0,0,881.72,7,540950.52,18,6,4,10,True
2716924,404,1,-1,1460,881992474,0,1,0,881.94,4,540950.52,10,1,14,10,True
2820540,1119,0,10,1963,881992474,0,0,0,882.12,6,541832.64,24,1,21,10,True
2916122,404,1,30,4104,881992474,0,0,0,881.95,8,540950.69,10,5,20,10,True
3013931,702,4,451,4611,881992474,0,0,0,882.32,7,540068.37,18,6,3,12,True
3170348,1474,0,20,5686,881992474,0,0,0,882.03,5,539186.34,24,3,16,1,True
3324162,464,1,10,1657,881992474,0,0,0,882.03,0,540068.37,13,6,11,2,True
3573305,653,1,-1,2538,881992474,0,1,0,881.92,4,540068.37,24,4,5,2,True
3806681,404,1,451,1657,881992474,0,0,0,882.01,7,539186.36,10,4,22,2,True
3821496,534,4,-1,6397,881992474,0,1,0,882.15,4,539186.36,18,5,4,2,True
4021897,990,0,10,3901,881992474,0,0,0,882.18,6,540068.54,22,1,13,3,True
4130809,811,0,20,4528,881992474,0,0,0,881.76,5,539186.78,18,4,21,3,True
4287502,618,3,-1,8174,881992474,0,1,0,881.89,1,539186.78,11,5,0,4,True
4478951,594,0,-1,1587,881992474,0,2,0,881.74,1,539186.78,24,4,3,4,True
4552077,404,1,30,9044,881992474,0,0,0,882.1,8,538304.68,10,2,16,5,True
4731765,329,1,10,8174,881992474,0,0,0,881.89,6,539186.57,11,2,17,5,True
5057116,341,0,10,1460,881992474,0,0,0,881.94,0,540068.51,24,0,2,6,True
5089372,616,1,10,9044,881992474,0,0,0,882.08,6,540950.59,11,0,20,6,True
5104503,191,3,30,2538,881992474,0,0,0,881.82,8,540068.77,18,2,15,6,True
5152308,594,0,25,1963,881992474,0,0,0,881.71,8,539187.06,24,4,23,7,True
5315727,148,1,10,3486,881992474,0,0,0,882.05,6,540069.11,18,3,6,8,True
5769259,534,4,-1,4528,881992474,0,1,0,881.74,4,540069.11,18,4,6,8,True
5801655,702,4,25,3394,881992474,0,0,0,881.96,8,539187.15,18,1,6,10,True
5836486,191,3,30,4104,881992474,0,0,0,882.0,8,538305.15,18,1,18,10,True
6040073,653,1,451,3901,881992474,0,0,0,881.86,7,537423.29,24,3,21,11,True
6059992,618,3,25,3486,881992474,0,0,0,882.01,8,536541.28,11,4,5,11,True
6108925,653,1,451,2538,881992474,0,0,0,882.24,7,535659.04,24,1,22,1,True
6176233,702,4,451,3344,881992474,0,0,0,882.13,7,534776.91,18,6,10,2,True
6395163,1226,2,20,1460,881992474,0,0,0,882.12,5,533894.79,18,0,12,3,True
6556292,618,3,-1,4611,881992474,0,1,0,881.69,4,533894.79,11,3,8,3,True
6651307,191,3,451,1657,881992474,0,0,0,881.81,7,533012.98,18,4,18,3,True
6690558,404,1,451,1587,881992474,0,0,0,881.96,7,532131.02,10,5,8,4,True
6928062,594,0,451,9456,881992474,0,0,0,882.08,7,531248.94,24,1,21,4,True
7209875,653,1,30,2097,881992474,0,0,0,882.13,8,530366.81,24,5,6,5,True
8199628,404,1,30,3964,881992474,0,0,0,881.97,8,529484.84,10,5,16,6,True
8200831,653,1,25,8174,881992474,0,0,0,881.93,8,528602.91,24,0,0,7,False
8403549,618,3,451,2599,881992474,0,0,0,881.93,7,527720.98,11,6,8,7,True
8592636,404,1,30,6995,881992474,0,0,0,881.77,8,526839.21,10,6,5,8,True
8627454,594,0,25,3394,881992474,0,0,0,881.95,8,525957.26,24,1,11,8,False
9048402,594,0,451,3964,881992474,0,0,0,882.04,7,525075.22,24,2,14,8,True
9052459,1072,0,10,3394,881992474,0,0,0,882.23,0,525957.45,18,1,8,8,True
9208016,653,1,30,8174,881992474,0,0,0,882.15,8,525075.3,24,4,20,8,True
9576859,404,1,30,5686,881992474,0,0,0,882.11,8,524193.19,10,6,8,9,True
9779555,653,1,451,5686,881992474,0,0,0,882.04,7,523311.15,24,0,11,9,True
9972754,653,1,25,1963,881992474,0,0,0,881.97,8,522429.18,24,6,21,10,True
1012263,783,0,451,7988,952794669,0,0,0,627.9,7,306844.1,14,5,18,1,True
1064955,233,4,30,1504,952794669,0,0,0,627.73,8,306216.37,26,4,20,1,True
1885418,822,4,451,2421,952794669,0,0,0,628.16,7,305588.21,18,6,17,3,True
2433830,480,0,10,8504,952794669,0,0,0,627.85,6,306216.06,5,4,4,4,True
2620916,783,0,25,2468,952794669,0,0,0,627.87,8,305588.19,14,3,10,4,True
2742013,924,4,30,1058,952794669,0,0,0,628.06,8,304960.13,18,4,3,5,False
3213724,137,2,451,2045,952794669,0,0,0,628.15,7,304331.98,18,2,19,5,True
3248890,1359,2,-1,9178,952794669,0,1,0,628.0,4,304331.98,24,0,19,6,True
3416467,958,2,25,2468,952794669,0,0,0,628.16,8,303703.82,13,4,13,6,True
3535343,137,2,-1,5118,952794669,0,1,0,627.73,4,303703.82,18,4,22,6,True
3667069,85,2,20,1058,952794669,0,0,0,628.35,5,303075.47,1,6,0,8,True
3683978,909,2,20,3598,952794669,0,0,0,628.15,5,302447.32,18,0,19,10,True
3722929,958,2,451,3598,952794669,0,0,0,628.11,7,301819.21,13,5,6,10,True
4242355,137,2,30,1058,952794669,0,0,0,628.03,8,301191.18,18,6,15,10,True
4522054,681,2,20,1504,952794669,0,0,0,628.1,3,300563.08,24,0,4,11,True
4527081,958,2,-1,9508,952794669,0,1,0,627.93,4,300563.08,13,4,12,12,True
4569755,822,4,451,9508,952794669,0,0,0,627.83,7,299935.25,18,0,3,1,True
4633928,783,0,451,3403,952794669,0,0,0,628.18,7,299307.07,14,0,5,2,True
4729601,137,2,30,6873,952794669,0,0,0,628.2,8,298678.87,18,1,1,2,True
4810475,783,0,25,3309,952794669,0,0,0,628.0,8,298050.87,14,2,18,3,True
4825356,137,2,451,2060,952794669,0,0,0,628.22,7,297422.65,18,6,2,3,True
4997608,924,4,451,3598,952794669,0,0,0,627.93,7,296794.72,18,4,9,3,True
5104286,958,2,451,7988,952794669,0,0,0,628.27,7,296166.45,13,3,23,4,True
5351217,1359,2,30,8504,952794669,0,0,0,627.7,8,295538.75,24,5,11,4,True
5399580,137,2,451,8716,952794669,0,0,0,628.18,7,294910.57,18,3,22,4,True
5412262,269,0,25,3309,952794669,0,0,0,628.02,8,294282.55,24,0,18,4,True
5599822,958,2,25,9178,952794669,0,0,0,627.87,8,293654.68,13,2,3,4,True
5637109,130,0,20,8504,952794669,0,0,0,628.0,3,293026.68,18,4,6,5,True
5674521,842,2,20,2468,952794669,0,0,0,627.93,5,292398.75,5,3,4,5,True
5973292,233,4,30,2060,952794669,0,0,0,627.79,8,291770.96,26,6,5,5,True
6299946,1387,1,451,6873,952794669,0,0,0,628.05,7,291142.91,24,4,20,6,True
6489947,713,0,20,2191,952794669,0,0,0,627.94,3,290514.97,18,1,22,6,True
6846130,1278,0,10,3403,952794669,0,0,0,628.15,0,291143.12,24,0,9,7,True
6849915,783,0,30,5557,952794669,0,0,0,627.99,8,290515.13,14,5,13,8,True
6852524,858,1,10,7988,952794669,0,0,0,627.96,6,291143.09,24,1,21,8,True
6888095,160,0,10,5118,952794669,0,0,0,627.98,6,291771.07,24,3,8,8,True
6919152,137,2,451,3309,952794669,0,0,0,628.14,7,291142.93,18,1,4,9,True
7099551,958,2,451,9178,952794669,0,0,0,627.81,7,290515.12,13,6,22,9,True
7203118,1387,1,30,2045,952794669,0,0,0,628.0,8,289887.12,24,2,2,10,True
7456483,918,2,20,6873,952794669,0,0,0,627.89,3,289259.23,18,4,14,10,True
7578306,958,2,451,2045,952794669,0,0,0,627.98,7,288631.25,13,3,20,11,True
7849736,204,0,10,5504,952794669,0,0,0,628.15,6,289259.4,9,4,1,12,True
8379826,715,0,20,6255,952794669,0,0,0,628.16,5,288631.24,18,4,18,1,True
8563853,1359,2,25,1986,952794669,0,0,0,628.14,8,288003.1,24,2,9,1,False
8683868,233,4,30,8716,952794669,0,0,0,628.01,8,287375.09,26,3,20,2,True
8932107,889,0,10,3309,952794669,0,0,0,628.1,0,288003.19,27,4,4,3,True
8939682,924,4,30,3598,952794669,0,0,0,628.25,8,287374.94,18,5,11,4,True
9015264,924,4,25,2191,952794669,0,0,0,628.06,8,286746.88,18,3,23,5,True
9061742,269,0,451,6873,952794669,0,0,0,628.27,7,286118.61,24,6,19,5,False
9073840,269,0,-1,2060,952794669,0,1,0,628.15,4,286118.61,24,0,1,6,True
9074470,825,2,20,1504,952794669,0,0,0,628.31,3,285490.3,18,2,13,6,True
9116108,254,0,10,7988,952794669,0,0,0,627.83,6,286118.13,6,4,4,6,True
9127876,1387,1,451,9178,952794669,0,0,0,627.94,7,285490.19,24,3,4,7,True
9483159,538,0,10,2060,952794669,0,0,0,627.98,6,286118.17,18,2,12,8,True
9715880,822,4,30,1504,952794669,0,0,0,627.85,8,285490.32,18,2,12,9,True
9909741,183,1,10,2191,952794669,0,0,0,627.89,0,286118.21,18,3,2,9,True
1180043,842,2,25,6007,729050654,0,0,0,755.99,8,731796.01,5,4,23,1,True
1343830,228,0,20,5679,729050654,0,0,0,756.1,5,731039.91,26,0,11,1,True
1683081,1276,4,30,7013,729050654,0,0,0,756.09,8,730283.82,24,2,22,2,False
1735773,648,3,30,6007,729050654,0,0,0,755.6,8,729528.22,24,4,22,4,True
1783339,842,2,451,3332,729050654,0,0,0,756.1,7,728772.12,5,4,10,4,False
1798315,114,0,20,2957,729050654,0,0,0,755.73,3,728016.39,3,5,11,5,True
1922495,587,2,30,3140,729050654,0,0,0,755.85,8,727260.54,24,2,5,6,True
2001254,1203,4,25,6354,729050654,0,0,0,755.86,8,726504.68,24,2,10,6,True
2034638,648,3,-1,7397,729050654,0,1,0,755.99,1,726504.68,24,6,11,7,True
2087165,587,2,30,2600,729050654,0,0,0,756.12,8,725748.56,24,2,13,7,True
2112123,1203,4,30,2950,729050654,0,0,0,755.92,8,724992.64,24,2,15,8,True
2171037,916,0,20,7397,729050654,0,0,0,756.11,5,724236.53,18,4,3,9,True
2223466,648,3,30,6007,729050654,0,0,0,756.04,8,723480.49,24,6,17,9,True
2515300,648,3,30,6038,729050654,0,0,0,755.98,8,722724.51,24,0,14,9,True
2868707,328,0,25,8243,729050654,0,0,0,755.85,8,721968.66,11,5,2,11,True
3076083,587,2,451,6761,729050654,0,0,0,756.09,7,721212.57,24,3,11,11,True
3077748,842,2,30,2957,729050654,0,0,0,755.91,8,720456.66,5,1,8,12,True
3439650,842,2,451,1539,729050654,0,0,0,756.02,7,719700.64,5,6,18,12,True
3631917,842,2,-1,5479,729050654,0,1,0,755.83,1,719700.64,5,0,1,1,True
3709619,819,2,20,5479,729050654,0,0,0,756.21,5,718944.43,18,4,23,2,True
3810727,1203,4,451,1539,729050654,0,0,0,755.98,7,718188.45,24,6,15,2,True
3887153,1276,4,30,2957,729050654,0,0,0,756.02,8,717432.43,24,0,16,2,True
4144409,1276,4,25,9083,729050654,0,0,0,755.94,8,716676.49,24,6,3,3,True
4162224,1203,4,-1,3473,729050654,0,1,0,756.16,4,716676.49,24,1,12,3,True
4238208,648,3,30,4208,729050654,0,0,0,756.02,8,715920.47,24,2,21,4,True
4630797,1276,4,25,6007,729050654,0,0,0,756.09,8,715164.38,24,0,18,4,True
5481302,587,2,451,7013,729050654,0,0,0,756.01,7,714408.37,24,1,19,5,True
5775087,1203,4,451,2600,729050654,0,0,0,756.01,7,713652.36,24,6,14,5,True
6162193,328,0,25,7370,729050654,0,0,0,756.24,8,712896.12,11,3,17,6,True
6374571,27,0,10,7135,729050654,0,0,0,755.83,0,713651.95,11,6,4,6,True
6461651,1461,0,20,3140,729050654,0,0,0,756.16,3,712895.79,11,4,4,6,True
6602600,282,2,20,7016,729050654,0,0,0,755.96,3,712139.83,24,2,20,7,True
6848741,1203,4,451,6007,729050654,0,0,0,756.04,7,711383.79,24,5,13,7,True
7341801,1276,4,-1,2957,729050654,0,1,0,756.23,4,711383.79,24,0,12,8,True
7356832,842,2,-1,7397,729050654,0,2,0,756.04,1,711383.79,5,3,14,9,True
7458371,1276,4,30,2435,729050654,0,0,0,756.17,8,710627.62,24,2,7,9,True
7590997,648,3,30,7640,729050654,0,0,0,756.29,8,709871.33,24,4,17,9,True
7624887,337,1,10,3790,729050654,0,0,0,755.8,0,710627.13,11,6,10,12,True
7635181,1017,2,20,7135,729050654,0,0,0,755.99,5,709871.14,26,4,5,12,True
7674049,587,2,30,3790,729050654,0,0,0,756.23,8,709114.91,24,4,2,1,True
7896997,842,2,451,7370,729050654,0,0,0,755.9,7,708359.01,5,0,9,1,True
8113889,648,3,30,5679,729050654,0,0,0,755.81,8,707603.2,24,1,16,1,True
8137329,362,0,20,1964,729050654,0,0,0,755.92,5,706847.28,24,1,21,3,True
8195923,1276,4,30,9083,729050654,0,0,0,755.97,8,706091.31,24,1,3,3,True
8349087,842,2,25,7135,729050654,0,0,0,755.83,8,705335.48,5,4,6,3,False
8728406,587,2,25,8243,729050654,0,0,0,755.96,8,704579.52,24,5,9,3,True
8823862,1388,1,10,2600,729050654,0,0,0,756.01,0,705335.53,24,1,11,4,True
8973532,648,3,451,5679,729050654,0,0,0,756.04,7,704579.49,24,3,7,4,True
9023639,1276,4,25,3332,729050654,0,0,0,755.89,8,703823.6,24,2,13,5,True
9190695,842,2,-1,1964,729050654,0,1,0,756.12,1,703823.6,5,2,8,5,True
9240912,1203,4,-1,6007,729050654,0,2,0,756.21,4,703823.6,24,2,11,6,True
9396963,328,0,451,7640,729050654,0,0,0,755.89,7,703067.71,11,5,5,6,True
9557847,842,2,451,8243,729050654,0,0,0,756.18,7,702311.53,5,2,12,7,True
9577742,611,0,10,2600,729050654,0,0,0,756.03,6,703067.56,11,6,21,7,True
9598420,303,0,20,1539,729050654,0,0,0,755.93,5,702311.63,4,2,1,8,True
9618547,648,3,451,4208,729050654,0,0,0,756.18,7,701555.45,24,2,16,10,True
9920540,1203,4,30,4998,729050654,0,0,0,756.06,8,700799.39,24,6,22,11,True
1035506,1474,0,451,1872,638020573,0,0,0,1005.36,7,572146.64,24,1,9,2,True
1258568,812,0,20,6116,638020573,0,0,0,1005.01,5,571141.63,18,0,5,2,True
1294382,394,0,-1,1527,638020573,0,1,0,1004.89,1,571141.63,10,2,5,2,True
1331651,130,0,451,3325,638020573,0,0,0,1004.84,7,570136.79,18,5,4,2,True
1677842,404,1,10,5537,638020573,0,0,0,1005.23,6,571142.02,10,4,6,2,True
1833973,1150,0,20,5026,638020573,0,0,0,1005.34,5,570136.68,15,3,9,2,True
2180390,780,0,30,5559,638020573,0,0,0,1005.03,8,569131.65,14,4,14,3,True
2322893,785,0,10,7261,638020573,0,0,0,1005.31,6,570136.96,14,2,10,3,True
2898760,1244,4,25,1724,638020573,0,0,0,1004.92,8,569132.04,18,5,9,6,True
3088492,130,0,30,5559,638020573,0,0,0,1004.91,8,568127.13,18,5,22,6,True
3384089,842,2,451,2434,638020573,0,0,0,1004.85,7,567122.28,5,2,22,6,True
3493025,1244,4,30,3441,638020573,0,0,0,1004.58,8,566117.7,18,0,13,7,True
3536929,780,0,30,1779,638020573,0,0,0,1004.88,8,565112.82,14,0,16,7,True
3569944,130,0,30,5537,638020573,0,0,0,1004.9,8,564107.92,18,0,15,8,False
3661963,842,2,30,1527,638020573,0,0,0,1005.14,8,563102.78,5,2,12,8,True
3829209,727,0,451,2434,638020573,0,0,0,1004.9,7,562097.88,11,6,21,8,True
4087851,394,0,10,8961,638020573,0,0,0,1004.93,6,563102.81,10,3,18,8,False
4093030,727,0,451,1860,638020573,0,0,0,1005.12,7,562097.69,11,5,20,11,True
4105150,780,0,25,5537,638020573,0,0,0,1004.95,8,561092.74,14,4,13,11,True
4236691,130,0,451,6982,638020573,0,0,0,1005.05,7,560087.69,18,4,23,12,True
4467122,1428,1,10,8661,638020573,0,0,0,1005.14,0,561092.83,24,1,22,12,True
4728610,1463,2,20,7261,638020573,0,0,0,1005.08,5,560087.75,11,2,10,1,True
4739044,130,0,25,1527,638020573,0,0,0,1004.83,8,559082.92,18,3,11,1,True
4815630,1244,4,451,5537,638020573,0,0,0,1004.9,7,558078.02,18,3,6,4,True
4836233,1474,0,451,2434,638020573,0,0,0,1005.19,7,557072.83,24,3,11,5,True
4971890,1478,4,25,5026,638020573,0,0,0,1004.93,8,556067.9,24,0,7,5,True
5786953,130,0,-1,1527,638020573,0,1,0,1005.38,1,556067.9,18,1,1,5,True
5789305,130,0,25,9042,638020573,0,0,0,1004.9,8,555063.0,18,0,5,6,True
6076679,1244,4,25,6982,638020573,0,0,0,1005.1,8,554057.9,18,2,6,6,True
6198740,1262,0,20,3655,638020573,0,0,0,1005.06,5,553052.84,23,2,19,7,True
6274390,842,2,-1,8661,638020573,0,1,0,1005.22,4,553052.84,5,1,15,8,True
6496163,842,2,451,7932,638020573,0,0,0,1005.1,7,552047.74,5,3,18,9,True
6524079,1474,0,451,7872,638020573,0,0,0,1004.67,7,551043.07,24,3,21,9,True
7033804,1244,4,25,4597,638020573,0,0,0,1004.78,8,550038.29,18,1,9,10,True
7043220,1244,4,25,7872,638020573,0,0,0,1005.13,8,549033.16,18,6,20,10,True
7466412,394,0,25,9042,638020573,0,0,0,1004.9,8,548028.26,10,4,8,11,True
7783135,1244,4,451,5537,638020573,0,0,0,1005.15,7,547023.11,18,0,19,11,True
7897372,780,0,30,6982,638020573,0,0,0,1004.77,8,546018.34,14,1,10,12,True
8087849,842,2,-1,1022,638020573,0,1,0,1005.04,1,546018.34,5,3,14,12,True
8327957,883,0,20,6982,638020573,0,0,0,1004.75,5,545013.59,24,1,8,2,True
8401179,1244,4,25,6116,638020573,0,0,0,1005.05,8,544008.54,18,3,21,3,True
8410235,1478,4,25,8241,638020573,0,0,0,1005.05,8,543003.49,24,6,16,3,True
8520766,916,0,-1,2434,638020573,0,1,0,1004.94,4,543003.49,18,1,8,4,True
8562010,550,0,20,6982,638020573,0,0,0,1004.81,3,541998.68,17,2,16,5,True
8572182,1000,0,20,9467,638020573,0,0,0,1005.01,3,540993.67,26,4,14,5,True
8774232,780,0,451,9467,638020573,0,0,0,1004.83,7,539988.84,14,2,21,5,True
8960043,1404,2,20,8961,638020573,0,0,0,1004.98,3,538983.86,24,4,15,5,True
8978866,130,0,-1,1527,638020573,0,1,0,1005.16,4,538983.86,18,3,1,5,True
9023165,780,0,451,3325,638020573,0,0,0,1005.09,7,537978.77,14,4,22,5,True
9319706,916,0,451,3018,638020573,0,0,0,1005.26,7,536973.51,18,5,2,8,True
9330363,498,0,20,9956,638020573,0,0,0,1004.93,5,535968.58,12,5,23,8,True
9367055,916,0,-1,3018,638020573,0,1,0,1005.4,1,535968.58,18,5,8,10,True
9420306,130,0,-1,1527,638020573,0,2,0,1005.0,1,535968.58,18,6,5,10,True
9457680,727,0,451,8661,638020573,0,0,0,1004.78,7,534963.8,11,1,5,10,True
9901099,130,0,451,8241,638020573,0,0,0,1004.86,7,533958.94,18,2,8,10,True
9926101,1488,0,10,9956,638020573,0,0,0,1005.07,0,534964.01,24,4,10,11,True
9941675,130,0,30,6116,638020573,0,0,0,1004.97,8,533959.04,18,0,3,11,False
1501718,1001,4,30,4397,354568575,0,0,0,1166.38,8,402710.62,26,0,7,1,True
1514334,980,1,25,7731,354568575,0,0,0,1166.16,8,401544.46,22,5,5,2,True
1533765,641,0,20,6826,354568575,0,0,0,1166.31,3,400378.15,24,1,12,2,True
1646714,1001,4,-1,4184,354568575,0,1,0,1165.8,1,400378.15,26,5,10,7,True
1795232,980,1,30,4184,354568575,0,0,0,1166.15,8,399212.0,22,1,20,8,True
1873416,980,1,451,9619,354568575,0,0,0,1166.01,7,398045.99,22,2,9,10,True
1943904,980,1,451,7731,354568575,0,0,0,1166.02,7,396879.97,22,5,6,11,True
2047753,372,0,20,9049,354568575,0,0,0,1165.9,5,395714.07,25,0,9,11,False
2717931,980,1,25,8442,354568575,0,0,0,1166.12,8,394547.95,22,6,20,12,True
2731656,783,0,20,7731,354568575,0,0,0,1166.12,3,393381.83,14,4,7,12,True
2941316,429,0,451,4090,354568575,0,0,0,1165.97,7,392215.86,24,2,9,1,True
3146076,780,0,20,9049,354568575,0,0,0,1165.94,5,391049.92,14,0,15,2,True
3181660,399,2,20,7731,354568575,0,0,0,1165.71,3,389884.21,10,1,8,2,True
4112791,89,3,-1,4416,354568575,0,1,0,1166.32,4,389884.21,1,5,19,4,True
4553657,89,3,30,9619,354568575,0,0,0,1166.17,8,388718.04,1,3,5,4,True
5326855,1413,0,20,7840,354568575,0,0,0,1166.19,3,387551.85,24,5,15,6,True
5489225,1258,3,30,1793,354568575,0,0,0,1165.69,8,386386.16,23,2,0,7,True
5715623,980,1,25,6304,354568575,0,0,0,1165.97,8,385220.19,22,4,5,8,True
5745572,198,0,20,3867,354568575,0,0,0,1165.98,3,384054.21,18,2,18,11,True
5840467,1001,4,25,7731,354568575,0,0,0,1166.02,8,382888.19,26,1,2,11,True
5889680,1110,0,20,4184,354568575,0,0,0,1166.3,3,381721.89,0,0,18,2,True
5898652,89,3,451,6001,354568575,0,0,0,1166.13,7,380555.76,1,5,3,5,True
6093957,525,0,20,4397,354568575,0,0,0,1165.89,5,379389.87,18,0,15,6,True
6242582,572,0,20,7602,354568575,0,0,0,1165.82,5,378224.05,11,0,15,8,True
6614238,89,3,-1,4397,354568575,0,1,0,1165.68,4,378224.05,1,4,16,9,True
7023441,1001,4,-1,6480,354568575,0,2,0,1166.09,4,378224.05,26,4,15,9,True
7260517,980,1,-1,6001,354568575,0,3,1,1166.0,4,0.0,22,3,2,11,True
1080686,553,1,-1,2335,211001165,0,1,0,721.9,4,812969.0,17,4,7,1,True
1137883,553,1,25,5356,211001165,0,0,0,722.12,8,812246.88,17,1,1,2,True
1163982,553,1,-1,7769,211001165,0,1,0,721.88,4,812246.88,17,5,9,2,True
1183284,588,0,10,1362,211001165,0,0,0,722.08,0,812968.96,24,2,23,2,True
1453751,454,1,30,6087,211001165,0,0,0,721.94,8,812247.02,13,6,3,4,False
1755697,1256,2,25,7485,211001165,0,0,0,722.28,8,811524.74,23,2,18,4,True
1844520,455,4,451,7600,211001165,0,0,0,722.1,7,810802.64,13,2,16,5,True
2083929,455,4,451,5356,211001165,0,0,0,722.21,7,810080.43,13,5,17,5,True
2261478,807,0,20,7485,211001165,0,0,0,721.79,5,809358.64,11,2,17,6,True
2414988,1151,4,-1,1362,211001165,0,1,0,722.07,4,809358.64,15,0,19,6,True
2449822,1297,0,20,1362,211001165,0,0,0,722.12,5,808636.52,5,4,12,7,True
2456891,455,4,451,7600,211001165,0,0,0,722.05,7,807914.47,13,0,23,8,True
2488497,1256,2,451,5671,211001165,0,0,0,722.12,7,807192.35,23,2,20,9,True
2583777,1256,2,30,7485,211001165,0,0,0,721.96,8,806470.39,23,3,12,10,True
2801557,1151,4,25,5304,211001165,0,0,0,722.06,8,805748.33,15,1,16,11,True
2989065,455,4,-1,7600,211001165,0,1,0,721.88,4,805748.33,13,5,18,12,True
3049254,1370,4,25,5807,211001165,0,0,0,722.31,8,805026.02,16,3,22,1,False
3299787,1151,4,-1,2189,211001165,0,1,0,722.01,4,805026.02,15,4,15,3,True
3815352,1370,4,-1,1362,211001165,0,2,0,721.88,4,805026.02,16,0,2,3,True
3846606,553,1,451,2189,211001165,0,0,0,722.05,7,804303.97,17,0,6,5,True
3932006,1273,0,10,5180,211001165,0,0,0,722.03,6,805026.0,24,5,22,7,False
3945508,1151,4,30,5239,211001165,0,0,0,722.03,8,804303.97,15,1,13,8,True
4171436,1134,1,10,7600,211001165,0,0,0,721.97,6,805025.94,24,1,11,9,True
4271761,553,1,30,7769,211001165,0,0,0,722.32,8,804303.62,17,6,3,9,False
4542157,454,1,-1,5356,211001165,0,1,0,722.14,1,804303.62,13,1,7,9,True
4754718,1256,2,451,2189,211001165,0,0,0,721.91,7,803581.71,23,2,1,10,True
5322578,1151,4,451,2335,211001165,0,0,0,721.79,7,802859.92,15,5,8,10,True
5668427,454,1,30,7600,211001165,0,0,0,721.98,8,802137.94,13,2,17,11,True
5884808,454,1,451,5239,211001165,0,0,0,721.97,7,801415.97,13,1,11,12,True
6025768,208,0,20,5671,211001165,0,0,0,722.15,5,800693.82,9,3,12,12,True
6671348,679,0,20,4919,211001165,0,0,0,721.85,3,799971.97,24,4,11,12,True
6772810,454,1,25,7600,211001165,0,0,0,721.94,8,799250.03,13,5,15,12,True
7178614,454,1,-1,6087,211001165,0,1,0,721.89,4,799250.03,13,3,16,1,True
7215352,455,4,451,9481,211001165,0,0,0,722.03,7,798528.0,13,3,12,1,True
7264429,454,1,451,4919,211001165,0,0,0,722.12,7,797805.88,13,1,16,2,True
7531586,1370,4,30,4141,211001165,0,0,0,721.91,8,797083.97,16,1,4,3,True
7612601,1370,4,-1,5239,211001165,0,1,0,721.97,4,797083.97,16,4,21,3,True
7803109,454,1,451,7485,211001165,0,0,0,721.89,7,796362.08,13,3,4,4,True
7863373,128,0,10,2335,211001165,0,0,0,722.02,6,797084.1,18,5,9,4,True
7885195,834,0,20,7769,211001165,0,0,0,722.13,5,796361.97,5,0,16,4,True
8338546,530,0,10,1362,211001165,0,0,0,722.08,6,797084.05,18,6,8,6,True
8341795,1151,4,30,7600,211001165,0,0,0,721.96,8,796362.09,15,6,11,6,True
8533818,455,4,30,7485,211001165,0,0,0,722.08,8,795640.01,13,1,9,6,True
8581870,1370,4,451,6028,211001165,0,0,0,721.9,7,794918.11,16,6,4,6,True
8603517,1151,4,30,9481,211001165,0,0,0,722.03,8,794196.08,15,6,9,6,True
8628356,553,1,30,7485,211001165,0,0,0,722.03,8,793474.05,17,1,0,7,True
8849197,1151,4,451,7938,211001165,0,0,0,721.98,7,792752.07,15,1,9,8,True
9094392,645,0,10,1362,211001165,0,0,0,722.12,6,793474.19,24,1,17,8,True
9396443,1370,4,-1,5671,211001165,0,1,0,722.06,4,793474.19,16,4,23,9,True
9640641,1380,0,10,7485,211001165,0,0,0,722.03,6,794196.22,16,3,12,10,True
9736304,553,1,451,1362,211001165,0,0,0,721.89,7,793474.33,17,1,8,10,True
1529311,1353,4,25,3342,572585457,0,0,0,1190.9,8,900294.1,24,1,15,1,True
1551283,1404,2,-1,8456,572585457,0,1,0,1191.09,4,900294.1,24,6,21,9,True
1633851,1170,0,-1,6532,572585457,0,2,0,1191.01,1,900294.1,24,1,1,2,True
1887699,312,0,-1,6321,572585457,0,3,1,1190.99,1,0.0,4,0,19,9,True
1127962,14,2,451,6716,736927428,0,0,0,907.0,7,765538.0,24,1,23,1,True
1459576,255,2,451,5393,736927428,0,0,0,906.91,7,764631.09,6,5,6,1,True
1562659,1187,4,30,7065,736927428,0,0,0,907.24,8,763723.85,24,5,7,1,True
1708466,804,0,10,5255,736927428,0,0,0,906.95,6,764630.8,11,2,18,4,True
2156429,106,4,-1,6716,736927428,0,1,0,906.95,1,764630.8,3,2,6,4,True
2204509,255,2,451,7641,736927428,0,0,0,906.7,7,763724.1,6,4,4,4,True
2464906,106,4,451,7075,736927428,0,0,0,907.16,7,762816.94,3,0,8,5,True
2484025,255,2,25,9696,736927428,0,0,0,907.02,8,761909.92,6,3,13,6,True
2493255,304,0,20,5393,736927428,0,0,0,906.98,5,761002.94,4,4,11,8,True
2728039,106,4,25,6716,736927428,0,0,0,906.99,8,760095.95,3,6,16,8,True
2805579,1187,4,30,5393,736927428,0,0,0,907.07,8,759188.88,24,1,23,8,True
3513364,1455,2,451,5393,736927428,0,0,0,907.12,7,758281.76,11,0,17,11,True
3939858,255,2,30,5255,736927428,0,0,0,907.07,8,757374.69,6,2,21,11,True
4466420,1455,2,451,7734,736927428,0,0,0,907.1,7,756467.59,11,4,21,12,True
5310442,463,1,10,8137,736927428,0,0,0,907.12,6,757374.71,13,2,2,1,True
5375552,1231,2,20,7065,736927428,0,0,0,907.11,5,756467.6,18,2,15,1,True
5403358,1187,4,25,6194,736927428,0,0,0,907.12,8,755560.48,24,6,10,1,True
5546780,1455,2,-1,8689,736927428,0,1,0,907.0,4,755560.48,11,4,18,2,True
5575447,202,4,451,5130,736927428,0,0,0,907.2,7,754653.28,9,2,15,2,True
5822528,202,4,-1,7019,736927428,0,1,0,906.97,4,754653.28,9,4,0,4,True
6148892,202,4,451,8137,736927428,0,0,0,907.05,7,753746.23,9,4,16,5,True
6287452,211,0,10,7019,736927428,0,0,0,907.1,6,754653.33,9,1,0,6,True
6579881,14,2,-1,7641,736927428,0,1,0,907.17,1,754653.33,24,3,19,6,True
6615041,255,2,451,4778,736927428,0,0,0,906.9,7,753746.43,6,0,11,7,True
6626133,360,0,20,7641,736927428,0,0,0,907.31,5,752839.12,24,2,23,7,True
6666257,958,2,20,2703,736927428,0,0,0,906.93,5,751932.19,13,4,3,7,True
7019737,785,0,20,7019,736927428,0,0,0,907.1,5,751025.09,14,3,16,7,True
7093998,1455,2,25,8689,736927428,0,0,0,906.93,8,750118.16,11,2,15,8,True
7144141,1483,0,10,6716,736927428,0,0,0,907.19,6,751025.35,24,5,6,10,True
7194228,804,0,10,1291,736927428,0,0,0,907.13,0,751932.48,11,2,17,11,True
7242820,580,0,20,7734,736927428,0,0,0,906.86,3,751025.62,11,0,8,12,True
7284747,14,2,-1,5130,736927428,0,1,0,906.78,1,751025.62,24,0,18,1,True
7312211,1187,4,-1,3871,736927428,0,2,0,906.82,4,751025.62,24,5,17,1,True
7441817,14,2,30,2703,736927428,0,0,0,906.72,8,750118.9,24,1,10,1,True
7486313,1455,2,451,7019,736927428,0,0,0,906.75,7,749212.15,11,6,11,2,True
7562428,202,4,-1,4607,736927428,0,1,0,907.12,4,749212.15,9,6,12,2,True
7839000,1321,0,20,1291,736927428,0,0,0,907.36,3,748304.79,18,5,6,2,True
8051189,106,4,30,1291,736927428,0,0,0,907.02,8,747397.77,3,3,17,2,True
8152322,106,4,25,7911,736927428,0,0,0,906.77,8,746491.0,3,5,7,2,True
8165252,376,0,20,6716,736927428,0,0,0,907.23,3,745583.77,25,5,21,2,True
8220980,1187,4,25,8689,736927428,0,0,0,907.17,8,744676.6,24,5,1,2,True
8436765,106,4,451,4607,736927428,0,0,0,906.93,7,743769.67,3,1,14,4,True
8494965,1205,0,20,1291,736927428,0,0,0,907.36,5,742862.31,24,2,22,5,True
8523962,1169,0,20,7734,736927428,0,0,0,907.11,5,741955.2,24,2,8,6,True
8550740,1159,0,10,2703,736927428,0,0,0,907.12,6,742862.32,15,5,0,7,True
8725364,1455,2,30,7065,736927428,0,0,0,906.72,8,741955.6,11,0,4,7,True
8729563,362,0,20,3314,736927428,0,0,0,906.88,3,741048.72,24,3,0,7,True
8738788,255,2,451,7075,736927428,0,0,0,906.7,7,740142.02,6,6,4,8,True
8872014,1455,2,25,7019,736927428,0,0,0,906.7,8,739235.32,11,6,18,8,True
9004011,255,2,451,5130,736927428,0,0,0,907.07,7,738328.25,6,1,11,9,True
9080031,1187,4,-1,3871,736927428,0,1,0,906.97,4,738328.25,24,6,10,10,True
9199337,255,2,-1,3871,736927428,0,2,0,906.89,4,738328.25,6,0,13,10,True
9521876,1325,0,20,8137,736927428,0,0,0,907.3,3,737420.95,18,2,21,10,True
9565287,1455,2,-1,6194,736927428,0,1,0,906.85,4,737420.95,11,0,10,11,True
9573803,14,2,25,3314,736927428,0,0,0,907.13,8,736513.82,24,1,16,11,True
9808821,147,0,20,7075,736927428,0,0,0,906.99,5,735606.83,18,2,18,11,True
1004710,297,0,20,1511,546844539,1,0,0,1050.08,3,894909.92,4,2,15,1,True
1028841,1142,2,451,5308,546844539,1,0,0,1049.83,7,893860.09,15,3,1,1,True
1100179,811,0,20,1695,546844539,1,0,0,1049.82,5,892810.27,18,6,11,2,True
1731555,794,2,20,1511,546844539,1,0,0,1049.83,3,891760.44,11,3,1,2,True
2375078,951,0,10,5549,546844539,1,0,0,1049.7,6,892810.14,24,3,15,3,True
2525826,1142,2,-1,3294,546844539,1,1,0,1049.94,1,892810.14,15,1,7,3,True
2660502,944,2,20,1107,546844539,1,0,0,1049.87,5,891760.27,24,5,12,3,True
2728512,127,1,-1,5308,546844539,1,1,0,1050.09,4,891760.27,18,5,19,5,True
2833283,804,0,10,7445,546844539,1,0,0,1050.21,0,892810.48,11,5,6,6,True
2954829,620,3,25,5101,546844539,1,0,0,1049.95,8,891760.53,11,3,2,6,True
3069025,620,3,451,1550,546844539,1,0,0,1050.0,7,890710.53,11,4,1,7,True
3306775,399,2,25,1107,546844539,1,0,0,1049.85,8,889660.68,10,6,16,7,True
3376215,127,1,25,3163,546844539,1,0,0,1050.02,8,888610.66,18,2,19,8,True
3429011,792,1,451,8812,546844539,1,0,0,1050.19,7,887560.47,11,2,7,9,True
3489252,81,0,25,7445,546844539,1,0,0,1049.82,8,886510.65,1,6,18,10,False
3737331,792,1,451,7553,546844539,1,0,0,1050.12,7,885460.53,11,1,19,10,True
3813589,792,1,-1,5549,546844539,1,1,0,1049.86,1,885460.53,11,4,21,10,True
3844788,1175,2,20,4535,546844539,1,0,0,1050.13,5,884410.4,24,6,19,10,True
3959600,81,0,451,9216,546844539,1,0,0,1049.92,7,883360.48,1,2,15,11,True
3970582,1142,2,451,7445,546844539,1,0,0,1049.95,7,882310.53,15,1,7,12,True
4033825,81,0,-1,3945,546844539,1,1,0,1049.9,1,882310.53,1,6,16,12,True
4094447,792,1,451,3163,546844539,1,0,0,1050.03,7,881260.5,11,2,18,1,True
4422784,557,1,10,3163,546844539,1,0,0,1049.91,6,882310.41,17,4,21,2,True
4569272,1019,0,20,9758,546844539,1,0,0,1050.35,3,881260.06,26,4,6,2,True
4904225,583,2,30,8336,546844539,1,0,0,1050.05,8,880210.01,11,4,20,3,True
4959338,81,0,451,5549,546844539,1,0,0,1049.74,7,879160.27,1,4,16,3,True
5135189,1445,2,20,7593,546844539,1,0,0,1049.91,5,878110.36,24,5,5,5,True
5570997,1044,0,10,3294,546844539,1,0,0,1049.97,0,879160.33,11,0,5,5,True
5790058,81,0,30,2227,546844539,1,0,0,1050.11,8,878110.22,1,3,9,6,True
5933711,117,1,10,9580,546844539,1,0,0,1050.01,6,879160.23,18,4,17,8,True
6460711,792,1,-1,3294,546844539,1,1,0,1049.8,4,879160.23,11,5,16,8,True
6515610,792,1,25,1695,546844539,1,0,0,1050.18,8,878110.05,11,4,15,8,True
6718986,378,0,20,9781,546844539,1,0,0,1050.08,5,877059.97,25,4,11,8,True
6933286,1366,4,-1,9580,546844539,1,1,0,1050.16,1,877059.97,16,1,17,9,True
7002986,399,2,30,8690,546844539,1,0,0,1050.11,8,876009.86,10,0,8,9,True
7009912,583,2,30,9782,546844539,1,0,0,1050.07,8,874959.79,11,1,11,10,True
7016961,399,2,30,4535,546844539,1,0,0,1050.13,8,873909.66,10,1,2,10,True
7039523,262,2,451,9192,546844539,1,0,0,1049.99,7,872859.67,6,1,22,10,True
7130924,844,1,10,1511,546844539,1,0,0,1049.84,0,873909.51,5,1,16,12,True
7170049,792,1,25,3163,546844539,1,0,0,1050.04,8,872859.47,11,6,2,12,True
7409891,399,2,451,8336,546844539,1,0,0,1049.95,7,871809.52,10,2,23,1,True
7420962,185,1,10,9216,546844539,1,0,0,1049.86,0,872859.38,18,4,12,2,True
7470115,620,3,451,8690,546844539,1,0,0,1049.95,7,871809.43,11,5,3,3,True
7520111,1017,2,20,5549,546844539,1,0,0,1050.13,5,870759.3,26,2,4,4,True
7845312,1366,4,30,9758,546844539,1,0,0,1050.32,8,869708.98,16,1,9,4,True
7984085,583,2,25,7445,546844539,1,0,0,1050.45,8,868658.53,11,4,18,5,False
8095708,127,1,451,8812,546844539,1,0,0,1049.81,7,867608.72,18,2,21,5,True
8168776,572,0,20,5101,546844539,1,0,0,1050.01,5,866558.71,11,4,3,5,False
8204682,1233,0,10,1695,546844539,1,0,0,1050.15,6,867608.86,18,2,11,5,True
8212797,485,1,10,9758,546844539,1,0,0,1049.97,6,868658.83,5,5,16,6,True
8302236,399,2,30,3945,546844539,1,0,0,1050.12,8,867608.71,10,4,7,6,True
8893140,1366,4,25,2125,546844539,1,0,0,1050.24,8,866558.47,16,3,8,8,True
8975400,583,2,30,9192,546844539,1,0,0,1049.9,8,865508.57,11,4,16,8,True
9078699,127,1,30,8690,546844539,1,0,0,1049.8,8,864458.77,18,5,8,8,True
9149290,1041,0,20,9758,546844539,1,0,0,1049.92,5,863408.85,11,0,11,8,True
9212397,1366,4,30,9216,546844539,1,0,0,1050.12,8,862358.73,16,2,0,9,True
9611835,787,0,20,7553,546844539,1,0,0,1049.66,3,861309.07,14,3,3,10,True
9668085,807,0,20,9192,546844539,1,0,0,1049.82,3,860259.25,11,0,4,11,True
9966645,1366,4,-1,9192,546844539,1,1,0,1049.9,4,860259.25,16,6,19,11,False
1045640,616,1,10,8101,153472984,1,0,0,316.95,6,157712.95,11,6,19,1,True
1102855,808,3,-1,3330,153472984,1,1,0,316.98,1,157712.95,11,6,11,2,True
1291697,1197,3,30,4411,153472984,1,0,0,317.08,8,157395.87,24,1,3,3,True
1308962,341,0,10,9040,153472984,1,0,0,317.06,6,157712.93,24,0,9,4,True
1364532,1068,2,451,7252,153472984,1,0,0,316.98,7,157395.95,18,2,17,4,True
1454214,1197,3,30,4411,153472984,1,0,0,316.81,8,157079.14,24,5,19,4,True
1532541,1413,0,30,2477,153472984,1,0,0,316.85,8,156762.29,24,1,3,4,True
1635790,95,2,20,8649,153472984,1,0,0,317.2,5,156445.09,1,5,4,4,True
1810030,498,0,20,1905,153472984,1,0,0,317.12,3,156127.97,12,6,3,5,True
2062566,1197,3,30,2477,153472984,1,0,0,316.92,8,155811.05,24,2,20,5,True
2512962,1068,2,451,5199,153472984,1,0,0,316.86,7,155494.19,18,3,2,8,True
2700596,808,3,451,9971,153472984,1,0,0,317.09,7,155177.1,11,0,16,8,True
3028539,441,4,451,1905,153472984,1,0,0,316.76,7,154860.34,24,6,2,9,True
3086999,1197,3,451,8101,153472984,1,0,0,316.85,7,154543.49,24,1,21,9,True
3124062,865,0,10,4411,153472984,1,0,0,316.89,0,154860.38,24,1,11,10,True
3128689,1019,0,10,1976,153472984,1,0,0,317.21,6,155177.59,26,3,8,11,True
3197772,268,2,-1,6499,153472984,1,1,0,317.16,4,155177.59,24,6,1,11,True
3414211,808,3,451,5721,153472984,1,0,0,317.17,7,154860.42,11,6,17,12,True
3476979,1413,0,25,7451,153472984,1,0,0,317.16,8,154543.26,24,3,10,12,True
3802349,800,0,20,5199,153472984,1,0,0,317.06,5,154226.2,11,2,10,12,True
3804740,679,0,20,7451,153472984,1,0,0,316.81,5,153909.39,24,6,19,1,False
3859376,1364,0,10,8649,153472984,1,0,0,316.9,6,154226.29,16,4,10,1,True
4093696,1137,1,25,9483,153472984,1,0,0,317.11,8,153909.18,24,4,5,2,True
4127533,1137,1,30,5199,153472984,1,0,0,316.67,8,153592.51,24,5,0,2,True
4148545,808,3,25,6499,153472984,1,0,0,316.79,8,153275.72,11,0,13,2,True
4352095,268,2,30,8101,153472984,1,0,0,316.69,8,152959.03,24,0,20,3,True
4473799,1068,2,451,1976,153472984,1,0,0,317.04,7,152641.99,18,4,23,3,True
5012329,123,0,451,1976,153472984,1,0,0,317.0,7,152324.99,18,1,13,4,True
5040477,645,0,20,5824,153472984,1,0,0,317.03,3,152007.96,24,6,9,4,True
5252915,1197,3,30,8649,153472984,1,0,0,317.26,8,151690.7,24,5,0,5,True
5519279,123,0,-1,5024,153472984,1,1,0,317.07,4,151690.7,18,1,0,6,True
5930703,1027,0,10,2170,153472984,1,0,0,316.98,0,152007.68,11,5,13,9,True
6119736,1137,1,30,7681,153472984,1,0,0,317.01,8,151690.67,24,5,16,10,True
6219058,441,4,25,4411,153472984,1,0,0,316.74,8,151373.93,24,0,10,10,True
6339515,808,3,25,5024,153472984,1,0,0,317.06,8,151056.87,11,4,6,11,True
6792721,1282,2,20,9016,153472984,1,0,0,316.89,5,150739.98,24,3,10,11,False
6870829,808,3,-1,5721,153472984,1,1,0,316.9,4,150739.98,11,5,21,12,True
6887321,441,4,25,5824,153472984,1,0,0,316.87,8,150423.11,24,3,4,1,True
7105050,238,0,10,5199,153472984,1,0,0,316.98,6,150740.09,26,3,23,2,True
7236525,1068,2,451,7451,153472984,1,0,0,316.95,7,150423.14,18,4,1,3,True
7377921,1413,0,30,9362,153472984,1,0,0,316.94,8,150106.2,24,0,10,4,True
7471128,123,0,451,9483,153472984,1,0,0,317.13,7,149789.07,18,0,11,5,True
7477619,96,0,10,8649,153472984,1,0,0,316.86,0,150105.93,1,3,3,5,True
7824862,802,2,20,5199,153472984,1,0,0,316.8,5,149789.13,11,5,3,5,True
7857666,441,4,25,9971,153472984,1,0,0,316.89,8,149472.24,24,5,4,6,False
7870445,883,0,10,9040,153472984,1,0,0,317.28,6,149789.52,24,3,11,7,True
7887182,1413,0,25,1976,153472984,1,0,0,317.18,8,149472.34,24,2,6,7,True
7919274,1068,2,451,9362,153472984,1,0,0,317.12,7,149155.22,18,5,16,7,True
8236626,1068,2,25,2008,153472984,1,0,0,317.35,8,148837.87,18,5,16,7,True
8295492,312,0,10,9483,153472984,1,0,0,317.06,0,149154.93,4,1,1,7,True
8336352,1413,0,451,9362,153472984,1,0,0,317.06,7,148837.87,24,4,7,8,True
8860919,588,0,20,8818,153472984,1,0,0,317.1,3,148520.77,24,4,7,8,True
8882172,1197,3,-1,7451,153472984,1,1,0,316.92,4,148520.77,24,2,21,9,True
9323669,1197,3,451,7681,153472984,1,0,0,316.96,7,148203.81,24,3,13,10,True
9386124,268,2,25,9971,153472984,1,0,0,316.95,8,147886.86,24,1,13,10,True
9824109,1413,0,30,5824,153472984,1,0,0,316.92,8,147569.94,24,4,11,11,True
9884196,1068,2,25,2909,153472984,1,0,0,316.92,8,147253.02,18,5,3,11,False
9925718,1413,0,451,2477,153472984,1,0,0,317.21,7,146935.81,24,6,4,11,True
1062983,59,0,25,6034,273880071,0,0,0,840.94,8,615794.06,20,5,10,1,True
1083506,622,4,451,3903,273880071,0,0,0,841.21,7,614952.85,11,1,13,3,True
1190728,622,4,-1,1324,273880071,0,1,0,841.1,4,614952.85,11,6,1,3,True
1486403,372,0,10,3893,273880071,0,0,0,840.85,6,615793.7,25,6,22,3,True
1652999,341,0,20,1324,273880071,0,0,0,840.76,5,614952.94,24,4,3,4,False
1741797,1486,2,20,4382,273880071,0,0,0,840.85,5,614112.09,24,1,8,4,True
1775012,273,4,30,3359,273880071,0,0,0,840.73,8,613271.36,24,1,5,5,True
1821219,59,0,25,8068,273880071,0,0,0,841.15,8,612430.21,20,1,18,5,True
1858860,273,4,-1,2433,273880071,0,1,0,841.01,4,612430.21,24,0,1,6,True
1928075,664,2,25,7334,273880071,0,0,0,841.16,8,611589.05,18,0,14,6,True
2018946,59,0,451,9632,273880071,0,0,0,840.97,7,610748.08,20,5,9,6,True
2332617,622,4,-1,6910,273880071,0,1,0,840.94,4,610748.08,11,5,20,7,True
2341111,664,2,451,6034,273880071,0,0,0,841.3,7,609906.78,18,0,22,7,True
2588784,1288,0,20,4874,273880071,0,0,0,841.06,5,609065.72,24,5,2,7,True
2748601,622,4,25,5866,273880071,0,0,0,840.9,8,608224.82,11,4,1,8,False
2836932,622,4,451,9048,273880071,0,0,0,840.58,7,607384.24,11,0,4,9,True
3049278,622,4,30,8068,273880071,0,0,0,841.07,8,606543.17,11,1,9,9,True
3091554,64,0,451,4874,273880071,0,0,0,841.03,7,605702.14,20,6,18,11,True
3152433,622,4,451,6034,273880071,0,0,0,841.19,7,604860.95,11,2,3,12,True
3756599,64,0,-1,7375,273880071,0,1,0,840.87,1,604860.95,20,5,12,1,True
4031148,873,4,30,3903,273880071,0,0,0,840.99,8,604019.96,24,0,19,1,True
4333947,273,4,451,4874,273880071,0,0,0,841.07,7,603178.89,24,5,1,4,True
4443472,273,4,451,3903,273880071,0,0,0,840.91,7,602337.98,24,5,1,5,True
4890949,59,0,30,6910,273880071,0,0,0,841.17,8,601496.81,20,6,0,6,True
5398188,59,0,25,2869,273880071,0,0,0,840.76,8,600656.05,20,0,16,6,True
5708397,275,0,25,3576,273880071,0,0,0,841.24,8,599814.81,24,4,1,6,True
5854907,664,2,-1,8068,273880071,0,1,0,840.77,1,599814.81,18,4,5,7,True
5874543,790,0,20,8147,273880071,0,0,0,840.82,3,598973.99,11,2,9,8,True
6224566,59,0,30,5866,273880071,0,0,0,840.84,8,598133.15,20,0,4,8,True
6232231,64,0,25,9632,273880071,0,0,0,841.03,8,597292.12,20,6,21,10,True
6242666,664,2,25,2433,273880071,0,0,0,840.91,8,596451.21,18,2,21,11,True
6284430,873,4,25,3903,273880071,0,0,0,841.06,8,595610.15,24,0,14,12,True
6344402,664,2,451,5866,273880071,0,0,0,841.1,7,594769.05,18,0,1,12,True
6456528,873,4,30,3576,273880071,0,0,0,840.99,8,593928.06,24,4,22,12,True
6519340,873,4,25,5866,273880071,0,0,0,840.79,8,593087.27,24,2,16,12,True
6650080,273,4,-1,4382,273880071,0,1,0,841.12,4,593087.27,24,3,16,1,True
6751929,59,0,30,6910,273880071,0,0,0,841.21,8,592246.06,20,5,12,1,True
7293104,842,2,20,5866,273880071,0,0,0,841.12,3,591404.94,5,4,0,1,True
7335264,64,0,30,7375,273880071,0,0,0,841.05,8,590563.89,20,5,15,2,True
7559269,273,4,451,4874,273880071,0,0,0,841.09,7,589722.8,24,5,15,2,True
7777322,622,4,30,9048,273880071,0,0,0,840.94,8,588881.86,11,4,11,3,True
7889318,1072,0,20,3599,273880071,0,0,0,840.99,5,588040.87,18,4,22,3,True
7921829,269,0,20,3359,273880071,0,0,0,841.13,5,587199.74,24,3,4,3,True
8017512,275,0,25,3903,273880071,0,0,0,840.96,8,586358.78,24,1,10,4,True
8181769,622,4,25,1324,273880071,0,0,0,840.95,8,585517.83,11,3,5,4,False
8442873,59,0,-1,8068,273880071,0,1,0,840.79,4,585517.83,20,5,10,4,True
8516545,622,4,451,7375,273880071,0,0,0,840.78,7,584677.05,11,5,23,5,True
8781671,580,0,10,7334,273880071,0,0,0,840.85,0,585517.9,11,1,6,5,True
8871945,273,4,-1,2869,273880071,0,1,0,841.01,4,585517.9,24,2,7,6,True
8977037,59,0,25,1324,273880071,0,0,0,840.72,8,584677.18,20,2,13,6,True
9029985,935,1,10,6034,273880071,0,0,0,840.95,6,585518.13,24,5,5,6,True
9116629,273,4,30,9632,273880071,0,0,0,840.98,8,584677.15,24,4,3,7,True
9350696,59,0,451,4382,273880071,0,0,0,841.15,7,583836.0,20,5,4,8,True
9376365,622,4,25,2433,273880071,0,0,0,840.8,8,582995.2,11,1,7,9,True
9570410,1260,0,20,9048,273880071,0,0,0,841.18,5,582154.02,23,0,6,9,True
9619949,64,0,25,8147,273880071,0,0,0,841.24,8,581312.78,20,1,10,10,True
9697228,275,0,451,6235,273880071,0,0,0,840.68,7,580472.1,24,1,5,10,True
1071035,1459,1,451,3779,576552229,1,0,0,348.21,7,93070.79,11,4,16,1,False
1376085,735,1,25,3422,576552229,1,0,0,347.91,8,92722.88,11,2,9,1,True
1439709,752,0,451,8233,576552229,1,0,0,348.1,7,92374.78,24,2,4,1,True
1844009,1459,1,451,1075,576552229,1,0,0,347.91,7,92026.87,11,5,0,2,True
2079770,1246,0,20,1047,576552229,1,0,0,347.85,5,91679.02,23,1,4,2,False
2121848,1459,1,451,2999,576552229,1,0,0,348.09,7,91330.93,11,6,13,2,True
2474033,203,0,10,1661,576552229,1,0,0,348.07,6,91679.0,9,0,4,4,True
2479944,561,4,25,2999,576552229,1,0,0,348.14,8,91330.86,17,0,19,4,True
2637154,312,0,20,1853,576552229,1,0,0,348.09,5,90982.77,4,2,16,6,True
2668164,996,0,10,9493,576552229,1,0,0,348.07,0,91330.84,26,5,15,6,True
2695586,1459,1,25,1661,576552229,1,0,0,347.78,8,90983.06,11,1,14,6,True
2986855,993,0,451,4907,576552229,1,0,0,347.87,7,90635.19,22,4,10,7,True
3386425,752,0,451,6974,576552229,1,0,0,348.17,7,90287.02,24,0,1,7,True
3453235,1459,1,451,7531,576552229,1,0,0,347.69,7,89939.33,11,0,15,7,True
3651106,735,1,30,7796,576552229,1,0,0,348.09,8,89591.24,11,1,15,7,True
3688425,1123,2,20,1551,576552229,1,0,0,348.18,5,89243.06,24,2,16,8,True
3798948,752,0,451,2796,576552229,1,0,0,347.88,7,88895.18,24,1,17,8,True
3882644,1211,4,25,9221,576552229,1,0,0,347.85,8,88547.33,24,5,18,8,True
4060536,993,0,30,9221,576552229,1,0,0,348.18,8,88199.15,22,4,11,9,True
4149409,1459,1,451,3779,576552229,1,0,0,348.1,7,87851.05,11,6,2,9,True
4339579,1201,0,25,3779,576552229,1,0,0,348.08,8,87502.97,24,0,19,11,True
4449311,993,0,451,8314,576552229,1,0,0,347.78,7,87155.19,22,3,20,12,True
4931366,752,0,-1,7531,576552229,1,1,0,348.03,4,87155.19,24,4,6,1,True
5049783,1201,0,451,1075,576552229,1,0,0,347.88,7,86807.31,24,1,3,2,True
5433769,993,0,451,1047,576552229,1,0,0,347.9,7,86459.41,22,6,19,4,True
5570321,857,1,25,8233,576552229,1,0,0,347.93,8,86111.48,24,2,12,6,True
5595821,1201,0,25,5773,576552229,1,0,0,348.07,8,85763.41,24,0,9,7,True
5725970,1425,0,20,9806,576552229,1,0,0,347.9,5,85415.51,24,5,2,7,True
5754677,1086,0,20,6974,576552229,1,0,0,348.17,3,85067.34,18,6,2,8,True
6231387,1201,0,-1,5773,576552229,1,1,0,348.02,4,85067.34,24,0,2,9,True
6476088,841,1,10,8314,576552229,1,0,0,347.83,0,85415.17,5,0,16,9,True
6951909,735,1,451,9110,576552229,1,0,0,347.97,7,85067.2,11,4,10,9,True
6967324,1211,4,-1,1047,576552229,1,1,0,348.43,4,85067.2,24,3,9,10,True
6987687,857,1,25,8314,576552229,1,0,0,348.08,8,84719.12,24,0,2,10,True
7067257,1211,4,25,1661,576552229,1,0,0,348.01,8,84371.11,24,6,9,11,True
7168597,1201,0,10,9806,576552229,1,0,0,348.26,6,84719.37,24,4,4,11,True
7330883,752,0,451,8314,576552229,1,0,0,347.92,7,84371.45,24,1,19,12,True
7433107,561,4,451,9806,576552229,1,0,0,348.22,7,84023.23,17,5,17,12,True
7472568,1201,0,25,9493,576552229,1,0,0,347.86,8,83675.37,24,1,20,12,True
7584614,752,0,30,2999,576552229,1,0,0,348.12,8,83327.25,24,0,14,1,True
7884598,1201,0,451,1075,576552229,1,0,0,348.22,7,82979.03,24,3,2,1,True
8057388,917,0,20,1047,576552229,1,0,0,348.02,5,82631.01,18,3,8,1,True
8355917,857,1,25,4907,576552229,1,0,0,347.72,8,82283.29,24,3,19,2,True
8442007,735,1,25,1075,576552229,1,0,0,348.08,8,81935.21,11,4,4,2,True
8653187,752,0,25,3422,576552229,1,0,0,348.18,8,81587.03,24,3,5,3,True
8856195,446,1,10,9493,576552229,1,0,0,347.87,6,81934.9,13,4,3,3,True
9113134,561,4,-1,1047,576552229,1,1,0,348.16,4,81934.9,17,1,16,4,True
9323577,1201,0,451,5773,576552229,1,0,0,348.07,7,81586.83,24,2,16,6,True
9332578,792,1,10,9221,576552229,1,0,0,347.94,6,81934.77,11,1,14,7,True
9351799,1201,0,30,3104,576552229,1,0,0,348.02,8,81586.75,24,0,5,9,True
9388477,752,0,-1,9806,576552229,1,1,0,348.06,4,81586.75,24,3,0,9,True
9429677,735,1,451,9493,576552229,1,0,0,347.96,7,81238.79,11,3,20,10,True
9759554,502,0,20,9221,576552229,1,0,0,347.89,5,80890.9,12,2,20,10,True
1206676,1334,3,451,8358,326420263,0,0,0,159.86,7,181480.14,18,4,15,1,True
1424924,1334,3,25,8460,326420263,0,0,0,159.93,8,181320.21,18,3,18,3,False
1459644,1192,2,20,1012,326420263,0,0,0,160.36,5,181159.85,24,6,12,3,True
1811529,1347,4,451,1007,326420263,0,0,0,159.95,7,180999.9,24,4,5,5,True
1918532,1347,4,30,2754,326420263,0,0,0,159.91,8,180839.99,24,0,20,5,True
2186629,751,4,451,1007,326420263,0,0,0,159.91,7,180680.08,24,1,15,7,True
2278802,751,4,-1,1012,326420263,0,1,0,159.79,1,180680.08,24,0,0,7,True
2289982,751,4,25,2419,326420263,0,0,0,160.12,8,180519.96,24,3,6,8,True
2570847,998,0,20,1007,326420263,0,0,0,160.49,5,180359.47,26,4,12,9,True
2684255,1334,3,451,1004,326420263,0,0,0,159.84,7,180199.63,18,6,15,9,True
2750868,41,2,451,7402,326420263,0,0,0,160.13,7,180039.5,11,1,6,10,True
2814300,1483,0,10,8460,326420263,0,0,0,160.03,0,180199.53,24,1,23,11,True
3073940,224,3,-1,4295,326420263,0,1,0,160.26,4,180199.53,26,4,6,11,True
3209284,224,3,451,8358,326420263,0,0,0,160.1,7,180039.43,26,3,8,12,True
3283332,1347,4,-1,8460,326420263,0,1,0,159.9,1,180039.43,24,1,18,12,True
3370744,224,3,451,8358,326420263,0,0,0,159.98,7,179879.45,26,0,5,1,True
3555171,224,3,30,3032,326420263,0,0,0,159.87,8,179719.58,26,2,2,1,True
3760256,342,0,10,2419,326420263,0,0,0,160.1,0,179879.68,24,3,21,1,True
3783894,751,4,-1,2754,326420263,0,1,0,159.98,4,179879.68,24,1,20,2,True
3883688,1334,3,30,5685,326420263,0,0,0,159.57,8,179720.11,18,6,18,3,True
3891353,708,2,20,1004,326420263,0,0,0,160.04,5,179560.07,18,2,5,4,True
4022800,41,2,-1,8358,326420263,0,1,0,159.89,1,179560.07,11,1,14,4,True
4318575,1334,3,30,1012,326420263,0,0,0,160.05,8,179400.02,18,1,9,5,True
4339500,751,4,-1,5685,326420263,0,1,0,160.02,1,179400.02,24,6,0,5,True
4428762,1347,4,30,1007,326420263,0,0,0,159.64,8,179240.38,24,6,6,5,True
4592329,1334,3,25,7402,326420263,0,0,0,159.94,8,179080.44,18,4,18,6,True
4617071,751,4,-1,2419,326420263,0,1,0,159.84,4,179080.44,24,4,22,6,True
4913956,41,2,-1,8460,326420263,0,2,0,160.09,1,179080.44,11,5,20,7,True
4992070,1044,0,451,8394,326420263,0,0,0,160.1,7,178920.34,11,3,3,8,True
5075288,503,0,10,8460,326420263,0,0,0,160.14,6,179080.48,12,2,12,8,True
5267850,579,0,20,8394,326420263,0,0,0,160.09,3,178920.39,11,2,22,8,True
5480286,1044,0,25,3032,326420263,0,0,0,160.07,8,178760.32,11,2,6,11,True
5573122,95,2,20,9456,326420263,0,0,0,160.0,5,178600.32,1,5,2,11,True
5829363,41,2,-1,2754,326420263,0,1,0,159.93,4,178600.32,11,3,16,12,True
5997616,1014,1,10,1012,326420263,0,0,0,159.8,6,178760.12,26,5,15,12,True
6342391,1044,0,451,1004,326420263,0,0,0,160.16,7,178599.96,11,1,20,1,True
6412930,41,2,25,8461,326420263,0,0,0,159.84,8,178440.12,11,1,21,1,True
6430852,842,2,20,3754,326420263,0,0,0,159.99,5,178280.13,5,4,7,1,True
6443736,584,0,10,4295,326420263,0,0,0,160.15,6,178440.28,11,5,20,1,True
6487685,438,1,25,3032,326420263,0,0,0,160.11,8,178280.17,24,6,0,2,True
6637134,1219,1,10,8625,326420263,0,0,0,160.13,6,178440.3,24,1,20,2,True
7189298,224,3,30,2419,326420263,0,0,0,160.07,8,178280.23,26,1,10,2,True
7256688,1334,3,25,1012,326420263,0,0,0,159.93,8,178120.3,18,2,0,3,True
7278160,1347,4,-1,1004,326420263,0,1,0,159.94,1,178120.3,24,0,4,3,True
7363431,471,0,10,1012,326420263,0,0,0,159.88,6,178280.18,5,6,6,3,True
7995441,1347,4,-1,1007,326420263,0,1,0,160.22,4,178280.18,24,2,8,4,True
8132827,1347,4,451,8460,326420263,0,0,0,160.01,7,178120.17,24,5,2,4,True
8172766,98,0,10,4295,326420263,0,0,0,159.65,6,178279.82,3,4,15,5,True
8475643,1347,4,30,7402,326420263,0,0,0,160.05,8,178119.77,24,1,16,5,True
8590427,1334,3,-1,8394,326420263,0,1,0,160.26,4,178119.77,18,4,23,5,True
8678946,68,0,10,3754,326420263,0,0,0,159.69,6,178279.46,20,5,9,7,True
8831703,1334,3,451,9456,326420263,0,0,0,160.08,7,178119.38,18,5,4,10,True
8894416,1044,0,451,4295,326420263,0,0,0,160.02,7,177959.36,11,5,15,10,True
9094977,850,1,10,8394,326420263,0,0,0,159.95,0,178119.31,5,6,6,10,True
9160642,224,3,451,2754,326420263,0,0,0,160.15,7,177959.16,26,2,9,10,True
9212258,224,3,451,5685,326420263,0,0,0,160.06,7,177799.1,26,0,6,10,True
9577930,41,2,25,2780,326420263,0,0,0,160.23,8,177638.87,11,3,4,11,True
9644371,751,4,451,8461,326420263,0,0,0,159.98,7,177478.89,24,4,23,11,True
1213197,1007,2,25,2863,168847159,0,0,0,1037.19,8,221258.81,26,1,5,1,True
1347326,796,2,25,4639,168847159,0,0,0,1036.92,8,220221.89,11,1,16,1,True
1374562,796,2,25,7726,168847159,0,0,0,1036.92,8,219184.97,11,1,14,3,True
1599883,309,0,451,7691,168847159,0,0,0,1037.06,7,218147.91,4,5,16,4,True
1623225,234,0,30,3522,168847159,0,0,0,1037.24,8,217110.67,26,0,22,4,True
1700600,642,0,10,3522,168847159,0,0,0,1037.1,0,218147.77,24,3,4,5,True
1739196,1408,1,10,9527,168847159,0,0,0,1036.92,0,219184.69,24,3,6,5,True
1844487,309,0,-1,2381,168847159,0,1,0,1036.96,4,219184.69,4,5,6,6,True
2170202,234,0,30,2863,168847159,0,0,0,1036.76,8,218147.93,26,5,19,10,True
2197781,1113,1,451,4494,168847159,0,0,0,1037.18,7,217110.75,0,0,18,11,True
2387136,76,0,20,4402,168847159,0,0,0,1036.96,5,216073.79,20,1,18,11,True
2419676,796,2,451,1372,168847159,0,0,0,1037.08,7,215036.71,11,0,14,11,True
2476917,309,0,-1,2863,168847159,0,1,0,1036.8,1,215036.71,4,3,1,12,True
2864223,282,2,30,6146,168847159,0,0,0,1037.18,8,213999.53,24,5,11,12,True
2871338,282,2,451,7726,168847159,0,0,0,1036.99,7,212962.54,24,5,17,12,True
3067811,234,0,451,1866,168847159,0,0,0,1037.03,7,211925.51,26,1,16,1,True
3186728,796,2,30,6146,168847159,0,0,0,1037.02,8,210888.49,11,5,19,1,True
3382910,734,0,20,4548,168847159,0,0,0,1037.06,5,209851.43,11,1,15,1,True
3537086,282,2,451,4548,168847159,0,0,0,1036.82,7,208814.61,24,1,13,2,True
3740736,1113,1,451,9527,168847159,0,0,0,1036.95,7,207777.66,0,1,20,3,True
3788988,234,0,25,4494,168847159,0,0,0,1037.19,8,206740.47,26,2,17,3,True
3994116,796,2,25,6402,168847159,0,0,0,1037.02,8,205703.45,11,1,0,3,True
4016968,642,0,10,2863,168847159,0,0,0,1037.1,6,206740.55,24,1,12,4,True
4298345,21,0,20,4402,168847159,0,0,0,1036.94,5,205703.61,11,5,13,5,True
4318772,115,2,20,1540,168847159,0,0,0,1037.12,5,204666.49,3,6,21,5,True
4534324,1113,1,30,8890,168847159,0,0,0,1037.01,8,203629.48,0,4,9,5,True
4595328,1007,2,451,1372,168847159,0,0,0,1036.82,7,202592.66,26,4,7,7,True
4661334,282,2,-1,8784,168847159,0,1,0,1037.22,4,202592.66,24,6,10,7,True
4770537,796,2,30,9527,168847159,0,0,0,1037.07,8,201555.59,11,0,20,7,True
4944917,877,2,20,8784,168847159,0,0,0,1037.13,3,200518.46,24,5,22,7,True
4960383,551,0,20,5849,168847159,0,0,0,1037.19,5,199481.27,17,4,7,8,True
5424551,1007,2,-1,3522,168847159,0,1,0,1036.98,4,199481.27,26,5,15,10,True
5553649,309,0,30,4548,168847159,0,0,0,1036.88,8,198444.39,4,3,4,10,True
5724569,333,1,10,8766,168847159,0,0,0,1036.87,0,199481.26,11,3,6,11,True
6041864,1007,2,30,1540,168847159,0,0,0,1037.0,8,198444.26,26,0,16,11,True
6290598,234,0,30,8155,168847159,0,0,0,1037.15,8,197407.11,26,5,8,12,True
6425368,796,2,-1,8766,168847159,0,1,0,1037.05,4,197407.11,11,2,12,12,True
6649069,1113,1,-1,3511,168847159,0,2,0,1036.96,1,197407.11,0,3,19,12,True
6852517,309,0,25,2381,168847159,0,0,0,1037.06,8,196370.05,4,3,21,12,True
7239669,497,0,20,8155,168847159,0,0,0,1037.1,5,195332.95,12,2,20,1,True
7509045,1007,2,-1,1540,168847159,0,1,0,1037.14,4,195332.95,26,0,15,2,True
7832890,652,0,20,9527,168847159,0,0,0,1037.18,5,194295.77,24,0,16,3,True
7975368,649,0,10,4494,168847159,0,0,0,1037.12,6,195332.89,24,6,11,3,True
8174210,309,0,451,6146,168847159,0,0,0,1037.09,7,194295.8,4,2,5,5,True
8271662,1007,2,30,6146,168847159,0,0,0,1036.85,8,193258.95,26,2,10,6,True
8281698,234,0,25,4639,168847159,0,0,0,1037.1,8,192221.85,26,6,16,8,True
8281959,1113,1,30,7691,168847159,0,0,0,1036.78,8,191185.07,0,3,5,8,True
8297040,1113,1,30,1866,168847159,0,0,0,1037.17,8,190147.9,0,2,21,9,True
8881887,616,1,10,1866,168847159,0,0,0,1036.66,0,191184.56,11,5,3,9,True
9121915,282,2,30,8766,168847159,0,0,0,1037.08,8,190147.48,24,4,6,9,True
9222537,1113,1,25,2381,168847159,0,0,0,1036.87,8,189110.61,0,2,15,9,True
9491992,144,1,10,2863,168847159,0,0,0,1036.94,6,190147.55,18,4,1,9,True
9525906,796,2,451,8134,168847159,0,0,0,1037.22,7,189110.33,11,0,18,9,True
9942523,282,2,-1,4494,168847159,0,1,0,1037.06,1,189110.33,24,1,21,10,True
9978291,1113,1,-1,2863,168847159,0,2,0,1037.06,4,189110.33,0,6,11,10,True
1105716,235,4,25,2504,466915142,1,0,0,467.04,8,400572.96,26,6,1,2,False
1188775,121,4,451,9919,466915142,1,0,0,467.18,7,400105.78,18,5,4,4,True
1608745,976,4,451,8788,466915142,1,0,0,466.88,7,399638.9,22,3,3,4,True
1624944,121,4,451,4409,466915142,1,0,0,466.98,7,399171.92,18,5,21,4,True
1753252,995,1,451,8609,466915142,1,0,0,467.08,7,398704.84,22,4,8,5,True
1850715,995,1,30,3541,466915142,1,0,0,466.99,8,398237.85,22,6,2,5,True
1870197,976,4,25,7226,466915142,1,0,0,466.97,8,397770.88,22,4,1,6,True
2087894,384,3,25,7977,466915142,1,0,0,466.85,8,397304.03,25,2,14,6,True
2246517,384,3,451,8609,466915142,1,0,0,467.09,7,396836.94,25,3,15,6,True
2469354,384,3,451,3622,466915142,1,0,0,466.84,7,396370.1,25,2,10,7,True
2474472,235,4,-1,9251,466915142,1,1,0,466.89,4,396370.1,26,0,23,9,True
2543381,384,3,25,9317,466915142,1,0,0,466.98,8,395903.12,25,4,21,9,True
2668024,384,3,-1,7428,466915142,1,1,0,467.06,4,395903.12,25,0,4,10,True
2763912,267,0,20,5708,466915142,1,0,0,467.06,3,395436.06,6,4,2,10,True
2791068,713,0,20,5708,466915142,1,0,0,466.94,3,394969.12,18,3,12,11,True
3334374,121,4,-1,5708,466915142,1,1,0,466.9,4,394969.12,18,0,23,11,True
3359080,235,4,25,9317,466915142,1,0,0,467.1,8,394502.02,26,6,16,11,True
3407646,187,4,451,9988,466915142,1,0,0,467.39,7,394034.63,18,3,17,1,True
3468775,187,4,451,9988,466915142,1,0,0,467.11,7,393567.52,18,3,22,1,True
3795359,384,3,451,4364,466915142,1,0,0,466.87,7,393100.65,25,3,18,3,True
3894844,950,0,10,3541,466915142,1,0,0,466.97,0,393567.62,24,4,16,5,True
3959018,1181,2,20,7977,466915142,1,0,0,466.99,5,393100.63,24,5,7,5,True
3970105,235,4,451,2210,466915142,1,0,0,466.84,7,392633.79,26,6,7,6,True
4103215,1315,0,20,8788,466915142,1,0,0,466.76,5,392167.03,5,1,0,7,True
4346206,198,0,10,3622,466915142,1,0,0,467.09,0,392634.12,18,6,15,8,True
4400344,121,4,30,7428,466915142,1,0,0,466.99,8,392167.13,18,2,14,8,True
4760520,976,4,-1,4364,466915142,1,1,0,467.04,4,392167.13,22,4,10,8,True
4766631,121,4,451,6522,466915142,1,0,0,467.09,7,391700.04,18,4,18,9,True
4906114,976,4,451,7226,466915142,1,0,0,466.99,7,391233.05,22,4,18,9,True
4927708,995,1,451,7977,466915142,1,0,0,466.94,7,390766.11,22,6,2,9,True
5336487,235,4,25,3320,466915142,1,0,0,467.26,8,390298.85,26,6,9,9,True
5351062,187,4,25,7428,466915142,1,0,0,467.22,8,389831.63,18,1,16,10,True
5688440,384,3,30,6094,466915142,1,0,0,467.03,8,389364.6,25,3,12,10,True
5865059,187,4,25,2504,466915142,1,0,0,466.98,8,388897.62,18,2,21,11,True
5974800,816,0,10,3541,466915142,1,0,0,467.09,0,389364.71,18,0,13,11,True
6372768,438,1,10,8609,466915142,1,0,0,466.84,0,389831.55,24,0,6,12,True
6626081,976,4,451,6492,466915142,1,0,0,467.09,7,389364.46,22,1,9,12,True
6793953,121,4,451,9919,466915142,1,0,0,467.06,7,388897.4,18,5,17,12,True
6920984,384,3,30,2210,466915142,1,0,0,467.03,8,388430.37,25,5,22,1,True
7249028,235,4,30,6887,466915142,1,0,0,467.02,8,387963.35,26,3,0,1,False
7399612,96,0,20,7428,466915142,1,0,0,467.01,5,387496.34,1,3,10,2,True
7414068,1305,2,20,8788,466915142,1,0,0,466.92,3,387029.42,5,6,22,2,True
7576511,235,4,-1,7428,466915142,1,1,0,466.93,4,387029.42,26,3,4,3,True
8020206,235,4,-1,3624,466915142,1,2,0,467.25,4,387029.42,26,1,15,4,True
8287121,121,4,25,4409,466915142,1,0,0,467.05,8,386562.37,18,6,15,4,True
8316146,976,4,-1,8058,466915142,1,1,0,467.05,1,386562.37,22,5,15,6,True
8365364,235,4,25,6492,466915142,1,0,0,467.21,8,386095.16,26,0,5,6,True
8585929,235,4,451,6094,466915142,1,0,0,466.89,7,385628.27,26,1,23,6,True
8672963,976,4,25,6094,466915142,1,0,0,467.22,8,385161.05,22,4,22,7,True
8979863,235,4,30,3320,466915142,1,0,0,467.1,8,384693.95,26,0,14,9,True
9347125,121,4,30,3622,466915142,1,0,0,466.92,8,384227.03,18,2,0,9,True
9427596,1000,0,20,8788,466915142,1,0,0,466.78,3,383760.25,26,1,1,10,False
9606551,337,1,10,6094,466915142,1,0,0,466.79,6,384227.04,11,4,3,10,False
9667060,428,0,10,4409,466915142,1,0,0,466.86,6,384693.9,18,1,9,10,True
9777349,235,4,25,8609,466915142,1,0,0,466.72,8,384227.18,26,0,11,10,True
9781291,121,4,25,6281,466915142,1,0,0,466.91,8,383760.27,18,0,16,11,True
9926401,976,4,25,8609,466915142,1,0,0,466.94,8,383293.33,22,5,18,11,True
1033486,327,0,30,6870,745962072,1,0,0,1157.67,8,761590.33,11,5,8,1,True
1468058,327,0,30,4611,745962072,1,0,0,1158.06,8,760432.27,11,6,9,1,True
1513717,1401,1,10,9443,745962072,1,0,0,1158.1,6,761590.37,24,0,22,1,True
1687263,616,1,451,7648,745962072,1,0,0,1158.19,7,760432.18,11,2,1,2,True
1847107,542,0,30,3201,745962072,1,0,0,1157.91,8,759274.27,17,5,18,2,True
2266353,35,2,20,6109,745962072,1,0,0,1158.16,5,758116.11,11,2,2,3,True
2291996,327,0,451,3201,745962072,1,0,0,1158.3,7,756957.81,11,3,8,3,True
2300866,464,1,10,9443,745962072,1,0,0,1157.84,6,758115.65,13,2,21,6,True
2360575,1341,4,30,9808,745962072,1,0,0,1158.08,8,756957.57,24,6,1,6,True
2445772,1341,4,25,7648,745962072,1,0,0,1157.98,8,755799.59,24,1,20,7,True
2676391,425,4,451,6345,745962072,1,0,0,1158.33,7,754641.26,18,5,2,7,True
3049272,1037,0,10,6870,745962072,1,0,0,1157.98,0,755799.24,11,1,14,8,True
3169178,327,0,-1,1280,745962072,1,1,0,1157.73,4,755799.24,11,0,22,9,True
3441821,865,0,451,7020,745962072,1,0,0,1158.36,7,754640.88,24,0,3,9,True
3651555,616,1,451,7020,745962072,1,0,0,1158.01,7,753482.87,11,0,8,10,True
3900730,1341,4,25,8995,745962072,1,0,0,1158.1,8,752324.77,24,3,21,10,True
3969644,1455,2,20,7648,745962072,1,0,0,1158.06,3,751166.71,11,3,13,10,True
4027489,993,0,20,2914,745962072,1,0,0,1158.13,5,750008.58,22,2,12,11,True
4126936,110,4,451,4971,745962072,1,0,0,1158.12,7,748850.46,3,4,4,11,True
4182229,865,0,451,4971,745962072,1,0,0,1158.09,7,747692.37,24,5,18,11,True
4184392,305,1,10,6345,745962072,1,0,0,1157.91,0,748850.28,4,6,8,11,True
4212409,865,0,-1,6017,745962072,1,1,0,1158.27,4,748850.28,24,2,23,12,True
4509485,865,0,451,6345,745962072,1,0,0,1157.9,7,747692.38,24,3,18,1,True
4591292,865,0,451,7020,745962072,1,0,0,1157.88,7,746534.5,24,3,22,2,True
4616374,312,0,20,6017,745962072,1,0,0,1157.96,3,745376.54,4,3,0,3,True
4678517,824,2,20,9788,745962072,1,0,0,1158.3,5,744218.24,18,5,3,4,True
4716778,1363,0,20,2914,745962072,1,0,0,1157.91,5,743060.33,16,6,1,5,True
4963727,1315,0,10,9808,745962072,1,0,0,1157.96,6,744218.29,5,4,3,5,True
5152466,542,0,451,1280,745962072,1,0,0,1157.82,7,743060.47,17,0,23,7,True
5272774,952,0,20,7648,745962072,1,0,0,1157.91,5,741902.56,13,3,0,8,True
5288308,865,0,25,6345,745962072,1,0,0,1158.06,8,740744.5,24,4,7,9,True
6039193,616,1,30,4971,745962072,1,0,0,1158.14,8,739586.36,11,1,23,10,True
6497406,425,4,451,4611,745962072,1,0,0,1157.93,7,738428.43,18,1,8,10,True
6592589,425,4,25,7648,745962072,1,0,0,1157.96,8,737270.47,18,3,13,11,True
6878536,327,0,-1,6870,745962072,1,1,0,1158.06,4,737270.47,11,3,7,11,True
7180772,1341,4,30,6870,745962072,1,0,0,1157.61,8,736112.86,24,4,14,12,True
7378039,1278,0,20,6870,745962072,1,0,0,1158.04,3,734954.82,24,1,11,12,True
7463573,542,0,451,7020,745962072,1,0,0,1158.09,7,733796.73,17,5,4,1,True
7498080,616,1,451,4611,745962072,1,0,0,1158.14,7,732638.59,11,6,1,2,True
7744467,654,1,10,6017,745962072,1,0,0,1157.95,0,733796.54,18,1,21,2,True
7762399,865,0,30,4611,745962072,1,0,0,1158.12,8,732638.42,24,0,8,2,True
7901051,428,0,20,1280,745962072,1,0,0,1158.14,5,731480.28,18,4,21,3,True
8367627,1227,0,10,1363,745962072,1,0,0,1158.01,0,732638.29,18,6,14,3,True
8508571,542,0,451,6017,745962072,1,0,0,1158.06,7,731480.23,17,2,13,3,True
8545841,542,0,25,7087,745962072,1,0,0,1157.97,8,730322.26,17,5,5,3,True
8657423,1164,0,20,1280,745962072,1,0,0,1158.09,3,729164.17,24,4,17,3,True
8845971,110,4,-1,7087,745962072,1,1,0,1157.83,4,729164.17,3,6,3,5,False
8904833,783,0,10,1698,745962072,1,0,0,1158.09,0,730322.26,14,3,20,5,True
8976781,1338,0,20,7648,745962072,1,0,0,1158.01,5,729164.25,18,0,8,5,True
9178373,542,0,-1,1280,745962072,1,1,0,1157.85,4,729164.25,17,6,12,6,True
9307460,110,4,-1,6876,745962072,1,2,0,1158.01,1,729164.25,3,3,15,6,True
9482745,425,4,451,6876,745962072,1,0,0,1157.97,7,728006.28,18,5,8,9,True
9582939,1341,4,30,7020,745962072,1,0,0,1157.94,8,726848.34,24,2,10,10,True
9591428,542,0,30,9808,745962072,1,0,0,1157.9,8,725690.44,17,5,0,11,True
9852983,282,2,20,6017,745962072,1,0,0,1158.18,5,724532.26,24,1,20,11,True
9992210,425,4,30,9808,745962072,1,0,0,1157.88,8,723374.38,18,2,6,11,True
1019923,939,0,20,1738,289249620,1,0,0,929.04,5,343610.96,24,1,23,2,True
1058636,75,3,-1,2508,289249620,1,1,0,929.24,4,343610.96,20,2,9,2,True
1536578,867,0,10,6155,289249620,1,0,0,929.11,6,344540.07,24,3,4,2,True
1671543,874,4,25,1738,289249620,1,0,0,928.74,8,343611.33,24,5,10,2,True
2275603,75,3,30,3123,289249620,1,0,0,928.84,8,342682.49,20,2,7,2,True
2422169,1179,0,30,1120,289249620,1,0,0,928.79,8,341753.7,24,6,20,3,True
2554858,1066,4,-1,1738,289249620,1,1,0,928.76,1,341753.7,11,3,10,3,True
2622276,1066,4,30,2583,289249620,1,0,0,928.89,8,340824.81,11,2,19,4,True
2732890,664,2,20,6889,289249620,1,0,0,928.91,5,339895.9,18,4,4,4,True
2872520,1027,0,20,3123,289249620,1,0,0,928.78,5,338967.12,11,2,15,5,True
3091325,874,4,-1,7603,289249620,1,1,0,929.13,1,338967.12,24,5,8,5,True
3583356,75,3,451,8986,289249620,1,0,0,928.91,7,338038.21,20,1,5,6,True
3630752,874,4,25,2984,289249620,1,0,0,929.17,8,337109.04,24,2,22,7,True
4119430,1297,0,20,7603,289249620,1,0,0,928.78,5,336180.26,5,4,21,8,True
4458679,211,0,30,4827,289249620,1,0,0,928.86,8,335251.4,9,4,11,9,True
4503087,75,3,25,2508,289249620,1,0,0,928.89,8,334322.51,20,3,14,9,True
4723880,367,1,10,7656,289249620,1,0,0,929.0,6,335251.51,25,3,9,10,True
4748664,75,3,451,3138,289249620,1,0,0,929.16,7,334322.35,20,6,19,10,True
4844984,874,4,451,2256,289249620,1,0,0,928.92,7,333393.43,24,5,13,11,True
4936328,874,4,25,9218,289249620,1,0,0,929.07,8,332464.36,24,1,1,12,True
5326919,75,3,30,4530,289249620,1,0,0,928.9,8,331535.46,20,5,16,12,True
5349094,1179,0,-1,8259,289249620,1,1,0,929.15,4,331535.46,24,3,2,2,True
5759217,689,0,10,7603,289249620,1,0,0,928.9,6,332464.36,24,4,7,3,True
5766850,1066,4,451,4628,289249620,1,0,0,929.37,7,331534.99,11,0,7,5,True
5780267,1179,0,-1,3426,289249620,1,1,0,929.1,4,331534.99,24,2,1,5,True
6227721,900,1,10,4628,289249620,1,0,0,929.2,6,332464.19,24,2,13,5,True
6611426,1066,4,30,4530,289249620,1,0,0,928.99,8,331535.2,11,3,11,6,True
6662859,1298,0,451,3426,289249620,1,0,0,928.99,7,330606.21,5,2,21,7,True
6971413,211,0,25,7603,289249620,1,0,0,929.08,8,329677.13,9,3,23,8,True
7041178,574,2,20,2984,289249620,1,0,0,929.12,5,328748.01,11,1,15,9,True
7229081,1179,0,451,6116,289249620,1,0,0,928.78,7,327819.23,24,6,7,9,True
7239756,1298,0,30,7603,289249620,1,0,0,929.22,8,326890.01,5,2,7,10,True
7240265,75,3,451,1120,289249620,1,0,0,929.09,7,325960.92,20,4,12,10,True
7287402,874,4,-1,6155,289249620,1,1,0,929.15,1,325960.92,24,5,5,10,True
7398325,874,4,-1,4628,289249620,1,2,0,928.66,1,325960.92,24,3,11,11,True
7442936,64,0,10,4089,289249620,1,0,0,929.28,6,326890.2,20,1,5,12,True
7641800,276,0,20,2817,289249620,1,0,0,929.01,5,325961.19,24,4,19,12,True
7827101,195,1,10,1120,289249620,1,0,0,929.06,0,326890.25,18,0,0,1,True
7834553,909,2,20,8986,289249620,1,0,0,928.9,5,325961.35,18,5,13,4,True
8187333,734,0,10,4087,289249620,1,0,0,929.09,6,326890.44,11,4,6,5,True
8393070,1273,0,20,4628,289249620,1,0,0,928.85,5,325961.59,24,5,9,6,True
8522108,1298,0,451,6934,289249620,1,0,0,928.68,7,325032.91,5,5,19,6,True
8616101,1298,0,451,3123,289249620,1,0,0,929.14,7,324103.77,5,5,16,6,True
8851641,1298,0,30,3372,289249620,1,0,0,929.2,8,323174.57,5,1,11,6,True
8981854,874,4,451,2256,289249620,1,0,0,929.25,7,322245.32,24,0,16,7,True
9010672,1019,0,10,4111,289249620,1,0,0,928.93,0,323174.25,26,6,3,7,True
9026498,1260,0,20,4628,289249620,1,0,0,928.74,3,322245.51,23,0,18,7,True
9159988,1064,0,20,7427,289249620,1,0,0,928.87,5,321316.64,11,4,10,8,False
9352151,1298,0,-1,4087,289249620,1,1,0,928.91,4,321316.64,5,2,4,8,True
9493350,874,4,-1,6889,289249620,1,2,0,928.79,4,321316.64,24,6,3,9,True
9523565,211,0,25,1738,289249620,1,0,0,928.82,8,320387.82,9,0,13,10,True
9665689,512,0,20,2508,289249620,1,0,0,928.76,3,319459.06,12,5,2,10,True
9751518,312,0,20,7563,289249620,1,0,0,929.11,5,318529.95,4,0,0,11,True
9981329,457,0,20,6116,289249620,1,0,0,929.23,5,317600.72,13,5,8,11,True
1072284,261,3,-1,7472,667131057,0,1,0,125.06,4,858538.0,6,2,8,1,True
1292237,742,4,451,4444,667131057,0,0,0,125.05,7,858412.95,24,1,18,2,True
1402281,1246,0,30,6991,667131057,0,0,0,125.04,8,858287.91,23,3,14,4,True
1606663,742,4,-1,8669,667131057,0,1,0,124.65,4,858287.91,24,1,21,5,True
1627051,742,4,25,7472,667131057,0,0,0,125.16,8,858162.75,24,0,18,5,True
1663075,443,2,20,2077,667131057,0,0,0,125.13,3,858037.62,24,4,1,7,True
1962742,448,0,10,2543,667131057,0,0,0,125.01,6,858162.63,13,5,7,7,True
2117956,742,4,451,7972,667131057,0,0,0,124.86,7,858037.77,24,3,8,7,True
2679173,1246,0,25,5022,667131057,0,0,0,124.86,8,857912.91,23,4,21,8,True
2681553,1246,0,25,2539,667131057,0,0,0,125.0,8,857787.91,23,5,11,8,True
2932890,261,3,451,2048,667131057,0,0,0,125.2,7,857662.71,6,1,6,8,True
2985270,1495,3,451,9506,667131057,0,0,0,124.99,7,857537.72,24,5,16,9,True
3242849,261,3,-1,8977,667131057,0,1,0,124.92,1,857537.72,6,0,9,9,True
3396646,261,3,451,5071,667131057,0,0,0,124.87,7,857412.85,6,1,3,10,True
3503992,261,3,25,7177,667131057,0,0,0,125.0,8,857287.85,6,6,9,1,True
3505245,742,4,30,8669,667131057,0,0,0,125.18,8,857162.67,24,6,0,4,True
3538811,403,0,20,9927,667131057,0,0,0,125.22,5,857037.45,10,3,0,4,False
3620453,269,0,10,4444,667131057,0,0,0,125.03,0,857162.48,24,3,9,5,False
3689359,1433,4,25,8812,667131057,0,0,0,124.89,8,857037.59,24,4,22,6,True
3891949,1433,4,-1,5022,667131057,0,1,0,124.8,4,857037.59,24,0,12,6,True
3901748,742,4,25,4585,667131057,0,0,0,124.9,8,856912.69,24,4,6,7,True
4314044,1495,3,-1,8669,667131057,0,1,0,124.89,4,856912.69,24,0,11,7,True
4456660,167,2,20,2077,667131057,0,0,0,124.84,5,856787.85,24,0,22,7,True
4480167,118,2,20,8267,667131057,0,0,0,124.68,3,856663.17,18,1,19,7,True
4762892,1459,1,10,5071,667131057,0,0,0,124.94,6,856788.11,11,2,23,8,False
4970733,261,3,25,5071,667131057,0,0,0,125.08,8,856663.03,6,0,17,11,True
5198101,1433,4,-1,2048,667131057,0,1,0,124.99,4,856663.03,24,4,15,12,True
5269981,1495,3,451,8977,667131057,0,0,0,124.97,7,856538.06,24,5,0,12,True
5385225,261,3,30,9501,667131057,0,0,0,124.7,8,856413.36,6,0,8,1,True
5591769,1495,3,-1,5071,667131057,0,1,0,125.0,1,856413.36,24,0,17,1,True
5598434,261,3,451,9927,667131057,0,0,0,124.78,7,856288.58,6,0,4,2,True
5639507,1246,0,30,7199,667131057,0,0,0,124.97,8,856163.61,23,0,21,2,True
6029481,1433,4,451,5071,667131057,0,0,0,125.17,7,856038.44,24,4,6,2,True
6414978,1246,0,30,7500,667131057,0,0,0,124.8,8,855913.64,23,3,20,2,True
6478679,261,3,451,5594,667131057,0,0,0,125.17,7,855788.47,6,2,21,2,True
6594006,742,4,25,8267,667131057,0,0,0,124.89,8,855663.58,24,6,21,3,True
6696850,742,4,451,9506,667131057,0,0,0,124.86,7,855538.72,24,5,12,3,True
6728297,742,4,30,2077,667131057,0,0,0,124.86,8,855413.86,24,6,9,3,True
6846180,742,4,30,2077,667131057,0,0,0,124.9,8,855288.96,24,1,18,4,True
6869351,1156,1,10,3257,667131057,0,0,0,125.03,6,855413.99,15,0,14,5,True
7272259,1246,0,451,4585,667131057,0,0,0,124.81,7,855289.18,23,1,13,6,True
7424912,1433,4,30,8812,667131057,0,0,0,124.88,8,855164.3,24,3,3,7,True
7816221,261,3,-1,6991,667131057,0,1,0,124.86,1,855164.3,6,3,11,7,True
8059416,1495,3,25,7500,667131057,0,0,0,124.86,8,855039.44,24,6,12,9,True
8427775,742,4,-1,4444,667131057,0,1,0,125.36,4,855039.44,24,3,4,9,True
8541209,1433,4,25,2077,667131057,0,0,0,125.03,8,854914.41,24,5,18,9,True
8731013,1495,3,-1,2048,667131057,0,1,0,124.93,4,854914.41,24,2,7,10,True
9448378,218,0,10,2539,667131057,0,0,0,125.1,6,855039.51,9,1,21,10,True
9549455,403,0,10,8267,667131057,0,0,0,125.01,6,855164.52,10,2,6,11,True
9837176,752,0,20,4444,667131057,0,0,0,125.0,5,855039.52,24,1,18,11,True
1011536,774,2,20,2426,782852627,1,0,0,385.94,5,502355.06,14,5,11,1,True
1195376,1471,0,30,4253,782852627,1,0,0,385.98,8,501969.08,24,4,4,1,True
1461248,910,0,20,7792,782852627,1,0,0,385.87,3,501583.21,18,0,15,1,True
1896094,1247,0,10,2194,782852627,1,0,0,386.06,6,501969.27,23,2,21,2,True
2081814,1471,0,30,5096,782852627,1,0,0,386.03,8,501583.24,24,3,10,2,True
2176094,1471,0,451,7660,782852627,1,0,0,386.13,7,501197.11,24,5,13,2,True
2575037,348,0,20,8307,782852627,1,0,0,385.78,5,500811.33,24,6,15,3,True
2668216,713,0,-1,2245,782852627,1,1,0,385.93,1,500811.33,18,5,0,4,True
2671387,281,1,10,4841,782852627,1,0,0,386.42,6,501197.75,24,5,0,6,True
2811889,403,0,10,1809,782852627,1,0,0,386.13,6,501583.88,10,3,8,6,True
3088606,1471,0,25,2817,782852627,1,0,0,386.15,8,501197.73,24,2,20,6,True
3667481,1012,0,451,1684,782852627,1,0,0,386.26,7,500811.47,26,5,16,7,True
3844684,1012,0,-1,8307,782852627,1,1,0,386.19,1,500811.47,26,6,11,7,True
3990973,1012,0,30,5389,782852627,1,0,0,385.98,8,500425.49,26,3,20,8,True
4170917,394,0,10,2453,782852627,1,0,0,385.86,6,500811.35,10,4,7,9,True
4211322,733,3,30,2903,782852627,1,0,0,386.17,8,500425.18,11,4,21,9,True
4285320,1354,0,30,5096,782852627,1,0,0,386.28,8,500038.9,24,2,19,9,True
4320320,695,2,20,9416,782852627,1,0,0,386.02,5,499652.88,24,0,1,9,True
4329864,713,0,30,3604,782852627,1,0,0,386.02,8,499266.86,18,0,4,12,True
4418165,1354,0,451,3930,782852627,1,0,0,386.05,7,498880.81,24,5,17,1,True
4471078,733,3,25,3930,782852627,1,0,0,385.81,8,498495.0,11,0,4,1,True
4599587,713,0,451,2453,782852627,1,0,0,385.98,7,498109.02,18,2,13,2,True
4661992,1217,0,10,8307,782852627,1,0,0,386.06,0,498495.08,24,2,4,4,True
4882841,783,0,10,6254,782852627,1,0,0,386.0,0,498881.08,14,3,2,4,True
5216898,448,0,10,1809,782852627,1,0,0,385.87,6,499266.95,13,0,17,4,True
5224095,733,3,30,2316,782852627,1,0,0,386.42,8,498880.53,11,2,5,5,True
5344515,733,3,451,2316,782852627,1,0,0,385.76,7,498494.77,11,3,12,5,True
5345790,816,0,20,5096,782852627,1,0,0,386.1,3,498108.67,18,3,0,6,True
5471827,1471,0,451,8691,782852627,1,0,0,385.92,7,497722.75,24,4,20,6,True
5556776,713,0,451,3604,782852627,1,0,0,386.08,7,497336.67,18,1,6,7,False
5563939,192,2,20,6254,782852627,1,0,0,386.28,3,496950.39,18,3,6,7,True
5956666,1471,0,451,9564,782852627,1,0,0,386.01,7,496564.38,24,4,20,7,True
6079889,1471,0,451,7792,782852627,1,0,0,385.97,7,496178.41,24,5,21,7,True
6704666,1012,0,25,6904,782852627,1,0,0,385.96,8,495792.45,26,1,1,8,True
6914140,713,0,30,2903,782852627,1,0,0,385.81,8,495406.64,18,0,19,9,True
7005367,1012,0,451,2269,782852627,1,0,0,386.24,7,495020.4,26,4,13,9,False
7121650,733,3,25,1684,782852627,1,0,0,386.09,8,494634.31,11,4,22,9,True
7133178,1012,0,451,4253,782852627,1,0,0,386.21,7,494248.1,26,3,15,10,True
7355964,1029,0,10,6254,782852627,1,0,0,385.87,6,494633.97,11,6,1,11,True
8075966,393,1,10,2269,782852627,1,0,0,385.94,0,495019.91,10,6,5,12,True
8096126,1471,0,451,3758,782852627,1,0,0,386.29,7,494633.62,24,6,0,12,True
8334258,1354,0,451,2903,782852627,1,0,0,385.89,7,494247.73,24,1,6,1,True
8569438,1012,0,30,7660,782852627,1,0,0,386.2,8,493861.53,26,4,2,1,True
8615693,1463,2,20,2426,782852627,1,0,0,386.0,3,493475.53,11,0,3,2,True
8680737,1354,0,30,2596,782852627,1,0,0,386.02,8,493089.51,24,4,1,3,True
8711826,1053,1,10,7660,782852627,1,0,0,385.87,0,493475.38,11,6,9,3,True
8717803,1012,0,451,2321,782852627,1,0,0,385.8,7,493089.58,26,3,8,5,True
8919672,713,0,-1,4253,782852627,1,1,0,386.15,4,493089.58,18,1,8,5,True
8954381,1471,0,25,5389,782852627,1,0,0,385.71,8,492703.87,24,3,17,5,True
8988779,713,0,30,1684,782852627,1,0,0,386.09,8,492317.78,18,4,0,7,True
9028331,1233,0,10,4253,782852627,1,0,0,386.18,0,492703.96,18,5,17,7,True
9394698,1354,0,-1,2316,782852627,1,1,0,385.88,4,492703.96,24,0,1,8,True
9431244,1471,0,451,9416,782852627,1,0,0,385.98,7,492317.98,24,0,16,9,True
9664579,767,0,20,5389,782852627,1,0,0,385.91,3,491932.07,14,4,16,10,True
9746739,713,0,30,2817,782852627,1,0,0,386.16,8,491545.91,18,6,11,10,True
9948895,713,0,-1,1797,782852627,1,1,0,386.02,4,491545.91,18,3,6,11,True
9987075,1354,0,25,3604,782852627,1,0,0,386.14,8,491159.77,24,1,8,11,True
1439186,1267,2,451,8216,999660534,1,0,0,713.96,7,391710.04,23,0,4,1,True
1450086,538,0,20,9701,999660534,1,0,0,713.78,5,390996.26,18,6,15,1,True
1452901,398,0,30,4354,999660534,1,0,0,714.19,8,390282.07,10,6,20,2,True
1509944,58,2,20,6748,999660534,1,0,0,713.93,5,389568.14,20,2,12,3,True
1526193,1086,0,20,4354,999660534,1,0,0,714.1,5,388854.04,18,5,7,3,True
1566872,238,0,10,4180,999660534,1,0,0,713.76,6,389567.8,26,2,0,5,True
1692598,398,0,-1,9701,999660534,1,1,0,714.29,4,389567.8,10,3,19,5,True
1833016,547,4,-1,4057,999660534,1,2,0,713.92,4,389567.8,17,2,1,7,True
2047408,487,4,451,8785,999660534,1,0,0,714.05,7,388853.75,12,2,12,8,True
2067293,1267,2,25,4057,999660534,1,0,0,714.2,8,388139.55,23,2,11,8,True
2367859,398,0,30,1042,999660534,1,0,0,714.14,8,387425.41,10,4,1,9,True
2555334,398,0,25,1042,999660534,1,0,0,713.97,8,386711.44,10,4,4,9,True
2681813,487,4,451,1500,999660534,1,0,0,714.22,7,385997.22,12,0,22,10,True
2687289,1255,0,20,2894,999660534,1,0,0,714.19,5,385283.03,23,1,4,10,True
2733365,993,0,30,9701,999660534,1,0,0,713.74,8,384569.29,22,2,7,11,True
3062382,333,1,451,4057,999660534,1,0,0,713.99,7,383855.3,11,1,22,11,True
3353907,467,0,10,6748,999660534,1,0,0,713.77,6,384569.07,5,3,16,12,True
3406417,975,4,451,4417,999660534,1,0,0,714.0,7,383855.07,22,1,7,12,True
3688289,23,0,20,5769,999660534,1,0,0,713.74,5,383141.33,11,2,16,12,True
3715527,547,4,451,1766,999660534,1,0,0,713.91,7,382427.42,17,1,11,1,True
3896767,975,4,-1,3515,999660534,1,1,0,713.94,4,382427.42,22,4,4,1,True
4212845,398,0,25,8326,999660534,1,0,0,713.88,8,381713.54,10,4,14,1,True
4421985,1267,2,30,4417,999660534,1,0,0,713.69,8,380999.85,23,0,7,1,True
4480931,398,0,30,1042,999660534,1,0,0,713.96,8,380285.89,10,1,0,2,True
4572451,333,1,-1,2581,999660534,1,1,0,713.71,4,380285.89,11,0,0,3,True
5035777,975,4,30,4417,999660534,1,0,0,713.85,8,379572.04,22,4,14,3,True
5056237,512,0,20,8216,999660534,1,0,0,713.96,5,378858.08,12,6,4,4,True
5064164,333,1,25,5039,999660534,1,0,0,714.12,8,378143.96,11,0,2,4,True
5504806,580,0,-1,1509,999660534,1,1,0,713.74,4,378143.96,11,0,22,4,True
5528967,993,0,451,1509,999660534,1,0,0,713.95,7,377430.01,22,6,22,5,True
5598845,580,0,25,6748,999660534,1,0,0,714.16,8,376715.85,11,1,3,5,True
5704792,487,4,-1,6748,999660534,1,1,0,713.97,4,376715.85,12,6,20,8,True
5753748,487,4,451,1766,999660534,1,0,0,713.98,7,376001.87,12,3,12,8,True
5902435,580,0,451,5755,999660534,1,0,0,714.04,7,375287.83,11,3,7,9,True
6043503,580,0,451,1042,999660534,1,0,0,714.14,7,374573.69,11,6,2,9,True
6151758,471,0,20,9400,999660534,1,0,0,714.15,3,373859.54,5,1,15,12,True
6549134,398,0,30,1766,999660534,1,0,0,713.71,8,373145.83,10,4,7,1,True
6844399,642,0,10,1766,999660534,1,0,0,713.77,0,373859.6,24,3,9,2,True
6865110,1029,0,10,8018,999660534,1,0,0,713.93,6,374573.53,11,2,4,3,True
6928123,547,4,30,9701,999660534,1,0,0,714.32,8,373859.21,17,5,2,3,True
7101995,487,4,30,8773,999660534,1,0,0,714.07,8,373145.14,12,6,22,3,True
7288294,975,4,-1,9701,999660534,1,1,0,714.28,4,373145.14,22,5,8,3,True
7355633,993,0,451,8018,999660534,1,0,0,713.86,7,372431.28,22,2,4,4,True
7356588,97,0,20,8216,999660534,1,0,0,713.93,3,371717.35,3,4,8,4,True
7392759,333,1,-1,6748,999660534,1,1,0,713.98,1,371717.35,11,0,22,5,True
7817294,398,0,30,9226,999660534,1,0,0,713.94,8,371003.41,10,1,15,5,True
7844325,398,0,30,5934,999660534,1,0,0,713.81,8,370289.6,10,0,21,5,True
7977989,1101,2,20,4057,999660534,1,0,0,714.25,3,369575.35,0,4,9,5,True
8010467,81,0,20,2363,999660534,1,0,0,713.92,3,368861.43,1,0,16,7,True
8021896,757,0,451,5755,999660534,1,0,0,713.92,7,368147.51,24,0,6,7,True
8344047,628,0,10,8018,999660534,1,0,0,713.84,6,368861.35,11,2,13,8,True
8516349,487,4,30,2894,999660534,1,0,0,713.94,8,368147.41,12,1,10,9,True
8635339,1267,2,-1,4354,999660534,1,1,0,713.98,4,368147.41,23,5,15,9,True
8806253,910,0,10,9226,999660534,1,0,0,713.81,0,368861.22,18,4,13,9,True
9033061,1359,2,20,5934,999660534,1,0,0,713.87,5,368147.35,24,6,11,9,True
9153745,757,0,-1,5755,999660534,1,1,0,713.88,1,368147.35,24,0,20,11,True
9300162,1267,2,-1,5039,999660534,1,2,0,714.1,4,368147.35,23,4,8,11,True
9964963,333,1,451,4057,999660534,1,0,0,713.92,7,367433.43,11,0,22,11,True
1036960,1074,4,451,9063,315864478,0,0,0,117.92,7,773550.08,18,1,14,2,True
1129348,1315,0,20,9664,315864478,0,0,0,118.12,5,773431.96,5,2,15,2,True
1343911,1408,1,-1,5007,315864478,0,1,0,117.79,4,773431.96,24,5,8,2,True
1492474,1456,4,-1,7385,315864478,0,2,0,118.27,4,773431.96,11,1,6,2,True
1554434,1456,4,30,8853,315864478,0,0,0,117.78,8,773314.18,11,2,10,2,True
1570733,1074,4,-1,5007,315864478,0,1,0,117.99,4,773314.18,18,2,21,3,True
1833797,1349,3,451,4302,315864478,0,0,0,117.86,7,773196.32,24,3,9,3,True
1934542,1456,4,451,8853,315864478,0,0,0,117.92,7,773078.4,11,1,4,4,True
1982858,1478,4,30,5389,315864478,0,0,0,118.34,8,772960.06,24,2,19,4,True
2148256,917,0,10,8355,315864478,0,0,0,117.87,6,773077.93,18,6,20,5,True
2230937,1349,3,451,9664,315864478,0,0,0,118.04,7,772959.89,24,1,16,5,True
2258529,342,0,20,2783,315864478,0,0,0,117.84,5,772842.05,24,2,7,5,True
2305651,1367,4,451,1493,315864478,0,0,0,117.95,7,772724.1,16,5,20,6,True
2383587,1478,4,-1,9063,315864478,0,1,0,118.05,4,772724.1,24,5,1,6,True
2445996,255,2,20,2157,315864478,0,0,0,117.94,5,772606.16,6,4,14,7,True
2464974,1367,4,451,5007,315864478,0,0,0,118.03,7,772488.13,16,6,3,8,True
2702019,1074,4,451,2783,315864478,0,0,0,117.83,7,772370.3,18,4,1,8,True
2720221,1025,1,10,1493,315864478,0,0,0,118.03,6,772488.33,11,6,1,8,True
2888211,1159,0,20,8853,315864478,0,0,0,118.09,3,772370.24,15,0,1,9,True
3150175,1408,1,451,6866,315864478,0,0,0,118.05,7,772252.19,24,4,16,10,True
3346607,1074,4,25,5389,315864478,0,0,0,118.02,8,772134.17,18,0,15,11,True
3588366,1037,0,10,1493,315864478,0,0,0,117.99,6,772252.16,11,2,21,11,True
3735166,140,3,-1,5007,315864478,0,1,0,117.89,4,772252.16,18,5,0,12,True
4101040,140,3,451,2783,315864478,0,0,0,118.07,7,772134.09,18,1,15,1,True
4416322,1349,3,25,7771,315864478,0,0,0,117.62,8,772016.47,24,3,8,1,True
4568263,1367,4,-1,6866,315864478,0,1,0,118.04,4,772016.47,16,3,11,5,True
5254587,1399,0,20,6043,315864478,0,0,0,117.89,5,771898.58,24,2,3,5,True
5309751,1367,4,451,5389,315864478,0,0,0,117.9,7,771780.68,16,4,17,5,True
5818956,1478,4,451,9063,315864478,0,0,0,118.26,7,771662.42,24,3,9,7,True
6281386,1074,4,30,4302,315864478,0,0,0,117.8,8,771544.62,18,4,0,8,True
6330537,1408,1,451,9063,315864478,0,0,0,117.98,7,771426.64,24,4,4,8,True
6708802,1367,4,451,1275,315864478,0,0,0,118.11,7,771308.53,16,1,23,8,True
7016046,1367,4,451,6866,315864478,0,0,0,118.11,7,771190.42,16,4,16,8,True
7289598,328,0,10,4302,315864478,0,0,0,118.11,6,771308.53,11,4,11,9,True
7333416,1349,3,451,6043,315864478,0,0,0,118.01,7,771190.52,24,2,14,10,True
7488395,1367,4,451,6866,315864478,0,0,0,117.91,7,771072.61,16,2,6,11,True
7713507,1367,4,451,2157,315864478,0,0,0,118.0,7,770954.61,16,5,21,11,True
7891476,1349,3,25,9664,315864478,0,0,0,117.97,8,770836.64,24,2,2,11,True
8004363,1408,1,30,9063,315864478,0,0,0,118.06,8,770718.58,24,5,15,11,True
8083133,1367,4,25,5389,315864478,0,0,0,117.95,8,770600.63,16,3,1,12,True
8235098,349,2,20,2157,315864478,0,0,0,117.99,5,770482.64,24,4,2,12,True
8249842,1349,3,451,5184,315864478,0,0,0,117.88,7,770364.76,24,4,18,1,True
8345045,1456,4,451,1493,315864478,0,0,0,117.96,7,770246.8,11,4,3,3,True
8414353,1408,1,30,9664,315864478,0,0,0,118.05,8,770128.75,24,5,16,3,False
8459220,140,3,451,6866,315864478,0,0,0,118.27,7,770010.48,18,3,17,4,True
8460148,1477,2,20,2157,315864478,0,0,0,117.93,5,769892.55,24,0,15,5,True
8693365,1074,4,-1,1493,315864478,0,1,0,118.06,1,769892.55,18,1,4,7,True
8789339,1349,3,451,8355,315864478,0,0,0,117.95,7,769774.6,24,1,6,7,True
8805419,1074,4,451,6866,315864478,0,0,0,117.96,7,769656.64,18,3,21,8,True
8912810,348,0,10,9063,315864478,0,0,0,118.03,6,769774.67,24,3,13,9,True
9225971,1456,4,451,5389,315864478,0,0,0,118.07,7,769656.6,11,6,7,9,True
9226755,935,1,10,9303,315864478,0,0,0,117.88,6,769774.48,24,0,8,9,True
9558108,1478,4,451,9063,315864478,0,0,0,117.96,7,769656.52,24,4,21,9,True
9649279,334,0,20,9039,315864478,0,0,0,118.02,5,769538.5,11,2,18,10,True
9879589,1074,4,30,2157,315864478,0,0,0,118.04,8,769420.46,18,5,18,10,True
9929757,1367,4,30,1493,315864478,0,0,0,118.3,8,769302.16,16,5,13,11,True
1015020,834,0,20,3750,180587807,0,0,0,590.05,5,768789.95,5,5,4,1,True
1492140,1380,0,-1,4124,180587807,0,1,0,590.0,4,768789.95,16,6,20,2,True
1519751,1140,0,-1,2875,180587807,0,2,0,590.08,1,768789.95,15,2,5,2,False
1535374,1380,0,451,1296,180587807,0,0,0,589.84,7,768200.11,16,5,9,3,True
1671320,962,0,10,2875,180587807,0,0,0,589.89,0,768790.0,13,6,2,3,True
2030206,1380,0,25,2734,180587807,0,0,0,589.97,8,768200.03,16,4,0,4,True
2176433,943,4,30,8000,180587807,0,0,0,589.81,8,767610.22,24,2,0,6,True
2184150,367,1,10,8494,180587807,0,0,0,590.13,0,768200.35,25,5,6,7,True
2207378,1140,0,25,3410,180587807,0,0,0,589.93,8,767610.42,15,0,18,7,True
2255358,1015,0,20,1387,180587807,0,0,0,590.12,5,767020.3,26,1,2,8,True
2326948,943,4,-1,9179,180587807,0,1,0,589.75,4,767020.3,24,2,11,9,True
2601818,943,4,451,3410,180587807,0,0,0,590.09,7,766430.21,24,2,13,9,True
2643464,525,0,30,5547,180587807,0,0,0,589.87,8,765840.34,18,5,22,10,True
2761221,525,0,451,3410,180587807,0,0,0,589.77,7,765250.57,18,1,14,10,True
2786907,476,1,10,6807,180587807,0,0,0,589.96,0,765840.53,5,6,6,10,True
3040235,979,0,10,4559,180587807,0,0,0,590.13,0,766430.66,22,0,2,10,True
3068202,943,4,30,4716,180587807,0,0,0,589.84,8,765840.82,24,5,9,11,True
3490241,748,1,10,7082,180587807,0,0,0,589.79,6,766430.61,24,6,10,11,True
3584612,653,1,-1,2734,180587807,0,1,0,589.97,1,766430.61,24,5,23,12,True
3635745,325,0,20,3410,180587807,0,0,0,590.01,5,765840.6,11,2,9,12,True
3790461,943,4,25,9179,180587807,0,0,0,589.96,8,765250.64,24,2,4,1,True
3813656,763,3,451,5892,180587807,0,0,0,589.84,7,764660.8,14,2,7,2,True
3816149,1380,0,451,8000,180587807,0,0,0,590.03,7,764070.77,16,1,5,3,True
3895784,1140,0,30,5547,180587807,0,0,0,589.93,8,763480.84,15,1,21,4,True
4081948,1140,0,-1,8530,180587807,0,1,0,590.19,4,763480.84,15,2,8,5,True
4119094,1239,1,25,8580,180587807,0,0,0,589.96,8,762890.88,18,4,18,6,True
4415595,1380,0,-1,1387,180587807,0,1,0,590.24,1,762890.88,16,3,8,7,True
4541539,46,1,10,8580,180587807,0,0,0,590.19,6,763481.07,24,1,13,8,True
4609630,568,1,10,2734,180587807,0,0,0,590.13,6,764071.2,11,6,0,8,True
4726135,763,3,30,4559,180587807,0,0,0,589.98,8,763481.22,14,4,1,8,True
4793878,1159,0,20,8000,180587807,0,0,0,589.8,5,762891.42,15,0,1,10,True
4919725,572,0,10,2875,180587807,0,0,0,589.99,6,763481.41,11,0,14,10,True
5055658,653,1,451,7082,180587807,0,0,0,589.82,7,762891.59,24,0,7,11,True
5126789,1239,1,30,8860,180587807,0,0,0,590.1,8,762301.49,18,3,12,12,True
5167236,464,1,10,8245,180587807,0,0,0,590.11,6,762891.6,13,4,5,1,True
5195591,763,3,-1,7082,180587807,0,1,0,590.12,4,762891.6,14,0,11,1,True
5325110,537,0,20,5547,180587807,0,0,0,589.9,5,762301.7,18,6,5,2,True
5546124,1380,0,-1,9860,180587807,0,1,0,589.97,4,762301.7,16,3,14,2,True
5980200,1239,1,451,1208,180587807,0,0,0,590.04,7,761711.66,18,4,5,3,True
6299275,1140,0,30,8000,180587807,0,0,0,590.14,8,761121.52,15,3,1,4,True
6887726,712,0,20,3410,180587807,0,0,0,590.13,5,760531.39,18,4,18,5,True
7241677,1380,0,30,1296,180587807,0,0,0,590.17,8,759941.22,16,0,1,5,True
7287322,1270,1,10,1387,180587807,0,0,0,589.8,6,760531.02,23,5,9,5,True
7511550,1239,1,25,2875,180587807,0,0,0,589.79,8,759941.23,18,2,18,6,True
7587827,653,1,30,5547,180587807,0,0,0,589.91,8,759351.32,24,4,20,6,True
7805832,943,4,451,7082,180587807,0,0,0,590.16,7,758761.16,24,5,4,7,True
8034839,1451,1,10,8860,180587807,0,0,0,590.05,0,759351.21,11,2,18,8,True
8348443,525,0,451,8860,180587807,0,0,0,589.82,7,758761.39,18,3,21,9,True
8940339,1140,0,451,4559,180587807,0,0,0,590.11,7,758171.28,15,4,9,9,True
9056091,1239,1,451,8245,180587807,0,0,0,590.0,7,757581.28,18,3,22,10,True
9261079,1380,0,-1,6807,180587807,0,1,0,590.07,4,757581.28,16,2,15,10,True
9815458,653,1,30,1208,180587807,0,0,0,590.08,8,756991.2,24,2,16,10,True
9840221,1380,0,30,5547,180587807,0,0,0,589.95,8,756401.25,16,3,1,11,True
1014241,204,0,10,2016,716439202,0,0,0,947.05,0,492630.05,9,5,14,1,True
1496847,1386,4,30,3215,716439202,0,0,0,946.89,8,491683.16,24,2,4,2,True
1881622,584,0,451,8724,716439202,0,0,0,946.97,7,490736.19,11,6,5,2,True
1904443,1033,4,-1,2670,716439202,0,1,0,947.12,4,490736.19,11,3,18,3,True
2014125,1314,2,30,4597,716439202,0,0,0,946.99,8,489789.2,5,1,20,5,True
2032770,1383,4,25,3059,716439202,0,0,0,947.11,8,488842.09,16,2,15,6,True
2156489,584,0,-1,9683,716439202,0,1,0,946.91,4,488842.09,11,2,10,7,True
2218652,1093,0,10,8708,716439202,0,0,0,946.87,6,489788.96,18,5,13,7,True
2303031,342,0,20,2016,716439202,0,0,0,946.82,5,488842.14,24,1,3,8,True
2381751,584,0,30,5537,716439202,0,0,0,946.76,8,487895.38,11,5,8,8,True
2689537,372,0,20,8724,716439202,0,0,0,947.09,5,486948.29,25,6,12,9,True
2708527,1029,0,10,5071,716439202,0,0,0,946.87,0,487895.16,11,4,13,9,True
2858071,583,2,20,9669,716439202,0,0,0,947.17,5,486947.99,11,3,19,12,True
3007827,1451,1,10,4164,716439202,0,0,0,946.91,6,487894.9,11,3,8,1,True
3070473,1383,4,30,2883,716439202,0,0,0,947.26,8,486947.64,16,1,8,1,True
3095368,1033,4,25,7044,716439202,0,0,0,947.14,8,486000.5,11,3,22,1,True
3299841,1260,0,20,4164,716439202,0,0,0,947.05,3,485053.45,23,2,6,2,True
3481986,584,0,25,9683,716439202,0,0,0,946.9,8,484106.55,11,1,5,2,True
3490728,145,0,20,2670,716439202,0,0,0,947.0,3,483159.55,18,6,5,2,True
3891360,1383,4,25,2885,716439202,0,0,0,946.67,8,482212.88,16,5,12,3,True
3950096,1386,4,25,8724,716439202,0,0,0,947.08,8,481265.8,24,6,5,4,True
4661232,484,0,10,2670,716439202,0,0,0,947.17,0,482212.97,5,1,19,4,True
4662178,1314,2,451,6421,716439202,0,0,0,946.72,7,481266.25,5,3,4,5,True
4775856,610,0,10,7543,716439202,0,0,0,947.14,0,482213.39,11,1,14,5,True
4825343,1386,4,-1,5071,716439202,0,1,0,946.81,1,482213.39,24,4,11,7,True
4859047,1383,4,451,6784,716439202,0,0,0,946.68,7,481266.71,16,5,8,7,True
4923726,1386,4,-1,2885,716439202,0,1,0,947.29,4,481266.71,24,1,20,9,True
4927139,1033,4,25,5560,716439202,0,0,0,947.07,8,480319.64,11,6,13,10,True
4989353,644,0,10,9577,716439202,0,0,0,946.99,0,481266.63,24,6,7,10,True
5013325,1386,4,451,3992,716439202,0,0,0,946.79,7,480319.84,24,6,7,11,True
5235220,1386,4,30,6784,716439202,0,0,0,947.21,8,479372.63,24,0,19,11,False
5314819,1386,4,30,2016,716439202,0,0,0,947.08,8,478425.55,24,2,0,12,True
5556331,1033,4,-1,3059,716439202,0,1,0,946.83,4,478425.55,11,6,5,12,True
6102761,1383,4,25,3059,716439202,0,0,0,946.89,8,477478.66,16,2,11,1,True
6288862,1321,0,20,5482,716439202,0,0,0,947.02,3,476531.64,18,4,12,1,True
6349766,512,0,20,6784,716439202,0,0,0,947.11,5,475584.53,12,0,10,2,True
6394109,1336,2,20,4164,716439202,0,0,0,946.87,5,474637.66,18,5,4,2,True
6514628,1033,4,-1,4597,716439202,0,1,0,946.95,1,474637.66,11,5,2,2,False
6940396,496,1,10,5482,716439202,0,0,0,946.98,6,475584.64,12,3,18,2,True
7282372,937,0,10,3314,716439202,0,0,0,947.11,6,476531.75,24,6,7,2,True
7302204,584,0,451,3314,716439202,0,0,0,946.91,7,475584.84,11,1,18,3,True
7455713,484,0,20,7543,716439202,0,0,0,946.94,5,474637.9,5,3,21,3,True
7523595,626,2,20,7801,716439202,0,0,0,946.77,3,473691.13,11,4,20,4,True
7759189,1033,4,25,7438,716439202,0,0,0,946.85,8,472744.28,11,6,20,6,True
7917092,204,0,20,3059,716439202,0,0,0,947.29,5,471796.99,9,1,4,6,False
8005488,583,2,20,3059,716439202,0,0,0,947.22,5,470849.77,11,4,15,6,True
8138837,1386,4,30,9669,716439202,0,0,0,946.87,8,469902.9,24,0,22,6,True
8161898,1033,4,451,4776,716439202,0,0,0,947.03,7,468955.87,11,3,6,8,True
8240602,1386,4,451,3314,716439202,0,0,0,947.14,7,468008.73,24,1,11,8,True
8877140,1352,1,10,8708,716439202,0,0,0,946.85,6,468955.58,24,6,19,8,True
9087087,1314,2,30,2885,716439202,0,0,0,947.13,8,468008.45,5,1,16,9,True
9106174,1110,0,10,5537,716439202,0,0,0,946.99,6,468955.44,0,1,11,9,True
9197014,1383,4,25,8724,716439202,0,0,0,947.15,8,468008.29,16,1,3,9,True
9229340,1383,4,30,3059,716439202,0,0,0,946.61,8,467061.68,16,2,12,9,True
9410500,1386,4,25,4776,716439202,0,0,0,946.69,8,466114.99,24,3,0,9,True
9470758,1033,4,451,7044,716439202,0,0,0,947.01,7,465167.98,11,5,9,9,True
9515762,1033,4,-1,2670,716439202,0,1,0,947.04,4,465167.98,11,6,17,10,True
9736034,1383,4,30,5071,716439202,0,0,0,947.13,8,464220.85,16,0,21,10,True
9879097,889,0,20,6421,716439202,0,0,0,946.79,3,463274.06,27,6,10,11,True
1195135,1297,0,20,4990,702890747,0,0,0,312.78,3,534617.22,5,3,2,1,True
1292940,1166,2,25,7407,702890747,0,0,0,313.0,8,534304.22,24,1,17,2,True
1516804,945,1,451,1134,702890747,0,0,0,313.15,7,533991.07,24,6,19,2,True
1904368,78,3,-1,6296,702890747,0,1,0,312.93,1,533991.07,1,5,4,4,True
2114984,1355,4,25,1715,702890747,0,0,0,312.77,8,533678.3,24,2,18,4,True
2142059,945,1,30,2463,702890747,0,0,0,313.05,8,533365.25,24,4,17,4,True
2222436,78,3,-1,9564,702890747,0,1,0,312.9,4,533365.25,1,5,5,4,True
2317280,945,1,30,9478,702890747,0,0,0,313.03,8,533052.22,24,5,13,5,True
2375369,1485,0,20,4843,702890747,0,0,0,312.91,5,532739.31,24,4,18,6,True
2497172,1000,0,20,6324,702890747,0,0,0,313.0,5,532426.31,26,3,5,7,True
2667915,1461,0,10,3692,702890747,0,0,0,312.9,6,532739.21,11,5,20,7,True
2673410,78,3,30,9905,702890747,0,0,0,313.11,8,532426.1,1,5,15,7,True
2763170,78,3,451,7407,702890747,0,0,0,313.05,7,532113.05,1,1,4,8,True
2798540,78,3,451,6296,702890747,0,0,0,313.07,7,531799.98,1,1,13,8,True
2988029,394,0,451,5684,702890747,0,0,0,313.21,7,531486.77,10,4,18,10,True
3228804,1355,4,-1,9564,702890747,0,1,0,313.14,4,531486.77,24,3,11,11,True
3254754,945,1,30,6324,702890747,0,0,0,313.14,8,531173.63,24,5,12,11,True
3273752,945,1,-1,1715,702890747,0,1,0,313.25,4,531173.63,24,6,7,11,True
3671408,1243,2,451,4843,702890747,0,0,0,312.93,7,530860.7,18,6,22,11,True
3773464,1243,2,25,1134,702890747,0,0,0,313.11,8,530547.59,18,5,1,12,True
3850385,394,0,-1,1503,702890747,0,1,0,313.03,1,530547.59,10,4,19,12,True
3944974,108,2,20,1715,702890747,0,0,0,312.93,3,530234.66,3,0,10,1,True
4013044,394,0,25,4990,702890747,0,0,0,312.8,8,529921.86,10,0,20,1,True
4212836,303,0,25,1715,702890747,0,0,0,313.13,8,529608.73,4,1,11,1,True
4258263,1029,0,25,4843,702890747,0,0,0,312.96,8,529295.77,11,2,19,4,True
4530464,1166,2,451,6324,702890747,0,0,0,313.17,7,528982.6,24,6,6,4,True
4739826,945,1,25,6324,702890747,0,0,0,312.99,8,528669.61,24,6,16,5,True
4821830,530,0,10,7407,702890747,0,0,0,313.01,6,528982.62,18,5,22,6,True
4957611,1243,2,25,4048,702890747,0,0,0,313.01,8,528669.61,18,6,6,7,True
5224468,1166,2,451,5209,702890747,0,0,0,313.35,7,528356.26,24,5,15,7,True
5675865,761,2,20,2997,702890747,0,0,0,313.01,5,528043.25,24,0,0,7,True
5949740,1474,0,10,4843,702890747,0,0,0,312.99,6,528356.24,24,1,12,10,True
5989147,1284,2,20,7407,702890747,0,0,0,312.75,5,528043.49,24,6,12,11,True
6209409,78,3,25,4843,702890747,0,0,0,312.81,8,527730.68,1,0,17,11,True
6223059,669,2,20,6296,702890747,0,0,0,313.28,5,527417.4,18,5,3,12,True
6696731,652,0,10,1134,702890747,0,0,0,313.03,6,527730.43,24,6,5,2,True
6911536,1243,2,-1,4843,702890747,0,1,0,312.98,4,527730.43,18,0,5,3,True
6951155,716,0,10,4843,702890747,0,0,0,313.03,6,528043.46,18,6,20,4,True
7130303,1213,2,20,5508,702890747,0,0,0,312.97,3,527730.49,24,2,22,5,True
7139822,1264,0,20,1586,702890747,0,0,0,313.33,3,527417.16,23,2,2,5,False
7194173,78,3,25,9905,702890747,0,0,0,313.14,8,527104.02,1,4,6,5,True
7319933,1355,4,25,2463,702890747,0,0,0,312.96,8,526791.06,24,4,7,6,True
7381483,394,0,30,5209,702890747,0,0,0,312.99,8,526478.07,10,0,23,7,True
7690647,78,3,-1,5443,702890747,0,1,0,312.88,1,526478.07,1,0,14,7,True
7800242,945,1,451,9478,702890747,0,0,0,313.27,7,526164.8,24,6,6,7,True
8225574,557,1,10,9478,702890747,0,0,0,313.01,0,526477.81,17,0,11,8,True
8530930,572,0,10,5508,702890747,0,0,0,313.18,6,526790.99,11,0,23,8,True
8733107,1064,0,10,5443,702890747,0,0,0,312.78,6,527103.77,11,3,6,8,True
9150166,394,0,30,9905,702890747,0,0,0,313.04,8,526790.73,10,6,23,8,True
9261613,1029,0,451,5508,702890747,0,0,0,313.08,7,526477.65,11,3,6,8,True
9293835,1090,0,20,5508,702890747,0,0,0,313.2,5,526164.45,18,4,6,9,True
9423566,147,0,10,1134,702890747,0,0,0,312.9,0,526477.35,18,1,17,11,True
9597167,879,1,10,3692,702890747,0,0,0,312.9,6,526790.25,27,1,21,11,True
1024888,791,3,451,5251,576464614,0,0,0,305.94,7,377122.06,11,6,23,1,True
1254968,1118,4,451,6984,576464614,0,0,0,305.82,7,376816.24,24,3,6,2,True
1304329,1260,0,10,5074,576464614,0,0,0,305.8,0,377122.04,23,0,23,2,True
1501946,995,1,10,4818,576464614,0,0,0,305.97,6,377428.01,22,2,18,2,True
1627650,1431,4,451,6984,576464614,0,0,0,306.02,7,377121.99,24,6,17,4,True
1636233,1184,4,451,1007,576464614,0,0,0,305.85,7,376816.14,24,2,4,4,True
1779754,714,2,20,1673,576464614,0,0,0,305.86,5,376510.28,18,3,4,4,True
1930701,791,3,25,5374,576464614,0,0,0,305.86,8,376204.42,11,1,23,5,True
1937420,1334,3,-1,8495,576464614,0,1,0,305.94,1,376204.42,18,4,16,5,True
3213249,791,3,25,4818,576464614,0,0,0,305.8,8,375898.62,11,4,23,6,True
3479433,1184,4,25,1737,576464614,0,0,0,306.19,8,375592.43,24,0,23,7,True
3506996,1118,4,451,5005,576464614,0,0,0,305.61,7,375286.82,24,1,1,7,True
3688044,1035,0,30,7263,576464614,0,0,0,306.1,8,374980.72,11,1,7,9,True
3820138,1431,4,25,6984,576464614,0,0,0,305.97,8,374674.75,24,6,7,9,True
4771534,1118,4,451,1007,576464614,0,0,0,306.0,7,374368.75,24,2,21,10,True
4889253,126,1,10,5625,576464614,0,0,0,306.06,6,374674.81,18,5,4,10,True
5038026,791,3,25,1007,576464614,0,0,0,306.02,8,374368.79,11,2,7,11,True
5109219,228,0,20,5005,576464614,0,0,0,305.95,5,374062.84,26,0,0,11,True
5139064,1035,0,30,5277,576464614,0,0,0,306.29,8,373756.55,11,1,19,11,True
5176307,1118,4,25,3944,576464614,0,0,0,306.17,8,373450.38,24,2,6,12,True
5245149,1035,0,451,4818,576464614,0,0,0,306.12,7,373144.26,11,2,17,1,True
5278012,304,0,10,4818,576464614,0,0,0,306.11,6,373450.37,4,3,15,1,True
5297040,482,1,10,5074,576464614,0,0,0,305.93,0,373756.3,5,3,21,1,True
5324245,471,0,20,5774,576464614,0,0,0,306.07,3,373450.23,5,5,12,2,True
5488352,935,1,10,6984,576464614,0,0,0,306.04,6,373756.27,24,2,19,3,True
5632494,1321,0,30,8895,576464614,0,0,0,305.97,8,373450.3,18,6,18,3,True
5746914,1359,2,20,6984,576464614,0,0,0,306.11,5,373144.19,24,2,22,3,True
5753632,791,3,451,3217,576464614,0,0,0,305.92,7,372838.27,11,4,19,4,True
5945313,972,3,30,3217,576464614,0,0,0,305.82,8,372532.45,13,6,12,5,True
6401467,791,3,25,5368,576464614,0,0,0,306.26,8,372226.19,11,1,0,6,True
6407215,1401,1,10,8895,576464614,0,0,0,306.15,6,372532.34,24,6,4,7,True
6528108,1184,4,30,1673,576464614,0,0,0,305.85,8,372226.49,24,2,22,10,True
6583963,365,0,10,2384,576464614,0,0,0,305.68,6,372532.17,25,0,19,10,True
6602315,791,3,451,5625,576464614,0,0,0,306.02,7,372226.15,11,5,17,11,True
7032992,1334,3,451,1673,576464614,0,0,0,306.01,7,371920.14,18,5,5,11,True
7069623,972,3,451,5256,576464614,0,0,0,306.03,7,371614.11,13,5,2,11,True
7130888,882,0,20,5368,576464614,0,0,0,306.08,5,371308.03,27,1,14,11,True
7319524,910,0,20,1737,576464614,0,0,0,306.14,5,371001.89,18,3,3,12,True
7415147,1431,4,451,4000,576464614,0,0,0,305.87,7,370696.02,24,5,9,12,True
7418719,1184,4,-1,6688,576464614,0,1,0,306.11,4,370696.02,24,2,0,1,True
7525331,1477,2,20,5251,576464614,0,0,0,305.82,5,370390.2,24,4,11,1,True
7587861,1321,0,451,5150,576464614,0,0,0,306.13,7,370084.07,18,6,14,2,True
7709592,1273,0,10,2384,576464614,0,0,0,305.62,0,370389.69,24,3,12,2,True
7863354,1035,0,30,1673,576464614,0,0,0,306.01,8,370083.68,11,3,14,4,True
7935158,1184,4,451,3944,576464614,0,0,0,306.0,7,369777.68,24,3,21,4,True
7992295,1118,4,25,2384,576464614,0,0,0,306.03,8,369471.65,24,3,0,5,True
8309713,1012,0,10,5277,576464614,0,0,0,306.06,6,369777.71,26,0,20,5,True
8522129,791,3,30,8895,576464614,0,0,0,305.96,8,369471.75,11,5,23,5,True
8568670,1334,3,451,5625,576464614,0,0,0,305.67,7,369166.08,18,5,21,6,True
9142062,1041,0,20,3944,576464614,0,0,0,306.05,5,368860.03,11,2,23,7,True
9172219,1118,4,25,8495,576464614,0,0,0,306.37,8,368553.66,24,0,4,7,True
9600688,816,0,10,5251,576464614,0,0,0,306.09,0,368859.75,18,6,5,8,True
9834268,1118,4,451,4000,576464614,0,0,0,305.92,7,368553.83,24,0,8,8,True
9873472,1118,4,25,5277,576464614,0,0,0,305.89,8,368247.94,24,0,13,11,True
9885414,972,3,30,5074,576464614,0,0,0,305.92,8,367942.02,13,4,0,11,True
9963415,1321,0,-1,8495,576464614,0,1,0,306.05,4,367942.02,18,0,13,11,True
1150349,64,0,20,7284,753984993,1,0,0,806.03,5,672736.97,20,3,8,1,True
1332878,1397,4,-1,7284,753984993,1,1,0,806.04,4,672736.97,24,0,21,1,True
1457414,1304,0,30,1300,753984993,1,0,0,806.05,8,671930.92,5,0,17,3,True
1475709,1397,4,-1,8628,753984993,1,1,0,806.09,4,671930.92,24,1,8,3,True
1617632,484,0,10,2520,753984993,1,0,0,805.97,6,672736.89,5,1,9,3,True
1639023,622,4,-1,9993,753984993,1,1,0,805.86,1,672736.89,11,0,5,4,True
1828637,123,0,10,4464,753984993,1,0,0,805.97,6,673542.86,18,1,7,5,True
1984104,1397,4,25,4296,753984993,1,0,0,806.01,8,672736.85,24,3,0,5,True
2062165,1120,4,-1,9993,753984993,1,1,0,805.89,4,672736.85,24,3,0,6,True
2068059,485,1,10,1334,753984993,1,0,0,806.07,0,673542.92,5,6,9,6,True
2472419,58,2,25,8628,753984993,1,0,0,806.04,8,672736.88,20,2,1,6,True
2586990,65,3,-1,9488,753984993,1,1,0,806.15,4,672736.88,20,4,12,9,True
2621534,1304,0,25,7265,753984993,1,0,0,806.24,8,671930.64,5,6,2,10,True
2651578,622,4,451,9405,753984993,1,0,0,805.85,7,671124.79,11,6,18,11,True
2734194,406,1,10,9488,753984993,1,0,0,806.15,0,671930.94,10,6,12,1,True
2982955,1412,2,20,9488,753984993,1,0,0,806.03,5,671124.91,24,4,14,2,True
3333306,64,0,10,1570,753984993,1,0,0,806.3,6,671931.21,20,5,2,3,True
3381020,398,0,20,6178,753984993,1,0,0,806.04,5,671125.17,10,2,3,3,True
3594658,622,4,-1,6873,753984993,1,1,0,805.94,4,671125.17,11,5,12,3,True
3897377,58,2,30,4266,753984993,1,0,0,805.95,8,670319.22,20,2,14,3,True
4243954,1304,0,30,2520,753984993,1,0,0,805.93,8,669513.29,5,4,22,5,True
4392501,65,3,-1,9488,753984993,1,1,0,806.04,4,669513.29,20,0,4,6,True
4401743,58,2,451,1334,753984993,1,0,0,806.0,7,668707.29,20,4,1,7,True
4639745,58,2,451,6303,753984993,1,0,0,805.94,7,667901.35,20,2,4,8,True
4779293,931,0,20,1510,753984993,1,0,0,805.92,5,667095.43,24,5,13,10,True
5061562,622,4,-1,6303,753984993,1,1,0,805.84,4,667095.43,11,0,17,11,True
5062532,1454,1,10,4056,753984993,1,0,0,806.24,6,667901.67,11,0,11,1,True
5139100,1304,0,30,1510,753984993,1,0,0,806.17,8,667095.5,5,3,10,2,False
5208248,1120,4,451,1334,753984993,1,0,0,806.05,7,666289.45,24,3,22,2,False
5298401,1120,4,30,4056,753984993,1,0,0,805.68,8,665483.77,24,3,21,3,True
5702381,1120,4,30,7284,753984993,1,0,0,806.08,8,664677.69,24,2,8,4,True
5722459,58,2,451,4556,753984993,1,0,0,805.91,7,663871.78,20,3,11,4,False
5811451,1120,4,451,7265,753984993,1,0,0,806.34,7,663065.44,24,4,4,4,True
5843891,58,2,25,7284,753984993,1,0,0,805.87,8,662259.57,20,5,18,4,True
6232465,1226,2,20,9993,753984993,1,0,0,805.63,5,661453.94,18,6,8,4,True
6327478,622,4,451,8058,753984993,1,0,0,806.15,7,660647.79,11,5,4,4,True
6574875,1397,4,30,8628,753984993,1,0,0,805.85,8,659841.94,24,3,20,5,True
7015128,135,2,20,1570,753984993,1,0,0,806.08,3,659035.86,18,2,18,5,True
7477038,626,2,20,8628,753984993,1,0,0,806.02,5,658229.84,11,0,1,6,True
7627050,1429,0,10,1300,753984993,1,0,0,805.99,6,659035.83,24,3,4,6,True
7726378,1304,0,451,9405,753984993,1,0,0,805.9,7,658229.93,5,0,2,6,True
7769289,1413,0,10,7284,753984993,1,0,0,805.79,0,659035.72,24,2,1,7,True
8639934,537,0,10,6750,753984993,1,0,0,806.15,0,659841.87,18,5,10,7,True
8741966,1397,4,30,9944,753984993,1,0,0,806.06,8,659035.81,24,3,22,7,True
8977713,780,0,20,9944,753984993,1,0,0,806.04,3,658229.77,14,0,4,7,True
9073531,424,1,10,4556,753984993,1,0,0,806.09,6,659035.86,18,1,18,8,False
9142712,65,3,451,4266,753984993,1,0,0,806.11,7,658229.75,20,6,6,9,True
9187883,622,4,30,4464,753984993,1,0,0,806.1,8,657423.65,11,1,17,9,False
9374899,622,4,25,1510,753984993,1,0,0,806.08,8,656617.57,11,6,4,9,False
9503498,58,2,-1,1510,753984993,1,1,0,806.07,1,656617.57,20,6,13,10,True
9700298,58,2,30,7238,753984993,1,0,0,805.94,8,655811.63,20,0,21,11,True
9943132,1120,4,30,4652,753984993,1,0,0,805.62,8,655006.01,24,5,5,11,True
1022566,812,0,10,3267,785612871,0,0,0,317.9,0,835282.9,18,5,14,1,False
1084529,1455,2,20,3946,785612871,0,0,0,318.03,5,834964.87,11,6,23,1,True
1106601,678,4,25,2089,785612871,0,0,0,317.88,8,834646.99,24,0,17,1,True
1161387,155,1,10,1966,785612871,0,0,0,317.86,6,834964.85,18,2,10,1,True
1195636,219,0,10,9054,785612871,0,0,0,317.99,6,835282.84,9,6,8,2,True
1324680,678,4,25,3431,785612871,0,0,0,318.17,8,834964.67,24,4,7,2,True
1329982,1150,0,10,9054,785612871,0,0,0,318.12,6,835282.79,15,3,8,3,True
1350086,201,1,25,7208,785612871,0,0,0,317.89,8,834964.9,9,1,20,3,True
1386104,676,4,25,2806,785612871,0,0,0,318.16,8,834646.74,24,0,22,3,True
1532222,72,4,30,3946,785612871,0,0,0,318.12,8,834328.62,20,0,15,4,True
1734375,996,0,30,9935,785612871,0,0,0,318.22,8,834010.4,26,3,21,4,True
1772822,303,0,20,9054,785612871,0,0,0,317.93,5,833692.47,4,1,22,4,True
1823707,126,1,10,7111,785612871,0,0,0,317.87,6,834010.34,18,4,17,5,True
1951596,712,0,10,9851,785612871,0,0,0,317.93,6,834328.27,18,4,18,5,True
2383840,676,4,-1,8331,785612871,0,1,0,318.08,1,834328.27,24,6,9,5,True
2572188,996,0,25,7111,785612871,0,0,0,318.18,8,834010.09,26,5,5,5,True
2687948,996,0,30,4949,785612871,0,0,0,318.1,8,833691.99,26,2,9,6,True
2754873,201,1,25,9149,785612871,0,0,0,318.26,8,833373.73,9,4,19,7,True
2828157,201,1,30,9026,785612871,0,0,0,317.94,8,833055.79,9,5,18,7,True
2835230,676,4,-1,5096,785612871,0,1,0,318.25,4,833055.79,24,2,4,8,True
3343047,72,4,451,2412,785612871,0,0,0,318.03,7,832737.76,20,5,3,8,True
3947316,676,4,25,1966,785612871,0,0,0,317.62,8,832420.14,24,5,17,10,True
3954098,72,4,451,4567,785612871,0,0,0,317.92,7,832102.22,20,2,10,12,True
4788359,676,4,-1,9851,785612871,0,1,0,318.02,4,832102.22,24,5,17,1,True
4796476,688,0,10,5592,785612871,0,0,0,317.84,0,832420.06,24,6,5,2,True
4946206,1110,0,20,3416,785612871,0,0,0,317.92,5,832102.14,0,4,7,3,True
5098663,777,3,30,5096,785612871,0,0,0,318.0,8,831784.14,14,1,12,3,True
5137681,611,0,30,5592,785612871,0,0,0,317.86,8,831466.28,11,3,17,3,True
5437558,796,2,20,2089,785612871,0,0,0,318.35,5,831147.93,11,5,18,4,True
5750381,1036,1,10,4949,785612871,0,0,0,317.98,6,831465.91,11,4,22,4,True
5776156,611,0,30,3267,785612871,0,0,0,317.9,8,831148.01,11,6,13,5,True
5934760,951,0,10,4567,785612871,0,0,0,317.9,6,831465.91,24,3,10,6,True
6010713,611,0,451,3202,785612871,0,0,0,318.12,7,831147.79,11,4,3,6,True
6034233,834,0,10,7111,785612871,0,0,0,318.07,6,831465.86,5,4,17,9,True
6078274,72,4,30,9190,785612871,0,0,0,318.11,8,831147.75,20,4,3,9,True
6096550,939,0,10,7902,785612871,0,0,0,317.82,6,831465.57,24,4,5,10,True
6251840,611,0,451,3946,785612871,0,0,0,318.03,7,831147.54,11,0,0,11,True
6326611,777,3,30,8331,785612871,0,0,0,318.08,8,830829.46,14,2,1,11,True
6415833,201,1,451,1887,785612871,0,0,0,318.17,7,830511.29,9,5,6,1,True
6434825,676,4,451,2323,785612871,0,0,0,317.98,7,830193.31,24,1,7,1,True
6753605,558,0,10,9149,785612871,0,0,0,318.06,6,830511.37,17,0,7,3,True
6776525,328,0,20,9026,785612871,0,0,0,317.93,3,830193.44,11,5,2,4,True
6825668,802,2,20,7111,785612871,0,0,0,317.87,3,829875.57,11,1,15,4,True
6881163,611,0,25,7775,785612871,0,0,0,317.87,8,829557.7,11,5,16,4,True
6882665,996,0,25,2412,785612871,0,0,0,318.1,8,829239.6,26,5,16,5,True
6929954,64,0,10,3202,785612871,0,0,0,317.95,0,829557.55,20,1,11,5,True
7149380,343,1,30,7902,785612871,0,0,0,317.8,8,829239.75,24,1,14,5,True
7184868,1137,1,10,2323,785612871,0,0,0,318.06,0,829557.81,24,6,6,6,True
7224856,996,0,451,4567,785612871,0,0,0,318.24,7,829239.57,26,4,21,7,True
7680735,678,4,30,3416,785612871,0,0,0,317.9,8,828921.67,24,0,23,7,True
8018133,1227,0,10,3946,785612871,0,0,0,317.86,6,829239.53,18,4,8,7,True
8069987,777,3,451,3416,785612871,0,0,0,318.2,7,828921.33,14,6,20,7,True
8125123,678,4,30,5096,785612871,0,0,0,318.16,8,828603.17,24,2,21,8,True
8379113,343,1,25,7775,785612871,0,0,0,317.98,8,828285.19,24,1,10,9,True
8411831,365,0,20,9054,785612871,0,0,0,318.09,5,827967.1,25,4,14,9,True
8666494,72,4,25,3431,785612871,0,0,0,318.06,8,827649.04,20,0,11,10,True
9235242,611,0,-1,5096,785612871,0,1,0,317.89,1,827649.04,11,0,2,11,False
9272274,676,4,451,7208,785612871,0,0,0,317.95,7,827331.09,24,0,14,11,True
9467083,611,0,451,7111,785612871,0,0,0,318.25,7,827012.84,11,0,16,11,True
1390724,594,0,20,2507,800454494,1,0,0,1013.12,5,313633.88,24,5,16,1,True
1492592,1041,0,451,8234,800454494,1,0,0,1012.93,7,312620.95,11,3,3,1,True
1964526,994,4,-1,8234,800454494,1,1,0,1013.09,4,312620.95,22,4,6,1,True
2493988,267,0,-1,7285,800454494,1,2,0,1012.83,4,312620.95,6,6,20,1,True
2517146,851,1,451,2475,800454494,1,0,0,1013.08,7,311607.87,5,6,8,1,True
3057987,549,1,30,5425,800454494,1,0,0,1013.08,8,310594.79,17,1,19,2,True
3083430,1041,0,451,4924,800454494,1,0,0,1012.82,7,309581.97,11,3,7,2,True
3192055,1249,2,20,7271,800454494,1,0,0,1012.91,3,308569.06,23,0,12,3,True
3513823,549,1,-1,5425,800454494,1,1,0,1013.01,1,308569.06,17,3,14,4,True
3599144,267,0,451,1577,800454494,1,0,0,1012.84,7,307556.22,6,3,16,4,True
3870884,994,4,25,3062,800454494,1,0,0,1012.9,8,306543.32,22,0,9,4,False
3934421,1089,0,20,8426,800454494,1,0,0,1012.8,3,305530.52,18,1,9,4,True
4279919,716,0,20,1119,800454494,1,0,0,1013.08,5,304517.44,18,0,22,5,True
4319337,994,4,451,4649,800454494,1,0,0,1013.07,7,303504.37,22,3,1,5,True
4413673,851,1,451,5425,800454494,1,0,0,1012.85,7,302491.52,5,0,9,5,True
4783824,467,0,20,5425,800454494,1,0,0,1013.14,3,301478.38,5,6,12,6,True
4822351,994,4,30,3095,800454494,1,0,0,1012.97,8,300465.41,22,1,11,7,True
4895877,549,1,451,7411,800454494,1,0,0,1013.17,7,299452.24,17,2,9,7,True
5243409,47,1,10,8234,800454494,1,0,0,1013.17,6,300465.41,24,2,21,8,True
5320802,373,1,10,4649,800454494,1,0,0,1013.0,0,301478.41,25,6,18,9,True
5381184,549,1,451,6650,800454494,1,0,0,1012.78,7,300465.63,17,3,15,9,True
5467914,851,1,-1,8642,800454494,1,1,0,1013.1,1,300465.63,5,4,16,10,True
5562874,549,1,30,5606,800454494,1,0,0,1013.11,8,299452.52,17,6,2,11,True
5808732,549,1,451,5914,800454494,1,0,0,1013.04,7,298439.48,17,3,6,12,True
5851355,994,4,451,3095,800454494,1,0,0,1013.11,7,297426.37,22,5,23,1,True
5890967,292,1,10,3062,800454494,1,0,0,1012.92,0,298439.29,4,4,20,2,True
5908287,267,0,30,6681,800454494,1,0,0,1013.15,8,297426.14,6,2,0,3,True
6085904,1210,0,20,2475,800454494,1,0,0,1012.92,5,296413.22,24,5,0,3,True
6242771,1412,2,20,7285,800454494,1,0,0,1012.95,5,295400.27,24,0,13,4,True
6284076,267,0,-1,5606,800454494,1,1,0,1012.72,1,295400.27,6,4,11,5,True
6731579,851,1,30,8602,800454494,1,0,0,1013.16,8,294387.11,5,3,11,6,True
6758950,994,4,451,6091,800454494,1,0,0,1012.96,7,293374.15,22,5,17,7,True
6854153,549,1,-1,1981,800454494,1,1,0,1012.94,1,293374.15,17,6,4,7,True
6878157,767,0,20,9732,800454494,1,0,0,1012.92,5,292361.23,14,4,16,8,True
7235219,851,1,25,3062,800454494,1,0,0,1012.78,8,291348.45,5,4,7,9,True
7328774,994,4,30,2475,800454494,1,0,0,1013.01,8,290335.44,22,2,6,9,True
7400609,1041,0,30,3826,800454494,1,0,0,1013.21,8,289322.23,11,5,0,9,True
7447757,267,0,-1,7271,800454494,1,1,0,1012.98,1,289322.23,6,3,5,9,True
7533095,267,0,451,1577,800454494,1,0,0,1013.21,7,288309.02,6,1,10,10,True
7605870,994,4,25,3949,800454494,1,0,0,1012.88,8,287296.14,22,5,22,10,True
7685324,1041,0,451,5914,800454494,1,0,0,1013.12,7,286283.02,11,6,17,11,True
7771299,1260,0,10,6091,800454494,1,0,0,1012.77,0,287295.79,23,4,23,11,True
7833128,994,4,25,4924,800454494,1,0,0,1012.99,8,286282.8,22,4,13,12,True
7985715,549,1,25,1119,800454494,1,0,0,1013.07,8,285269.73,17,2,10,1,True
8255837,267,0,451,7411,800454494,1,0,0,1012.9,7,284256.83,6,2,1,1,True
8273847,599,0,20,6091,800454494,1,0,0,1013.32,5,283243.51,24,5,14,2,True
8385856,1205,0,10,9732,800454494,1,0,0,1013.06,0,284256.57,24,2,2,3,True
8408157,851,1,25,1981,800454494,1,0,0,1013.5,8,283243.07,5,4,17,6,True
8694571,994,4,451,6650,800454494,1,0,0,1013.08,7,282229.99,22,0,11,7,True
8748542,549,1,451,3826,800454494,1,0,0,1013.04,7,281216.95,17,6,18,7,False
8754058,1041,0,25,2507,800454494,1,0,0,1013.05,8,280203.9,11,6,20,7,True
9240586,267,0,451,2570,800454494,1,0,0,1012.97,7,279190.93,6,1,5,8,True
9266136,267,0,30,5490,800454494,1,0,0,1012.89,8,278178.04,6,1,1,8,True
9599816,549,1,451,5490,800454494,1,0,0,1013.0,7,277165.04,17,1,0,9,True
9889976,792,1,10,4649,800454494,1,0,0,1012.85,0,278177.89,11,1,9,9,True
9948420,549,1,30,9218,800454494,1,0,0,1013.01,8,277164.88,17,3,5,9,True
9978124,851,1,-1,6650,800454494,1,1,0,1012.98,4,277164.88,5,4,16,10,True
1226847,1285,1,25,5061,241464203,1,0,0,673.0,8,333005.0,24,3,12,3,True
1230782,818,1,30,4416,241464203,1,0,0,672.75,8,332332.25,18,6,22,3,True
1293524,913,0,20,8258,241464203,1,0,0,673.27,3,331658.98,18,2,8,3,True
1423963,1419,1,30,7625,241464203,1,0,0,673.01,8,330985.97,24,0,12,4,True
1830558,1443,4,30,3583,241464203,1,0,0,672.93,8,330313.04,24,6,21,5,True
1923666,1419,1,25,1106,241464203,1,0,0,672.97,8,329640.07,24,5,21,5,True
2097346,309,0,20,7625,241464203,1,0,0,673.01,3,328967.06,4,2,6,5,True
2247822,164,4,451,1746,241464203,1,0,0,673.11,7,328293.95,24,0,3,6,True
2251612,1443,4,30,2919,241464203,1,0,0,672.94,8,327621.01,24,3,20,6,True
2365470,1272,0,451,4416,241464203,1,0,0,672.94,7,326948.07,24,3,17,9,True
2577274,1285,1,30,8180,241464203,1,0,0,673.02,8,326275.05,24,4,11,9,True
2739413,818,1,451,2778,241464203,1,0,0,672.84,7,325602.21,18,3,21,10,True
2796163,664,2,451,8549,241464203,1,0,0,673.37,7,324928.84,18,0,4,10,True
2818256,628,0,10,3996,241464203,1,0,0,673.08,6,325601.92,11,5,18,10,True
2871452,1126,4,451,1054,241464203,1,0,0,673.08,7,324928.84,24,1,0,12,True
2984921,1285,1,-1,2158,241464203,1,1,0,673.12,4,324928.84,24,4,17,1,True
3131034,1419,1,30,5061,241464203,1,0,0,672.88,8,324255.96,24,0,10,1,True
3151804,164,4,30,1714,241464203,1,0,0,673.01,8,323582.95,24,2,12,2,True
3219697,471,0,10,2930,241464203,1,0,0,672.84,6,324255.79,5,2,6,2,True
3439869,164,4,-1,6530,241464203,1,1,0,673.05,4,324255.79,24,5,10,2,True
3743309,58,2,20,8774,241464203,1,0,0,673.04,3,323582.75,20,0,23,5,True
4637439,1272,0,451,8865,241464203,1,0,0,673.09,7,322909.66,24,6,23,7,True
4700024,664,2,25,6709,241464203,1,0,0,673.02,8,322236.64,18,3,11,8,True
4871640,1443,4,-1,7925,241464203,1,1,0,672.75,4,322236.64,24,6,17,8,True
5034226,1443,4,25,2930,241464203,1,0,0,673.13,8,321563.51,24,5,0,8,True
5111791,1419,1,30,3583,241464203,1,0,0,673.17,8,320890.34,24,1,14,8,True
5150111,664,2,451,1746,241464203,1,0,0,673.08,7,320217.26,18,3,3,9,True
5259057,1272,0,451,1746,241464203,1,0,0,672.78,7,319544.48,24,5,0,9,True
5451778,965,4,451,5573,241464203,1,0,0,673.23,7,318871.25,13,5,21,9,True
5696255,1126,4,-1,1746,241464203,1,1,0,672.95,4,318871.25,24,5,13,10,False
5915091,1419,1,25,1980,241464203,1,0,0,673.32,8,318197.93,24,6,13,10,True
6021602,1443,4,30,8865,241464203,1,0,0,672.85,8,317525.08,24,3,9,10,True
6116236,1436,0,20,8258,241464203,1,0,0,673.4,5,316851.68,24,5,19,10,True
6487937,965,4,451,1714,241464203,1,0,0,672.98,7,316178.7,13,2,11,11,True
6677218,1124,0,10,3651,241464203,1,0,0,672.84,6,316851.54,24,4,5,11,True
6715438,1419,1,25,8549,241464203,1,0,0,672.82,8,316178.72,24,4,7,12,True
6766952,807,0,10,8180,241464203,1,0,0,672.95,0,316851.67,11,4,21,12,True
7077272,577,0,10,1054,241464203,1,0,0,672.79,0,317524.46,11,5,7,12,True
7353908,1285,1,30,7925,241464203,1,0,0,672.81,8,316851.65,24,3,23,1,True
7762757,965,4,30,2930,241464203,1,0,0,672.97,8,316178.68,13,3,4,1,True
8013098,254,0,20,1054,241464203,1,0,0,673.1,5,315505.58,6,1,22,1,True
8050121,1443,4,451,1980,241464203,1,0,0,673.03,7,314832.55,24,3,8,2,True
8270217,1443,4,451,2930,241464203,1,0,0,673.05,7,314159.5,24,2,14,3,False
8289841,1288,0,20,6709,241464203,1,0,0,673.11,5,313486.39,24,2,2,4,True
8687241,1152,0,10,3996,241464203,1,0,0,672.96,6,314159.35,15,3,0,5,True
9122525,1126,4,25,2919,241464203,1,0,0,673.0,8,313486.35,24,0,17,5,True
9220142,1285,1,451,5573,241464203,1,0,0,673.29,7,312813.06,24,1,23,5,True
9266605,965,4,-1,6530,241464203,1,1,0,672.94,4,312813.06,13,1,3,9,True
9572883,818,1,30,7625,241464203,1,0,0,672.84,8,312140.22,18,0,7,9,True
9574862,965,4,451,2104,241464203,1,0,0,673.05,7,311467.17,13,4,0,10,True
9870109,1419,1,25,1980,241464203,1,0,0,672.75,8,310794.42,24,2,2,10,True
9976289,818,1,451,7625,241464203,1,0,0,672.97,7,310121.45,18,2,4,10,True
1040166,579,0,451,2849,142776076,0,0,0,1048.84,7,302753.16,11,5,7,1,True
1174064,132,2,20,4685,142776076,0,0,0,1048.89,5,301704.27,18,6,16,1,True
1276160,732,0,20,3726,142776076,0,0,0,1049.02,5,300655.25,11,5,17,1,True
1305178,620,3,25,2606,142776076,0,0,0,1049.0,8,299606.25,11,2,17,1,True
1479020,203,0,20,7355,142776076,0,0,0,1048.91,3,298557.34,9,2,8,2,True
1724374,579,0,451,8660,142776076,0,0,0,1049.16,7,297508.18,11,1,2,4,True
1863127,1050,4,25,8742,142776076,0,0,0,1048.98,8,296459.2,11,0,15,4,True
1908478,1325,0,10,6525,142776076,0,0,0,1048.73,6,297507.93,18,5,12,6,True
2069008,148,1,10,6492,142776076,0,0,0,1049.09,0,298557.02,18,4,2,6,True
2472639,620,3,25,7431,142776076,0,0,0,1048.94,8,297508.08,11,2,6,6,True
2482382,776,3,30,7431,142776076,0,0,0,1048.97,8,296459.11,14,4,10,7,True
2672938,776,3,451,4685,142776076,0,0,0,1049.15,7,295409.96,14,3,6,8,True
2722514,535,0,20,8921,142776076,0,0,0,1048.8,5,294361.16,18,5,15,8,True
2893166,1050,4,25,8769,142776076,0,0,0,1049.09,8,293312.07,11,1,18,8,True
3008680,776,3,25,8769,142776076,0,0,0,1049.32,8,292262.75,14,4,0,9,True
3750734,620,3,25,5154,142776076,0,0,0,1048.98,8,291213.77,11,6,22,9,True
4009381,935,1,25,8660,142776076,0,0,0,1049.32,8,290164.45,24,2,17,10,True
4111297,824,2,20,7355,142776076,0,0,0,1049.2,5,289115.25,18,1,1,11,True
4171489,525,0,20,8679,142776076,0,0,0,1049.1,3,288066.15,18,3,18,11,True
4281838,1063,0,10,6933,142776076,0,0,0,1049.22,6,289115.37,11,5,13,11,True
4361189,579,0,451,6372,142776076,0,0,0,1048.95,7,288066.42,11,0,19,11,True
4570405,780,0,10,3951,142776076,0,0,0,1048.86,0,289115.28,14,0,7,12,True
4690178,318,0,20,4097,142776076,0,0,0,1049.03,3,288066.25,11,4,8,12,True
4747197,620,3,30,8660,142776076,0,0,0,1049.24,8,287017.01,11,3,2,12,True
5185129,130,0,20,6933,142776076,0,0,0,1048.96,5,285968.05,18,6,3,2,True
5230713,1474,0,20,8706,142776076,0,0,0,1049.28,5,284918.77,24,3,16,2,False
5342905,776,3,451,4910,142776076,0,0,0,1048.93,7,283869.84,14,5,1,4,True
5520473,1288,0,10,3788,142776076,0,0,0,1048.93,0,284918.77,24,3,18,4,True
5541094,958,2,20,3788,142776076,0,0,0,1049.03,5,283869.74,13,5,20,5,True
5669122,583,2,20,3788,142776076,0,0,0,1049.39,3,282820.35,11,6,0,7,True
5853009,620,3,451,9452,142776076,0,0,0,1048.76,7,281771.59,11,3,15,8,True
6093394,776,3,30,6933,142776076,0,0,0,1048.85,8,280722.74,14,0,7,8,False
6296407,776,3,30,8027,142776076,0,0,0,1048.96,8,279673.78,14,3,0,9,True
6467042,776,3,30,5432,142776076,0,0,0,1049.11,8,278624.67,14,6,23,10,True
6711567,579,0,-1,8769,142776076,0,1,0,1048.69,4,278624.67,11,2,2,10,False
6876074,935,1,30,8921,142776076,0,0,0,1048.98,8,277575.69,24,2,22,10,True
7547612,776,3,30,6933,142776076,0,0,0,1048.87,8,276526.82,14,3,16,11,True
7584415,935,1,451,4097,142776076,0,0,0,1048.72,7,275478.1,24,4,8,12,False
7682012,1050,4,30,8769,142776076,0,0,0,1048.96,8,274429.14,11,0,20,12,True
7714976,512,0,20,4097,142776076,0,0,0,1048.91,5,273380.23,12,2,18,1,True
7797787,41,2,20,4097,142776076,0,0,0,1048.89,3,272331.34,11,5,13,3,True
7937913,1050,4,451,7355,142776076,0,0,0,1049.03,7,271282.31,11,5,11,3,True
7940938,776,3,30,4685,142776076,0,0,0,1048.69,8,270233.62,14,5,18,3,True
8302439,620,3,451,6372,142776076,0,0,0,1048.94,7,269184.68,11,1,19,3,True
8562928,935,1,25,5222,142776076,0,0,0,1049.12,8,268135.56,24,5,15,3,True
8612311,1050,4,451,7939,142776076,0,0,0,1049.01,7,267086.55,11,5,13,4,True
8782248,935,1,25,4685,142776076,0,0,0,1048.88,8,266037.67,24,0,12,4,True
8811854,935,1,30,3310,142776076,0,0,0,1049.1,8,264988.57,24,2,4,5,True
9129338,579,0,30,5222,142776076,0,0,0,1049.3,8,263939.27,11,1,7,6,True
9314848,620,3,25,6525,142776076,0,0,0,1048.52,8,262890.75,11,6,16,6,False
9340755,620,3,25,2606,142776076,0,0,0,1049.13,8,261841.62,11,2,17,7,True
9390394,935,1,451,8921,142776076,0,0,0,1049.19,7,260792.43,24,4,16,8,True
9514326,620,3,451,5222,142776076,0,0,0,1048.97,7,259743.46,11,1,12,8,False
9520554,935,1,-1,8679,142776076,0,1,0,1049.3,4,259743.46,24,4,15,9,False
9664976,620,3,-1,8027,142776076,0,2,0,1049.08,1,259743.46,11,1,17,9,True
1107478,291,3,25,1256,731906429,1,0,0,377.98,8,560597.02,24,4,21,1,True
1163899,652,0,451,7688,731906429,1,0,0,378.02,7,560219.0,24,1,19,2,True
1237424,642,0,20,9762,731906429,1,0,0,377.92,3,559841.08,24,2,7,2,True
1460647,291,3,451,7226,731906429,1,0,0,377.63,7,559463.45,24,0,4,2,False
1582337,137,2,20,7966,731906429,1,0,0,378.07,5,559085.38,18,4,7,3,True
1951820,291,3,30,7188,731906429,1,0,0,378.01,8,558707.37,24,0,5,3,True
1987296,375,4,25,4898,731906429,1,0,0,377.86,8,558329.51,25,4,15,4,True
2161185,1349,3,451,5030,731906429,1,0,0,378.1,7,557951.41,24,0,2,4,True
2232662,1179,0,20,8552,731906429,1,0,0,377.91,5,557573.5,24,2,22,4,True
2396240,291,3,30,8552,731906429,1,0,0,378.01,8,557195.49,24,0,14,5,True
2793778,1349,3,25,5887,731906429,1,0,0,377.93,8,556817.56,24,5,1,5,True
2851243,291,3,451,5030,731906429,1,0,0,378.03,7,556439.53,24,5,6,6,True
2930864,465,0,10,8713,731906429,1,0,0,378.25,0,556817.78,13,0,20,6,True
2972769,913,0,10,3348,731906429,1,0,0,377.94,6,557195.72,18,0,18,7,True
3046148,729,0,20,2071,731906429,1,0,0,378.02,3,556817.7,11,6,5,7,True
3102371,816,0,451,4898,731906429,1,0,0,377.92,7,556439.78,18,2,7,8,True
3202396,1215,3,30,1256,731906429,1,0,0,377.93,8,556061.85,24,5,21,11,True
3280996,375,4,451,2464,731906429,1,0,0,377.71,7,555684.14,25,1,16,11,True
3444145,956,1,10,8713,731906429,1,0,0,377.96,6,556062.1,13,5,7,12,True
3733265,774,2,20,3348,731906429,1,0,0,377.97,5,555684.13,14,6,5,12,True
3782212,375,4,451,8552,731906429,1,0,0,378.1,7,555306.03,25,3,15,12,True
3833735,1063,0,20,5887,731906429,1,0,0,378.04,5,554927.99,11,3,10,1,True
3862446,1065,0,20,5293,731906429,1,0,0,377.95,3,554550.04,11,4,18,1,True
3926450,341,0,20,7226,731906429,1,0,0,378.16,5,554171.88,24,5,11,1,True
3930220,375,4,30,4898,731906429,1,0,0,378.07,8,553793.81,25,6,18,3,True
4168529,611,0,451,7966,731906429,1,0,0,377.89,7,553415.92,11,2,2,3,True
4234331,1215,3,30,7188,731906429,1,0,0,377.87,8,553038.05,24,5,4,3,True
4528137,816,0,30,3597,731906429,1,0,0,377.98,8,552660.07,18,6,16,3,True
4578349,149,2,20,8552,731906429,1,0,0,377.84,5,552282.23,18,2,23,4,True
4882045,816,0,451,5030,731906429,1,0,0,377.97,7,551904.26,18,6,8,4,True
4921634,291,3,25,7688,731906429,1,0,0,377.82,8,551526.44,24,2,4,5,True
5401367,1486,2,20,4898,731906429,1,0,0,378.12,5,551148.32,24,2,9,9,True
5508955,611,0,451,7688,731906429,1,0,0,378.17,7,550770.15,11,6,14,9,True
5877799,652,0,-1,7688,731906429,1,1,0,378.12,4,550770.15,24,0,7,10,True
5902440,1349,3,-1,5293,731906429,1,2,0,377.77,4,550770.15,24,3,7,11,True
5918762,1215,3,30,3813,731906429,1,0,0,377.74,8,550392.41,24,3,10,11,True
6057724,1215,3,451,7188,731906429,1,0,0,378.46,7,550013.95,24,4,19,11,True
6103357,132,2,20,7188,731906429,1,0,0,377.99,3,549635.96,18,3,11,11,True
6325259,1215,3,-1,1256,731906429,1,1,0,378.35,4,549635.96,24,2,7,11,True
6490906,816,0,25,1256,731906429,1,0,0,378.01,8,549257.95,18,2,0,11,True
6773381,291,3,30,1256,731906429,1,0,0,377.93,8,548880.02,24,4,12,12,True
6994275,291,3,451,8713,731906429,1,0,0,378.17,7,548501.85,24,6,4,1,True
7003733,816,0,30,2071,731906429,1,0,0,377.88,8,548123.97,18,4,14,2,True
7159951,149,2,25,1256,731906429,1,0,0,377.72,8,547746.25,18,4,10,2,True
7337493,346,0,10,9762,731906429,1,0,0,377.92,6,548124.17,24,5,19,4,True
7379659,1215,3,451,8097,731906429,1,0,0,377.96,7,547746.21,24,3,5,4,True
7423568,291,3,451,4688,731906429,1,0,0,377.73,7,547368.48,24,4,11,5,True
7719412,291,3,30,7688,731906429,1,0,0,377.98,8,546990.5,24,0,17,5,True
7786617,149,2,-1,8552,731906429,1,1,0,377.77,4,546990.5,18,0,5,5,True
8210461,816,0,30,5030,731906429,1,0,0,378.05,8,546612.45,18,6,13,6,True
8210829,1349,3,451,8713,731906429,1,0,0,377.84,7,546234.61,24,3,11,7,True
8429825,375,4,451,9762,731906429,1,0,0,377.96,7,545856.65,25,6,14,7,True
8843743,652,0,30,7688,731906429,1,0,0,378.16,8,545478.49,24,2,6,9,True
9029375,291,3,-1,2071,731906429,1,1,0,377.97,1,545478.49,24,6,20,9,True
9217577,149,2,25,4898,731906429,1,0,0,377.98,8,545100.51,18,5,5,10,True
9535793,688,0,20,3597,731906429,1,0,0,378.24,3,544722.27,24,3,9,11,True
9545062,652,0,-1,3813,731906429,1,1,0,377.85,4,544722.27,24,4,7,11,True
9552621,149,2,25,8623,731906429,1,0,0,378.01,8,544344.26,18,4,13,11,False
1090803,292,1,10,4908,505457889,1,0,0,1037.78,6,678894.78,4,0,10,1,True
1186261,584,0,20,3502,505457889,1,0,0,1038.09,3,677856.69,11,2,6,4,True
1288977,274,1,30,5883,505457889,1,0,0,1038.11,8,676818.58,24,3,2,5,True
1327003,199,0,20,1977,505457889,1,0,0,1038.22,3,675780.36,18,6,13,5,True
1329968,977,4,451,3502,505457889,1,0,0,1037.74,7,674742.62,22,5,16,6,True
1344187,416,2,451,9336,505457889,1,0,0,1037.99,7,673704.63,18,5,1,7,True
1527134,1037,0,20,3589,505457889,1,0,0,1038.08,5,672666.55,11,1,3,8,True
1721386,551,0,20,6924,505457889,1,0,0,1037.78,5,671628.77,17,2,7,8,True
1808465,253,2,25,6952,505457889,1,0,0,1038.1,8,670590.67,6,1,0,9,True
2208646,1033,4,30,4908,505457889,1,0,0,1038.14,8,669552.53,11,4,21,9,True
2284490,1379,3,451,7085,505457889,1,0,0,1037.86,7,668514.67,16,1,12,10,True
2337482,253,2,451,4487,505457889,1,0,0,1037.93,7,667476.74,6,2,13,10,True
2609695,851,1,10,3502,505457889,1,0,0,1037.93,0,668514.67,5,6,7,10,True
2659400,253,2,30,1977,505457889,1,0,0,1037.96,8,667476.71,6,6,17,10,True
2835898,1467,0,20,6101,505457889,1,0,0,1037.93,3,666438.78,11,5,7,11,True
2925346,652,0,10,3502,505457889,1,0,0,1037.89,6,667476.67,24,0,12,11,True
2960205,945,1,-1,6924,505457889,1,1,0,1038.29,4,667476.67,24,1,9,11,True
3119370,274,1,25,9131,505457889,1,0,0,1038.24,8,666438.43,24,0,16,11,True
3260595,594,0,20,1977,505457889,1,0,0,1037.71,3,665400.72,24,5,23,12,True
3491262,945,1,30,2395,505457889,1,0,0,1037.86,8,664362.86,24,3,4,12,True
3671693,416,2,451,5883,505457889,1,0,0,1037.76,7,663325.1,18,2,7,1,True
3804757,471,0,20,3589,505457889,1,0,0,1037.76,5,662287.34,5,2,18,2,True
3831722,274,1,451,1539,505457889,1,0,0,1038.26,7,661249.08,24,2,6,3,True
4151903,945,1,-1,6303,505457889,1,1,0,1038.21,4,661249.08,24,4,19,3,True
4305361,274,1,-1,4487,505457889,1,2,0,1037.74,1,661249.08,24,0,4,4,True
4819468,274,1,25,2395,505457889,1,0,0,1037.99,8,660211.09,24,1,4,5,True
4912361,1364,0,10,9336,505457889,1,0,0,1037.99,6,661249.08,16,2,6,5,True
4917901,1033,4,451,4908,505457889,1,0,0,1038.21,7,660210.87,11,6,4,6,True
4994315,416,2,-1,5883,505457889,1,1,0,1038.14,4,660210.87,18,4,19,6,True
5585421,977,4,-1,5883,505457889,1,2,0,1038.07,1,660210.87,22,1,15,7,True
5593280,1033,4,451,6924,505457889,1,0,0,1037.98,7,659172.89,11,5,12,8,True
5751919,977,4,-1,6101,505457889,1,1,0,1037.88,1,659172.89,22,3,19,10,True
5804508,1033,4,451,8568,505457889,1,0,0,1037.83,7,658135.06,11,5,20,10,True
5900486,1379,3,451,9131,505457889,1,0,0,1037.9,7,657097.16,16,4,6,10,True
6115018,416,2,451,6303,505457889,1,0,0,1037.82,7,656059.34,18,5,2,10,True
6124957,416,2,451,1539,505457889,1,0,0,1037.8,7,655021.54,18,4,3,11,True
6150588,116,0,20,3502,505457889,1,0,0,1037.81,3,653983.73,3,1,4,11,True
6327805,804,0,451,6303,505457889,1,0,0,1037.99,7,652945.74,11,1,15,12,True
6528222,512,0,10,3502,505457889,1,0,0,1038.2,6,653983.94,12,1,2,12,True
7046581,274,1,451,2395,505457889,1,0,0,1037.85,7,652946.09,24,5,19,1,True
7338032,346,0,20,7603,505457889,1,0,0,1037.84,5,651908.25,24,4,22,1,False
7379369,945,1,30,1539,505457889,1,0,0,1038.18,8,650870.07,24,1,22,2,True
7417349,1379,3,25,3589,505457889,1,0,0,1038.22,8,649831.85,16,1,20,3,True
7465986,1379,3,-1,5883,505457889,1,1,0,1037.84,1,649831.85,16,3,19,3,True
7491558,274,1,-1,1977,505457889,1,2,0,1038.0,1,649831.85,24,5,3,4,False
7561223,416,2,451,5883,505457889,1,0,0,1037.79,7,648794.06,18,3,3,4,True
7844296,274,1,25,3502,505457889,1,0,0,1037.98,8,647756.08,24,3,11,5,True
8431244,274,1,-1,9336,505457889,1,1,0,1037.91,1,647756.08,24,2,17,6,True
8880640,804,0,-1,7603,505457889,1,2,0,1037.77,1,647756.08,11,6,5,7,True
8914474,945,1,25,3589,505457889,1,0,0,1037.89,8,646718.19,24,2,17,7,True
8946551,530,0,10,3502,505457889,1,0,0,1038.09,6,647756.28,18,5,0,7,True
9215306,1379,3,451,6101,505457889,1,0,0,1037.96,7,646718.32,16,5,14,8,True
9292987,253,2,451,6101,505457889,1,0,0,1038.0,7,645680.32,6,5,17,9,False
9582442,1033,4,451,9044,505457889,1,0,0,1038.05,7,644642.27,11,5,15,10,True
9740513,348,0,10,4929,505457889,1,0,0,1038.07,6,645680.34,24,0,3,10,True
9853118,1233,0,10,1539,505457889,1,0,0,1038.05,6,646718.39,18,1,0,10,True
9892150,854,0,10,6101,505457889,1,0,0,1038.05,6,647756.44,24,3,1,11,True
9973862,416,2,-1,9336,505457889,1,1,0,1038.21,4,647756.44,18,0,1,11,False
1064382,22,3,451,4466,569977786,0,0,0,253.03,7,493174.97,11,1,4,1,True
1665759,573,0,10,1751,569977786,0,0,0,252.89,6,493427.86,11,4,19,1,False
1974089,1393,3,25,5837,569977786,0,0,0,253.11,8,493174.75,24,4,8,3,True
1992627,1336,2,20,3975,569977786,0,0,0,252.94,5,492921.81,18,6,6,4,True
2209452,1061,2,451,9445,569977786,0,0,0,252.72,7,492669.09,11,3,1,4,True
2288678,410,4,451,1842,569977786,0,0,0,252.8,7,492416.29,18,4,18,4,True
2349121,410,4,30,8050,569977786,0,0,0,253.38,8,492162.91,18,4,15,5,True
2421109,1123,2,20,3975,569977786,0,0,0,252.68,5,491910.23,24,5,2,5,True
2544117,942,0,10,3182,569977786,0,0,0,252.86,6,492163.09,24,5,6,6,True
2583202,398,0,20,1581,569977786,0,0,0,253.08,5,491910.01,10,2,19,6,True
2925966,22,3,451,3182,569977786,0,0,0,252.93,7,491657.08,11,5,19,7,True
3036182,22,3,25,9624,569977786,0,0,0,253.13,8,491403.95,11,0,18,7,True
3235697,364,4,-1,9624,569977786,0,1,0,253.04,4,491403.95,25,6,8,8,True
3246999,1061,2,451,1581,569977786,0,0,0,253.33,7,491150.62,11,6,10,8,True
3335656,1393,3,-1,1751,569977786,0,1,0,253.03,1,491150.62,24,3,0,9,True
3834641,364,4,451,6972,569977786,0,0,0,253.19,7,490897.43,25,0,18,10,True
3890544,1000,0,10,5837,569977786,0,0,0,252.99,0,491150.42,26,6,14,12,True
3965967,1125,1,10,5660,569977786,0,0,0,253.04,6,491403.46,24,2,17,12,True
4394032,476,1,10,5504,569977786,0,0,0,253.01,0,491656.47,5,2,1,1,True
4423409,22,3,25,1033,569977786,0,0,0,253.13,8,491403.34,11,1,16,1,True
4708707,410,4,-1,2675,569977786,0,1,0,253.09,1,491403.34,18,0,23,1,True
4765403,21,0,10,8050,569977786,0,0,0,252.72,0,491656.06,11,5,18,3,True
4935626,1061,2,451,3182,569977786,0,0,0,252.81,7,491403.25,11,6,12,3,True
4950118,22,3,451,1696,569977786,0,0,0,253.09,7,491150.16,11,4,19,4,True
4963042,1037,0,20,9445,569977786,0,0,0,252.72,5,490897.44,11,4,8,5,True
5102884,1061,2,451,4293,569977786,0,0,0,252.92,7,490644.52,11,0,17,6,True
5200504,22,3,451,7770,569977786,0,0,0,252.77,7,490391.75,11,2,8,6,True
5221321,1393,3,-1,5660,569977786,0,1,0,253.04,4,490391.75,24,1,14,6,True
5260767,1061,2,30,3502,569977786,0,0,0,253.1,8,490138.65,11,2,16,7,True
5273988,1393,3,-1,1033,569977786,0,1,0,252.99,1,490138.65,24,1,22,8,True
5409943,364,4,-1,3408,569977786,0,2,0,252.96,4,490138.65,25,5,4,8,True
5552960,334,0,20,2675,569977786,0,0,0,253.11,3,489885.54,11,3,22,8,True
5819601,1075,0,20,1448,569977786,0,0,0,253.01,5,489632.53,18,3,11,9,True
5999947,22,3,25,4293,569977786,0,0,0,252.84,8,489379.69,11,6,3,10,True
6032019,364,4,-1,3975,569977786,0,1,0,252.86,4,489379.69,25,1,7,10,True
6305819,1393,3,451,8050,569977786,0,0,0,252.64,7,489127.05,24,1,11,12,True
6438701,22,3,451,5837,569977786,0,0,0,252.99,7,488874.06,11,6,21,1,True
6648558,1061,2,-1,8093,569977786,0,1,0,253.15,4,488874.06,11,0,18,1,True
6831714,1019,0,20,4764,569977786,0,0,0,253.01,5,488621.05,26,3,12,3,True
6892606,1393,3,30,1033,569977786,0,0,0,253.23,8,488367.82,24,1,21,3,True
7018118,980,1,10,7770,569977786,0,0,0,253.03,6,488620.85,22,2,15,3,True
7265397,364,4,25,2675,569977786,0,0,0,253.06,8,488367.79,25,4,5,4,True
7509671,1094,0,10,4801,569977786,0,0,0,252.71,6,488620.5,0,3,4,4,True
8634488,1164,0,10,1033,569977786,0,0,0,253.0,0,488873.5,24,6,21,4,True
8652571,364,4,25,9975,569977786,0,0,0,252.98,8,488620.52,25,3,13,4,True
8720827,364,4,25,2675,569977786,0,0,0,252.95,8,488367.57,25,1,11,5,True
8722013,1061,2,-1,4293,569977786,0,1,0,252.97,4,488367.57,11,4,23,5,True
8959950,1393,3,25,8050,569977786,0,0,0,253.04,8,488114.53,24,1,1,6,True
9086750,1390,0,10,1696,569977786,0,0,0,252.97,6,488367.5,24,5,3,6,True
9255777,1393,3,30,8340,569977786,0,0,0,252.93,8,488114.57,24,5,6,7,True
9356399,364,4,25,6022,569977786,0,0,0,253.18,8,487861.39,25,0,3,7,True
9652040,410,4,25,6132,569977786,0,0,0,252.69,8,487608.7,18,3,18,8,True
9726717,364,4,451,8500,569977786,0,0,0,253.05,7,487355.65,25,4,9,9,True
1070122,529,2,20,2534,296726164,0,0,0,254.42,3,811517.58,18,6,23,2,True
1211165,639,4,30,9741,296726164,0,0,0,254.12,8,811263.46,24,0,4,2,True
1250613,1094,0,451,1713,296726164,0,0,0,253.64,7,811009.82,0,6,0,3,True
1325040,394,0,10,4780,296726164,0,0,0,254.26,6,811264.08,10,3,23,3,True
1335465,974,3,30,3464,296726164,0,0,0,254.02,8,811010.06,22,3,19,4,True
1420365,1254,4,451,9741,296726164,0,0,0,254.08,7,810755.98,23,5,13,4,True
1505064,1254,4,-1,2450,296726164,0,1,0,254.07,4,810755.98,23,0,7,6,True
1627613,149,2,451,3627,296726164,0,0,0,254.24,7,810501.74,18,6,8,10,True
1840024,887,2,20,3627,296726164,0,0,0,254.0,5,810247.74,27,3,6,10,True
2099574,482,1,10,6811,296726164,0,0,0,254.22,0,810501.96,5,0,15,10,True
2119814,325,0,10,2534,296726164,0,0,0,254.11,6,810756.07,11,2,19,11,True
2176061,404,1,10,4780,296726164,0,0,0,254.05,6,811010.12,10,0,11,11,True
2205592,639,4,30,1769,296726164,0,0,0,253.81,8,810756.31,24,0,20,11,True
2406382,218,0,451,2450,296726164,0,0,0,254.03,7,810502.28,9,4,1,12,True
2575151,1254,4,451,9741,296726164,0,0,0,254.19,7,810248.09,23,5,4,12,True
2605401,120,4,-1,2534,296726164,0,1,0,254.09,1,810248.09,18,4,15,1,True
2736731,218,0,25,3464,296726164,0,0,0,253.98,8,809994.11,9,3,22,1,True
2779385,420,4,30,4826,296726164,0,0,0,253.79,8,809740.32,18,6,23,1,True
2888353,974,3,-1,1769,296726164,0,1,0,253.94,4,809740.32,22,2,0,1,True
2900323,1399,0,20,7670,296726164,0,0,0,253.89,3,809486.43,24,6,15,1,True
3102860,974,3,451,2512,296726164,0,0,0,254.18,7,809232.25,22,3,13,2,True
3208843,203,0,20,5804,296726164,0,0,0,254.09,3,808978.16,9,1,4,2,True
3217757,1474,0,10,1410,296726164,0,0,0,253.87,6,809232.03,24,2,22,3,True
4101533,420,4,25,4780,296726164,0,0,0,254.02,8,808978.01,18,1,16,5,True
4116682,149,2,25,4469,296726164,0,0,0,254.18,8,808723.83,18,3,16,6,True
4129089,404,1,10,5804,296726164,0,0,0,253.91,6,808977.74,10,1,5,7,True
4135092,1144,2,20,2512,296726164,0,0,0,254.02,5,808723.72,15,0,12,7,True
4483741,1254,4,-1,4689,296726164,0,1,0,254.1,4,808723.72,23,3,3,8,True
4529097,1254,4,-1,4767,296726164,0,2,0,254.13,4,808723.72,23,5,12,8,True
4572122,1219,1,10,1769,296726164,0,0,0,253.98,0,808977.7,24,3,11,9,True
4805545,218,0,-1,4689,296726164,0,1,0,253.86,1,808977.7,9,3,23,10,False
4951252,1428,1,10,6811,296726164,0,0,0,253.91,0,809231.61,24,5,20,11,True
4996755,120,4,30,4689,296726164,0,0,0,254.17,8,808977.44,18,3,10,11,True
5316723,120,4,451,8934,296726164,0,0,0,254.03,7,808723.41,18,5,2,11,True
5463178,761,2,20,3627,296726164,0,0,0,254.06,5,808469.35,24,6,7,11,True
5601456,1254,4,451,7670,296726164,0,0,0,253.99,7,808215.36,23,1,5,12,True
5815636,1399,0,20,5804,296726164,0,0,0,254.31,5,807961.05,24,5,11,12,True
6011870,420,4,25,2512,296726164,0,0,0,253.84,8,807707.21,18,1,18,12,True
6027620,168,0,20,9273,296726164,0,0,0,254.14,5,807453.07,24,3,5,12,True
6045737,639,4,451,7488,296726164,0,0,0,254.0,7,807199.07,24,0,17,12,True
6516814,120,4,451,1410,296726164,0,0,0,253.76,7,806945.31,18,4,2,12,True
6550303,1455,2,20,4767,296726164,0,0,0,253.85,3,806691.46,11,5,8,1,True
6583821,639,4,25,9273,296726164,0,0,0,253.81,8,806437.65,24,6,0,1,True
6718819,1411,0,20,6811,296726164,0,0,0,253.94,5,806183.71,24,6,21,1,True
6757660,218,0,451,7488,296726164,0,0,0,253.92,7,805929.79,9,4,7,2,True
7065640,420,4,-1,4780,296726164,0,1,0,254.12,4,805929.79,18,5,12,2,True
7478843,974,3,30,8934,296726164,0,0,0,254.1,8,805675.69,22,4,0,3,True
7534431,974,3,451,1769,296726164,0,0,0,253.77,7,805421.92,22,4,16,4,True
7778495,218,0,30,4826,296726164,0,0,0,253.9,8,805168.02,9,1,11,4,True
7948550,1247,0,20,8934,296726164,0,0,0,253.99,3,804914.03,23,3,7,5,True
8009886,1254,4,-1,2450,296726164,0,1,0,253.99,1,804914.03,23,3,1,6,True
8353892,200,0,10,3627,296726164,0,0,0,253.81,6,805167.84,9,4,19,6,True
8443903,120,4,30,7670,296726164,0,0,0,254.07,8,804913.77,18,0,20,6,False
8680133,1092,1,10,3464,296726164,0,0,0,253.89,0,805167.66,18,4,14,7,True
8710731,120,4,451,1713,296726164,0,0,0,253.92,7,804913.74,18,4,18,8,True
8903698,120,4,30,6811,296726164,0,0,0,254.24,8,804659.5,18,3,23,8,True
9264795,990,0,10,2534,296726164,0,0,0,254.06,6,804913.56,22,3,7,10,True
9276823,628,0,20,9273,296726164,0,0,0,254.11,3,804659.45,11,6,20,10,True
9749370,1094,0,451,5289,296726164,0,0,0,253.77,7,804405.68,0,3,7,10,False
1077997,282,2,20,3976,210562394,1,0,0,348.97,3,226975.03,24,2,6,1,True
1202447,27,0,10,8168,210562394,1,0,0,349.06,0,227324.09,11,5,10,2,True
1262550,267,0,10,6057,210562394,1,0,0,348.8,6,227672.89,6,3,12,2,True
1313628,787,0,20,3663,210562394,1,0,0,348.97,5,227323.92,14,1,7,3,True
1376151,612,4,451,3663,210562394,1,0,0,349.25,7,226974.67,11,4,3,3,True
1425289,1361,2,-1,4555,210562394,1,1,0,348.7,4,226974.67,16,2,8,4,True
1802272,796,2,20,2428,210562394,1,0,0,349.14,5,226625.53,11,4,12,4,True
2088637,889,0,10,3084,210562394,1,0,0,348.86,6,226974.39,27,2,21,5,True
2122794,960,3,451,4362,210562394,1,0,0,349.26,7,226625.13,13,4,2,6,True
2158456,612,4,30,5413,210562394,1,0,0,349.13,8,226276.0,11,2,19,6,True
2320573,612,4,-1,7470,210562394,1,1,0,348.78,1,226276.0,11,6,8,6,True
2532839,1361,2,451,4574,210562394,1,0,0,348.97,7,225927.03,16,2,2,7,True
2630855,612,4,25,4555,210562394,1,0,0,349.12,8,225577.91,11,3,17,8,True
2645250,1361,2,451,1654,210562394,1,0,0,349.17,7,225228.74,16,1,5,9,True
3453110,1124,0,10,5432,210562394,1,0,0,349.12,6,225577.86,24,1,17,10,True
3472743,955,4,30,8243,210562394,1,0,0,349.14,8,225228.72,13,3,4,10,True
3517158,1439,4,25,5413,210562394,1,0,0,349.31,8,224879.41,24,1,19,10,True
4036501,612,4,25,6839,210562394,1,0,0,349.24,8,224530.17,11,3,5,12,True
4181259,960,3,30,5413,210562394,1,0,0,349.09,8,224181.08,13,2,10,1,True
4472080,465,0,20,8190,210562394,1,0,0,348.88,5,223832.2,13,4,16,1,True
4861317,960,3,25,6057,210562394,1,0,0,349.3,8,223482.9,13,0,7,1,True
4896534,955,4,451,3685,210562394,1,0,0,348.83,7,223134.07,13,6,8,2,True
4897036,1439,4,-1,3898,210562394,1,1,0,348.89,4,223134.07,24,1,16,2,True
4903657,955,4,25,6839,210562394,1,0,0,349.06,8,222785.01,13,0,3,2,True
5015245,820,1,10,3663,210562394,1,0,0,349.02,6,223134.03,18,5,2,3,True
5125796,1361,2,30,6839,210562394,1,0,0,348.96,8,222785.07,16,0,0,3,True
5216759,558,0,10,8190,210562394,1,0,0,349.22,6,223134.29,17,0,11,3,True
5395883,1439,4,30,1654,210562394,1,0,0,349.09,8,222785.2,24,2,11,5,True
5753161,955,4,25,4078,210562394,1,0,0,348.78,8,222436.42,13,6,10,6,True
5983816,612,4,-1,8168,210562394,1,1,0,349.05,4,222436.42,11,1,18,7,True
6027108,879,1,10,4362,210562394,1,0,0,349.27,0,222785.69,27,0,17,7,True
6043901,612,4,451,3685,210562394,1,0,0,349.01,7,222436.68,11,6,22,8,True
6176211,1192,2,20,2428,210562394,1,0,0,349.01,3,222087.67,24,1,8,8,True
7011189,612,4,451,4555,210562394,1,0,0,348.99,7,221738.68,11,1,20,8,True
7053469,267,0,20,6057,210562394,1,0,0,349.06,5,221389.62,6,2,0,10,True
7135178,1361,2,451,8190,210562394,1,0,0,348.73,7,221040.89,16,0,13,10,True
7198388,612,4,30,5432,210562394,1,0,0,349.0,8,220691.89,11,6,23,12,True
7478903,130,0,20,8168,210562394,1,0,0,348.91,3,220342.98,18,3,3,12,True
7635049,781,1,10,6839,210562394,1,0,0,348.97,6,220691.95,14,0,11,2,True
7699196,1361,2,30,4078,210562394,1,0,0,349.24,8,220342.71,16,4,12,2,True
7723301,1439,4,-1,7470,210562394,1,1,0,348.95,4,220342.71,24,3,23,3,True
7919323,612,4,451,2428,210562394,1,0,0,349.09,7,219993.62,11,0,19,3,True
8263410,612,4,451,6839,210562394,1,0,0,348.91,7,219644.71,11,0,22,3,False
8357253,960,3,451,8168,210562394,1,0,0,349.29,7,219295.42,13,2,6,4,True
8397570,955,4,-1,4574,210562394,1,1,0,348.97,4,219295.42,13,3,17,5,True
8530545,612,4,451,3685,210562394,1,0,0,348.99,7,218946.43,11,3,19,6,True
8667214,1361,2,-1,8168,210562394,1,1,0,348.68,1,218946.43,16,0,16,9,True
8814988,1388,1,10,6767,210562394,1,0,0,348.92,6,219295.35,24,5,23,10,True
8970800,612,4,-1,6429,210562394,1,1,0,348.94,1,219295.35,11,4,23,10,True
9198460,955,4,25,6767,210562394,1,0,0,348.82,8,218946.53,13,5,5,10,True
9267609,1289,1,10,1654,210562394,1,0,0,349.01,0,219295.54,24,3,16,10,True
9923591,612,4,30,1927,210562394,1,0,0,348.82,8,218946.72,11,1,13,11,True
1018209,655,3,30,3952,907588906,1,0,0,564.29,8,434047.71,18,0,18,5,False
1161708,860,1,30,5666,907588906,1,0,0,564.07,8,433483.64,24,5,14,6,True
1173740,378,0,451,3952,907588906,1,0,0,564.2,7,432919.44,25,0,22,7,False
1663974,1273,0,20,5092,907588906,1,0,0,564.2,5,432355.24,24,0,7,10,True
1698492,1179,0,20,7554,907588906,1,0,0,564.0,5,431791.24,24,3,14,2,True
1855991,378,0,25,1860,907588906,1,0,0,563.9,8,431227.34,25,3,17,2,True
2022007,1190,3,25,5761,907588906,1,0,0,564.17,8,430663.17,24,6,18,5,True
2252236,860,1,451,4369,907588906,1,0,0,564.07,7,430099.1,24,6,7,6,True
2455976,1110,0,10,3604,907588906,1,0,0,564.17,6,430663.27,0,6,6,7,True
2458589,1190,3,-1,4599,907588906,1,1,0,563.66,4,430663.27,24,5,1,3,True
2675404,1190,3,-1,5874,907588906,1,2,0,563.93,4,430663.27,24,5,22,4,True
2841194,860,1,-1,7554,907588906,1,3,1,564.05,1,430663.27,24,5,11,5,True
1010939,548,2,25,4310,645614101,0,0,0,951.95,8,681116.05,17,4,1,1,True
1086094,1186,2,25,5954,645614101,0,0,0,951.99,8,680164.06,24,0,19,2,True
1180867,548,2,30,3566,645614101,0,0,0,952.02,8,679212.04,17,1,22,2,True
1346072,379,4,451,8202,645614101,0,0,0,952.06,7,678259.98,25,0,10,3,True
1577279,634,1,-1,8202,645614101,0,1,0,952.16,4,678259.98,24,0,13,3,True
2224153,634,1,25,9361,645614101,0,0,0,951.93,8,677308.05,24,4,19,4,True
2251379,1088,4,25,7978,645614101,0,0,0,952.14,8,676355.91,18,6,22,4,True
2335042,1186,2,-1,7978,645614101,0,1,0,951.9,4,676355.91,24,0,20,4,True
2541163,910,0,20,6730,645614101,0,0,0,951.84,5,675404.07,18,3,12,6,True
2636689,1088,4,30,3893,645614101,0,0,0,952.03,8,674452.04,18,0,16,6,True
2973694,1217,0,30,8276,645614101,0,0,0,952.05,8,673499.99,24,3,22,8,True
3234438,1186,2,30,3468,645614101,0,0,0,952.04,8,672547.95,24,5,13,8,True
3451607,1088,4,451,4044,645614101,0,0,0,952.19,7,671595.76,18,3,15,9,True
3460168,95,2,20,6730,645614101,0,0,0,952.28,3,670643.48,1,4,11,10,True
3588030,378,0,10,3468,645614101,0,0,0,952.35,0,671595.83,25,5,7,10,True
3974952,807,0,30,5668,645614101,0,0,0,952.04,8,670643.79,11,3,22,12,True
4094438,1113,1,10,8760,645614101,0,0,0,951.92,6,671595.71,0,6,17,3,True
4109482,1186,2,30,7978,645614101,0,0,0,951.94,8,670643.77,24,3,14,3,True
4153836,1217,0,451,2065,645614101,0,0,0,952.12,7,669691.65,24,3,13,3,True
4417610,933,4,30,4310,645614101,0,0,0,952.25,8,668739.4,24,4,3,4,True
4466642,807,0,25,8760,645614101,0,0,0,952.01,8,667787.39,11,0,11,5,True
4510853,933,4,25,1228,645614101,0,0,0,951.88,8,666835.51,24,6,14,6,True
4682938,738,2,-1,1228,645614101,0,1,0,951.78,4,666835.51,11,5,15,6,True
4954654,860,1,10,4310,645614101,0,0,0,952.13,0,667787.64,24,3,2,7,True
5076989,738,2,30,3566,645614101,0,0,0,952.4,8,666835.24,11,0,20,8,True
5110792,548,2,-1,9090,645614101,0,1,0,952.06,4,666835.24,17,2,10,8,True
5326685,1088,4,30,8760,645614101,0,0,0,952.17,8,665883.07,18,4,12,9,True
5552518,1088,4,25,9493,645614101,0,0,0,952.06,8,664931.01,18,1,11,9,True
5564139,807,0,30,9361,645614101,0,0,0,951.94,8,663979.07,11,0,20,10,True
5580048,1217,0,451,1228,645614101,0,0,0,951.8,7,663027.27,24,0,13,10,False
5687823,933,4,451,1794,645614101,0,0,0,952.11,7,662075.16,24,2,17,11,True
6250986,1217,0,451,4310,645614101,0,0,0,952.07,7,661123.09,24,0,4,11,True
6429167,628,0,10,4762,645614101,0,0,0,951.85,6,662074.94,11,3,3,12,True
6483262,933,4,-1,9493,645614101,0,1,0,951.92,1,662074.94,24,3,18,12,True
6644125,548,2,25,1228,645614101,0,0,0,951.83,8,661123.11,17,2,22,3,True
6776517,548,2,30,5668,645614101,0,0,0,951.77,8,660171.34,17,3,8,3,True
7191076,933,4,30,7931,645614101,0,0,0,951.59,8,659219.75,24,5,3,3,True
7506152,1288,0,10,8760,645614101,0,0,0,952.0,6,660171.75,24,1,14,5,True
7709591,1088,4,-1,7921,645614101,0,1,0,952.02,4,660171.75,18,3,20,5,True
8114246,1186,2,30,8202,645614101,0,0,0,952.15,8,659219.6,24,2,23,7,True
8273350,933,4,-1,9361,645614101,0,1,0,951.83,4,659219.6,24,2,21,7,False
8289744,1217,0,451,3468,645614101,0,0,0,952.08,7,658267.52,24,6,23,7,True
8297405,379,4,25,3086,645614101,0,0,0,951.86,8,657315.66,25,5,18,7,False
8322296,635,2,20,3086,645614101,0,0,0,951.67,3,656363.99,24,3,10,8,True
8613377,634,1,451,4044,645614101,0,0,0,951.87,7,655412.12,24,2,21,8,True
8693954,807,0,451,8760,645614101,0,0,0,952.03,7,654460.09,11,6,6,9,True
8784088,1186,2,30,1794,645614101,0,0,0,951.85,8,653508.24,24,2,0,9,True
9422704,933,4,25,3566,645614101,0,0,0,952.17,8,652556.07,24,3,0,9,True
9722499,585,2,20,3566,645614101,0,0,0,952.04,5,651604.03,11,6,13,9,True
9822952,1186,2,-1,7978,645614101,0,1,0,952.15,4,651604.03,24,3,13,9,True
9980572,807,0,25,3086,645614101,0,0,0,951.98,8,650652.05,11,3,0,10,True
1302036,1380,0,25,6108,144633903,0,0,0,669.95,8,859115.05,16,1,23,2,True
1313868,1380,0,451,9478,144633903,0,0,0,670.19,7,858444.86,16,4,1,2,True
1495843,184,0,20,1026,144633903,0,0,0,669.89,5,857774.97,18,1,15,3,True
2091865,428,0,20,3914,144633903,0,0,0,670.03,5,857104.94,18,3,12,3,True
2133414,1203,4,25,9467,144633903,0,0,0,669.92,8,856435.02,24,2,18,3,True
2175206,480,0,10,9986,144633903,0,0,0,669.81,6,857104.83,5,5,14,4,True
2554119,857,1,-1,6973,144633903,0,1,0,669.77,4,857104.83,24,6,18,6,True
2595895,857,1,451,4467,144633903,0,0,0,670.1,7,856434.73,24,0,17,7,True
2865809,1360,4,451,9478,144633903,0,0,0,669.92,7,855764.81,24,6,3,7,True
3137080,857,1,30,2355,144633903,0,0,0,669.97,8,855094.84,24,0,22,9,True
3253407,998,0,10,2355,144633903,0,0,0,670.16,6,855765.0,26,3,18,9,True
3305099,485,1,25,1898,144633903,0,0,0,670.23,8,855094.77,5,1,14,10,True
3347549,324,4,30,1659,144633903,0,0,0,670.07,8,854424.7,11,5,8,10,True
3389509,1203,4,30,7549,144633903,0,0,0,670.15,8,853754.55,24,5,23,11,True
3516091,1380,0,30,9467,144633903,0,0,0,670.24,8,853084.31,16,2,18,11,True
3886128,1203,4,451,9986,144633903,0,0,0,669.95,7,852414.36,24,4,6,11,True
3992165,370,4,25,8104,144633903,0,0,0,669.96,8,851744.4,25,4,16,12,True
4020551,370,4,30,6212,144633903,0,0,0,670.13,8,851074.27,25,5,18,12,True
4132734,203,0,25,2727,144633903,0,0,0,669.75,8,850404.52,9,5,1,12,True
4262600,1360,4,-1,8104,144633903,0,1,0,669.99,4,850404.52,24,6,21,1,True
4632572,203,0,451,2727,144633903,0,0,0,669.92,7,849734.6,9,4,5,1,True
4652077,203,0,30,7543,144633903,0,0,0,669.92,8,849064.68,9,2,8,2,True
4711186,485,1,-1,7543,144633903,0,1,0,669.72,1,849064.68,5,4,16,2,True
4836216,145,0,20,7543,144633903,0,0,0,670.01,5,848394.67,18,3,22,2,True
4950284,151,4,25,1050,144633903,0,0,0,670.04,8,847724.63,18,3,8,2,True
5365235,996,0,10,5811,144633903,0,0,0,669.78,0,848394.41,26,1,21,3,True
5369124,201,1,10,1126,144633903,0,0,0,669.79,6,849064.2,9,4,13,3,True
5640411,1203,4,-1,1026,144633903,0,1,0,670.33,4,849064.2,24,5,22,3,True
5729771,234,0,10,1026,144633903,0,0,0,669.98,6,849734.18,26,3,13,6,True
5793638,1203,4,-1,1358,144633903,0,1,0,670.01,4,849734.18,24,5,11,7,True
5835075,857,1,25,3973,144633903,0,0,0,670.03,8,849064.15,24,0,15,8,True
6316706,1203,4,-1,6212,144633903,0,1,0,670.19,4,849064.15,24,4,14,9,True
6483603,1360,4,451,2281,144633903,0,0,0,670.02,7,848394.13,24,2,19,9,True
6704426,370,4,451,1126,144633903,0,0,0,669.98,7,847724.15,25,0,11,9,True
6847411,570,2,20,7549,144633903,0,0,0,670.0,5,847054.15,11,3,6,10,True
6981621,675,2,20,2281,144633903,0,0,0,670.11,5,846384.04,24,1,14,10,True
7033447,203,0,-1,6108,144633903,0,1,0,670.15,1,846384.04,9,3,8,11,True
7040232,151,4,30,1358,144633903,0,0,0,670.15,8,845713.89,18,5,8,11,False
7103765,1360,4,451,1898,144633903,0,0,0,669.99,7,845043.9,24,1,5,3,True
7192900,445,0,20,9901,144633903,0,0,0,669.85,3,844374.05,13,4,11,3,True
7621966,64,0,10,5811,144633903,0,0,0,669.73,0,845043.78,20,2,18,4,True
7945322,857,1,25,9478,144633903,0,0,0,669.94,8,844373.84,24,4,13,5,True
8033750,800,0,20,4443,144633903,0,0,0,670.12,5,843703.72,11,6,23,5,True
8051070,297,0,10,1358,144633903,0,0,0,669.9,0,844373.62,4,4,13,5,True
8653975,203,0,451,9986,144633903,0,0,0,669.97,7,843703.65,9,1,7,6,True
8749273,479,2,20,1898,144633903,0,0,0,670.02,5,843033.63,5,2,13,6,True
8934972,324,4,451,2559,144633903,0,0,0,669.79,7,842363.84,11,5,2,6,True
9210444,1203,4,451,9394,144633903,0,0,0,670.27,7,841693.57,24,2,21,9,True
9478305,1380,0,-1,2355,144633903,0,1,0,669.88,4,841693.57,16,3,1,10,True
9940652,203,0,25,2559,144633903,0,0,0,669.83,8,841023.74,9,1,2,10,True
9945907,1380,0,25,5811,144633903,0,0,0,670.26,8,840353.48,16,2,11,11,True
1034971,1103,4,451,4725,609997307,0,0,0,1104.09,7,193828.91,0,0,15,1,True
1121355,427,2,451,2897,609997307,0,0,0,1104.29,7,192724.62,18,5,22,2,False
1126574,865,0,20,6464,609997307,0,0,0,1104.28,5,191620.34,24,2,8,2,True
1218301,118,2,451,4725,609997307,0,0,0,1104.08,7,190516.26,18,6,0,3,True
1443033,611,0,-1,2250,609997307,0,1,0,1103.83,1,190516.26,11,2,5,3,True
2121153,1116,0,20,6464,609997307,0,0,0,1104.03,5,189412.23,24,4,15,4,True
2177234,1232,1,451,4279,609997307,0,0,0,1104.02,7,188308.21,18,4,17,4,True
2193977,427,2,30,6455,609997307,0,0,0,1103.91,8,187204.3,18,4,0,5,True
2276672,558,0,20,5509,609997307,0,0,0,1103.81,5,186100.49,17,6,11,5,True
2581485,123,0,10,5706,609997307,0,0,0,1104.08,0,187204.57,18,2,17,6,True
2636213,343,1,-1,4725,609997307,0,1,0,1103.9,4,187204.57,24,2,12,6,True
2813606,611,0,25,2897,609997307,0,0,0,1104.06,8,186100.51,11,0,2,9,True
2981281,611,0,25,6373,609997307,0,0,0,1104.15,8,184996.36,11,3,11,9,True
3226605,52,4,451,1122,609997307,0,0,0,1103.98,7,183892.38,20,3,17,10,True
3873285,611,0,25,5154,609997307,0,0,0,1103.95,8,182788.43,11,5,1,11,True
4025394,52,4,-1,2897,609997307,0,1,0,1104.01,4,182788.43,20,3,2,11,True
4108704,1132,0,20,4279,609997307,0,0,0,1103.87,3,181684.56,24,1,18,11,True
4143118,52,4,30,5509,609997307,0,0,0,1103.88,8,180580.68,20,4,3,12,True
4180111,1063,0,20,2250,609997307,0,0,0,1104.05,5,179476.63,11,6,18,12,True
4262540,427,2,30,5706,609997307,0,0,0,1104.32,8,178372.31,18,6,2,12,True
4370849,1015,0,10,4725,609997307,0,0,0,1103.72,6,179476.03,26,0,14,1,True
4558051,799,2,20,5044,609997307,0,0,0,1104.06,3,178371.97,11,1,7,1,True
4623357,916,0,10,4725,609997307,0,0,0,1104.0,6,179475.97,18,1,14,1,True
4697622,663,4,30,6464,609997307,0,0,0,1103.93,8,178372.04,18,2,11,3,True
4916451,471,0,10,5044,609997307,0,0,0,1103.78,0,179475.82,5,6,18,3,True
4938583,1103,4,30,1814,609997307,0,0,0,1104.09,8,178371.73,0,5,10,3,True
5033186,663,4,25,6464,609997307,0,0,0,1104.09,8,177267.64,18,2,4,3,True
5093979,118,2,25,2897,609997307,0,0,0,1104.13,8,176163.51,18,1,15,5,True
5384350,1103,4,25,7852,609997307,0,0,0,1103.98,8,175059.53,0,2,15,5,True
5474424,1232,1,25,2250,609997307,0,0,0,1104.26,8,173955.27,18,0,2,6,True
5842587,663,4,30,6464,609997307,0,0,0,1104.04,8,172851.23,18,3,11,7,True
6344901,118,2,25,5044,609997307,0,0,0,1104.01,8,171747.22,18,3,6,8,True
6980558,1103,4,25,5154,609997307,0,0,0,1103.89,8,170643.33,0,1,22,10,True
7162486,118,2,25,5044,609997307,0,0,0,1103.95,8,169539.38,18,4,11,10,True
7513397,1304,0,30,4279,609997307,0,0,0,1104.09,8,168435.29,5,1,13,11,True
7756559,274,1,10,4725,609997307,0,0,0,1103.97,6,169539.26,24,2,3,11,True
7850241,260,0,20,2897,609997307,0,0,0,1104.2,5,168435.06,6,0,6,11,True
7974878,343,1,25,6455,609997307,0,0,0,1103.99,8,167331.07,24,4,17,12,False
8032888,1103,4,30,2250,609997307,0,0,0,1103.86,8,166227.21,0,3,17,1,True
8076982,1232,1,-1,1814,609997307,0,1,0,1104.18,4,166227.21,18,5,12,1,True
8336818,343,1,-1,5154,609997307,0,2,0,1104.01,4,166227.21,24,4,1,2,True
8417536,52,4,25,6373,609997307,0,0,0,1103.87,8,165123.34,20,0,19,3,True
8435042,343,1,30,6455,609997307,0,0,0,1104.18,8,164019.16,24,1,2,4,True
8592985,52,4,25,7852,609997307,0,0,0,1103.7,8,162915.46,20,3,5,5,True
8962846,343,1,25,1814,609997307,0,0,0,1103.86,8,161811.6,24,5,9,5,True
9025163,1103,4,451,1814,609997307,0,0,0,1104.0,7,160707.6,0,6,5,8,True
9056142,427,2,25,7852,609997307,0,0,0,1104.05,8,159603.55,18,3,5,9,True
9187763,118,2,30,2897,609997307,0,0,0,1103.94,8,158499.61,18,4,3,9,True
9301360,761,2,20,6373,609997307,0,0,0,1103.92,5,157395.69,24,0,1,9,True
9764275,118,2,30,4279,609997307,0,0,0,1103.97,8,156291.72,18,3,20,9,True
1167422,1012,0,10,4138,664765062,1,0,0,1087.81,6,551243.81,26,3,8,1,False
1183185,951,0,25,5276,664765062,1,0,0,1088.07,8,550155.74,24,3,13,1,True
1513091,1280,3,451,3795,664765062,1,0,0,1088.18,7,549067.56,24,6,17,1,True
1601173,343,1,30,7366,664765062,1,0,0,1087.94,8,547979.62,24,0,13,1,True
1703902,63,3,25,3668,664765062,1,0,0,1087.99,8,546891.63,20,5,11,2,True
1706255,343,1,25,2509,664765062,1,0,0,1087.99,8,545803.64,24,4,4,2,False
1872324,1280,3,-1,7548,664765062,1,1,0,1088.06,4,545803.64,24,2,14,4,True
1916704,939,0,10,3795,664765062,1,0,0,1087.98,6,546891.62,24,3,22,4,True
1946278,199,0,10,4138,664765062,1,0,0,1088.09,6,547979.71,18,1,3,5,True
2226219,748,1,451,5907,664765062,1,0,0,1088.0,7,546891.71,24,1,2,5,True
2743344,369,1,451,4549,664765062,1,0,0,1088.09,7,545803.62,25,2,12,5,True
2941611,1280,3,-1,3729,664765062,1,1,0,1088.23,1,545803.62,24,3,18,6,True
3198253,64,0,10,7611,664765062,1,0,0,1087.85,0,546891.47,20,3,20,8,True
3250453,63,3,451,5041,664765062,1,0,0,1087.9,7,545803.57,20,5,10,9,True
3405686,1124,0,20,8068,664765062,1,0,0,1087.94,5,544715.63,24,5,13,9,True
3471598,343,1,451,7611,664765062,1,0,0,1087.72,7,543627.91,24,4,4,9,True
3573558,1364,0,10,2509,664765062,1,0,0,1087.85,0,544715.76,16,0,16,9,True
3846059,572,0,10,8054,664765062,1,0,0,1088.16,6,545803.92,11,3,11,10,True
3953630,951,0,451,7611,664765062,1,0,0,1087.98,7,544715.94,24,2,18,10,True
4090128,63,3,-1,4549,664765062,1,1,0,1087.96,1,544715.94,20,5,19,10,True
4377690,1307,0,451,4549,664765062,1,0,0,1087.73,7,543628.21,5,4,15,11,True
4411403,1468,1,-1,8068,664765062,1,1,0,1088.19,1,543628.21,11,4,22,12,True
4690245,1307,0,451,6602,664765062,1,0,0,1087.9,7,542540.31,5,0,13,1,True
4843754,369,1,451,4549,664765062,1,0,0,1088.12,7,541452.19,25,0,21,2,True
4847403,748,1,451,4138,664765062,1,0,0,1088.11,7,540364.08,24,5,3,2,True
4881328,369,1,451,6474,664765062,1,0,0,1088.17,7,539275.91,25,0,22,3,True
5196089,1307,0,451,5041,664765062,1,0,0,1087.93,7,538187.98,5,4,19,3,True
5271822,1307,0,30,7611,664765062,1,0,0,1088.0,8,537099.98,5,3,17,3,True
5454451,1451,1,10,5276,664765062,1,0,0,1087.91,6,538187.89,11,6,2,4,True
5603260,1247,0,10,4549,664765062,1,0,0,1087.95,6,539275.84,23,6,6,5,True
5767938,628,0,20,3795,664765062,1,0,0,1088.15,5,538187.69,11,5,16,5,True
5916229,748,1,30,2745,664765062,1,0,0,1088.04,8,537099.65,24,0,22,6,True
5951308,355,1,10,6474,664765062,1,0,0,1088.08,6,538187.73,24,1,21,7,True
6001100,748,1,30,2501,664765062,1,0,0,1087.91,8,537099.82,24,0,6,7,True
6528680,182,1,10,3267,664765062,1,0,0,1087.94,0,538187.76,18,3,16,8,True
6537774,1307,0,-1,3267,664765062,1,1,0,1087.7,1,538187.76,5,6,23,9,True
7106198,748,1,30,6602,664765062,1,0,0,1088.09,8,537099.67,24,2,10,9,True
7289287,509,0,10,4138,664765062,1,0,0,1088.05,0,538187.72,12,4,8,12,True
7543401,149,2,20,2509,664765062,1,0,0,1088.23,5,537099.49,18,3,0,12,True
7556851,1468,1,25,6602,664765062,1,0,0,1087.79,8,536011.7,11,2,11,12,True
7577083,63,3,25,3668,664765062,1,0,0,1087.88,8,534923.82,20,1,15,1,True
7595148,343,1,451,5276,664765062,1,0,0,1088.11,7,533835.71,24,0,13,1,True
7829839,343,1,25,3729,664765062,1,0,0,1087.74,8,532747.97,24,0,21,1,True
8149444,1238,0,20,8054,664765062,1,0,0,1087.84,5,531660.13,18,1,2,1,True
8159172,1454,1,10,7548,664765062,1,0,0,1087.94,6,532748.07,11,0,16,1,True
8215672,63,3,25,4138,664765062,1,0,0,1088.13,8,531659.94,20,1,16,1,True
8337002,748,1,451,6602,664765062,1,0,0,1088.02,7,530571.92,24,2,15,2,True
8404102,448,0,10,7548,664765062,1,0,0,1087.92,0,531659.84,13,0,11,3,True
8765689,1468,1,30,3267,664765062,1,0,0,1087.9,8,530571.94,11,6,12,6,True
8952516,951,0,30,3267,664765062,1,0,0,1087.94,8,529484.0,24,3,7,8,True
8977014,63,3,30,4138,664765062,1,0,0,1087.96,8,528396.04,20,4,19,8,True
9501493,748,1,451,2509,664765062,1,0,0,1088.13,7,527307.91,24,5,22,8,True
9511447,343,1,451,7548,664765062,1,0,0,1087.85,7,526220.06,24,5,11,9,True
9795385,748,1,25,6474,664765062,1,0,0,1087.94,8,525132.12,24,5,23,9,True
9803843,320,1,10,4549,664765062,1,0,0,1088.08,6,526220.2,11,6,18,9,True
9879675,63,3,-1,6474,664765062,1,1,0,1088.12,4,526220.2,20,4,11,10,True
9895505,1027,0,10,7548,664765062,1,0,0,1088.0,0,527308.2,11,5,12,11,True
1014021,723,1,30,2313,292408413,0,0,0,746.2,8,317129.8,11,5,17,1,True
1118270,889,0,30,7778,292408413,0,0,0,745.94,8,316383.86,27,5,4,1,True
1149236,1339,2,30,1043,292408413,0,0,0,745.99,8,315637.87,18,4,17,1,True
1293297,723,1,25,7574,292408413,0,0,0,746.09,8,314891.78,11,5,20,1,True
1302558,889,0,451,1043,292408413,0,0,0,746.18,7,314145.6,27,2,9,2,True
1715172,889,0,451,7826,292408413,0,0,0,746.3,7,313399.3,27,5,12,3,True
1830899,723,1,30,3111,292408413,0,0,0,746.13,8,312653.17,11,0,22,3,True
1924439,1339,2,-1,5337,292408413,0,1,0,746.24,4,312653.17,18,2,20,5,False
1935279,1351,4,30,7826,292408413,0,0,0,746.1,8,311907.07,24,0,21,5,True
2002255,148,1,10,8810,292408413,0,0,0,746.12,0,312653.19,18,6,3,7,True
2067457,274,1,10,2344,292408413,0,0,0,745.74,6,313398.93,24,5,9,7,True
2128808,863,4,-1,7778,292408413,0,1,0,745.67,4,313398.93,24,5,16,8,True
2188627,1102,2,20,3111,292408413,0,0,0,745.92,3,312653.01,0,2,1,8,True
2199420,980,1,10,3111,292408413,0,0,0,745.98,6,313398.99,22,5,14,10,True
2219319,812,0,10,1043,292408413,0,0,0,746.18,6,314145.17,18,3,12,11,True
2380453,1339,2,30,2344,292408413,0,0,0,746.33,8,313398.84,18,1,10,12,True
2423611,889,0,-1,1043,292408413,0,1,0,745.89,4,313398.84,27,6,16,12,True
2567575,863,4,451,9951,292408413,0,0,0,746.05,7,312652.79,24,5,18,12,True
2595408,1408,1,10,7574,292408413,0,0,0,745.82,6,313398.61,24,2,11,2,True
2629806,198,0,10,7526,292408413,0,0,0,746.06,6,314144.67,18,0,5,2,True
2729068,1101,2,20,1043,292408413,0,0,0,746.09,5,313398.58,0,5,1,3,True
3135818,1321,0,20,4845,292408413,0,0,0,746.06,5,312652.52,18,2,22,5,True
3203878,1351,4,451,3963,292408413,0,0,0,746.15,7,311906.37,24,6,20,6,True
3282568,1012,0,20,2344,292408413,0,0,0,745.9,5,311160.47,26,4,19,6,True
3308174,1339,2,25,7826,292408413,0,0,0,745.78,8,310414.69,18,2,23,6,True
3423851,1351,4,30,2313,292408413,0,0,0,745.75,8,309668.94,24,2,13,7,True
3593259,1351,4,451,9951,292408413,0,0,0,745.96,7,308922.98,24,3,9,7,True
3625077,863,4,25,9112,292408413,0,0,0,745.84,8,308177.14,24,6,8,7,True
3746890,1339,2,-1,1043,292408413,0,1,0,745.97,1,308177.14,18,6,0,9,True
4058202,723,1,25,3963,292408413,0,0,0,745.78,8,307431.36,11,2,13,9,True
4472993,889,0,30,7826,292408413,0,0,0,746.25,8,306685.11,27,1,18,9,True
4536820,1339,2,30,3111,292408413,0,0,0,745.75,8,305939.36,18,5,23,9,True
4719255,723,1,451,1043,292408413,0,0,0,746.35,7,305193.01,11,0,5,10,True
4849992,1029,0,20,1043,292408413,0,0,0,745.62,5,304447.39,11,4,6,11,True
4951957,1339,2,451,7778,292408413,0,0,0,746.2,7,303701.19,18,5,11,11,True
5190911,1339,2,451,7778,292408413,0,0,0,746.03,7,302955.16,18,5,12,11,True
5787093,889,0,30,8810,292408413,0,0,0,746.01,8,302209.15,27,4,2,12,True
5872598,548,2,20,7526,292408413,0,0,0,745.87,5,301463.28,17,3,0,1,True
5878889,1339,2,25,7826,292408413,0,0,0,745.95,8,300717.33,18,3,17,1,True
6112457,863,4,451,4845,292408413,0,0,0,745.97,7,299971.36,24,2,10,1,True
6181724,238,0,20,7526,292408413,0,0,0,745.92,5,299225.44,26,6,2,2,True
6337272,880,1,10,8038,292408413,0,0,0,745.99,6,299971.43,27,1,0,2,True
6394544,603,0,20,5337,292408413,0,0,0,745.9,5,299225.53,24,6,23,2,True
6532385,863,4,30,8038,292408413,0,0,0,746.1,8,298479.43,24,4,20,3,False
6709051,42,2,20,2313,292408413,0,0,0,745.95,3,297733.48,24,3,14,3,True
7178629,1034,1,10,7526,292408413,0,0,0,746.01,6,298479.49,11,1,20,5,False
7207992,889,0,451,8810,292408413,0,0,0,746.01,7,297733.48,27,3,8,5,True
7511841,537,0,20,1854,292408413,0,0,0,746.14,3,296987.34,18,0,13,6,True
7874882,863,4,25,7574,292408413,0,0,0,746.2,8,296241.14,24,3,22,6,True
7997589,1351,4,451,1043,292408413,0,0,0,745.55,7,295495.59,24,5,6,7,True
8348271,1075,0,10,8810,292408413,0,0,0,746.04,6,296241.63,18,2,20,8,True
8922065,863,4,25,3111,292408413,0,0,0,745.92,8,295495.71,24,3,17,9,True
9196061,1260,0,10,4221,292408413,0,0,0,745.83,6,296241.54,23,1,18,9,True
9209664,863,4,25,5337,292408413,0,0,0,745.94,8,295495.6,24,2,17,9,True
9624324,21,0,10,3111,292408413,0,0,0,746.12,0,296241.72,11,0,22,10,True
9752923,950,0,10,4845,292408413,0,0,0,745.84,6,296987.56,24,2,2,10,True
9914272,1339,2,-1,9112,292408413,0,1,0,745.71,4,296987.56,18,5,17,11,True
1072538,256,4,451,1809,439911730,1,0,0,1114.01,7,453753.99,6,4,12,1,False
1334556,1063,0,10,6443,439911730,1,0,0,1113.57,6,454867.56,11,5,6,1,True
1334951,1243,2,451,6441,439911730,1,0,0,1114.21,7,453753.35,18,3,21,1,True
1386532,256,4,451,1342,439911730,1,0,0,1113.91,7,452639.44,6,4,19,1,True
1430793,1169,0,30,2563,439911730,1,0,0,1114.03,8,451525.41,24,0,23,2,True
1532221,1010,0,451,8953,439911730,1,0,0,1113.91,7,450411.5,26,1,11,3,True
1537154,1266,4,451,2086,439911730,1,0,0,1114.07,7,449297.43,23,5,4,4,True
1662373,256,4,-1,1470,439911730,1,1,0,1113.97,4,449297.43,6,4,23,6,True
1668905,1255,0,10,9265,439911730,1,0,0,1114.0,0,450411.43,23,5,14,6,True
1677298,1173,1,10,2563,439911730,1,0,0,1113.87,6,451525.3,24,1,22,7,True
1760260,357,4,451,6710,439911730,1,0,0,1114.17,7,450411.13,24,0,3,8,True
1765907,1266,4,451,2086,439911730,1,0,0,1114.14,7,449296.99,23,5,22,8,True
1781641,1266,4,451,6746,439911730,1,0,0,1114.23,7,448182.76,23,5,12,9,True
1850211,512,0,20,1809,439911730,1,0,0,1113.78,5,447068.98,12,4,12,12,True
1972627,357,4,451,4080,439911730,1,0,0,1113.85,7,445955.13,24,1,10,12,True
2131543,256,4,-1,9265,439911730,1,1,0,1113.93,4,445955.13,6,6,9,12,True
2218840,1019,0,451,1809,439911730,1,0,0,1114.28,7,444840.85,26,2,21,12,True
2408934,1019,0,25,4296,439911730,1,0,0,1114.25,8,443726.6,26,1,14,1,True
2540764,610,0,10,8033,439911730,1,0,0,1113.86,6,444840.46,11,2,19,1,True
2593017,523,2,20,1457,439911730,1,0,0,1113.88,5,443726.58,18,1,6,1,True
2716799,498,0,10,2563,439911730,1,0,0,1113.86,0,444840.44,12,3,20,2,True
2908330,1243,2,25,8953,439911730,1,0,0,1113.91,8,443726.53,18,5,18,2,True
2919454,31,3,25,6746,439911730,1,0,0,1114.21,8,442612.32,11,4,4,3,True
3132644,729,0,20,6710,439911730,1,0,0,1114.06,5,441498.26,11,1,2,3,True
3808998,31,3,-1,4080,439911730,1,1,0,1113.86,4,441498.26,11,1,6,3,True
3958826,116,0,10,4080,439911730,1,0,0,1113.94,0,442612.2,3,1,9,4,True
4250569,399,2,20,6710,439911730,1,0,0,1113.91,3,441498.29,10,1,18,4,True
4376423,1019,0,-1,1470,439911730,1,1,0,1113.93,4,441498.29,26,0,12,7,True
4422133,1010,0,451,1470,439911730,1,0,0,1113.76,7,440384.53,26,1,5,7,True
4618331,956,1,10,1470,439911730,1,0,0,1114.15,0,441498.68,13,1,17,7,True
4771920,951,0,451,6441,439911730,1,0,0,1113.86,7,440384.82,24,5,0,7,True
4804782,1019,0,451,2086,439911730,1,0,0,1114.08,7,439270.74,26,4,20,8,True
5022009,1019,0,25,7172,439911730,1,0,0,1113.92,8,438156.82,26,6,19,8,True
5074820,1315,0,10,1470,439911730,1,0,0,1113.89,6,439270.71,5,1,5,8,True
5128377,1019,0,451,2563,439911730,1,0,0,1114.02,7,438156.69,26,6,12,9,True
5265102,1010,0,451,7172,439911730,1,0,0,1114.26,7,437042.43,26,2,23,9,True
5268939,256,4,451,1457,439911730,1,0,0,1114.02,7,435928.41,6,3,9,9,True
5969786,357,4,30,4296,439911730,1,0,0,1113.95,8,434814.46,24,6,1,10,True
6110608,357,4,451,6710,439911730,1,0,0,1113.88,7,433700.58,24,6,17,10,True
6480699,734,0,10,8953,439911730,1,0,0,1113.77,6,434814.35,11,0,17,10,True
6760315,1010,0,-1,9265,439911730,1,1,0,1114.08,4,434814.35,26,0,17,10,True
7012140,1298,0,20,8033,439911730,1,0,0,1113.76,5,433700.59,5,2,18,11,False
7139383,951,0,451,8033,439911730,1,0,0,1114.07,7,432586.52,24,0,12,12,True
7528797,1010,0,-1,6710,439911730,1,1,0,1113.98,1,432586.52,26,1,1,12,True
7644285,1019,0,30,4296,439911730,1,0,0,1113.85,8,431472.67,26,1,18,12,True
8173269,1262,0,10,5126,439911730,1,0,0,1113.87,0,432586.54,23,3,0,1,True
8269202,689,0,20,9265,439911730,1,0,0,1114.12,5,431472.42,24,3,4,1,True
8404413,256,4,451,5126,439911730,1,0,0,1113.96,7,430358.46,6,1,15,1,True
8460541,917,0,20,8033,439911730,1,0,0,1113.81,5,429244.65,18,2,15,2,True
8508040,357,4,30,1809,439911730,1,0,0,1113.88,8,428130.77,24,5,19,2,True
8653776,1262,0,10,6441,439911730,1,0,0,1114.29,0,429245.06,23,1,13,3,True
9029831,1019,0,25,1457,439911730,1,0,0,1113.85,8,428131.21,26,2,13,4,True
9057831,357,4,-1,1470,439911730,1,1,0,1113.99,1,428131.21,24,5,3,7,True
9081431,1243,2,451,4296,439911730,1,0,0,1114.19,7,427017.02,18,3,11,7,True
9107565,1266,4,-1,6443,439911730,1,1,0,1113.97,1,427017.02,23,3,16,8,True
9445079,357,4,451,1457,439911730,1,0,0,1113.92,7,425903.1,24,5,17,8,True
9607027,1262,0,10,2086,439911730,1,0,0,1113.99,0,427017.09,23,6,8,9,True
9666428,1169,0,451,2086,439911730,1,0,0,1114.08,7,425903.01,24,5,22,11,True
1071628,300,0,20,3100,311083835,1,0,0,613.02,5,151099.98,4,2,17,1,True
1562326,567,1,451,2070,311083835,1,0,0,613.1,7,150486.88,11,5,14,1,True
1613762,1126,4,25,9143,311083835,1,0,0,612.99,8,149873.89,24,5,22,2,True
1617540,612,4,451,5274,311083835,1,0,0,612.99,7,149260.9,11,2,6,2,True
1983560,1247,0,-1,3959,311083835,1,1,0,612.98,4,149260.9,23,0,6,2,True
2010772,612,4,451,1766,311083835,1,0,0,613.09,7,148647.81,11,3,7,2,True
2051805,689,0,10,8119,311083835,1,0,0,612.98,0,149260.79,24,6,1,4,True
2201630,678,4,30,5124,311083835,1,0,0,612.96,8,148647.83,24,2,4,4,True
2660001,851,1,10,6085,311083835,1,0,0,613.04,0,149260.87,5,0,5,4,True
2702873,23,0,10,9143,311083835,1,0,0,613.19,0,149874.06,11,2,1,4,False
3104689,678,4,30,1766,311083835,1,0,0,612.82,8,149261.24,24,5,19,5,True
3202542,216,4,451,5124,311083835,1,0,0,612.97,7,148648.27,9,5,7,7,True
3296441,1312,0,20,1063,311083835,1,0,0,612.81,5,148035.46,5,2,10,7,True
3302265,822,4,451,2070,311083835,1,0,0,613.05,7,147422.41,18,6,17,7,True
3628380,567,1,30,6744,311083835,1,0,0,613.02,8,146809.39,11,1,3,8,True
3755874,216,4,30,5274,311083835,1,0,0,612.93,8,146196.46,9,3,2,9,True
3987319,216,4,451,2918,311083835,1,0,0,612.91,7,145583.55,9,4,21,11,True
4054415,337,1,10,2011,311083835,1,0,0,612.99,0,146196.54,11,3,23,11,True
4077569,567,1,451,5408,311083835,1,0,0,612.8,7,145583.74,11,1,11,12,True
4093234,34,1,-1,9143,311083835,1,1,0,613.01,4,145583.74,11,3,14,1,True
4182052,34,1,451,7475,311083835,1,0,0,613.18,7,144970.56,11,3,23,1,True
4272187,822,4,25,2237,311083835,1,0,0,613.18,8,144357.38,18,3,14,1,True
4537970,1247,0,30,6744,311083835,1,0,0,612.94,8,143744.44,23,4,15,2,True
4656491,567,1,-1,2070,311083835,1,1,0,613.21,4,143744.44,11,5,0,4,True
4665758,1126,4,451,2011,311083835,1,0,0,613.25,7,143131.19,24,2,9,5,True
5475503,673,0,25,7301,311083835,1,0,0,612.98,8,142518.21,18,5,10,6,True
5511651,1247,0,-1,2020,311083835,1,1,0,613.23,1,142518.21,23,1,11,8,True
5625159,342,0,10,5124,311083835,1,0,0,612.74,6,143130.95,24,0,12,9,True
5654529,612,4,451,6015,311083835,1,0,0,612.97,7,142517.98,11,2,4,10,True
5869504,211,0,10,8119,311083835,1,0,0,612.92,6,143130.9,9,2,13,10,True
5898274,216,4,-1,6377,311083835,1,1,0,613.06,4,143130.9,9,2,14,10,True
5966397,1233,0,20,2020,311083835,1,0,0,612.95,3,142517.95,18,6,1,10,True
6018519,673,0,451,5274,311083835,1,0,0,612.94,7,141905.01,18,4,4,11,True
6181980,34,1,30,2070,311083835,1,0,0,613.3,8,141291.71,11,2,7,11,True
6316527,1247,0,30,5895,311083835,1,0,0,613.03,8,140678.68,23,1,11,11,True
6320418,309,0,10,5895,311083835,1,0,0,612.83,6,141291.51,4,1,16,11,True
6652578,678,4,451,8119,311083835,1,0,0,613.05,7,140678.46,24,0,7,12,True
6994605,238,0,10,2070,311083835,1,0,0,612.97,6,141291.43,26,3,5,12,True
7073413,299,1,10,2020,311083835,1,0,0,612.88,6,141904.31,4,2,4,1,True
8076650,278,1,10,6085,311083835,1,0,0,613.18,0,142517.49,24,5,12,1,True
8488288,98,0,10,7644,311083835,1,0,0,613.0,0,143130.49,3,3,4,2,True
8615909,1278,0,20,2020,311083835,1,0,0,612.92,5,142517.57,24,2,8,3,True
8654852,1247,0,25,3959,311083835,1,0,0,612.92,8,141904.65,23,0,8,3,True
8933123,320,1,10,2237,311083835,1,0,0,613.02,0,142517.67,11,6,22,3,True
9095091,1247,0,25,5274,311083835,1,0,0,612.82,8,141904.85,23,5,6,6,True
9240627,299,1,10,5895,311083835,1,0,0,613.14,0,142517.99,4,0,19,6,True
9319600,1247,0,451,5408,311083835,1,0,0,613.07,7,141904.92,23,4,4,6,True
9644759,34,1,-1,9218,311083835,1,1,0,613.24,1,141904.92,11,3,10,7,True
9890814,34,1,30,5295,311083835,1,0,0,612.87,8,141292.05,11,1,6,8,True
9936534,275,0,20,1063,311083835,1,0,0,612.82,5,140679.23,24,6,22,10,True
1180830,404,1,-1,7668,473037261,1,1,0,833.91,4,935124.0,10,2,15,1,True
1326896,404,1,451,6955,473037261,1,0,0,834.39,7,934289.61,10,4,1,1,True
1400333,570,2,20,1524,473037261,1,0,0,833.95,5,933455.66,11,1,22,2,True
1798896,1308,3,451,8607,473037261,1,0,0,833.76,7,932621.9,5,1,15,5,True
1805906,739,1,25,3296,473037261,1,0,0,833.85,8,931788.05,24,2,2,5,True
1857275,341,0,10,7633,473037261,1,0,0,834.07,6,932622.12,24,4,11,6,True
1973036,1037,0,20,6803,473037261,1,0,0,834.07,3,931788.05,11,2,15,7,True
2121922,89,3,-1,9959,473037261,1,1,0,833.94,4,931788.05,1,0,21,7,True
2543249,362,0,10,8340,473037261,1,0,0,834.29,6,932622.34,24,2,21,7,True
2705856,89,3,-1,1386,473037261,1,1,0,834.29,4,932622.34,1,1,16,9,True
3524113,1308,3,25,2122,473037261,1,0,0,834.41,8,931787.93,5,5,18,11,True
3611911,404,1,25,2122,473037261,1,0,0,834.14,8,930953.79,10,6,8,11,True
3650270,1277,2,30,2611,473037261,1,0,0,833.99,8,930119.8,24,2,7,1,True
3666090,89,3,25,6955,473037261,1,0,0,833.78,8,929286.02,1,0,3,2,True
4422213,739,1,25,7668,473037261,1,0,0,834.14,8,928451.88,24,6,16,2,True
4665284,1256,2,20,6955,473037261,1,0,0,833.96,3,927617.92,23,2,0,3,True
4772574,1277,2,451,9624,473037261,1,0,0,834.02,7,926783.9,24,2,0,3,True
4934764,765,4,30,5009,473037261,1,0,0,833.94,8,925949.96,14,2,23,3,True
5000507,1308,3,30,6955,473037261,1,0,0,833.97,8,925115.99,5,3,15,4,True
5062123,882,0,-1,1204,473037261,1,1,0,833.79,4,925115.99,27,4,12,5,True
5174542,365,0,20,9288,473037261,1,0,0,833.95,3,924282.04,25,0,21,7,True
5350674,404,1,30,3518,473037261,1,0,0,833.88,8,923448.16,10,0,4,7,True
5648168,404,1,30,5716,473037261,1,0,0,834.01,8,922614.15,10,4,21,7,True
5688798,89,3,451,1386,473037261,1,0,0,833.83,7,921780.32,1,3,12,7,True
6116315,765,4,451,1524,473037261,1,0,0,834.25,7,920946.07,14,2,13,8,True
6147211,89,3,25,5716,473037261,1,0,0,833.89,8,920112.18,1,0,10,9,True
6443097,765,4,25,7668,473037261,1,0,0,834.12,8,919278.06,14,6,12,9,True
6639269,404,1,451,5009,473037261,1,0,0,834.07,7,918443.99,10,6,17,9,True
6919145,765,4,451,5009,473037261,1,0,0,833.93,7,917610.06,14,0,2,10,True
6995921,993,0,20,7031,473037261,1,0,0,834.09,5,916775.97,22,4,7,10,True
7068626,469,4,451,1204,473037261,1,0,0,834.05,7,915941.92,5,3,10,10,True
7128821,882,0,30,2122,473037261,1,0,0,833.89,8,915108.03,27,3,4,10,True
7412272,89,3,451,5009,473037261,1,0,0,833.92,7,914274.11,1,4,12,11,True
7565093,739,1,30,8340,473037261,1,0,0,833.99,8,913440.12,24,5,8,12,True
7587202,469,4,30,6291,473037261,1,0,0,833.92,8,912606.2,5,0,11,12,True
7665568,59,0,20,2611,473037261,1,0,0,834.11,5,911772.09,20,0,12,1,True
7947201,882,0,451,6848,473037261,1,0,0,834.09,7,910938.0,27,6,7,1,True
8186110,469,4,451,5009,473037261,1,0,0,834.04,7,910103.96,5,5,18,2,True
8284755,1277,2,25,3296,473037261,1,0,0,833.93,8,909270.03,24,3,8,2,True
8705804,404,1,25,5716,473037261,1,0,0,833.99,8,908436.04,10,1,8,3,True
8830350,1308,3,30,1524,473037261,1,0,0,833.79,8,907602.25,5,5,18,3,True
8993266,882,0,451,7633,473037261,1,0,0,834.18,7,906768.07,27,2,8,5,True
9106025,404,1,-1,6803,473037261,1,1,0,834.05,1,906768.07,10,2,21,5,True
9114117,739,1,451,6803,473037261,1,0,0,834.07,7,905934.0,24,4,10,5,True
9132257,1354,0,20,9624,473037261,1,0,0,834.21,5,905099.79,24,6,14,6,True
9146117,1090,0,20,3320,473037261,1,0,0,834.06,5,904265.73,18,0,21,7,True
9231899,591,0,20,7668,473037261,1,0,0,833.79,3,903431.94,24,4,2,7,True
9588266,765,4,451,9653,473037261,1,0,0,834.13,7,902597.81,14,0,15,7,True
9667124,882,0,25,9288,473037261,1,0,0,834.14,8,901763.67,27,1,0,8,True
9811896,739,1,25,3518,473037261,1,0,0,833.85,8,900929.82,24,1,7,9,True
9844372,765,4,25,1386,473037261,1,0,0,833.73,8,900096.09,14,0,15,10,True
9885265,1063,0,10,2906,473037261,1,0,0,833.97,6,900930.06,11,1,23,11,True
9955645,404,1,30,9288,473037261,1,0,0,834.02,8,900096.04,10,0,2,11,True
1419012,1280,3,30,8179,644904760,1,0,0,831.98,8,933334.02,24,5,5,2,True
1708874,1354,0,20,7132,644904760,1,0,0,832.15,5,932501.87,24,6,7,2,True
2240050,41,2,451,9202,644904760,1,0,0,832.16,7,931669.71,11,5,19,2,True
2487787,44,4,451,9040,644904760,1,0,0,832.2,7,930837.51,24,4,18,3,True
2611473,662,1,25,9625,644904760,1,0,0,831.73,8,930005.78,18,1,1,3,True
2883313,1226,2,20,6215,644904760,1,0,0,831.84,5,929173.94,18,4,2,4,True
2936326,419,4,25,7132,644904760,1,0,0,831.96,8,928341.98,18,4,20,5,True
3038484,228,0,10,4586,644904760,1,0,0,832.1,6,929174.08,26,3,6,5,True
3356834,337,1,10,9877,644904760,1,0,0,832.15,6,930006.23,11,2,14,7,True
3634024,1179,0,10,9202,644904760,1,0,0,832.14,6,930838.37,24,3,13,7,True
3669040,41,2,451,6341,644904760,1,0,0,832.19,7,930006.18,11,2,16,7,True
3801651,314,0,20,3453,644904760,1,0,0,831.82,5,929174.36,4,4,21,7,True
3814569,419,4,25,4692,644904760,1,0,0,831.86,8,928342.5,18,4,14,8,True
4071565,41,2,451,6974,644904760,1,0,0,832.09,7,927510.41,11,6,23,8,True
4284526,607,2,20,6936,644904760,1,0,0,831.96,5,926678.45,24,3,21,9,True
4374846,44,4,25,6901,644904760,1,0,0,831.99,8,925846.46,24,5,5,9,False
4468536,41,2,25,1931,644904760,1,0,0,831.86,8,925014.6,11,0,22,10,True
4471275,1280,3,451,9202,644904760,1,0,0,831.88,7,924182.72,24,4,13,11,True
4506820,712,0,20,9877,644904760,1,0,0,832.19,5,923350.53,18,3,17,1,True
4520026,21,0,20,6974,644904760,1,0,0,831.73,3,922518.8,11,4,23,2,True
4616741,44,4,451,5936,644904760,1,0,0,832.11,7,921686.69,24,3,8,2,True
4680958,611,0,20,3453,644904760,1,0,0,831.96,3,920854.73,11,5,1,3,True
4870642,41,2,451,4344,644904760,1,0,0,832.0,7,920022.73,11,2,3,3,True
4895973,275,0,451,8179,644904760,1,0,0,832.29,7,919190.44,24,1,5,5,True
5138407,275,0,451,8179,644904760,1,0,0,832.18,7,918358.26,24,0,3,6,True
5423809,662,1,-1,6974,644904760,1,1,0,831.86,4,918358.26,18,2,10,6,True
5721529,752,0,10,6215,644904760,1,0,0,831.81,6,919190.07,24,4,18,6,True
5825688,419,4,-1,6215,644904760,1,1,0,831.89,4,919190.07,18,5,7,9,True
6120574,44,4,451,9781,644904760,1,0,0,831.87,7,918358.2,24,2,1,9,True
6147750,95,2,20,9202,644904760,1,0,0,832.02,3,917526.18,1,6,21,1,True
6185219,1485,0,20,6936,644904760,1,0,0,831.99,3,916694.19,24,2,7,1,True
6280198,155,1,10,9781,644904760,1,0,0,831.93,0,917526.12,18,3,22,2,True
6286952,419,4,-1,9625,644904760,1,1,0,831.84,1,917526.12,18,4,6,2,True
6513818,419,4,25,6901,644904760,1,0,0,832.27,8,916693.85,18,1,6,2,True
6844619,457,0,20,6936,644904760,1,0,0,832.02,5,915861.83,13,2,5,2,True
7045230,1280,3,451,4586,644904760,1,0,0,831.95,7,915029.88,24,5,12,3,True
7065015,511,1,10,7132,644904760,1,0,0,831.95,0,915861.83,12,4,17,3,False
7143284,399,2,20,9877,644904760,1,0,0,831.89,3,915029.94,10,1,13,4,True
7152951,1280,3,451,9781,644904760,1,0,0,832.22,7,914197.72,24,3,13,4,True
7179429,662,1,30,9040,644904760,1,0,0,832.16,8,913365.56,18,6,2,4,True
7357833,937,0,10,6901,644904760,1,0,0,832.21,6,914197.77,24,6,17,4,True
7408248,858,1,10,9625,644904760,1,0,0,832.32,0,915030.09,24,6,19,5,True
7595629,419,4,30,7579,644904760,1,0,0,831.98,8,914198.11,18,0,5,5,True
7785663,44,4,25,1931,644904760,1,0,0,832.19,8,913365.92,24,6,14,5,True
7844064,662,1,25,6936,644904760,1,0,0,831.76,8,912534.16,18,1,0,5,True
8095307,44,4,25,9625,644904760,1,0,0,831.7,8,911702.46,24,6,10,6,True
8368696,130,0,10,9549,644904760,1,0,0,832.08,0,912534.54,18,2,21,7,True
8388698,64,0,10,4586,644904760,1,0,0,831.95,6,913366.49,20,5,13,7,True
8578052,662,1,-1,6341,644904760,1,1,0,832.03,4,913366.49,18,4,23,7,True
9198522,662,1,-1,9877,644904760,1,2,0,831.75,4,913366.49,18,1,7,8,True
9289985,44,4,451,6341,644904760,1,0,0,832.1,7,912534.39,24,1,20,9,True
9812456,662,1,451,6341,644904760,1,0,0,831.84,7,911702.55,18,1,4,10,True
9996619,757,0,10,6341,644904760,1,0,0,832.01,6,912534.56,24,6,2,11,True
1143772,812,0,-1,7391,565907549,0,1,0,246.11,4,106798.0,18,6,1,1,True
1436779,257,1,10,8117,565907549,0,0,0,246.15,6,107044.15,6,4,11,1,True
1790588,812,0,451,4677,565907549,0,0,0,246.14,7,106798.01,18,6,2,2,True
1897468,949,4,451,6547,565907549,0,0,0,245.85,7,106552.16,24,4,5,2,True
2137631,1406,0,10,5157,565907549,0,0,0,246.1,6,106798.26,24,0,23,2,True
2203450,144,1,451,9705,565907549,0,0,0,246.29,7,106551.97,18,3,2,2,True
2259494,812,0,30,1373,565907549,0,0,0,246.15,8,106305.82,18,4,7,3,True
2351271,949,4,-1,5088,565907549,0,1,0,246.14,1,106305.82,24,6,4,3,True
2532458,485,1,25,3411,565907549,0,0,0,246.13,8,106059.69,5,0,0,3,True
2588839,1192,2,20,1660,565907549,0,0,0,245.99,5,105813.7,24,4,19,4,True
2635196,59,0,30,7967,565907549,0,0,0,245.92,8,105567.78,20,1,17,4,True
2635605,199,0,10,7967,565907549,0,0,0,246.09,0,105813.87,18,0,15,5,True
3014984,471,0,10,2123,565907549,0,0,0,246.1,6,106059.97,5,0,13,5,True
3069102,59,0,25,2123,565907549,0,0,0,245.78,8,105814.19,20,4,15,7,True
3370254,144,1,451,5332,565907549,0,0,0,246.18,7,105568.01,18,0,16,7,True
3436736,59,0,-1,8005,565907549,0,1,0,246.04,4,105568.01,20,5,21,7,True
3441996,144,1,451,7391,565907549,0,0,0,245.99,7,105322.02,18,5,11,9,True
3886217,144,1,30,7391,565907549,0,0,0,246.11,8,105075.91,18,4,18,11,True
3913931,812,0,451,2984,565907549,0,0,0,245.93,7,104829.98,18,2,17,11,True
3925366,812,0,30,2984,565907549,0,0,0,246.12,8,104583.86,18,0,12,11,False
4048007,812,0,451,1318,565907549,0,0,0,246.27,7,104337.59,18,4,8,12,True
4277510,59,0,451,8117,565907549,0,0,0,246.23,7,104091.36,20,2,18,12,True
4409993,144,1,30,1318,565907549,0,0,0,246.34,8,103845.02,18,3,13,2,True
4471134,812,0,25,5088,565907549,0,0,0,245.87,8,103599.15,18,4,4,2,True
4480938,949,4,451,6867,565907549,0,0,0,245.96,7,103353.19,24,1,19,2,True
4558093,18,4,-1,8042,565907549,0,1,0,246.33,4,103353.19,24,0,4,3,True
4600890,485,1,30,1660,565907549,0,0,0,246.05,8,103107.14,5,1,19,4,True
4606661,949,4,30,5332,565907549,0,0,0,245.98,8,102861.16,24,3,17,6,True
5136504,59,0,25,8005,565907549,0,0,0,246.16,8,102615.0,20,3,17,7,True
5145066,1429,0,20,5088,565907549,0,0,0,245.91,5,102369.09,24,1,21,10,True
5952831,59,0,451,7967,565907549,0,0,0,246.13,7,102122.96,20,1,20,10,True
5992253,588,0,10,9705,565907549,0,0,0,246.06,6,102369.02,24,5,8,10,True
6008523,479,2,20,8005,565907549,0,0,0,246.36,3,102122.66,5,5,13,10,True
6054995,18,4,451,2154,565907549,0,0,0,246.13,7,101876.53,24,4,13,10,True
6955235,18,4,451,5088,565907549,0,0,0,245.88,7,101630.65,24,2,4,11,True
7190687,59,0,30,7391,565907549,0,0,0,245.91,8,101384.74,20,2,4,11,True
7290731,949,4,25,3411,565907549,0,0,0,246.23,8,101138.51,24,6,21,12,True
7558151,1304,0,10,2123,565907549,0,0,0,246.03,0,101384.54,5,0,12,12,True
7724626,812,0,25,9121,565907549,0,0,0,246.08,8,101138.46,18,5,18,12,True
7777080,144,1,25,2818,565907549,0,0,0,246.14,8,100892.32,18,3,13,1,True
7794067,76,0,10,7967,565907549,0,0,0,245.98,6,101138.3,20,2,20,1,True
7901983,1377,0,10,1660,565907549,0,0,0,245.86,0,101384.16,16,1,4,2,True
8189591,485,1,25,2123,565907549,0,0,0,245.96,8,101138.2,5,0,9,3,True
8197100,485,1,451,1318,565907549,0,0,0,245.84,7,100892.36,5,6,21,4,True
8254925,485,1,30,8005,565907549,0,0,0,245.88,8,100646.48,5,3,21,4,True
8262211,1029,0,10,7967,565907549,0,0,0,246.08,6,100892.56,11,6,3,4,True
8299518,812,0,25,2818,565907549,0,0,0,245.97,8,100646.59,18,2,13,4,True
8769809,831,1,10,7391,565907549,0,0,0,246.25,6,100892.84,5,3,10,6,True
8772529,577,0,20,2123,565907549,0,0,0,245.79,5,100647.05,11,3,23,7,True
8903309,144,1,30,2060,565907549,0,0,0,246.06,8,100400.99,18,1,7,7,False
8941361,812,0,-1,7967,565907549,0,1,0,245.9,4,100400.99,18,2,16,7,True
9163011,35,2,20,7208,565907549,0,0,0,245.95,5,100155.04,11,3,20,7,True
9416465,485,1,451,7391,565907549,0,0,0,246.07,7,99908.97,5,6,3,8,True
9440049,1399,0,20,1660,565907549,0,0,0,245.78,5,99663.19,24,6,8,9,True
9679035,144,1,30,3411,565907549,0,0,0,245.85,8,99417.34,18,2,6,10,True
9871628,366,0,10,2123,565907549,0,0,0,245.91,6,99663.25,25,1,13,11,True
1397880,790,0,-1,7002,743725248,0,1,0,959.92,1,768416.0,11,5,12,1,True
1553881,954,4,30,9110,743725248,0,0,0,960.05,8,767455.95,13,0,17,1,True
2520195,1063,0,10,1715,743725248,0,0,0,960.03,6,768415.98,11,4,23,1,True
2698802,328,0,20,7804,743725248,0,0,0,959.9,5,767456.08,11,6,5,1,True
2984796,954,4,451,7583,743725248,0,0,0,960.01,7,766496.07,13,1,10,3,True
3295299,331,4,25,7583,743725248,0,0,0,960.06,8,765536.01,11,1,14,3,True
3370647,790,0,30,1656,743725248,0,0,0,960.2,8,764575.81,11,2,23,3,True
3933170,360,0,10,1136,743725248,0,0,0,959.74,6,765535.55,24,1,6,4,True
4163275,1456,4,451,9260,743725248,0,0,0,960.16,7,764575.39,11,2,1,4,True
4235862,1456,4,30,7006,743725248,0,0,0,960.04,8,763615.35,11,0,4,5,True
4654762,1456,4,25,9110,743725248,0,0,0,959.87,8,762655.48,11,2,2,6,True
4782279,757,0,20,8429,743725248,0,0,0,959.79,5,761695.69,24,3,14,6,True
4942683,727,0,20,1711,743725248,0,0,0,959.98,3,760735.71,11,3,16,7,True
5105128,670,0,20,8388,743725248,0,0,0,960.12,3,759775.59,18,2,9,8,False
5187680,372,0,10,8694,743725248,0,0,0,960.26,6,760735.85,25,3,11,9,True
5412393,767,0,20,2448,743725248,0,0,0,959.95,5,759775.9,14,3,4,9,True
5703451,933,4,30,5435,743725248,0,0,0,960.21,8,758815.69,24,1,17,11,True
6434628,32,3,30,1711,743725248,0,0,0,959.91,8,757855.78,11,0,23,11,True
7032930,331,4,451,8388,743725248,0,0,0,959.76,7,756896.02,11,2,12,11,True
7239130,1115,1,10,6361,743725248,0,0,0,960.13,6,757856.15,0,0,11,12,True
7259950,990,0,10,9110,743725248,0,0,0,959.98,6,758816.13,22,6,4,12,True
7265507,1456,4,30,2448,743725248,0,0,0,959.74,8,757856.39,11,3,4,1,True
7290530,579,0,20,1136,743725248,0,0,0,959.89,5,756896.5,11,4,21,3,True
7291545,331,4,451,5500,743725248,0,0,0,959.94,7,755936.56,11,4,7,3,True
7379138,1456,4,30,6535,743725248,0,0,0,959.84,8,754976.72,11,4,6,5,True
7474118,331,4,25,5500,743725248,0,0,0,959.92,8,754016.8,11,2,20,5,True
7482059,160,0,10,5500,743725248,0,0,0,960.05,6,754976.85,24,6,12,5,True
7546278,954,4,25,8694,743725248,0,0,0,959.92,8,754016.93,13,5,8,5,True
7622267,1456,4,-1,1656,743725248,0,1,0,960.01,1,754016.93,11,5,22,6,True
7654528,331,4,-1,5500,743725248,0,2,0,959.93,4,754016.93,11,5,3,8,True
7673645,897,0,20,4232,743725248,0,0,0,959.82,5,753057.11,24,0,1,10,True
7698347,954,4,30,7002,743725248,0,0,0,960.0,8,752097.11,13,4,17,10,True
7701014,331,4,-1,9260,743725248,0,1,0,959.77,1,752097.11,11,3,0,10,True
7727176,1456,4,451,9260,743725248,0,0,0,959.79,7,751137.32,11,5,14,12,True
8129423,732,0,20,8429,743725248,0,0,0,959.96,5,750177.36,11,1,7,12,True
8132714,1456,4,25,1033,743725248,0,0,0,960.25,8,749217.11,11,3,23,12,True
8218946,696,2,20,6535,743725248,0,0,0,959.94,3,748257.17,24,2,18,1,True
8283874,790,0,25,2448,743725248,0,0,0,959.82,8,747297.35,11,1,7,1,True
8359812,1339,2,20,7006,743725248,0,0,0,959.88,5,746337.47,18,2,18,1,True
8547976,790,0,25,8388,743725248,0,0,0,959.76,8,745377.71,11,5,4,1,True
8634163,1456,4,30,9260,743725248,0,0,0,960.04,8,744417.67,11,5,9,3,True
8660762,1360,4,30,1136,743725248,0,0,0,960.03,8,743457.64,24,1,15,4,True
8677956,304,0,20,2414,743725248,0,0,0,959.87,3,742497.77,4,2,11,4,True
8723338,331,4,451,5435,743725248,0,0,0,959.9,7,741537.87,11,6,2,6,True
8961539,933,4,-1,7002,743725248,0,1,0,960.06,4,741537.87,24,3,14,6,True
9004744,1360,4,451,1033,743725248,0,0,0,959.77,7,740578.1,24,6,0,6,True
9158052,933,4,451,6361,743725248,0,0,0,960.13,7,739617.97,24,0,3,7,True
9312429,331,4,451,6535,743725248,0,0,0,960.0,7,738657.97,11,6,16,8,True
9398119,954,4,-1,1711,743725248,0,1,0,959.84,4,738657.97,13,4,18,8,True
9410591,790,0,25,8388,743725248,0,0,0,960.03,8,737697.94,11,2,6,9,True
9984576,1456,4,30,1656,743725248,0,0,0,959.76,8,736738.18,11,6,2,11,True
1347808,294,3,451,2442,382676735,1,0,0,1104.99,7,101436.01,4,3,6,2,True
1483189,1191,4,25,9183,382676735,1,0,0,1104.81,8,100331.2,24,6,17,3,True
1505052,1191,4,25,1383,382676735,1,0,0,1104.91,8,99226.29,24,2,21,4,True
1604719,674,4,451,1058,382676735,1,0,0,1104.99,7,98121.3,24,2,14,4,True
1823738,1477,2,20,8360,382676735,1,0,0,1105.25,5,97016.05,24,0,11,5,True
2254464,1191,4,451,9183,382676735,1,0,0,1104.85,7,95911.2,24,5,16,5,True
2338464,980,1,10,9382,382676735,1,0,0,1105.04,0,97016.24,22,1,15,8,True
2402390,1025,1,-1,1383,382676735,1,1,0,1104.78,1,97016.24,11,0,15,9,False
2410007,529,2,30,3306,382676735,1,0,0,1104.84,8,95911.4,18,0,5,9,True
2858224,1191,4,30,9108,382676735,1,0,0,1105.06,8,94806.34,24,3,17,10,True
2899222,114,0,20,9183,382676735,1,0,0,1105.07,3,93701.27,3,2,18,10,False
3191209,1191,4,30,1058,382676735,1,0,0,1105.06,8,92596.21,24,1,2,10,True
3329596,674,4,25,3306,382676735,1,0,0,1104.61,8,91491.6,24,3,12,12,True
3741378,529,2,-1,3335,382676735,1,1,0,1105.22,4,91491.6,18,4,0,1,True
3782012,848,2,20,3727,382676735,1,0,0,1105.11,3,90386.49,5,5,19,1,True
3939973,1025,1,-1,4461,382676735,1,1,0,1105.0,4,90386.49,11,6,1,1,True
4138149,1356,2,25,1058,382676735,1,0,0,1105.2,8,89281.29,24,0,8,1,False
4193482,529,2,25,6296,382676735,1,0,0,1105.01,8,88176.28,18,2,1,1,True
4439948,674,4,25,9183,382676735,1,0,0,1105.01,8,87071.27,24,2,20,1,True
4835240,294,3,25,6876,382676735,1,0,0,1104.54,8,85966.73,4,2,0,3,True
4844444,1356,2,-1,6378,382676735,1,1,0,1105.17,1,85966.73,24,5,12,3,True
4967851,1471,0,10,1383,382676735,1,0,0,1104.83,0,87071.56,24,5,17,4,True
5117755,1191,4,451,2056,382676735,1,0,0,1104.93,7,85966.63,24,5,1,4,True
5422423,573,0,10,5727,382676735,1,0,0,1105.23,6,87071.86,11,5,4,5,True
5439325,287,0,10,6876,382676735,1,0,0,1104.79,6,88176.65,24,2,2,5,True
6042422,951,0,20,9382,382676735,1,0,0,1104.82,3,87071.83,24,1,10,6,True
6102392,127,1,10,1058,382676735,1,0,0,1105.0,6,88176.83,18,5,11,7,True
6107384,674,4,-1,4461,382676735,1,1,0,1104.69,1,88176.83,24,4,22,11,True
6396460,1025,1,-1,2442,382676735,1,2,0,1105.09,1,88176.83,11,5,8,12,True
6488100,1191,4,25,6378,382676735,1,0,0,1104.97,8,87071.86,24,0,17,1,True
6687830,294,3,451,1058,382676735,1,0,0,1104.8,7,85967.06,4,4,13,1,True
6723256,610,0,20,9108,382676735,1,0,0,1104.92,3,84862.14,11,4,15,1,True
6769539,1025,1,30,9108,382676735,1,0,0,1104.84,8,83757.3,11,1,9,1,True
6950091,294,3,30,1058,382676735,1,0,0,1105.12,8,82652.18,4,6,4,2,True
7150704,1191,4,25,6652,382676735,1,0,0,1105.08,8,81547.1,24,2,8,2,True
7266343,1025,1,30,1058,382676735,1,0,0,1104.98,8,80442.12,11,6,5,3,True
7476401,117,1,10,6876,382676735,1,0,0,1104.81,6,81546.93,18,5,23,4,True
7503530,529,2,30,4461,382676735,1,0,0,1104.95,8,80441.98,18,6,7,4,True
7514625,1025,1,451,6296,382676735,1,0,0,1105.01,7,79336.97,11,4,8,5,True
7752402,294,3,-1,6876,382676735,1,1,0,1105.06,4,79336.97,4,0,15,5,True
7957916,1210,0,20,3306,382676735,1,0,0,1104.92,5,78232.05,24,6,22,6,True
7970875,314,0,20,9108,382676735,1,0,0,1105.15,3,77126.9,4,0,7,7,True
8420566,294,3,25,5727,382676735,1,0,0,1105.04,8,76021.86,4,6,5,7,True
8460932,674,4,451,9108,382676735,1,0,0,1105.01,7,74916.85,24,6,19,7,True
8593146,1191,4,451,5727,382676735,1,0,0,1105.13,7,73811.72,24,3,6,8,True
8648312,529,2,451,9183,382676735,1,0,0,1104.59,7,72707.13,18,4,0,8,True
8741705,1041,0,20,8360,382676735,1,0,0,1105.06,3,71602.07,11,1,10,9,True
8883037,674,4,-1,2442,382676735,1,1,0,1105.03,4,71602.07,24,6,3,10,True
9615497,529,2,25,6378,382676735,1,0,0,1104.64,8,70497.43,18,6,20,11,True
9951585,1356,2,30,2056,382676735,1,0,0,1104.84,8,69392.59,24,5,15,11,True
1042843,1483,0,30,3351,706487512,0,0,0,979.91,8,337705.09,24,0,1,2,True
1082208,863,4,451,8409,706487512,0,0,0,979.86,7,336725.23,24,6,0,3,True
1283369,373,1,30,2099,706487512,0,0,0,980.04,8,335745.19,25,1,9,3,True
1469798,1009,0,451,3684,706487512,0,0,0,979.99,7,334765.2,26,1,22,4,True
1586463,427,2,20,7433,706487512,0,0,0,979.98,3,333785.22,18,5,21,4,True
1640277,967,1,30,3684,706487512,0,0,0,980.0,8,332805.22,13,5,8,5,True
1766325,594,0,30,1292,706487512,0,0,0,979.82,8,331825.4,24,6,12,5,True
1827981,1160,0,10,1292,706487512,0,0,0,980.02,6,332805.42,15,6,18,5,True
1928893,873,4,451,2099,706487512,0,0,0,979.89,7,331825.53,24,3,5,6,True
2206058,635,2,20,2099,706487512,0,0,0,980.12,5,330845.41,24,1,17,7,True
2291655,863,4,25,3601,706487512,0,0,0,980.15,8,329865.26,24,1,2,9,True
2378685,532,4,30,7433,706487512,0,0,0,980.15,8,328885.11,18,4,4,9,True
2486718,895,0,20,3998,706487512,0,0,0,980.16,5,327904.95,24,2,21,10,True
2558959,594,0,30,3036,706487512,0,0,0,980.06,8,326924.89,24,6,21,11,True
2865346,1267,2,20,1292,706487512,0,0,0,980.16,5,325944.73,23,5,9,12,True
3240379,594,0,25,3601,706487512,0,0,0,979.78,8,324964.95,24,6,17,1,True
3368449,715,0,10,9372,706487512,0,0,0,980.04,0,325944.99,18,6,15,1,True
3378894,873,4,-1,5442,706487512,0,1,0,979.9,1,325944.99,24,4,14,1,True
3409519,594,0,30,5937,706487512,0,0,0,980.41,8,324964.58,24,3,7,1,True
3505854,1009,0,-1,9185,706487512,0,1,0,980.32,4,324964.58,26,0,5,2,True
3508067,532,4,-1,8409,706487512,0,2,0,980.05,4,324964.58,18,6,9,3,True
3610966,1009,0,30,4113,706487512,0,0,0,980.31,8,323984.27,26,0,8,4,True
3678398,480,0,20,7433,706487512,0,0,0,980.02,5,323004.25,5,4,17,5,True
3864828,1150,0,20,5937,706487512,0,0,0,980.34,3,322023.91,15,4,12,5,True
4000249,749,4,-1,4113,706487512,0,1,0,979.78,4,322023.91,24,4,20,7,False
4130052,594,0,451,4113,706487512,0,0,0,979.89,7,321044.02,24,4,21,8,True
4224477,1009,0,-1,4025,706487512,0,1,0,980.16,4,321044.02,26,2,7,9,True
4416824,967,1,25,3684,706487512,0,0,0,979.85,8,320064.17,13,0,16,10,True
4480720,373,1,-1,3601,706487512,0,1,0,980.17,4,320064.17,25,0,4,11,True
4574410,873,4,451,3601,706487512,0,0,0,980.1,7,319084.07,24,3,13,11,True
4801879,594,0,451,3601,706487512,0,0,0,979.98,7,318104.09,24,3,15,1,False
4917357,373,1,30,3601,706487512,0,0,0,979.82,8,317124.27,25,0,17,3,True
5253405,532,4,25,3318,706487512,0,0,0,979.77,8,316144.5,18,2,2,3,True
5309790,967,1,30,8409,706487512,0,0,0,979.99,8,315164.51,13,6,4,3,True
5381648,749,4,451,5937,706487512,0,0,0,979.81,7,314184.7,24,3,0,3,True
5504338,967,1,-1,1292,706487512,0,1,0,980.06,4,314184.7,13,5,22,4,True
5814104,204,0,10,9185,706487512,0,0,0,980.23,6,315164.93,9,3,18,5,True
6392022,594,0,25,4025,706487512,0,0,0,980.08,8,314184.85,24,5,6,6,True
6467626,873,4,25,3036,706487512,0,0,0,979.61,8,313205.24,24,2,17,6,True
6508010,873,4,451,7433,706487512,0,0,0,979.93,7,312225.31,24,5,13,6,False
6511031,873,4,30,3351,706487512,0,0,0,979.89,8,311245.42,24,6,6,6,True
6514555,594,0,451,3036,706487512,0,0,0,979.97,7,310265.45,24,2,14,7,True
6542470,373,1,451,3318,706487512,0,0,0,980.0,7,309285.45,25,6,15,7,True
6644541,1471,0,20,3998,706487512,0,0,0,979.72,5,308305.73,24,1,20,7,True
6674255,873,4,25,3318,706487512,0,0,0,979.73,8,307326.0,24,2,17,8,True
6793358,967,1,30,3318,706487512,0,0,0,979.91,8,306346.09,13,3,9,8,True
7016128,749,4,30,5937,706487512,0,0,0,980.15,8,305365.94,24,1,10,8,True
7204427,1364,0,20,3998,706487512,0,0,0,980.11,3,304385.83,16,3,13,8,True
7404535,594,0,25,8409,706487512,0,0,0,979.82,8,303406.01,24,4,11,8,True
8310991,1009,0,25,8409,706487512,0,0,0,979.99,8,302426.02,26,5,19,8,True
8323505,863,4,451,4025,706487512,0,0,0,980.01,7,301446.01,24,6,20,10,True
8370491,1425,0,10,5442,706487512,0,0,0,980.15,6,302426.16,24,1,6,11,True
8692131,594,0,25,3684,706487512,0,0,0,980.0,8,301446.16,24,6,5,11,True
9127558,1009,0,25,3601,706487512,0,0,0,980.12,8,300466.04,26,0,7,11,True
1216791,930,3,30,7987,404966438,0,0,0,806.11,8,438386.89,18,3,11,1,True
1984695,790,0,10,9222,404966438,0,0,0,806.06,6,439192.95,11,3,15,1,True
2043935,1282,2,20,1873,404966438,0,0,0,806.04,5,438386.91,24,5,14,1,True
2093497,121,4,-1,7266,404966438,0,1,0,806.06,4,438386.91,18,6,11,1,True
2193147,824,2,20,4239,404966438,0,0,0,805.97,5,437580.94,18,6,16,1,True
2337480,739,1,10,9900,404966438,0,0,0,806.0,0,438386.94,24,2,9,2,True
2631760,1424,4,-1,9900,404966438,0,1,0,806.31,1,438386.94,24,6,11,3,True
2647607,1262,0,451,9900,404966438,0,0,0,806.14,7,437580.8,23,6,20,3,True
2783287,121,4,25,6793,404966438,0,0,0,805.88,8,436774.92,18,5,21,4,True
2815243,121,4,451,8388,404966438,0,0,0,806.05,7,435968.87,18,0,8,4,True
2933392,940,1,10,4461,404966438,0,0,0,805.56,0,436774.43,24,3,9,5,True
3077709,1053,1,10,3043,404966438,0,0,0,806.04,6,437580.47,11,1,19,5,True
3191976,589,1,-1,7266,404966438,0,1,0,805.78,4,437580.47,24,1,15,6,True
3211292,1424,4,25,7253,404966438,0,0,0,806.19,8,436774.28,24,4,22,6,True
3238900,121,4,451,9222,404966438,0,0,0,805.89,7,435968.39,18,3,1,7,True
3413201,1262,0,25,5220,404966438,0,0,0,805.96,8,435162.43,23,1,18,8,True
3427539,589,1,-1,1873,404966438,0,1,0,806.05,4,435162.43,24,2,12,8,True
3505115,734,0,10,5994,404966438,0,0,0,805.9,0,435968.33,11,5,22,9,True
3619806,1424,4,-1,9291,404966438,0,1,0,806.01,1,435968.33,24,2,8,9,True
3715747,121,4,30,8988,404966438,0,0,0,805.8,8,435162.53,18,6,14,10,True
4090417,589,1,30,7987,404966438,0,0,0,805.86,8,434356.67,24,1,14,10,True
4209527,1387,1,10,4461,404966438,0,0,0,806.26,0,435162.93,24,6,20,10,True
4288151,1262,0,-1,6777,404966438,0,1,0,805.94,1,435162.93,23,2,9,11,True
4445571,898,1,451,8967,404966438,0,0,0,806.18,7,434356.75,24,6,10,11,True
5301794,589,1,30,3043,404966438,0,0,0,806.05,8,433550.7,24,1,6,12,True
5351489,913,0,20,3043,404966438,0,0,0,806.03,3,432744.67,18,4,5,12,True
5394199,562,1,10,7987,404966438,0,0,0,805.83,6,433550.5,17,0,19,1,True
5663846,1227,0,451,7266,404966438,0,0,0,805.98,7,432744.52,18,3,21,3,True
5749578,930,3,451,8519,404966438,0,0,0,806.1,7,431938.42,18,6,18,4,True
6177926,800,0,10,5220,404966438,0,0,0,806.07,6,432744.49,11,6,5,4,True
6271614,201,1,10,5994,404966438,0,0,0,805.93,0,433550.42,9,5,15,5,True
6339808,1227,0,30,8967,404966438,0,0,0,805.96,8,432744.46,18,3,21,6,True
6365959,1483,0,20,8388,404966438,0,0,0,806.08,3,431938.38,24,6,14,6,True
6487612,1227,0,30,9222,404966438,0,0,0,806.1,8,431132.28,18,1,17,7,True
6505578,930,3,25,8967,404966438,0,0,0,805.85,8,430326.43,18,5,1,8,True
6717543,1160,0,10,9488,404966438,0,0,0,806.22,6,431132.65,15,3,4,11,True
6817038,298,4,25,8519,404966438,0,0,0,806.07,8,430326.58,4,3,13,11,True
7100325,117,1,25,8388,404966438,0,0,0,806.2,8,429520.38,18,3,2,11,True
7196655,930,3,30,8967,404966438,0,0,0,805.86,8,428714.52,18,3,15,12,True
7271421,930,3,451,7253,404966438,0,0,0,805.69,7,427908.83,18,1,19,1,True
7466743,1227,0,30,9291,404966438,0,0,0,805.81,8,427103.02,18,2,2,1,True
7518222,716,0,10,6793,404966438,0,0,0,806.01,6,427909.03,18,1,3,2,True
7556254,121,4,30,6793,404966438,0,0,0,805.81,8,427103.22,18,4,18,2,True
7666653,1226,2,20,8988,404966438,0,0,0,806.19,3,426297.03,18,3,23,2,True
8188123,898,1,25,1375,404966438,0,0,0,806.03,8,425491.0,24,5,10,3,True
8532866,117,1,451,5220,404966438,0,0,0,805.9,7,424685.1,18,0,18,4,True
9242737,898,1,-1,5220,404966438,0,1,0,806.12,4,424685.1,24,4,19,5,True
9258804,898,1,25,9488,404966438,0,0,0,806.18,8,423878.92,24,1,9,5,True
9329014,121,4,25,5220,404966438,0,0,0,805.9,8,423073.02,18,4,16,6,True
9409438,930,3,25,9222,404966438,0,0,0,805.89,8,422267.13,18,1,9,7,True
9463521,1262,0,25,8967,404966438,0,0,0,806.05,8,421461.08,23,4,5,8,True
9592457,726,0,10,5220,404966438,0,0,0,806.1,6,422267.18,11,5,10,8,True
9790348,298,4,30,8388,404966438,0,0,0,806.06,8,421461.12,4,4,22,9,True
9917940,117,1,451,8519,404966438,0,0,0,806.05,7,420655.07,18,0,16,10,True
9992387,930,3,25,7987,404966438,0,0,0,806.15,8,419848.92,18,5,11,11,True
1099780,298,4,451,2095,306334557,0,0,0,182.0,7,792975.0,4,4,19,2,True
1145266,781,1,10,3982,306334557,0,0,0,182.17,0,793157.17,14,2,15,2,True
1193667,728,1,451,7300,306334557,0,0,0,181.85,7,792975.32,11,6,16,3,True
1321283,1405,4,451,8107,306334557,0,0,0,181.65,7,792793.67,24,3,19,3,True
1413735,487,4,451,7279,306334557,0,0,0,181.93,7,792611.74,12,1,14,3,True
1451553,498,0,10,9459,306334557,0,0,0,181.85,6,792793.59,12,5,4,4,True
1482298,1094,0,20,7300,306334557,0,0,0,182.02,3,792611.57,0,6,2,5,True
1850354,200,0,20,3817,306334557,0,0,0,182.3,3,792429.27,9,0,18,5,True
1865821,1307,0,30,6433,306334557,0,0,0,181.72,8,792247.55,5,6,5,5,True
1938388,1307,0,451,3817,306334557,0,0,0,181.88,7,792065.67,5,3,5,5,True
2144816,1307,0,30,2166,306334557,0,0,0,182.18,8,791883.49,5,0,13,5,True
2506966,1058,4,451,6665,306334557,0,0,0,182.03,7,791701.46,11,2,3,5,True
2707705,1047,3,-1,9459,306334557,0,1,0,182.07,4,791701.46,11,5,21,8,True
2815779,728,1,451,6393,306334557,0,0,0,181.6,7,791519.86,11,0,10,8,True
3061915,1307,0,30,2740,306334557,0,0,0,181.99,8,791337.87,5,2,12,10,True
3664634,1405,4,451,6814,306334557,0,0,0,182.12,7,791155.75,24,4,0,10,True
3834793,459,1,10,6078,306334557,0,0,0,182.05,6,791337.8,13,2,7,12,True
3978919,1058,4,451,4675,306334557,0,0,0,182.01,7,791155.79,11,1,22,12,True
4108280,1307,0,-1,1444,306334557,0,1,0,181.94,1,791155.79,5,2,3,12,True
4276638,1156,1,10,9391,306334557,0,0,0,181.77,6,791337.56,15,2,16,12,True
4299533,487,4,25,2900,306334557,0,0,0,181.66,8,791155.9,12,0,19,1,False
4382025,487,4,25,3982,306334557,0,0,0,182.01,8,790973.89,12,4,17,1,True
4399206,728,1,25,6665,306334557,0,0,0,181.96,8,790791.93,11,5,9,3,True
4981297,689,0,10,9459,306334557,0,0,0,182.08,6,790974.01,24,6,17,3,True
4981403,487,4,25,6665,306334557,0,0,0,181.97,8,790792.04,12,4,2,3,True
5022452,406,1,10,7787,306334557,0,0,0,181.87,6,790973.91,10,1,14,4,True
5423224,343,1,10,7300,306334557,0,0,0,181.99,0,791155.9,24,0,4,4,True
5493207,728,1,25,8107,306334557,0,0,0,182.02,8,790973.88,11,3,0,4,True
5589932,254,0,20,4675,306334557,0,0,0,181.91,5,790791.97,6,2,16,5,True
5611461,1029,0,20,3817,306334557,0,0,0,182.06,3,790609.91,11,5,0,8,True
5712825,276,0,10,2900,306334557,0,0,0,182.18,6,790792.09,24,4,7,8,True
5965288,1425,0,20,4675,306334557,0,0,0,182.11,5,790609.98,24,4,10,9,False
6071696,298,4,30,9459,306334557,0,0,0,181.79,8,790428.19,4,3,15,9,True
6415495,1058,4,25,2095,306334557,0,0,0,181.85,8,790246.34,11,2,3,9,True
6485442,1405,4,25,2095,306334557,0,0,0,182.01,8,790064.33,24,4,17,10,False
6675168,487,4,30,7279,306334557,0,0,0,181.99,8,789882.34,12,4,20,10,True
6837041,1058,4,25,2166,306334557,0,0,0,181.83,8,789700.51,11,2,9,11,True
6977950,487,4,25,5769,306334557,0,0,0,182.08,8,789518.43,12,1,20,11,True
7027098,1405,4,451,7300,306334557,0,0,0,182.0,7,789336.43,24,3,9,12,False
7193379,298,4,25,6591,306334557,0,0,0,182.29,8,789154.14,4,1,0,12,False
7203903,1058,4,25,6078,306334557,0,0,0,182.1,8,788972.04,11,1,7,1,True
7298935,1307,0,-1,6814,306334557,0,1,0,182.02,1,788972.04,5,3,11,2,False
7602839,1405,4,30,6078,306334557,0,0,0,182.19,8,788789.85,24,1,12,4,True
7757890,1307,0,30,6433,306334557,0,0,0,182.2,8,788607.65,5,4,6,4,True
7828269,298,4,451,7894,306334557,0,0,0,182.1,7,788425.55,4,6,8,4,True
7936747,1307,0,451,3982,306334557,0,0,0,182.1,7,788243.45,5,2,22,5,True
7945376,1047,3,451,6078,306334557,0,0,0,182.19,7,788061.26,11,0,10,6,True
8357508,1047,3,25,3982,306334557,0,0,0,181.73,8,787879.53,11,1,18,7,True
8372838,487,4,25,2166,306334557,0,0,0,181.9,8,787697.63,12,3,14,8,True
8566776,298,4,451,7279,306334557,0,0,0,181.88,7,787515.75,4,3,22,8,True
9158067,728,1,451,2095,306334557,0,0,0,182.18,7,787333.57,11,0,6,9,True
9285012,487,4,30,9391,306334557,0,0,0,182.07,8,787151.5,12,4,7,9,True
9289860,871,0,10,7894,306334557,0,0,0,181.99,6,787333.49,24,5,8,9,True
9335414,487,4,451,6665,306334557,0,0,0,182.01,7,787151.48,12,5,21,11,True
9961185,487,4,30,6814,306334557,0,0,0,181.93,8,786969.55,12,2,18,11,True
1172492,32,3,451,9873,327391406,1,0,0,762.07,7,527439.93,11,1,17,1,True
1591442,1117,4,25,5540,327391406,1,0,0,761.98,8,526677.95,24,2,14,1,True
1626435,662,1,10,5020,327391406,1,0,0,762.04,0,527439.99,18,4,11,1,True
1952820,1456,4,25,5054,327391406,1,0,0,762.21,8,526677.78,11,5,12,2,True
2261641,314,0,20,2589,327391406,1,0,0,762.15,5,525915.63,4,3,3,3,True
2541716,1117,4,-1,5020,327391406,1,1,0,761.89,4,525915.63,24,1,16,3,True
2872737,1456,4,25,5075,327391406,1,0,0,762.12,8,525153.51,11,2,15,4,True
3374295,46,1,10,1145,327391406,1,0,0,761.87,0,525915.38,24,6,20,4,True
3503320,215,0,451,9614,327391406,1,0,0,762.21,7,525153.17,9,5,22,4,True
3511632,1082,3,451,3742,327391406,1,0,0,761.74,7,524391.43,18,3,0,5,True
3575693,1082,3,30,7864,327391406,1,0,0,762.23,8,523629.2,18,1,4,6,True
3630297,1035,0,451,7864,327391406,1,0,0,762.16,7,522867.04,11,6,16,6,True
3685146,826,1,10,4226,327391406,1,0,0,761.67,0,523628.71,18,4,17,7,True
3704230,1117,4,25,9614,327391406,1,0,0,762.17,8,522866.54,24,5,10,7,True
3948325,1082,3,30,4945,327391406,1,0,0,762.3,8,522104.24,18,6,13,9,False
4133232,1456,4,451,3107,327391406,1,0,0,761.97,7,521342.27,11,4,6,9,True
4429467,427,2,20,9873,327391406,1,0,0,761.88,5,520580.39,18,1,3,10,True
4517189,579,0,20,8562,327391406,1,0,0,761.91,3,519818.48,11,3,11,10,True
4743038,215,0,30,7864,327391406,1,0,0,761.88,8,519056.6,9,2,7,1,False
4870058,1117,4,30,8562,327391406,1,0,0,761.72,8,518294.88,24,4,22,1,True
5246174,1117,4,451,9873,327391406,1,0,0,761.81,7,517533.07,24,1,12,1,True
5259736,1035,0,30,2488,327391406,1,0,0,762.21,8,516770.86,11,5,4,2,True
5445016,32,3,25,6684,327391406,1,0,0,761.85,8,516009.01,11,5,8,3,False
5513480,664,2,20,5054,327391406,1,0,0,762.05,3,515246.96,18,5,0,3,True
5546919,1082,3,451,5054,327391406,1,0,0,762.06,7,514484.9,18,2,5,3,True
5664254,215,0,451,9614,327391406,1,0,0,762.02,7,513722.88,9,4,7,3,True
5822831,1035,0,451,3107,327391406,1,0,0,761.88,7,512961.0,11,6,7,4,True
6788439,1117,4,451,3865,327391406,1,0,0,761.96,7,512199.04,24,0,2,5,True
6975107,215,0,25,3107,327391406,1,0,0,761.87,8,511437.17,9,0,11,6,True
7046193,583,2,20,6684,327391406,1,0,0,761.86,5,510675.31,11,1,1,7,True
7188839,1285,1,10,3865,327391406,1,0,0,761.97,0,511437.28,24,4,22,10,True
7234242,1307,0,20,3828,327391406,1,0,0,761.98,5,510675.3,5,5,13,1,True
7318511,1456,4,25,5075,327391406,1,0,0,762.02,8,509913.28,11,3,2,2,True
7357359,1082,3,451,2488,327391406,1,0,0,761.94,7,509151.34,18,6,5,2,True
7593200,1082,3,451,5020,327391406,1,0,0,762.16,7,508389.18,18,3,10,3,True
7843368,1075,0,20,7051,327391406,1,0,0,761.97,5,507627.21,18,1,7,4,True
7846152,567,1,10,5075,327391406,1,0,0,761.78,0,508388.99,11,5,2,4,True
8089402,1063,0,20,3107,327391406,1,0,0,761.96,5,507627.03,11,5,20,5,True
8117301,1456,4,451,3742,327391406,1,0,0,761.85,7,506865.18,11,2,11,6,True
8397632,1170,0,20,9614,327391406,1,0,0,761.95,3,506103.23,24,0,17,7,True
8501243,1082,3,30,5020,327391406,1,0,0,761.9,8,505341.33,18,6,15,8,False
8559674,20,0,20,3742,327391406,1,0,0,762.08,5,504579.25,24,0,10,8,True
8694531,195,1,10,9873,327391406,1,0,0,762.25,6,505341.5,18,0,19,9,True
9154814,32,3,451,2488,327391406,1,0,0,762.0,7,504579.5,11,1,10,9,True
9168124,276,0,10,8863,327391406,1,0,0,761.76,6,505341.26,24,6,2,9,True
9193921,1086,0,451,3828,327391406,1,0,0,762.14,7,504579.12,18,1,18,9,True
9197267,32,3,451,8572,327391406,1,0,0,762.0,7,503817.12,11,5,9,11,True
9291804,850,1,10,4226,327391406,1,0,0,761.81,0,504578.93,5,6,4,11,True
9675494,1117,4,25,3735,327391406,1,0,0,762.01,8,503816.92,24,3,6,11,True
9840300,802,2,20,3828,327391406,1,0,0,762.06,5,503054.86,11,5,16,11,True
1468613,479,2,25,6695,590693578,1,0,0,844.18,8,951876.82,5,6,20,1,True
1477723,613,4,451,3397,590693578,1,0,0,844.37,7,951032.45,11,5,6,2,True
1745131,1380,0,20,4177,590693578,1,0,0,844.1,3,950188.35,16,4,20,2,True
1796575,613,4,451,9036,590693578,1,0,0,843.95,7,949344.4,11,4,18,3,True
1813424,980,1,-1,4108,590693578,1,1,0,843.97,1,949344.4,22,6,15,3,True
1855237,645,0,30,3377,590693578,1,0,0,844.17,8,948500.23,24,4,9,4,True
1989643,863,4,-1,3397,590693578,1,1,0,844.09,4,948500.23,24,1,7,5,True
2088190,613,4,25,7970,590693578,1,0,0,844.2,8,947656.03,11,1,22,5,True
2381970,224,3,451,3586,590693578,1,0,0,843.82,7,946812.21,26,4,15,6,True
2594073,364,4,25,7970,590693578,1,0,0,844.04,8,945968.17,25,0,5,8,True
2648999,364,4,451,9036,590693578,1,0,0,843.92,7,945124.25,25,4,22,10,True
2720580,223,2,20,3397,590693578,1,0,0,844.03,5,944280.22,26,5,16,12,True
3031922,846,3,451,7970,590693578,1,0,0,843.94,7,943436.28,5,1,5,12,True
3150716,224,3,451,1622,590693578,1,0,0,844.01,7,942592.27,26,5,10,1,True
3221547,1429,0,10,3777,590693578,1,0,0,843.98,0,943436.25,24,6,9,2,True
3768123,1010,0,10,6242,590693578,1,0,0,844.08,6,944280.33,26,6,6,2,True
4056713,224,3,-1,9036,590693578,1,1,0,844.0,4,944280.33,26,5,20,3,True
4127521,613,4,30,7970,590693578,1,0,0,843.82,8,943436.51,11,0,4,3,True
4801426,1027,0,10,6695,590693578,1,0,0,844.01,6,944280.52,11,3,5,3,True
4934537,645,0,25,6242,590693578,1,0,0,844.09,8,943436.43,24,0,22,3,True
4958773,479,2,25,3586,590693578,1,0,0,844.01,8,942592.42,5,2,19,3,True
5145314,613,4,451,5649,590693578,1,0,0,843.99,7,941748.43,11,3,8,3,True
5175980,645,0,-1,3996,590693578,1,1,0,843.97,1,941748.43,24,6,17,4,True
5288173,364,4,451,3377,590693578,1,0,0,844.33,7,940904.1,25,2,19,4,True
5393500,215,0,10,1622,590693578,1,0,0,843.76,6,941747.86,9,6,3,5,True
5427408,846,3,-1,3996,590693578,1,1,0,844.13,4,941747.86,5,2,0,6,False
5676958,1142,2,20,7970,590693578,1,0,0,843.88,3,940903.98,15,1,2,6,True
5854431,645,0,25,1622,590693578,1,0,0,843.89,8,940060.09,24,1,7,6,True
5873209,846,3,-1,3377,590693578,1,1,0,844.03,4,940060.09,5,6,13,7,True
5935330,1413,0,10,3397,590693578,1,0,0,844.03,0,940904.12,24,5,4,7,True
6020236,613,4,451,9585,590693578,1,0,0,844.1,7,940060.02,11,4,10,7,True
6040692,135,2,20,6242,590693578,1,0,0,843.64,5,939216.38,18,4,4,8,True
6426558,224,3,25,6695,590693578,1,0,0,843.94,8,938372.44,26,3,15,9,True
6804632,1037,0,20,4108,590693578,1,0,0,843.9,3,937528.54,11,0,9,10,True
6807404,479,2,451,7877,590693578,1,0,0,844.09,7,936684.45,5,0,18,11,True
6890653,645,0,30,9585,590693578,1,0,0,843.82,8,935840.63,24,3,10,11,True
6976001,224,3,30,4177,590693578,1,0,0,844.28,8,934996.35,26,4,9,12,False
7008242,613,4,30,4108,590693578,1,0,0,843.96,8,934152.39,11,0,3,1,True
7138679,645,0,30,6695,590693578,1,0,0,843.8,8,933308.59,24,1,17,4,True
7283809,645,0,451,4108,590693578,1,0,0,844.26,7,932464.33,24,2,22,6,True
7673643,1134,1,10,7970,590693578,1,0,0,844.23,0,933308.56,24,4,13,6,True
7847737,980,1,30,3377,590693578,1,0,0,844.1,8,932464.46,22,6,9,7,True
7926207,364,4,30,4177,590693578,1,0,0,844.08,8,931620.38,25,5,7,7,True
8191385,863,4,-1,5649,590693578,1,1,0,843.82,1,931620.38,24,5,0,8,True
8279157,1321,0,10,7877,590693578,1,0,0,843.99,0,932464.37,18,5,8,8,True
8592664,645,0,25,5649,590693578,1,0,0,844.09,8,931620.28,24,1,5,10,True
8731998,863,4,30,6242,590693578,1,0,0,843.78,8,930776.5,24,2,16,10,True
9043008,980,1,451,5649,590693578,1,0,0,844.16,7,929932.34,22,5,7,10,True
9328687,224,3,-1,7877,590693578,1,1,0,844.13,1,929932.34,26,5,23,10,True
9518735,479,2,451,4108,590693578,1,0,0,843.84,7,929088.5,5,4,13,11,True
1036852,603,0,25,8321,188118633,0,0,0,780.93,8,445145.07,24,4,3,1,True
1058531,1486,2,20,5514,188118633,0,0,0,781.2,5,444363.87,24,2,3,1,True
1353655,1028,4,30,2737,188118633,0,0,0,780.93,8,443582.94,11,0,5,1,True
1380009,603,0,25,6615,188118633,0,0,0,781.16,8,442801.78,24,0,19,3,True
1524990,180,0,20,6892,188118633,0,0,0,781.21,3,442020.57,18,1,23,3,True
1804751,459,1,451,2121,188118633,0,0,0,780.95,7,441239.62,13,1,2,4,True
1924336,1028,4,451,1427,188118633,0,0,0,780.97,7,440458.65,11,6,3,6,True
2087937,372,0,25,1427,188118633,0,0,0,780.92,8,439677.73,25,5,10,6,True
2373573,459,1,451,9633,188118633,0,0,0,780.94,7,438896.79,13,4,1,8,True
2435912,603,0,25,2121,188118633,0,0,0,781.03,8,438115.76,24,0,18,8,True
2776569,459,1,451,2329,188118633,0,0,0,781.23,7,437334.53,13,2,3,9,True
2819354,470,1,25,5550,188118633,0,0,0,781.09,8,436553.44,5,5,12,10,True
2890984,215,0,-1,6892,188118633,0,1,0,780.88,4,436553.44,9,1,14,11,True
3006558,470,1,30,5514,188118633,0,0,0,781.16,8,435772.28,5,3,16,11,True
3094076,372,0,451,7229,188118633,0,0,0,781.16,7,434991.12,25,3,19,11,True
3443364,980,1,10,5255,188118633,0,0,0,781.05,0,435772.17,22,1,20,2,True
3666621,470,1,451,1935,188118633,0,0,0,780.8,7,434991.37,5,3,6,3,True
3952682,27,0,10,2329,188118633,0,0,0,780.97,0,435772.34,11,0,2,4,True
4001812,372,0,30,5564,188118633,0,0,0,781.14,8,434991.2,25,2,1,5,True
4222681,470,1,451,5514,188118633,0,0,0,781.09,7,434210.11,5,2,11,6,True
4470553,215,0,451,7229,188118633,0,0,0,781.22,7,433428.89,9,5,6,7,True
4474830,457,0,20,6615,188118633,0,0,0,781.0,5,432647.89,13,2,9,8,True
4507501,1409,1,10,1427,188118633,0,0,0,781.0,6,433428.89,24,3,13,8,True
4514719,1028,4,451,6784,188118633,0,0,0,780.9,7,432647.99,11,2,9,8,True
4537356,457,0,10,7286,188118633,0,0,0,780.94,6,433428.93,13,3,3,10,True
4613111,470,1,25,6615,188118633,0,0,0,781.1,8,432647.83,5,1,3,11,True
4916609,603,0,30,1267,188118633,0,0,0,781.23,8,431866.6,24,4,23,11,True
5234647,470,1,30,3603,188118633,0,0,0,781.13,8,431085.47,5,6,12,11,True
5830936,459,1,-1,3603,188118633,0,1,0,781.15,4,431085.47,13,1,5,12,True
5831941,1192,2,20,1850,188118633,0,0,0,780.89,3,430304.58,24,5,15,1,True
5968406,406,1,10,9868,188118633,0,0,0,781.07,6,431085.65,10,5,0,2,True
6326721,1471,0,20,5514,188118633,0,0,0,780.86,5,430304.79,24,6,22,2,True
6524842,991,1,10,1267,188118633,0,0,0,780.98,6,431085.77,22,2,20,2,True
6551615,1474,0,451,5514,188118633,0,0,0,780.8,7,430304.97,24,2,3,4,True
6813142,215,0,25,5550,188118633,0,0,0,780.78,8,429524.19,9,6,21,4,True
6912759,1159,0,20,6615,188118633,0,0,0,780.7,5,428743.49,15,5,4,4,True
6974377,603,0,-1,5255,188118633,0,1,0,780.94,1,428743.49,24,5,13,6,True
7018765,603,0,30,5550,188118633,0,0,0,780.84,8,427962.65,24,1,23,6,True
7153712,470,1,-1,6892,188118633,0,1,0,780.96,1,427962.65,5,4,15,6,True
7459882,1273,0,10,4098,188118633,0,0,0,781.07,6,428743.72,24,5,23,7,True
7497036,372,0,451,2121,188118633,0,0,0,781.02,7,427962.7,25,5,10,8,True
7588108,1474,0,451,1427,188118633,0,0,0,781.07,7,427181.63,24,0,19,8,True
7772188,1086,0,10,5514,188118633,0,0,0,780.88,6,427962.51,18,1,20,8,True
8072129,372,0,451,7418,188118633,0,0,0,781.01,7,427181.5,25,1,21,8,True
8371951,1277,2,20,6784,188118633,0,0,0,781.23,5,426400.27,24,0,19,9,True
8391683,372,0,25,1850,188118633,0,0,0,780.92,8,425619.35,25,4,9,9,True
8397555,372,0,451,2121,188118633,0,0,0,781.04,7,424838.31,25,0,0,9,True
8761892,215,0,-1,9633,188118633,0,1,0,780.8,4,424838.31,9,6,16,9,True
9009347,1356,2,20,3603,188118633,0,0,0,781.2,3,424057.11,24,3,13,10,True
9227275,1474,0,451,7418,188118633,0,0,0,780.98,7,423276.13,24,3,5,11,True
9319745,1028,4,25,2737,188118633,0,0,0,781.15,8,422494.98,11,4,22,11,True
9446971,459,1,-1,6892,188118633,0,1,0,780.96,1,422494.98,13,6,20,11,False
9663101,603,0,25,6615,188118633,0,0,0,781.11,8,421713.87,24,2,18,11,True
1022854,211,0,20,8871,784296256,1,0,0,327.06,3,456105.94,9,1,9,2,True
1107341,200,0,20,8077,784296256,1,0,0,327.16,5,455778.78,9,3,20,3,True
1178096,568,1,10,2775,784296256,1,0,0,327.01,0,456105.79,11,3,5,3,True
1412862,274,1,25,4285,784296256,1,0,0,327.1,8,455778.69,24,5,2,3,True
1472933,343,1,10,5390,784296256,1,0,0,326.82,6,456105.51,24,6,15,4,True
1613636,715,0,10,8442,784296256,1,0,0,326.9,6,456432.41,18,5,0,4,True
1656124,333,1,10,1301,784296256,1,0,0,327.05,6,456759.46,11,6,23,5,True
1693314,485,1,30,1489,784296256,1,0,0,327.01,8,456432.45,5,3,21,6,True
2001445,274,1,451,8127,784296256,1,0,0,327.02,7,456105.43,24,0,0,8,True
2073084,35,2,20,8442,784296256,1,0,0,327.03,5,455778.4,11,2,13,9,True
2229126,1476,0,25,2775,784296256,1,0,0,326.78,8,455451.62,24,3,10,9,True
2585870,485,1,30,5513,784296256,1,0,0,326.86,8,455124.76,5,1,2,10,True
2835760,485,1,451,8077,784296256,1,0,0,326.94,7,454797.82,5,5,1,11,True
2858152,1476,0,25,4163,784296256,1,0,0,326.95,8,454470.87,24,3,15,12,True
3431456,274,1,-1,5390,784296256,1,1,0,326.89,4,454470.87,24,5,0,1,True
3478807,269,0,451,4747,784296256,1,0,0,326.99,7,454143.88,24,0,3,2,True
3747266,1029,0,20,8871,784296256,1,0,0,327.05,5,453816.83,11,0,6,2,True
3819455,274,1,30,6876,784296256,1,0,0,327.09,8,453489.74,24,2,22,3,True
3978640,1461,0,451,1568,784296256,1,0,0,326.96,7,453162.78,11,6,7,3,True
4007424,1476,0,451,1220,784296256,1,0,0,327.14,7,452835.64,24,4,16,5,True
4534103,1184,4,30,2775,784296256,1,0,0,326.97,8,452508.67,24,2,22,5,True
4654849,274,1,451,9164,784296256,1,0,0,327.21,7,452181.46,24,3,4,6,True
4679806,1184,4,30,4136,784296256,1,0,0,327.17,8,451854.29,24,2,7,7,True
4779138,485,1,25,1615,784296256,1,0,0,326.94,8,451527.35,5,4,18,9,True
5071076,1476,0,-1,6876,784296256,1,1,0,327.03,4,451527.35,24,5,20,10,True
5210170,269,0,451,6739,784296256,1,0,0,326.94,7,451200.41,24,0,6,10,True
5289458,1476,0,25,8871,784296256,1,0,0,327.1,8,450873.31,24,3,21,11,True
5551587,274,1,451,5390,784296256,1,0,0,326.76,7,450546.55,24,6,11,11,True
5743339,485,1,30,4136,784296256,1,0,0,327.08,8,450219.47,5,5,1,12,True
5767125,1184,4,451,6739,784296256,1,0,0,326.96,7,449892.51,24,1,20,1,False
6026074,1461,0,-1,2775,784296256,1,1,0,326.87,1,449892.51,11,2,7,1,True
6336041,269,0,30,4747,784296256,1,0,0,326.95,8,449565.56,24,1,19,2,True
6562695,159,2,20,4285,784296256,1,0,0,326.97,5,449238.59,24,5,17,2,True
6944309,611,0,10,8127,784296256,1,0,0,326.94,6,449565.53,11,4,20,3,True
7117683,1184,4,-1,6876,784296256,1,1,0,327.4,4,449565.53,24,4,22,3,True
7324399,1377,0,10,4747,784296256,1,0,0,327.15,6,449892.68,16,5,1,3,True
7373356,269,0,451,9164,784296256,1,0,0,327.18,7,449565.5,24,6,11,5,True
7642021,1461,0,30,4136,784296256,1,0,0,327.15,8,449238.35,11,6,18,5,True
7659438,274,1,451,5390,784296256,1,0,0,326.86,7,448911.49,24,0,15,5,True
7907752,1476,0,451,4136,784296256,1,0,0,327.13,7,448584.36,24,2,0,5,True
8025455,274,1,-1,4136,784296256,1,1,0,327.07,4,448584.36,24,1,21,7,True
8084147,1184,4,30,1568,784296256,1,0,0,327.14,8,448257.22,24,5,2,8,True
8277312,1010,0,10,9164,784296256,1,0,0,326.7,0,448583.92,26,5,22,8,True
8420909,485,1,-1,4136,784296256,1,1,0,326.9,4,448583.92,5,4,20,9,True
8553464,910,0,20,8442,784296256,1,0,0,326.92,5,448257.0,18,2,4,9,True
8782611,485,1,451,1615,784296256,1,0,0,326.92,7,447930.08,5,5,8,10,True
8901957,411,2,20,8442,784296256,1,0,0,326.97,5,447603.11,18,0,20,10,True
9041329,219,0,10,2775,784296256,1,0,0,327.0,0,447930.11,9,3,7,10,True
9056414,269,0,-1,5024,784296256,1,1,0,326.73,4,447930.11,24,5,13,10,True
9208107,785,0,20,1568,784296256,1,0,0,326.93,5,447603.18,14,2,20,11,True
9333037,1485,0,10,6876,784296256,1,0,0,326.71,6,447929.89,24,1,9,11,True
9687850,269,0,451,8127,784296256,1,0,0,326.72,7,447603.17,24,2,0,11,False
1036399,443,2,20,9573,140659914,0,0,0,1125.11,5,633593.89,24,6,5,1,True
1170280,182,1,30,4664,140659914,0,0,0,1125.2,8,632468.69,18,6,16,1,True
1474871,182,1,25,9573,140659914,0,0,0,1124.96,8,631343.73,18,3,5,1,True
1530528,1435,2,25,4552,140659914,0,0,0,1125.05,8,630218.68,24,5,1,2,True
1622620,1141,4,25,4664,140659914,0,0,0,1124.85,8,629093.83,15,5,4,2,True
1814166,91,4,451,2433,140659914,0,0,0,1124.79,7,627969.04,1,5,12,4,True
2372875,182,1,451,3733,140659914,0,0,0,1124.89,7,626844.15,18,1,17,4,True
2496928,806,1,10,2190,140659914,0,0,0,1125.0,6,627969.15,11,2,19,6,True
2706164,1072,0,10,2442,140659914,0,0,0,1125.0,6,629094.15,18,3,17,8,True
2908005,182,1,25,3354,140659914,0,0,0,1124.93,8,627969.22,18,2,23,9,True
3382494,424,1,10,2433,140659914,0,0,0,1125.05,0,629094.27,18,4,15,10,True
3713780,1413,0,25,9573,140659914,0,0,0,1124.72,8,627969.55,24,2,15,11,True
3888652,91,4,30,3105,140659914,0,0,0,1124.91,8,626844.64,1,4,5,11,True
4200722,940,1,451,4664,140659914,0,0,0,1125.03,7,625719.61,24,6,15,11,True
4610687,1435,2,-1,2287,140659914,0,1,0,1124.99,4,625719.61,24,5,18,12,True
4662451,1103,4,451,6366,140659914,0,0,0,1125.22,7,624594.39,0,2,23,12,True
5029530,1413,0,30,8122,140659914,0,0,0,1125.05,8,623469.34,24,5,20,2,True
5054658,1435,2,451,2190,140659914,0,0,0,1125.04,7,622344.3,24,5,12,2,True
5573526,1103,4,25,4664,140659914,0,0,0,1125.02,8,621219.28,0,2,1,4,True
5626947,1064,0,20,5489,140659914,0,0,0,1124.7,5,620094.58,11,1,23,5,True
5843865,267,0,20,4552,140659914,0,0,0,1125.26,5,618969.32,6,3,16,5,True
5940256,1435,2,25,2442,140659914,0,0,0,1125.13,8,617844.19,24,4,14,5,True
5950892,91,4,451,5376,140659914,0,0,0,1125.43,7,616718.76,1,5,16,6,True
6058920,91,4,-1,4130,140659914,0,1,0,1124.95,4,616718.76,1,0,4,6,True
6120462,1103,4,451,2287,140659914,0,0,0,1124.95,7,615593.81,0,0,21,6,True
6216311,1141,4,451,6366,140659914,0,0,0,1124.78,7,614469.03,15,4,6,6,True
6233885,611,0,20,5489,140659914,0,0,0,1124.94,5,613344.09,11,4,15,6,True
6248294,1103,4,451,2287,140659914,0,0,0,1125.21,7,612218.88,0,5,17,7,True
6348816,1435,2,451,2433,140659914,0,0,0,1124.99,7,611093.89,24,0,13,7,True
6530556,1103,4,451,2287,140659914,0,0,0,1124.98,7,609968.91,0,6,16,8,True
6536606,1141,4,30,2190,140659914,0,0,0,1124.96,8,608843.95,15,2,16,8,True
6688626,1304,0,20,3338,140659914,0,0,0,1124.9,5,607719.05,5,6,15,9,True
6920810,1435,2,25,2433,140659914,0,0,0,1124.93,8,606594.12,24,2,10,10,True
7040708,865,0,20,2190,140659914,0,0,0,1125.01,5,605469.11,24,6,4,11,True
7042060,1413,0,451,2287,140659914,0,0,0,1125.12,7,604343.99,24,0,13,1,True
7411751,91,4,30,4552,140659914,0,0,0,1124.87,8,603219.12,1,0,15,1,True
7493041,1413,0,451,3105,140659914,0,0,0,1125.01,7,602094.11,24,0,20,1,True
7505845,867,0,10,3338,140659914,0,0,0,1124.88,6,603218.99,24,0,14,1,True
7650513,372,0,20,3354,140659914,0,0,0,1124.99,3,602094.0,25,1,1,1,True
7941426,465,0,20,3105,140659914,0,0,0,1125.05,5,600968.95,13,5,6,2,True
8066049,320,1,10,4552,140659914,0,0,0,1124.89,0,602093.84,11,0,6,2,True
8144007,1413,0,-1,2442,140659914,0,1,0,1124.86,4,602093.84,24,4,6,3,True
8229844,1103,4,25,8122,140659914,0,0,0,1125.1,8,600968.74,0,2,3,4,False
8390009,309,0,10,2442,140659914,0,0,0,1125.17,0,602093.91,4,6,11,4,False
8454738,182,1,-1,4664,140659914,0,1,0,1124.78,4,602093.91,18,1,13,5,True
8628379,913,0,20,3338,140659914,0,0,0,1125.07,5,600968.84,18,1,19,7,True
9039542,1435,2,-1,3733,140659914,0,1,0,1125.13,4,600968.84,24,4,14,8,True
9270718,1413,0,451,6224,140659914,0,0,0,1124.95,7,599843.89,24,3,22,8,False
9476670,91,4,30,4552,140659914,0,0,0,1125.02,8,598718.87,1,0,18,10,True
9521602,1141,4,451,3338,140659914,0,0,0,1124.97,7,597593.9,15,6,10,11,True
1133914,826,1,10,4407,499611655,1,0,0,431.11,0,839415.11,18,3,14,2,True
1175401,1196,4,451,2405,499611655,1,0,0,430.72,7,838984.39,24,4,1,2,True
1179595,1196,4,451,2405,499611655,1,0,0,430.95,7,838553.44,24,0,20,3,True
1266085,704,3,-1,9744,499611655,1,1,0,430.99,1,838553.44,18,0,13,3,True
1342420,463,1,10,5919,499611655,1,0,0,430.86,6,838984.3,13,5,7,3,True
1522484,433,4,451,9744,499611655,1,0,0,430.93,7,838553.37,24,6,1,5,True
1588388,1093,0,-1,8897,499611655,1,1,0,431.17,1,838553.37,18,2,5,6,True
1647498,342,0,20,3767,499611655,1,0,0,431.23,5,838122.14,24,3,0,7,True
1725067,80,4,30,5919,499611655,1,0,0,431.03,8,837691.11,1,1,5,8,True
1755775,1216,4,451,5673,499611655,1,0,0,430.73,7,837260.38,24,1,21,8,True
1905191,1196,4,451,4407,499611655,1,0,0,431.01,7,836829.37,24,6,0,9,True
2286679,205,0,10,8411,499611655,1,0,0,430.87,6,837260.24,9,6,0,10,True
2662604,1015,0,20,8411,499611655,1,0,0,431.05,3,836829.19,26,0,16,11,True
2663428,785,0,10,6987,499611655,1,0,0,430.93,0,837260.12,14,3,23,1,True
2855427,184,0,20,8897,499611655,1,0,0,430.8,3,836829.32,18,4,1,1,True
2982533,433,4,30,1932,499611655,1,0,0,430.81,8,836398.51,24,6,13,2,True
3152079,433,4,451,1500,499611655,1,0,0,430.89,7,835967.62,24,3,19,2,True
3401006,553,1,451,5697,499611655,1,0,0,431.01,7,835536.61,17,2,6,3,True
3427669,446,1,10,5697,499611655,1,0,0,431.01,6,835967.62,13,3,3,3,False
3470780,80,4,451,7814,499611655,1,0,0,431.0,7,835536.62,1,3,6,3,True
3764262,1196,4,-1,7814,499611655,1,1,0,431.29,4,835536.62,24,6,10,6,True
3814576,553,1,-1,7814,499611655,1,2,0,431.06,1,835536.62,17,1,14,6,True
3877616,80,4,25,3767,499611655,1,0,0,431.34,8,835105.28,1,2,7,7,True
3969414,80,4,30,8897,499611655,1,0,0,431.02,8,834674.26,1,4,4,7,True
4094720,553,1,-1,6987,499611655,1,1,0,430.98,1,834674.26,17,1,20,8,True
4235083,480,0,10,5697,499611655,1,0,0,431.12,6,835105.38,5,2,21,9,True
4493374,1323,4,25,5673,499611655,1,0,0,430.82,8,834674.56,18,0,16,10,True
4589657,1216,4,30,5673,499611655,1,0,0,430.88,8,834243.68,24,1,16,10,True
4644354,80,4,25,9609,499611655,1,0,0,431.15,8,833812.53,1,0,23,10,True
4660213,553,1,30,8411,499611655,1,0,0,431.18,8,833381.35,17,3,19,10,True
4717518,1093,0,25,2405,499611655,1,0,0,430.71,8,832950.64,18,1,18,11,True
5408441,433,4,451,9609,499611655,1,0,0,431.08,7,832519.56,24,1,0,12,True
5427778,748,1,10,2405,499611655,1,0,0,430.99,6,832950.55,24,4,10,1,True
5630685,1093,0,30,1284,499611655,1,0,0,431.0,8,832519.55,18,1,6,1,True
5777962,1322,2,20,1500,499611655,1,0,0,430.85,5,832088.7,18,0,19,1,True
5873430,708,2,20,5919,499611655,1,0,0,430.85,5,831657.85,18,5,18,2,True
5940963,433,4,-1,7814,499611655,1,1,0,430.64,1,831657.85,24,5,7,2,True
5974239,641,0,20,3767,499611655,1,0,0,430.87,3,831226.98,24,0,9,3,True
6109042,1093,0,451,8897,499611655,1,0,0,431.05,7,830795.93,18,4,13,4,True
6123376,1093,0,25,1284,499611655,1,0,0,431.13,8,830364.8,18,4,6,4,True
6377332,704,3,-1,5697,499611655,1,1,0,431.2,4,830364.8,18,5,22,5,True
6738832,1323,4,30,1932,499611655,1,0,0,430.97,8,829933.83,18,2,6,5,True
6818616,553,1,25,5919,499611655,1,0,0,431.03,8,829502.8,17,0,11,5,True
7019747,553,1,30,8897,499611655,1,0,0,430.91,8,829071.89,17,5,15,6,True
7088944,553,1,451,5673,499611655,1,0,0,431.0,7,828640.89,17,3,13,6,True
7216847,1323,4,451,1284,499611655,1,0,0,431.12,7,828209.77,18,0,13,7,True
7295392,433,4,25,8411,499611655,1,0,0,430.81,8,827778.96,24,1,0,7,True
7551897,1093,0,451,5919,499611655,1,0,0,430.81,7,827348.15,18,3,18,8,True
7700554,1323,4,451,1932,499611655,1,0,0,431.07,7,826917.08,18,3,16,8,True
7938697,1196,4,451,8843,499611655,1,0,0,430.99,7,826486.09,24,5,13,8,True
8790446,774,2,20,8411,499611655,1,0,0,431.0,5,826055.09,14,0,8,9,True
9116897,1196,4,30,1932,499611655,1,0,0,431.06,8,825624.03,24,2,23,9,True
9353453,589,1,25,5697,499611655,1,0,0,431.28,8,825192.75,24,6,23,9,True
9432863,553,1,30,6987,499611655,1,0,0,430.84,8,824761.91,17,2,14,10,True
9434314,589,1,30,3767,499611655,1,0,0,431.01,8,824330.9,24,4,20,10,True
9499333,1323,4,30,9744,499611655,1,0,0,431.17,8,823899.73,18,0,2,10,True
9886847,704,3,25,3767,499611655,1,0,0,430.85,8,823468.88,18,1,4,10,True
9945036,687,0,10,4407,499611655,1,0,0,430.8,6,823899.68,24,2,14,11,True
1143339,1407,4,451,4505,405121370,1,0,0,1153.72,7,963389.28,24,4,15,1,True
1334562,1407,4,30,6439,405121370,1,0,0,1154.12,8,962235.16,24,2,11,1,True
1387522,118,2,20,2028,405121370,1,0,0,1154.08,5,961081.08,18,0,14,2,True
1677686,614,4,30,2718,405121370,1,0,0,1154.17,8,959926.91,11,6,16,3,True
1730450,398,0,30,5243,405121370,1,0,0,1153.99,8,958772.92,10,5,3,3,True
1766459,614,4,30,5243,405121370,1,0,0,1153.82,8,957619.1,11,0,2,4,True
1820487,1407,4,451,9407,405121370,1,0,0,1153.91,7,956465.19,24,1,20,5,True
1894423,802,2,20,9620,405121370,1,0,0,1154.03,5,955311.16,11,3,7,5,True
1983289,614,4,30,5559,405121370,1,0,0,1153.87,8,954157.29,11,5,13,5,True
2211030,614,4,25,3646,405121370,1,0,0,1153.72,8,953003.57,11,6,2,7,True
2227299,1407,4,25,6439,405121370,1,0,0,1154.0,8,951849.57,24,0,11,8,True
2315523,398,0,25,1702,405121370,1,0,0,1154.11,8,950695.46,10,6,2,8,True
2365735,316,2,20,9407,405121370,1,0,0,1154.19,5,949541.27,4,2,17,8,True
2428527,917,0,10,9407,405121370,1,0,0,1154.09,6,950695.36,18,3,4,8,True
2678149,366,0,20,1702,405121370,1,0,0,1154.06,5,949541.3,25,4,17,8,True
2680155,260,0,10,9620,405121370,1,0,0,1154.11,6,950695.41,6,2,5,8,True
2783811,1023,2,20,7734,405121370,1,0,0,1153.88,5,949541.53,11,1,18,9,True
2995288,314,0,30,6507,405121370,1,0,0,1154.05,8,948387.48,4,4,6,10,True
3144752,275,0,451,7734,405121370,1,0,0,1154.23,7,947233.25,24,1,2,11,True
3191454,1181,2,20,7734,405121370,1,0,0,1153.9,3,946079.35,24,3,21,11,True
3471182,605,0,10,6439,405121370,1,0,0,1153.85,6,947233.2,24,0,17,12,True
3705587,398,0,25,1702,405121370,1,0,0,1153.95,8,946079.25,10,2,18,12,True
4076006,1108,1,25,5243,405121370,1,0,0,1153.76,8,944925.49,0,6,11,1,True
4714083,1015,0,20,1100,405121370,1,0,0,1153.78,3,943771.71,26,1,22,1,True
5483837,866,0,10,1702,405121370,1,0,0,1154.01,6,944925.72,24,6,19,3,True
5527893,1407,4,451,5424,405121370,1,0,0,1153.93,7,943771.79,24,0,11,3,True
5754838,398,0,451,7734,405121370,1,0,0,1153.96,7,942617.83,10,2,1,4,True
5872507,614,4,451,2718,405121370,1,0,0,1154.16,7,941463.67,11,1,19,5,True
6094527,29,0,20,5559,405121370,1,0,0,1153.91,5,940309.76,11,6,13,6,True
6187790,1407,4,25,9620,405121370,1,0,0,1153.89,8,939155.87,24,0,18,6,True
6371156,275,0,30,7734,405121370,1,0,0,1154.08,8,938001.79,24,1,11,6,True
6388523,314,0,30,6507,405121370,1,0,0,1153.87,8,936847.92,4,3,5,7,True
6516334,275,0,-1,1932,405121370,1,1,0,1154.06,4,936847.92,24,6,3,7,True
6568850,1361,2,20,4505,405121370,1,0,0,1153.92,5,935694.0,16,5,3,8,True
6684981,1407,4,25,5424,405121370,1,0,0,1153.87,8,934540.13,24,5,12,8,True
6711640,614,4,30,5559,405121370,1,0,0,1154.11,8,933386.02,11,3,2,8,True
7278450,394,0,20,2028,405121370,1,0,0,1154.04,5,932231.98,10,1,8,10,True
7469827,260,0,10,1932,405121370,1,0,0,1154.04,6,933386.02,6,6,0,12,True
7598757,1407,4,451,9620,405121370,1,0,0,1153.87,7,932232.15,24,0,7,1,True
7665963,1429,0,20,6339,405121370,1,0,0,1154.12,3,931078.03,24,5,14,1,True
7926380,1108,1,451,1932,405121370,1,0,0,1154.12,7,929923.91,0,3,13,1,True
8003305,614,4,25,1100,405121370,1,0,0,1153.92,8,928769.99,11,2,13,3,True
8087257,1108,1,30,5677,405121370,1,0,0,1153.71,8,927616.28,0,4,13,3,False
8725157,614,4,-1,5677,405121370,1,1,0,1153.85,1,927616.28,11,0,18,4,True
8744471,1407,4,451,5243,405121370,1,0,0,1153.95,7,926462.33,24,5,2,6,True
8783429,128,0,20,4505,405121370,1,0,0,1154.03,5,925308.3,18,5,19,6,True
8995428,314,0,-1,6339,405121370,1,1,0,1153.91,4,925308.3,4,1,14,7,True
9044056,219,0,10,2028,405121370,1,0,0,1154.18,0,926462.48,9,2,20,8,True
9118018,275,0,451,5677,405121370,1,0,0,1153.82,7,925308.66,24,3,4,8,True
9211838,314,0,25,5243,405121370,1,0,0,1153.96,8,924154.7,4,3,2,9,True
9416623,398,0,30,6339,405121370,1,0,0,1154.27,8,923000.43,10,0,0,10,True
9469195,208,0,20,7734,405121370,1,0,0,1153.91,5,921846.52,9,2,16,10,True
9702537,867,0,10,5243,405121370,1,0,0,1153.97,6,923000.49,24,6,5,10,True
9905013,373,1,10,2028,405121370,1,0,0,1153.91,6,924154.4,25,1,4,11,False
9953164,275,0,451,1702,405121370,1,0,0,1154.1,7,923000.3,24,3,3,11,True
1051133,1069,1,30,1121,774732977,0,0,0,716.19,8,337497.81,18,3,0,1,True
1125205,443,2,30,6827,774732977,0,0,0,716.01,8,336781.8,24,3,9,2,False
1285216,1109,4,-1,3131,774732977,0,1,0,716.13,4,336781.8,0,2,9,4,True
1492272,390,4,451,5700,774732977,0,0,0,716.16,7,336065.64,10,5,23,5,True
1780625,125,4,25,3763,774732977,0,0,0,715.8,8,335349.84,18,3,21,6,True
1846344,842,2,30,2529,774732977,0,0,0,716.04,8,334633.8,5,3,10,7,True
2004748,917,0,20,1261,774732977,0,0,0,716.13,5,333917.67,18,4,22,9,True
2115405,1109,4,451,3740,774732977,0,0,0,716.17,7,333201.5,0,6,0,10,True
2308635,1109,4,25,5700,774732977,0,0,0,715.94,8,332485.56,0,1,15,10,False
2334562,390,4,25,2112,774732977,0,0,0,716.04,8,331769.52,10,2,0,11,True
2540910,1094,0,451,5700,774732977,0,0,0,715.98,7,331053.54,0,3,1,12,True
2584410,842,2,-1,4351,774732977,0,1,0,716.05,4,331053.54,5,4,17,1,True
2970751,1094,0,451,1261,774732977,0,0,0,716.29,7,330337.25,0,3,17,2,True
3156422,1212,0,20,2112,774732977,0,0,0,715.9,5,329621.35,24,1,14,2,True
3386594,525,0,10,6290,774732977,0,0,0,715.94,6,330337.29,18,1,14,2,True
3538907,1109,4,451,6290,774732977,0,0,0,715.76,7,329621.53,0,6,6,3,True
3756513,1393,3,30,6290,774732977,0,0,0,716.02,8,328905.51,24,6,6,3,False
3877151,443,2,451,1158,774732977,0,0,0,715.86,7,328189.65,24,6,13,3,True
4025676,1393,3,-1,3653,774732977,0,1,0,715.92,4,328189.65,24,1,11,4,True
4206201,443,2,451,5700,774732977,0,0,0,716.17,7,327473.48,24,1,19,5,True
4779790,1109,4,-1,2529,774732977,0,1,0,716.27,4,327473.48,0,3,16,6,True
4953175,1069,1,30,2529,774732977,0,0,0,716.24,8,326757.24,18,6,13,7,True
5335531,1109,4,-1,7964,774732977,0,1,0,715.85,1,326757.24,0,0,2,8,True
5417602,1076,1,10,2529,774732977,0,0,0,716.11,6,327473.35,18,2,1,9,True
5419489,1393,3,451,4351,774732977,0,0,0,715.76,7,326757.59,24,3,23,10,True
5515626,125,4,30,4351,774732977,0,0,0,715.88,8,326041.71,18,6,5,10,True
5647631,729,0,10,3332,774732977,0,0,0,716.21,6,326757.92,11,5,4,11,True
5669850,1069,1,25,4351,774732977,0,0,0,715.88,8,326042.04,18,2,17,12,True
5725951,1393,3,-1,1261,774732977,0,1,0,715.85,1,326042.04,24,2,22,1,True
6018715,627,0,20,4710,774732977,0,0,0,716.07,5,325325.97,11,5,2,2,True
6106047,443,2,30,2112,774732977,0,0,0,716.04,8,324609.93,24,3,13,2,True
6130062,443,2,30,3131,774732977,0,0,0,715.73,8,323894.2,24,6,0,3,True
6154899,842,2,-1,3131,774732977,0,1,0,715.99,4,323894.2,5,3,20,3,True
6187341,1094,0,451,1389,774732977,0,0,0,716.22,7,323177.98,0,6,8,3,True
6210136,1393,3,451,1121,774732977,0,0,0,715.95,7,322462.03,24,0,4,3,True
6613830,1069,1,451,1389,774732977,0,0,0,715.96,7,321746.07,18,3,7,3,True
7079445,1109,4,451,5700,774732977,0,0,0,715.91,7,321030.16,0,2,10,3,True
7259920,1393,3,451,4351,774732977,0,0,0,716.15,7,320314.01,24,3,11,4,True
7421305,1069,1,25,3763,774732977,0,0,0,716.04,8,319597.97,18,2,18,4,True
7500342,1069,1,451,3131,774732977,0,0,0,716.14,7,318881.83,18,6,9,6,True
7706994,378,0,10,3332,774732977,0,0,0,716.15,6,319597.98,25,5,0,6,True
8349402,228,0,20,1389,774732977,0,0,0,716.39,5,318881.59,26,5,15,8,True
8363610,1393,3,30,3653,774732977,0,0,0,715.81,8,318165.78,24,3,13,8,True
8366691,1069,1,451,2112,774732977,0,0,0,716.08,7,317449.7,18,5,12,9,True
8626736,1109,4,30,5700,774732977,0,0,0,716.15,8,316733.55,0,2,14,9,True
8658038,842,2,30,3131,774732977,0,0,0,715.81,8,316017.74,5,1,2,10,True
8834685,443,2,30,1389,774732977,0,0,0,716.28,8,315301.46,24,5,22,10,True
8920511,842,2,25,1121,774732977,0,0,0,716.15,8,314585.31,5,1,22,10,True
9169767,842,2,451,6290,774732977,0,0,0,715.97,7,313869.34,5,3,21,11,True
9261214,1069,1,-1,7964,774732977,0,1,0,716.04,4,313869.34,18,1,21,11,True
1057615,569,4,-1,5561,298848722,0,1,0,1097.02,1,838097.0,11,0,17,1,True
1086378,569,4,-1,8915,298848722,0,2,0,1096.97,4,838097.0,11,4,23,2,True
1180824,1047,3,25,8186,298848722,0,0,0,1096.84,8,837000.16,11,6,12,2,True
1386631,569,4,30,3192,298848722,0,0,0,1096.96,8,835903.2,11,0,15,3,True
1455418,1477,2,30,3977,298848722,0,0,0,1097.18,8,834806.02,24,3,4,4,False
1632624,1418,3,-1,4134,298848722,0,1,0,1096.68,1,834806.02,24,4,23,4,True
1716297,1377,0,20,6758,298848722,0,0,0,1096.93,5,833709.09,16,5,13,4,True
1822303,227,4,451,5561,298848722,0,0,0,1096.98,7,832612.11,26,2,11,6,True
1836266,227,4,451,8705,298848722,0,0,0,1096.92,7,831515.19,26,0,19,7,False
1845837,569,4,25,3435,298848722,0,0,0,1097.13,8,830418.06,11,6,2,8,True
2163763,1477,2,451,8186,298848722,0,0,0,1097.02,7,829321.04,24,3,5,9,True
2940540,1477,2,20,3016,298848722,0,0,0,1097.04,5,828224.0,24,5,20,9,True
2942485,851,1,10,8186,298848722,0,0,0,1096.95,6,829320.95,5,4,2,9,True
2962280,569,4,-1,3016,298848722,0,1,0,1097.29,4,829320.95,11,4,13,10,True
3278499,1047,3,25,6758,298848722,0,0,0,1097.14,8,828223.81,11,1,13,11,True
3368309,732,0,10,4898,298848722,0,0,0,1096.69,6,829320.5,11,0,3,12,True
3493360,1477,2,-1,6758,298848722,0,1,0,1096.86,1,829320.5,24,3,18,12,True
3658592,1068,2,20,5561,298848722,0,0,0,1096.8,5,828223.7,18,1,9,1,True
3695192,569,4,451,3435,298848722,0,0,0,1096.93,7,827126.77,11,1,9,1,True
3753083,511,1,10,4134,298848722,0,0,0,1097.0,6,828223.77,12,1,10,1,True
4302590,1418,3,25,8915,298848722,0,0,0,1096.81,8,827126.96,24,5,11,2,True
4335161,227,4,25,1185,298848722,0,0,0,1097.07,8,826029.89,26,0,9,2,True
4841898,1418,3,25,6758,298848722,0,0,0,1096.69,8,824933.2,24,5,23,4,True
4850296,28,1,10,8186,298848722,0,0,0,1096.88,6,826030.08,11,3,6,4,True
4887102,1418,3,25,3435,298848722,0,0,0,1097.03,8,824933.05,24,4,21,5,True
5140836,696,2,20,5561,298848722,0,0,0,1097.31,5,823835.74,24,0,13,6,True
5280140,569,4,451,4898,298848722,0,0,0,1097.07,7,822738.67,11,0,19,6,True
5371845,1047,3,30,9646,298848722,0,0,0,1096.69,8,821641.98,11,1,12,6,True
5379480,1418,3,-1,8915,298848722,0,1,0,1096.88,4,821641.98,24,2,19,6,True
5728329,1312,0,20,3016,298848722,0,0,0,1097.2,5,820544.78,5,0,13,7,True
5765724,931,0,20,3977,298848722,0,0,0,1097.06,5,819447.72,24,6,21,9,True
5939875,512,0,20,3977,298848722,0,0,0,1097.1,3,818350.62,12,4,6,9,True
6320099,227,4,-1,7789,298848722,0,1,0,1096.9,4,818350.62,26,5,12,9,True
6441150,1047,3,-1,3435,298848722,0,2,0,1097.13,4,818350.62,11,3,8,9,True
6510122,812,0,20,6758,298848722,0,0,0,1096.85,3,817253.77,18,0,16,10,True
6603267,1418,3,30,8915,298848722,0,0,0,1096.98,8,816156.79,24,1,3,10,True
6825576,569,4,451,3192,298848722,0,0,0,1096.73,7,815060.06,11,6,5,10,True
6907855,1418,3,25,7572,298848722,0,0,0,1097.25,8,813962.81,24,4,22,12,True
6922378,509,0,20,3977,298848722,0,0,0,1097.03,5,812865.78,12,5,1,1,True
7009281,569,4,451,5561,298848722,0,0,0,1096.74,7,811769.04,11,6,11,1,True
7029420,227,4,451,8026,298848722,0,0,0,1096.92,7,810672.12,26,1,6,1,True
7066851,569,4,25,4134,298848722,0,0,0,1097.32,8,809574.8,11,3,13,1,True
7186420,1047,3,-1,8915,298848722,0,1,0,1096.89,1,809574.8,11,1,22,2,True
7267468,1418,3,30,7572,298848722,0,0,0,1096.93,8,808477.87,24,5,21,3,True
7312064,1047,3,451,8186,298848722,0,0,0,1097.07,7,807380.8,11,1,23,3,True
7617694,227,4,451,8705,298848722,0,0,0,1096.95,7,806283.85,26,5,1,3,True
7865033,1089,0,20,6758,298848722,0,0,0,1097.04,5,805186.81,18,6,0,3,True
7947013,1418,3,-1,8705,298848722,0,1,0,1096.94,1,805186.81,24,2,1,4,True
8344733,227,4,30,5561,298848722,0,0,0,1096.89,8,804089.92,26,0,11,5,True
8643311,303,0,10,8186,298848722,0,0,0,1097.09,6,805187.01,4,1,20,6,True
8917507,1477,2,25,9646,298848722,0,0,0,1096.8,8,804090.21,24,1,21,6,True
9206236,1044,0,20,7789,298848722,0,0,0,1097.03,5,802993.18,11,3,9,7,True
9212028,1418,3,25,5561,298848722,0,0,0,1097.17,8,801896.01,24,6,3,7,True
9736713,227,4,451,3192,298848722,0,0,0,1097.13,7,800798.88,26,2,9,9,True
9948379,227,4,25,3016,298848722,0,0,0,1097.23,8,799701.65,26,4,14,11,True
9969897,1047,3,30,6758,298848722,0,0,0,1096.94,8,798604.71,11,0,18,11,True
1183380,548,2,451,4659,828055432,1,0,0,654.08,7,314489.92,17,0,1,1,True
1580694,1244,4,-1,6648,828055432,1,1,0,654.01,4,314489.92,18,5,13,1,True
1765874,548,2,30,1146,828055432,1,0,0,653.86,8,313836.06,17,2,16,2,True
1769803,1478,4,451,5326,828055432,1,0,0,653.87,7,313182.19,24,1,3,2,True
2205772,1478,4,30,9258,828055432,1,0,0,653.62,8,312528.57,24,1,19,3,True
2319587,1121,3,-1,8202,828055432,1,1,0,653.89,4,312528.57,24,2,7,3,True
2394846,662,1,10,6179,828055432,1,0,0,654.21,6,313182.78,18,6,1,3,True
2405025,548,2,451,5563,828055432,1,0,0,654.05,7,312528.73,17,2,3,3,True
2587634,892,4,30,9258,828055432,1,0,0,654.15,8,311874.58,24,4,16,4,True
2666574,696,2,20,6179,828055432,1,0,0,654.1,5,311220.48,24,1,3,4,True
2865805,1121,3,451,4438,828055432,1,0,0,654.27,7,310566.21,24,3,22,7,True
3639001,1319,1,10,5602,828055432,1,0,0,654.04,0,311220.25,18,5,1,8,True
3742636,677,0,10,2793,828055432,1,0,0,654.15,6,311874.4,24,4,4,8,True
3821119,1478,4,-1,9238,828055432,1,1,0,653.96,4,311874.4,24,5,9,10,True
3928355,892,4,451,2444,828055432,1,0,0,653.93,7,311220.47,24,3,21,11,True
3943236,471,0,20,4482,828055432,1,0,0,654.12,5,310566.35,5,6,3,12,True
4285422,548,2,451,8968,828055432,1,0,0,654.18,7,309912.17,17,2,5,12,True
4473131,548,2,30,2444,828055432,1,0,0,653.86,8,309258.31,17,0,11,3,True
4645617,1244,4,-1,5326,828055432,1,1,0,654.03,4,309258.31,18,3,2,3,True
4694498,892,4,25,5602,828055432,1,0,0,653.94,8,308604.37,24,2,23,5,True
4898743,71,1,451,9238,828055432,1,0,0,654.28,7,307950.09,20,4,2,5,True
4950767,1244,4,30,2444,828055432,1,0,0,654.01,8,307296.08,18,4,13,5,True
5000195,548,2,-1,4343,828055432,1,1,0,654.04,1,307296.08,17,5,4,5,True
5173509,1478,4,-1,6836,828055432,1,2,0,653.76,4,307296.08,24,3,11,6,True
5463174,548,2,30,9258,828055432,1,0,0,654.14,8,306641.94,17,2,20,6,True
5612182,1244,4,451,4482,828055432,1,0,0,653.88,7,305988.06,18,5,15,7,True
5850448,362,0,10,9071,828055432,1,0,0,654.16,6,306642.22,24,5,1,7,True
5879763,1399,0,10,1943,828055432,1,0,0,654.16,0,307296.38,24,2,11,7,True
5923533,937,0,10,5563,828055432,1,0,0,654.18,6,307950.56,24,5,15,8,True
6133683,892,4,451,9071,828055432,1,0,0,653.94,7,307296.62,24,4,7,8,True
6290483,1478,4,451,4482,828055432,1,0,0,653.97,7,306642.65,24,6,8,8,True
6314404,548,2,25,4438,828055432,1,0,0,654.14,8,305988.51,17,3,19,9,True
6382946,372,0,10,1890,828055432,1,0,0,654.01,0,306642.52,25,0,0,10,True
6441534,548,2,451,8202,828055432,1,0,0,654.03,7,305988.49,17,5,4,11,True
6504804,605,0,10,4482,828055432,1,0,0,654.18,6,306642.67,24,1,3,12,True
6621078,71,1,25,7017,828055432,1,0,0,654.04,8,305988.63,20,3,13,1,True
6641522,1089,0,10,8543,828055432,1,0,0,653.93,6,306642.56,18,3,19,1,True
6885655,1244,4,-1,4659,828055432,1,1,0,653.81,4,306642.56,18,0,11,2,True
6897675,538,0,10,8543,828055432,1,0,0,653.99,6,307296.55,18,1,12,3,True
6944191,1478,4,25,6836,828055432,1,0,0,654.06,8,306642.49,24,1,0,4,True
7241113,892,4,25,1399,828055432,1,0,0,654.12,8,305988.37,24,4,22,4,True
7665703,1244,4,-1,6480,828055432,1,1,0,653.94,1,305988.37,18,6,13,4,True
7794887,892,4,451,4482,828055432,1,0,0,654.1,7,305334.27,24,1,21,6,True
8229285,1478,4,25,6648,828055432,1,0,0,653.92,8,304680.35,24,2,14,6,True
8317263,1478,4,-1,4219,828055432,1,1,0,654.07,1,304680.35,24,2,6,7,True
8369953,1244,4,451,5602,828055432,1,0,0,654.09,7,304026.26,18,3,2,7,True
8733342,1247,0,20,2793,828055432,1,0,0,654.06,5,303372.2,23,6,3,7,True
8900993,892,4,30,9071,828055432,1,0,0,654.06,8,302718.14,24,5,19,8,True
8907735,71,1,25,9258,828055432,1,0,0,653.79,8,302064.35,20,0,12,9,True
9454537,1121,3,-1,8543,828055432,1,1,0,654.14,4,302064.35,24,3,18,9,True
9714969,71,1,30,2793,828055432,1,0,0,653.67,8,301410.68,20,5,15,9,True
9825906,1478,4,451,7343,828055432,1,0,0,653.73,7,300756.95,24,6,14,9,True
9874904,892,4,-1,9258,828055432,1,1,0,653.87,4,300756.95,24,2,6,10,True
9931704,71,1,30,4343,828055432,1,0,0,654.05,8,300102.9,20,1,10,10,True
1048568,1384,4,451,7249,507494025,1,0,0,224.99,7,767079.01,24,5,8,1,True
1180664,1027,0,451,8732,507494025,1,0,0,224.71,7,766854.3,11,4,18,2,True
1299615,1384,4,451,2197,507494025,1,0,0,224.99,7,766629.31,24,3,16,3,True
1330911,1027,0,451,8668,507494025,1,0,0,225.32,7,766403.99,11,1,18,3,True
1451760,47,1,30,4657,507494025,1,0,0,225.45,8,766178.54,24,1,11,4,True
1502721,1384,4,451,6043,507494025,1,0,0,224.76,7,765953.78,24,5,22,4,True
1744976,1086,0,10,4261,507494025,1,0,0,224.97,6,766178.75,18,3,3,4,True
1893387,47,1,451,5539,507494025,1,0,0,224.85,7,765953.9,24,1,14,5,True
1979513,390,4,-1,7249,507494025,1,1,0,224.99,1,765953.9,10,5,2,7,True
2132638,1421,0,25,8668,507494025,1,0,0,224.89,8,765729.01,24,5,7,7,False
2452745,198,0,20,4194,507494025,1,0,0,225.14,3,765503.87,18,0,19,8,True
2729619,1421,0,451,2747,507494025,1,0,0,225.03,7,765278.84,24,1,9,9,True
2789101,1468,1,10,7249,507494025,1,0,0,224.69,6,765503.53,11,0,22,9,True
3064168,1421,0,30,2197,507494025,1,0,0,225.01,8,765278.52,24,4,10,10,True
3149565,390,4,451,2197,507494025,1,0,0,225.26,7,765053.26,10,5,15,10,True
3240932,1384,4,25,4194,507494025,1,0,0,224.85,8,764828.41,24,6,20,12,True
3647190,1027,0,451,9655,507494025,1,0,0,225.04,7,764603.37,11,2,9,12,True
3661271,1471,0,10,8644,507494025,1,0,0,225.0,0,764828.37,24,2,17,1,True
3773029,1027,0,451,4194,507494025,1,0,0,225.09,7,764603.28,11,4,6,1,True
3812033,390,4,30,4261,507494025,1,0,0,224.84,8,764378.44,10,3,7,2,True
3908435,1206,0,20,8644,507494025,1,0,0,224.74,3,764153.7,24,0,10,2,True
4021970,1384,4,25,2197,507494025,1,0,0,224.54,8,763929.16,24,2,4,4,True
4073775,1384,4,25,8668,507494025,1,0,0,224.75,8,763704.41,24,5,10,4,True
4195408,1421,0,30,7249,507494025,1,0,0,224.99,8,763479.42,24,1,16,6,True
4441058,390,4,30,7698,507494025,1,0,0,224.9,8,763254.52,10,2,9,6,True
4487661,1019,0,20,6043,507494025,1,0,0,224.68,3,763029.84,26,6,18,7,True
4589454,220,0,10,2747,507494025,1,0,0,224.94,0,763254.78,26,3,14,7,True
4682405,47,1,451,4261,507494025,1,0,0,224.89,7,763029.89,24,2,2,8,True
4802629,278,1,10,4194,507494025,1,0,0,225.19,6,763255.08,24,2,14,8,True
5103778,1027,0,-1,2197,507494025,1,1,0,224.96,4,763255.08,11,3,5,10,True
5382647,47,1,30,8668,507494025,1,0,0,225.07,8,763030.01,24,0,22,10,True
5706073,1027,0,30,8668,507494025,1,0,0,225.08,8,762804.93,11,6,17,11,True
5715625,533,2,20,8668,507494025,1,0,0,224.83,5,762580.1,18,2,8,11,True
6068036,47,1,25,1652,507494025,1,0,0,225.0,8,762355.1,24,6,0,12,True
6301453,1288,0,10,5539,507494025,1,0,0,224.96,0,762580.06,24,6,18,12,True
6475174,390,4,25,2747,507494025,1,0,0,224.9,8,762355.16,10,6,7,12,True
6957470,390,4,-1,5539,507494025,1,1,0,224.84,1,762355.16,10,2,7,1,True
7141834,390,4,30,1652,507494025,1,0,0,224.93,8,762130.23,10,2,14,1,True
7588622,327,0,10,5798,507494025,1,0,0,224.69,6,762354.92,11,3,3,2,True
8165543,1421,0,30,6043,507494025,1,0,0,225.27,8,762129.65,24,3,10,2,True
8283678,47,1,451,5798,507494025,1,0,0,225.08,7,761904.57,24,1,18,2,True
8375119,1421,0,451,8644,507494025,1,0,0,224.95,7,761679.62,24,2,5,2,True
8390130,1027,0,25,9655,507494025,1,0,0,224.88,8,761454.74,11,4,13,2,True
8755801,1027,0,451,4194,507494025,1,0,0,224.74,7,761230.0,11,6,22,2,True
8869215,390,4,30,2747,507494025,1,0,0,225.16,8,761004.84,10,5,15,3,True
8883184,480,0,10,5266,507494025,1,0,0,225.15,0,761229.99,5,1,2,3,True
9055415,47,1,30,9655,507494025,1,0,0,224.75,8,761005.24,24,5,9,4,True
9301009,47,1,30,9655,507494025,1,0,0,224.97,8,760780.27,24,3,4,5,True
9476788,1384,4,-1,8644,507494025,1,1,0,224.69,4,760780.27,24,5,7,6,True
9480628,1384,4,25,2747,507494025,1,0,0,225.2,8,760555.07,24,5,16,7,True
9802668,47,1,-1,8668,507494025,1,1,0,225.15,4,760555.07,24,3,13,8,True
9940802,390,4,-1,9655,507494025,1,2,0,224.95,4,760555.07,10,1,7,10,True
1124816,1239,1,-1,6575,460684713,0,1,0,500.06,1,292632.0,18,6,13,2,True
1179544,1159,0,10,5808,460684713,0,0,0,500.02,0,293132.02,15,5,22,3,True
1368023,588,0,20,7345,460684713,0,0,0,500.04,5,292631.98,24,0,3,3,True
1893382,716,0,30,3852,460684713,0,0,0,500.1,8,292131.88,18,5,13,3,True
1913113,616,1,10,3852,460684713,0,0,0,500.28,6,292632.16,11,4,8,4,False
2116090,1249,2,25,3088,460684713,0,0,0,500.07,8,292132.09,23,2,3,4,True
2281746,1166,2,451,1076,460684713,0,0,0,499.63,7,291632.46,24,5,16,4,False
2343186,1223,3,-1,3088,460684713,0,1,0,499.75,4,291632.46,24,4,2,4,True
2349201,433,4,30,5439,460684713,0,0,0,499.95,8,291132.51,24,4,1,5,True
2587351,283,4,451,6575,460684713,0,0,0,500.09,7,290632.42,24,1,15,5,True
2597963,716,0,451,4081,460684713,0,0,0,499.81,7,290132.61,18,3,11,5,True
2601016,198,0,10,6575,460684713,0,0,0,499.93,6,290632.54,18,3,7,6,False
2646334,1239,1,30,5439,460684713,0,0,0,499.82,8,290132.72,18,6,20,6,True
2832775,204,0,20,1272,460684713,0,0,0,500.14,3,289632.58,9,3,13,6,True
3161729,1223,3,30,1272,460684713,0,0,0,500.04,8,289132.54,24,5,16,7,True
3689566,283,4,-1,4081,460684713,0,1,0,499.84,4,289132.54,24,3,0,8,True
3838697,283,4,451,2017,460684713,0,0,0,499.9,7,288632.64,24,5,0,9,True
3882287,283,4,30,5439,460684713,0,0,0,499.96,8,288132.68,24,5,20,10,True
3913872,433,4,30,4081,460684713,0,0,0,499.9,8,287632.78,24,1,21,10,True
3945476,283,4,451,5439,460684713,0,0,0,499.79,7,287132.99,24,6,21,11,True
4012471,180,0,20,3852,460684713,0,0,0,499.92,3,286633.07,18,3,20,1,True
4150508,1239,1,451,3852,460684713,0,0,0,499.95,7,286133.12,18,3,19,3,True
4278445,716,0,30,5808,460684713,0,0,0,499.9,8,285633.22,18,2,16,4,True
4279637,1166,2,451,7937,460684713,0,0,0,500.12,7,285133.1,24,5,18,5,True
4593087,1127,0,20,7937,460684713,0,0,0,499.79,3,284633.31,24,6,15,6,True
4599894,1239,1,451,1076,460684713,0,0,0,499.61,7,284133.7,18,6,16,6,True
4858705,1488,0,20,3852,460684713,0,0,0,500.0,5,283633.7,24,5,16,7,True
5089548,1166,2,30,6819,460684713,0,0,0,499.93,8,283133.77,24,5,17,7,True
5371125,989,1,10,5439,460684713,0,0,0,499.95,0,283633.72,22,1,22,8,True
5652153,883,0,20,9904,460684713,0,0,0,500.2,5,283133.52,24,3,22,9,True
5712112,1249,2,30,1272,460684713,0,0,0,500.12,8,282633.4,23,6,1,10,True
5872945,1312,0,10,4081,460684713,0,0,0,500.18,6,283133.58,5,6,8,11,True
6063217,1223,3,30,4565,460684713,0,0,0,499.93,8,282633.65,24,5,5,12,True
6138954,1223,3,-1,5195,460684713,0,1,0,500.04,4,282633.65,24,2,16,12,True
6154529,1239,1,451,4081,460684713,0,0,0,500.17,7,282133.48,18,5,7,12,True
6212426,1223,3,25,4565,460684713,0,0,0,500.04,8,281633.44,24,5,0,1,True
6236882,716,0,451,4899,460684713,0,0,0,499.97,7,281133.47,18,5,21,1,True
6533304,627,0,10,2487,460684713,0,0,0,500.17,6,281633.64,11,6,0,1,True
6535791,1249,2,30,6819,460684713,0,0,0,499.95,8,281133.69,23,6,9,2,True
6786728,23,0,10,3852,460684713,0,0,0,500.02,0,281633.71,11,0,15,2,True
6900404,502,0,20,1272,460684713,0,0,0,499.93,3,281133.78,12,3,6,2,True
7063624,1425,0,10,2017,460684713,0,0,0,499.88,6,281633.66,24,1,2,3,True
7097371,1249,2,30,4081,460684713,0,0,0,500.12,8,281133.54,23,2,7,3,True
7509149,1413,0,10,3088,460684713,0,0,0,499.8,6,281633.34,24,4,20,3,True
7662471,1377,0,10,5439,460684713,0,0,0,499.85,6,282133.19,16,5,3,5,True
7928849,427,2,20,1272,460684713,0,0,0,500.25,5,281632.94,18,3,20,5,True
8204703,433,4,451,3088,460684713,0,0,0,500.11,7,281132.83,24,6,23,6,True
8241514,1223,3,451,1272,460684713,0,0,0,500.14,7,280632.69,24,6,0,6,True
8679778,1278,0,10,3852,460684713,0,0,0,500.09,6,281132.78,24,0,15,7,True
8802918,1388,1,10,1272,460684713,0,0,0,500.14,6,281632.92,24,4,15,8,True
8829327,1459,1,10,3852,460684713,0,0,0,500.06,6,282132.98,11,5,4,9,True
9040147,1249,2,25,1272,460684713,0,0,0,500.17,8,281632.81,23,6,8,9,False
9208239,1436,0,451,4081,460684713,0,0,0,500.0,7,281132.81,24,4,13,9,True
9597565,283,4,-1,6575,460684713,0,1,0,500.06,4,281132.81,24,6,21,9,True
9686430,372,0,20,6819,460684713,0,0,0,500.17,3,280632.64,25,6,5,10,True
9725953,1239,1,451,2487,460684713,0,0,0,499.96,7,280132.68,18,2,8,10,True
9825345,1239,1,30,4131,460684713,0,0,0,500.22,8,279632.46,18,1,8,11,True
1194008,752,0,30,5798,369836781,0,0,0,949.95,8,652995.05,24,1,19,1,True
1208959,1272,0,20,9359,369836781,0,0,0,949.75,5,652045.3,24,0,2,2,True
1308425,780,0,10,4940,369836781,0,0,0,949.86,0,652995.16,14,6,10,3,True
1707083,783,0,20,5798,369836781,0,0,0,949.97,3,652045.19,14,6,11,5,True
2022958,587,2,20,9303,369836781,0,0,0,950.19,3,651095.0,24,0,13,6,True
2222242,518,2,30,7789,369836781,0,0,0,949.98,8,650145.02,18,3,2,1,True
2419114,895,0,30,6725,369836781,0,0,0,949.92,8,649195.1,24,6,22,4,True
2441783,931,0,10,2298,369836781,0,0,0,950.01,6,650145.11,24,4,14,5,False
2519169,689,0,20,8259,369836781,0,0,0,950.03,3,649195.08,24,2,10,7,True
2552109,1339,2,20,9303,369836781,0,0,0,949.86,5,648245.22,18,6,6,7,True
2879404,848,2,25,5741,369836781,0,0,0,949.9,8,647295.32,5,5,1,7,True
3032822,752,0,-1,1278,369836781,0,1,0,950.06,1,647295.32,24,1,4,8,True
3127302,705,1,-1,2978,369836781,0,2,0,950.11,1,647295.32,18,2,2,8,True
3212777,369,1,10,7251,369836781,0,0,0,950.18,6,648245.5,25,1,8,10,True
3254979,255,2,451,1629,369836781,0,0,0,950.04,7,647295.46,6,2,11,11,True
3362567,705,1,25,9359,369836781,0,0,0,949.94,8,646345.52,18,1,19,11,True
3450746,895,0,451,2978,369836781,0,0,0,949.75,7,645395.77,24,2,20,11,True
3787604,95,2,451,1177,369836781,0,0,0,949.93,7,644445.84,1,3,13,12,True
3793533,865,0,20,6725,369836781,0,0,0,950.1,5,643495.74,24,4,0,12,True
3847566,318,0,10,5912,369836781,0,0,0,950.15,6,644445.89,11,3,20,5,True
3899667,752,0,451,1177,369836781,0,0,0,949.83,7,643496.06,24,4,19,6,True
3964436,95,2,-1,5798,369836781,0,1,0,949.77,4,643496.06,1,2,1,7,True
4004140,848,2,-1,7448,369836781,0,2,0,950.04,4,643496.06,5,0,15,7,True
4264922,848,2,-1,7448,369836781,0,3,1,950.28,1,0.0,5,6,8,8,True
1083429,108,2,25,6532,909552048,0,0,0,430.06,8,832746.94,3,5,10,2,True
1224032,183,1,10,5219,909552048,0,0,0,429.64,0,833176.58,18,6,15,3,True
1254596,1404,2,20,6610,909552048,0,0,0,429.89,5,832746.69,24,0,2,4,True
1264171,240,4,451,6610,909552048,0,0,0,429.96,7,832316.73,26,2,21,4,True
1268144,108,2,25,8126,909552048,0,0,0,429.93,8,831886.8,3,3,15,4,True
1334159,240,4,25,6557,909552048,0,0,0,430.21,8,831456.59,26,2,17,4,True
1416539,240,4,451,2209,909552048,0,0,0,429.94,7,831026.65,26,6,20,5,True
1473864,240,4,25,3153,909552048,0,0,0,429.98,8,830596.67,26,2,6,6,True
1496723,721,4,451,9386,909552048,0,0,0,430.06,7,830166.61,11,3,21,6,True
1527048,645,0,10,9555,909552048,0,0,0,429.94,6,830596.55,24,2,2,7,True
1653993,480,0,451,2209,909552048,0,0,0,430.22,7,830166.33,5,2,6,8,False
2000631,108,2,-1,1294,909552048,0,1,0,429.68,4,830166.33,3,1,20,8,True
2051841,480,0,451,6532,909552048,0,0,0,430.07,7,829736.26,5,5,13,9,True
2269180,1377,0,10,9555,909552048,0,0,0,430.09,6,830166.35,16,6,15,9,True
2346535,135,2,20,2519,909552048,0,0,0,429.74,3,829736.61,18,6,1,9,False
2406761,12,4,30,9555,909552048,0,0,0,430.03,8,829306.58,24,6,22,10,True
2467657,507,4,25,1729,909552048,0,0,0,430.19,8,828876.39,12,3,6,12,True
2679572,1422,1,10,6610,909552048,0,0,0,429.91,6,829306.3,24,5,11,12,True
2773537,480,0,451,6557,909552048,0,0,0,430.38,7,828875.92,5,0,6,1,True
2792786,645,0,20,9386,909552048,0,0,0,430.17,5,828445.75,24,6,8,1,True
2998453,108,2,25,9386,909552048,0,0,0,429.65,8,828016.1,3,4,20,1,True
3070743,318,0,10,2519,909552048,0,0,0,429.8,0,828445.9,11,0,13,2,True
3320956,108,2,-1,6610,909552048,0,1,0,430.11,1,828445.9,3,0,7,3,True
3483152,240,4,451,2209,909552048,0,0,0,429.97,7,828015.93,26,4,4,3,True
3592349,1124,0,30,9555,909552048,0,0,0,430.09,8,827585.84,24,6,19,4,True
3927620,721,4,25,6557,909552048,0,0,0,429.83,8,827156.01,11,4,2,5,True
4327747,1124,0,30,8126,909552048,0,0,0,429.87,8,826726.14,24,2,19,8,True
4625024,1124,0,451,1729,909552048,0,0,0,429.97,7,826296.17,24,2,18,8,True
4755996,577,0,10,8126,909552048,0,0,0,430.1,6,826726.27,11,2,13,8,False
4963462,1429,0,10,5219,909552048,0,0,0,429.91,6,827156.18,24,5,21,9,True
5119147,507,4,451,5219,909552048,0,0,0,429.75,7,826726.43,12,1,1,10,True
5195261,480,0,30,9555,909552048,0,0,0,429.83,8,826296.6,5,4,7,10,True
5329991,924,4,30,2519,909552048,0,0,0,430.03,8,825866.57,18,0,22,10,True
5433748,240,4,-1,8037,909552048,0,1,0,430.23,1,825866.57,26,5,14,12,True
5485071,924,4,451,1294,909552048,0,0,0,430.05,7,825436.52,18,3,21,1,True
5726707,240,4,-1,3153,909552048,0,1,0,429.84,1,825436.52,26,6,18,1,True
5977212,1124,0,451,4038,909552048,0,0,0,429.95,7,825006.57,24,6,11,1,True
6063581,108,2,-1,9386,909552048,0,1,0,429.89,4,825006.57,3,6,5,2,True
6593165,721,4,25,1158,909552048,0,0,0,429.92,8,824576.65,11,0,21,3,False
7325474,12,4,451,8126,909552048,0,0,0,429.92,7,824146.73,24,4,10,4,True
7386457,956,1,10,1729,909552048,0,0,0,430.01,6,824576.74,13,6,19,4,True
8099119,1429,0,10,2209,909552048,0,0,0,429.92,0,825006.66,24,0,23,5,True
8201604,480,0,451,9555,909552048,0,0,0,429.98,7,824576.68,5,6,13,6,True
8744101,721,4,451,8596,909552048,0,0,0,429.9,7,824146.78,11,6,20,6,True
8919335,108,2,451,9386,909552048,0,0,0,430.23,7,823716.55,3,0,22,7,True
8952701,471,0,10,3153,909552048,0,0,0,430.08,6,824146.63,5,4,9,7,True
9149497,1124,0,25,6557,909552048,0,0,0,430.12,8,823716.51,24,4,21,7,True
9183464,97,0,20,3153,909552048,0,0,0,429.88,5,823286.63,3,0,21,7,True
9330934,12,4,451,5219,909552048,0,0,0,430.03,7,822856.6,24,6,12,9,True
9350678,480,0,30,5219,909552048,0,0,0,429.69,8,822426.91,5,2,20,9,True
9596515,924,4,-1,2209,909552048,0,1,0,430.05,4,822426.91,18,3,13,9,True
9658751,1124,0,30,6610,909552048,0,0,0,429.99,8,821996.92,24,5,2,10,True
9867347,924,4,25,4038,909552048,0,0,0,430.06,8,821566.86,18,5,20,11,True
1016527,846,3,25,6509,866008262,1,0,0,479.17,8,285791.83,5,1,0,1,True
1078556,1317,4,451,9628,866008262,1,0,0,479.1,7,285312.73,18,4,13,2,True
1106150,478,4,451,2473,866008262,1,0,0,479.11,7,284833.62,5,5,0,2,True
1119383,846,3,30,6509,866008262,1,0,0,479.08,8,284354.54,5,4,1,2,True
1283440,478,4,25,1103,866008262,1,0,0,478.94,8,283875.6,5,4,1,3,True
1496107,359,2,451,4662,866008262,1,0,0,479.1,7,283396.5,24,5,13,4,True
1800463,846,3,25,7980,866008262,1,0,0,478.92,8,282917.58,5,6,1,6,True
1825696,1317,4,451,2383,866008262,1,0,0,479.14,7,282438.44,18,5,11,7,True
2155515,1212,0,-1,4064,866008262,1,1,0,478.93,4,282438.44,24,2,10,9,True
2406028,359,2,30,4753,866008262,1,0,0,479.18,8,281959.26,24,6,23,10,True
2570041,372,0,10,6139,866008262,1,0,0,478.97,6,282438.23,25,2,1,10,True
2634265,1370,4,30,6223,866008262,1,0,0,478.97,8,281959.26,16,1,7,10,True
3284551,1317,4,25,3101,866008262,1,0,0,478.85,8,281480.41,18,5,1,11,True
3408524,951,0,30,3324,866008262,1,0,0,479.13,8,281001.28,24,6,5,11,True
3573368,951,0,25,4739,866008262,1,0,0,478.86,8,280522.42,24,0,0,12,True
3846092,1317,4,30,6509,866008262,1,0,0,478.83,8,280043.59,18,2,13,12,True
3918522,846,3,25,1792,866008262,1,0,0,478.9,8,279564.69,5,5,11,1,True
4206663,478,4,-1,4739,866008262,1,1,0,478.95,1,279564.69,5,0,13,1,True
4268344,951,0,30,1755,866008262,1,0,0,478.93,8,279085.76,24,2,5,1,True
4415884,478,4,451,4064,866008262,1,0,0,479.12,7,278606.64,5,5,2,3,True
4452327,951,0,25,1792,866008262,1,0,0,479.09,8,278127.55,24,0,18,4,True
4531483,478,4,-1,1218,866008262,1,1,0,479.1,1,278127.55,5,1,7,4,True
4662173,951,0,451,9628,866008262,1,0,0,479.19,7,277648.36,24,5,4,5,True
4988953,1317,4,30,1792,866008262,1,0,0,478.93,8,277169.43,18,5,8,5,True
5012167,128,0,20,1792,866008262,1,0,0,479.06,5,276690.37,18,2,20,6,True
5070312,1454,1,10,7980,866008262,1,0,0,478.95,6,277169.32,11,6,6,6,True
5086888,846,3,25,7149,866008262,1,0,0,479.05,8,276690.27,5,0,10,7,True
5510791,478,4,-1,1103,866008262,1,1,0,479.22,4,276690.27,5,2,19,8,True
5523851,478,4,451,4064,866008262,1,0,0,479.14,7,276211.13,5,3,1,8,True
5605522,1212,0,30,6509,866008262,1,0,0,478.65,8,275732.48,24,6,11,8,True
5784592,846,3,451,2383,866008262,1,0,0,478.99,7,275253.49,5,3,16,9,True
6079348,68,0,10,4662,866008262,1,0,0,479.23,0,275732.72,20,3,9,10,True
6083838,1370,4,451,9462,866008262,1,0,0,479.04,7,275253.68,16,5,21,11,True
6204095,96,0,20,4753,866008262,1,0,0,479.02,5,274774.66,1,5,11,12,True
6293282,616,1,10,9462,866008262,1,0,0,479.04,0,275253.7,11,0,19,12,True
6330429,951,0,451,2473,866008262,1,0,0,479.07,7,274774.63,24,4,0,12,True
6789604,846,3,-1,7980,866008262,1,1,0,478.99,4,274774.63,5,2,18,1,True
6980745,1370,4,25,6139,866008262,1,0,0,479.22,8,274295.41,16,1,9,1,True
7251349,1212,0,451,7980,866008262,1,0,0,478.93,7,273816.48,24,3,18,2,True
7265266,1370,4,25,9315,866008262,1,0,0,479.28,8,273337.2,16,4,22,3,True
7268333,1205,0,10,1103,866008262,1,0,0,479.0,6,273816.2,24,2,11,4,True
7318335,727,0,20,9628,866008262,1,0,0,479.06,3,273337.14,11,0,8,4,True
7405889,1212,0,451,9628,866008262,1,0,0,478.76,7,272858.38,24,6,17,5,True
7483137,576,2,20,8157,866008262,1,0,0,479.06,5,272379.32,11,1,19,5,True
7512083,846,3,25,4064,866008262,1,0,0,479.11,8,271900.21,5,6,17,6,True
8003390,478,4,25,4753,866008262,1,0,0,479.04,8,271421.17,5,2,17,6,True
8088283,951,0,30,3311,866008262,1,0,0,478.93,8,270942.24,24,2,20,7,True
8334001,1212,0,25,9462,866008262,1,0,0,479.08,8,270463.16,24,5,10,8,True
8344144,1317,4,-1,2383,866008262,1,1,0,479.08,4,270463.16,18,6,16,8,True
9311322,1246,0,10,1792,866008262,1,0,0,479.17,6,270942.33,23,2,5,8,True
9342705,951,0,451,2473,866008262,1,0,0,479.13,7,270463.2,24,6,4,9,True
9675049,269,0,20,3101,866008262,1,0,0,479.05,5,269984.15,24,0,10,10,True
9705904,1212,0,25,6509,866008262,1,0,0,479.04,8,269505.11,24,6,9,11,True
1033187,929,0,10,8395,184163557,0,0,0,579.91,6,987037.91,18,3,4,9,True
1039849,829,4,-1,3263,184163557,0,1,0,579.98,4,987037.91,18,2,23,10,True
1082396,829,4,-1,7882,184163557,0,2,0,579.87,1,987037.91,18,1,23,12,True
1112815,829,4,-1,1483,184163557,0,3,1,580.06,1,0.0,18,4,14,12,True
1029635,318,0,10,7111,703136988,1,0,0,1059.71,6,247673.71,11,1,8,1,True
1033383,364,4,451,3857,703136988,1,0,0,1060.15,7,246613.56,25,1,9,3,True
1093342,1445,2,20,2596,703136988,1,0,0,1059.79,3,245553.77,24,1,5,3,True
1217274,395,4,451,8111,703136988,1,0,0,1060.09,7,244493.68,10,3,21,3,True
1363274,1377,0,10,6545,703136988,1,0,0,1059.89,6,245553.57,16,4,0,4,True
1684404,781,1,451,8998,703136988,1,0,0,1060.03,7,244493.54,14,3,7,4,True
2081248,781,1,30,5228,703136988,1,0,0,1060.02,8,243433.52,14,5,4,4,True
2128729,781,1,451,2404,703136988,1,0,0,1059.94,7,242373.58,14,1,16,5,True
2213504,512,0,20,6316,703136988,1,0,0,1060.15,5,241313.43,12,5,13,5,True
2737572,292,1,10,6545,703136988,1,0,0,1059.82,0,242373.25,4,2,17,6,True
2801858,364,4,-1,6797,703136988,1,1,0,1059.98,4,242373.25,25,0,10,6,True
3287645,781,1,451,4172,703136988,1,0,0,1060.12,7,241313.13,14,2,12,6,True
3388356,781,1,30,3857,703136988,1,0,0,1059.69,8,240253.44,14,2,9,7,True
3568565,35,2,20,5228,703136988,1,0,0,1059.96,5,239193.48,11,2,20,8,True
3661600,1210,0,20,6545,703136988,1,0,0,1060.07,5,238133.41,24,0,21,8,True
3687028,1192,2,20,7321,703136988,1,0,0,1059.92,5,237073.49,24,4,6,9,True
3822480,155,1,451,1022,703136988,1,0,0,1060.17,7,236013.32,18,1,1,9,True
3837191,739,1,30,7321,703136988,1,0,0,1060.01,8,234953.31,24,4,10,9,False
3969780,781,1,-1,4172,703136988,1,1,0,1059.99,4,234953.31,14,3,14,11,True
4054360,952,0,10,8870,703136988,1,0,0,1060.07,6,236013.38,13,6,3,12,True
4260868,739,1,25,6545,703136988,1,0,0,1060.3,8,234953.08,24,0,13,12,True
4310840,727,0,10,6545,703136988,1,0,0,1060.02,0,236013.1,11,2,10,12,True
4782698,1036,1,10,6599,703136988,1,0,0,1059.98,6,237073.08,11,3,15,12,True
4878954,155,1,30,3857,703136988,1,0,0,1059.93,8,236013.15,18,1,22,2,True
4950692,739,1,-1,7321,703136988,1,1,0,1060.19,4,236013.15,24,1,9,2,True
5611773,395,4,451,8427,703136988,1,0,0,1060.19,7,234952.96,10,5,3,3,True
5745997,395,4,25,4863,703136988,1,0,0,1060.0,8,233892.96,10,6,15,4,True
5820052,1025,1,10,6316,703136988,1,0,0,1059.91,6,234952.87,11,2,5,4,True
6115048,219,0,20,7111,703136988,1,0,0,1059.84,3,233893.03,9,3,13,4,True
6214739,155,1,25,8111,703136988,1,0,0,1060.05,8,232832.98,18,4,23,4,True
6244082,364,4,25,9391,703136988,1,0,0,1060.02,8,231772.96,25,4,18,5,True
6596830,560,2,20,9800,703136988,1,0,0,1059.77,5,230713.19,17,2,3,5,True
6836723,318,0,20,4172,703136988,1,0,0,1060.22,5,229652.97,11,3,8,5,True
7018409,155,1,25,7321,703136988,1,0,0,1059.88,8,228593.09,18,3,17,6,True
7026722,364,4,451,9800,703136988,1,0,0,1059.94,7,227533.15,25,5,18,7,True
7048680,364,4,25,8998,703136988,1,0,0,1059.7,8,226473.45,25,5,21,7,False
7355874,395,4,-1,3857,703136988,1,1,0,1060.14,1,226473.45,10,4,21,10,True
7429862,739,1,30,5228,703136988,1,0,0,1059.71,8,225413.74,24,0,1,10,True
7616928,739,1,-1,4172,703136988,1,1,0,1059.92,4,225413.74,24,4,22,11,True
7724185,395,4,25,8111,703136988,1,0,0,1059.99,8,224353.75,10,6,23,11,True
7875141,155,1,451,9391,703136988,1,0,0,1060.05,7,223293.7,18,1,19,2,True
7944439,395,4,-1,3857,703136988,1,1,0,1060.11,4,223293.7,10,5,9,3,True
8194223,395,4,25,3857,703136988,1,0,0,1059.85,8,222233.85,10,6,18,4,True
8454824,395,4,451,6797,703136988,1,0,0,1060.07,7,221173.78,10,5,22,4,True
8793669,628,0,10,1022,703136988,1,0,0,1060.26,0,222234.04,11,0,7,4,True
8957981,701,2,20,2596,703136988,1,0,0,1059.87,5,221174.17,18,2,7,5,True
9132364,364,4,30,9800,703136988,1,0,0,1059.82,8,220114.35,25,1,23,5,True
9173794,364,4,451,2404,703136988,1,0,0,1059.98,7,219054.37,25,3,9,6,True
9180017,739,1,-1,8998,703136988,1,1,0,1060.15,4,219054.37,24,6,20,6,True
9762354,917,0,20,9391,703136988,1,0,0,1060.04,3,217994.33,18,1,5,7,True
9769557,781,1,30,6797,703136988,1,0,0,1059.82,8,216934.51,14,4,4,7,True
9828454,395,4,25,4863,703136988,1,0,0,1059.88,8,215874.63,10,1,19,10,True
9839294,781,1,451,3857,703136988,1,0,0,1060.06,7,214814.57,14,3,3,10,True
9923428,364,4,451,2404,703136988,1,0,0,1059.99,7,213754.58,25,3,23,11,True
1797752,1190,3,451,2957,920814984,0,0,0,194.82,7,649854.18,24,2,19,2,True
1845948,1190,3,25,6791,920814984,0,0,0,194.94,8,649659.24,24,5,7,2,True
1864828,373,1,10,5214,920814984,0,0,0,195.13,0,649854.37,25,5,17,3,True
1952047,1001,4,30,1701,920814984,0,0,0,195.15,8,649659.22,26,1,17,3,True
2191997,1064,0,25,6791,920814984,0,0,0,194.9,8,649464.32,11,6,16,3,True
2241349,1064,0,451,5396,920814984,0,0,0,194.94,7,649269.38,11,4,7,3,True
2253307,1064,0,25,2957,920814984,0,0,0,195.22,8,649074.16,11,0,18,3,True
2274318,371,3,30,1701,920814984,0,0,0,194.86,8,648879.3,25,3,20,4,True
2642528,366,0,30,2957,920814984,0,0,0,194.9,8,648684.4,25,4,18,5,True
2699117,371,3,-1,7931,920814984,0,1,0,195.05,1,648684.4,25,0,16,6,True
2753735,366,0,451,9998,920814984,0,0,0,195.08,7,648489.32,25,0,12,8,True
3099888,1084,4,25,7410,920814984,0,0,0,194.77,8,648294.55,18,5,3,9,True
3158034,254,0,10,2038,920814984,0,0,0,195.04,0,648489.59,6,1,3,9,True
3228484,366,0,25,3614,920814984,0,0,0,194.95,8,648294.64,25,1,17,9,True
3241525,371,3,30,5002,920814984,0,0,0,194.91,8,648099.73,25,0,19,10,True
3477438,1190,3,451,6608,920814984,0,0,0,194.77,7,647904.96,24,4,7,10,True
3615652,1190,3,30,1701,920814984,0,0,0,195.09,8,647709.87,24,6,21,11,True
3778543,1084,4,-1,7410,920814984,0,1,0,194.85,4,647709.87,18,0,14,12,True
4333761,59,0,10,4247,920814984,0,0,0,195.07,6,647904.94,20,0,13,1,True
4349465,1190,3,25,4815,920814984,0,0,0,195.2,8,647709.74,24,6,6,2,True
4547912,371,3,451,5396,920814984,0,0,0,194.74,7,647515.0,25,5,0,3,True
4785097,1001,4,25,7225,920814984,0,0,0,194.99,8,647320.01,26,3,14,3,True
5039649,1190,3,30,8725,920814984,0,0,0,194.89,8,647125.12,24,2,6,4,True
5045230,1001,4,30,2038,920814984,0,0,0,194.98,8,646930.14,26,5,12,4,True
5420926,1190,3,-1,1182,920814984,0,1,0,194.78,1,646930.14,24,3,8,5,True
5725381,371,3,-1,4815,920814984,0,2,0,194.93,4,646930.14,25,3,10,6,True
5950222,525,0,10,1147,920814984,0,0,0,194.93,0,647125.07,18,4,18,7,True
6428398,1064,0,451,5002,920814984,0,0,0,195.25,7,646929.82,11,2,4,8,True
6514699,1001,4,25,8725,920814984,0,0,0,195.04,8,646734.78,26,2,9,9,True
6532076,371,3,25,7367,920814984,0,0,0,195.13,8,646539.65,25,3,10,9,True
6552985,1190,3,30,1147,920814984,0,0,0,194.94,8,646344.71,24,6,9,10,True
6577403,1233,0,10,5002,920814984,0,0,0,194.92,6,646539.63,18,3,5,10,True
6660284,371,3,451,3045,920814984,0,0,0,194.96,7,646344.67,25,3,23,11,True
6818515,1084,4,-1,4247,920814984,0,1,0,195.14,1,646344.67,18,3,14,11,True
6983616,1190,3,25,9998,920814984,0,0,0,194.77,8,646149.9,24,5,15,12,True
7234168,1001,4,451,4815,920814984,0,0,0,195.13,7,645954.77,26,4,18,1,True
7589012,1190,3,451,7367,920814984,0,0,0,194.82,7,645759.95,24,3,19,2,True
7758945,1084,4,30,1147,920814984,0,0,0,194.94,8,645565.01,18,0,8,3,True
7840456,1190,3,30,5873,920814984,0,0,0,194.79,8,645370.22,24,1,6,5,True
7858444,371,3,451,5214,920814984,0,0,0,195.04,7,645175.18,25,3,17,7,True
7932220,428,0,20,8725,920814984,0,0,0,195.21,5,644979.97,18,3,14,7,True
7944863,1001,4,451,6791,920814984,0,0,0,194.83,7,644785.14,26,0,11,7,True
8175958,1001,4,-1,4815,920814984,0,1,0,194.82,4,644785.14,26,5,9,8,True
8744449,1064,0,451,5873,920814984,0,0,0,195.02,7,644590.12,11,5,22,8,True
8762889,371,3,30,4247,920814984,0,0,0,195.05,8,644395.07,25,5,4,8,True
8825144,1116,0,10,5873,920814984,0,0,0,195.06,6,644590.13,24,6,15,9,True
8930780,366,0,451,7367,920814984,0,0,0,194.87,7,644395.26,25,4,2,9,True
8975886,1190,3,25,7410,920814984,0,0,0,195.04,8,644200.22,24,3,21,10,True
9032373,1084,4,25,6791,920814984,0,0,0,195.26,8,644004.96,18,5,3,10,True
9276618,584,0,20,5002,920814984,0,0,0,194.77,5,643810.19,11,5,11,10,True
9285563,1435,2,20,7410,920814984,0,0,0,195.05,5,643615.14,24,6,3,11,True
9704514,1084,4,451,3614,920814984,0,0,0,194.99,7,643420.15,18,2,0,11,True
1014905,1483,0,20,9022,588644472,0,0,0,236.04,5,867991.96,24,2,5,2,True
1158409,90,4,30,5942,588644472,0,0,0,235.88,8,867756.08,1,1,11,3,True
1568693,416,2,25,9022,588644472,0,0,0,235.98,8,867520.1,18,5,9,3,True
1670001,416,2,30,4622,588644472,0,0,0,236.05,8,867284.05,18,2,20,3,True
2313551,712,0,20,1116,588644472,0,0,0,235.97,5,867048.08,18,3,17,6,False
2433353,190,4,-1,8968,588644472,0,1,0,236.16,4,867048.08,18,3,15,6,True
2532845,331,4,30,9533,588644472,0,0,0,236.18,8,866811.9,11,6,8,8,True
2935745,145,0,10,9533,588644472,0,0,0,236.42,0,867048.32,18,4,3,9,True
2966662,790,0,25,5690,588644472,0,0,0,236.36,8,866811.96,11,0,11,9,True
3326354,790,0,25,9871,588644472,0,0,0,235.96,8,866576.0,11,0,21,9,True
3341129,331,4,-1,1988,588644472,0,1,0,236.08,4,866576.0,11,5,3,10,True
3389692,790,0,25,1988,588644472,0,0,0,236.12,8,866339.88,11,5,12,11,True
3518064,416,2,451,7301,588644472,0,0,0,235.92,7,866103.96,18,0,2,12,True
3694819,204,0,10,9396,588644472,0,0,0,235.91,6,866339.87,9,0,8,12,True
4132906,331,4,451,9022,588644472,0,0,0,236.01,7,866103.86,11,3,8,2,True
4195333,115,2,20,3624,588644472,0,0,0,236.01,5,865867.85,3,2,1,3,True
4248775,1425,0,25,9644,588644472,0,0,0,235.93,8,865631.92,24,3,7,3,True
4419673,190,4,451,9022,588644472,0,0,0,236.25,7,865395.67,18,2,14,4,True
4445238,1425,0,25,9022,588644472,0,0,0,235.89,8,865159.78,24,3,6,5,False
4536716,90,4,451,7301,588644472,0,0,0,236.16,7,864923.62,1,0,14,5,True
4799501,1235,1,10,8795,588644472,0,0,0,235.97,6,865159.59,18,6,11,5,True
4861185,790,0,10,4785,588644472,0,0,0,236.06,6,865395.65,11,3,22,5,True
5127501,1128,2,20,9871,588644472,0,0,0,235.91,5,865159.74,24,1,16,5,True
5182666,790,0,451,6001,588644472,0,0,0,236.06,7,864923.68,11,3,17,6,False
5266256,331,4,25,5942,588644472,0,0,0,235.99,8,864687.69,11,5,18,6,True
5416824,406,1,10,1116,588644472,0,0,0,235.86,6,864923.55,10,4,9,7,False
5436727,790,0,451,9871,588644472,0,0,0,236.22,7,864687.33,11,0,3,8,True
5513994,416,2,451,9871,588644472,0,0,0,236.13,7,864451.2,18,4,16,11,False
5536373,416,2,-1,4622,588644472,0,1,0,235.93,4,864451.2,18,2,20,1,True
5662128,128,0,20,3624,588644472,0,0,0,236.18,5,864215.02,18,4,13,1,True
5769922,1425,0,25,9022,588644472,0,0,0,236.03,8,863978.99,24,2,20,1,True
5929533,393,1,10,3655,588644472,0,0,0,236.25,6,864215.24,10,4,5,1,True
5952531,190,4,451,2250,588644472,0,0,0,235.88,7,863979.36,18,4,11,2,True
6327052,190,4,451,4457,588644472,0,0,0,236.0,7,863743.36,18,4,3,3,True
6368901,790,0,451,9363,588644472,0,0,0,236.29,7,863507.07,11,4,4,3,True
6410682,190,4,25,5360,588644472,0,0,0,235.98,8,863271.09,18,5,19,3,True
6605720,393,1,10,8795,588644472,0,0,0,236.12,6,863507.21,10,2,11,4,True
6883471,416,2,25,9057,588644472,0,0,0,236.15,8,863271.06,18,4,2,4,True
6930449,184,0,10,4298,588644472,0,0,0,235.94,6,863507.0,18,0,10,4,True
6991944,1425,0,30,7301,588644472,0,0,0,236.04,8,863270.96,24,2,18,5,True
7267706,416,2,451,1253,588644472,0,0,0,235.92,7,863035.04,18,1,2,5,True
7422765,1114,1,10,8795,588644472,0,0,0,235.88,0,863270.92,0,2,6,5,True
7482232,190,4,30,9022,588644472,0,0,0,235.9,8,863035.02,18,3,8,5,True
7754356,331,4,30,9644,588644472,0,0,0,235.76,8,862799.26,11,5,17,6,True
8165299,90,4,451,9022,588644472,0,0,0,235.8,7,862563.46,1,2,6,6,True
8330475,1425,0,25,9396,588644472,0,0,0,235.95,8,862327.51,24,4,9,6,True
8350096,1425,0,30,3655,588644472,0,0,0,236.13,8,862091.38,24,0,12,6,True
8825264,1065,0,10,7301,588644472,0,0,0,236.36,6,862327.74,11,4,8,6,True
8917145,1063,0,20,3624,588644472,0,0,0,235.89,3,862091.85,11,0,16,7,True
8974139,360,0,20,5942,588644472,0,0,0,236.23,5,861855.62,24,5,23,7,True
9153594,90,4,30,5942,588644472,0,0,0,235.94,8,861619.68,1,0,13,7,True
9320508,1425,0,25,6001,588644472,0,0,0,236.13,8,861383.55,24,1,5,7,True
9449473,190,4,-1,1988,588644472,0,1,0,236.36,4,861383.55,18,2,17,7,True
9594419,790,0,25,7301,588644472,0,0,0,236.02,8,861147.53,11,6,15,8,True
9674511,1075,0,10,2250,588644472,0,0,0,236.2,0,861383.73,18,6,21,9,True
9799358,1425,0,-1,9871,588644472,0,1,0,235.89,1,861383.73,24,2,8,9,True
9868175,90,4,25,2250,588644472,0,0,0,236.15,8,861147.58,1,1,0,10,True
9878020,90,4,-1,3624,588644472,0,1,0,235.97,1,861147.58,1,0,6,11,True
1010480,289,4,451,9305,287484291,1,0,0,377.03,7,948403.97,24,5,17,1,True
1420593,814,4,-1,8142,287484291,1,1,0,376.98,4,948403.97,18,0,6,1,True
1447121,234,0,10,8850,287484291,1,0,0,376.73,6,948780.7,26,3,1,1,True
1631727,289,4,25,4502,287484291,1,0,0,377.08,8,948403.62,24,4,1,1,True
1840960,289,4,451,1808,287484291,1,0,0,376.89,7,948026.73,24,0,6,2,True
1923913,428,0,10,8850,287484291,1,0,0,377.2,6,948403.93,18,5,2,2,True
2096672,294,3,30,4502,287484291,1,0,0,377.18,8,948026.75,4,4,6,3,True
2482716,814,4,451,9305,287484291,1,0,0,377.18,7,947649.57,18,1,10,4,True
2600313,568,1,10,9061,287484291,1,0,0,377.06,6,948026.63,11,1,17,5,True
2738128,497,0,20,9990,287484291,1,0,0,376.71,5,947649.92,12,5,8,6,True
2927964,1379,3,30,8142,287484291,1,0,0,377.15,8,947272.77,16,2,6,6,True
3051249,1474,0,20,1008,287484291,1,0,0,376.75,5,946896.02,24,2,3,7,True
3113166,289,4,451,9990,287484291,1,0,0,377.0,7,946519.02,24,0,15,7,True
3510327,726,0,20,2092,287484291,1,0,0,376.96,3,946142.06,11,4,4,8,True
3944015,294,3,30,4502,287484291,1,0,0,377.14,8,945764.92,4,5,21,9,True
4082433,289,4,451,8850,287484291,1,0,0,377.2,7,945387.72,24,1,21,9,True
4102838,780,0,10,5231,287484291,1,0,0,376.94,6,945764.66,14,6,11,10,True
4390685,1481,4,-1,8850,287484291,1,1,0,376.8,1,945764.66,24,5,8,10,False
4412269,814,4,-1,2092,287484291,1,2,0,376.9,4,945764.66,18,3,22,10,True
4506880,289,4,30,9317,287484291,1,0,0,376.75,8,945387.91,24,6,23,10,False
4523433,1379,3,30,9317,287484291,1,0,0,376.99,8,945010.92,16,0,17,10,True
4662478,195,1,10,9061,287484291,1,0,0,377.1,6,945388.02,18,0,9,11,True
4681904,804,0,10,9990,287484291,1,0,0,377.12,6,945765.14,11,2,23,11,True
4997308,1379,3,30,8278,287484291,1,0,0,376.69,8,945388.45,16,4,5,12,True
5201751,1379,3,25,8965,287484291,1,0,0,376.72,8,945011.73,16,3,5,12,True
5498534,814,4,30,2092,287484291,1,0,0,377.04,8,944634.69,18,3,13,12,True
5513379,787,0,20,3735,287484291,1,0,0,376.83,5,944257.86,14,6,10,3,True
5649240,645,0,20,5231,287484291,1,0,0,376.96,3,943880.9,24,1,7,3,True
5711543,289,4,451,9305,287484291,1,0,0,377.12,7,943503.78,24,0,0,3,True
5811931,1481,4,451,1808,287484291,1,0,0,376.73,7,943127.05,24,3,4,4,True
5948823,1481,4,451,8278,287484291,1,0,0,376.84,7,942750.21,24,0,18,5,True
6461709,1481,4,-1,9990,287484291,1,1,0,377.21,4,942750.21,24,2,12,5,True
6519993,294,3,30,1008,287484291,1,0,0,377.04,8,942373.17,4,5,15,6,True
6532630,1481,4,25,3739,287484291,1,0,0,376.97,8,941996.2,24,6,15,6,True
6563522,1041,0,20,9990,287484291,1,0,0,377.17,3,941619.03,11,6,11,8,False
6783617,294,3,30,2092,287484291,1,0,0,377.08,8,941241.95,4,1,16,8,True
6800186,1379,3,451,8965,287484291,1,0,0,377.13,7,940864.82,16,0,3,8,True
6832780,1379,3,451,9305,287484291,1,0,0,376.99,7,940487.83,16,6,9,8,True
6990437,814,4,451,9990,287484291,1,0,0,376.99,7,940110.84,18,4,15,9,True
7282288,1379,3,451,3739,287484291,1,0,0,376.95,7,939733.89,16,5,18,9,True
7486587,814,4,30,9061,287484291,1,0,0,377.02,8,939356.87,18,5,17,10,True
7579764,1239,1,10,4502,287484291,1,0,0,376.98,6,939733.85,18,6,3,10,True
7725448,1379,3,-1,9305,287484291,1,1,0,376.82,4,939733.85,16,6,20,11,True
7828392,289,4,30,3739,287484291,1,0,0,376.62,8,939357.23,24,3,2,1,True
8047999,814,4,451,2092,287484291,1,0,0,377.02,7,938980.21,18,1,0,1,True
8355660,759,0,10,9990,287484291,1,0,0,377.05,0,939357.26,24,6,9,1,True
8510535,1379,3,25,8278,287484291,1,0,0,377.13,8,938980.13,16,0,5,1,True
8552834,814,4,25,2092,287484291,1,0,0,376.91,8,938603.22,18,3,13,2,True
8643269,1379,3,30,4502,287484291,1,0,0,377.07,8,938226.15,16,1,18,3,True
8702748,577,0,20,8850,287484291,1,0,0,377.03,5,937849.12,11,5,18,4,True
8727088,814,4,-1,8850,287484291,1,1,0,377.13,4,937849.12,18,0,18,4,True
9013017,1379,3,-1,8142,287484291,1,2,0,377.38,4,937849.12,16,0,12,6,True
9071352,814,4,25,3739,287484291,1,0,0,377.2,8,937471.92,18,4,0,6,True
9096663,877,2,20,9990,287484291,1,0,0,377.08,5,937094.84,24,3,0,8,True
9167358,289,4,30,1008,287484291,1,0,0,377.15,8,936717.69,24,5,3,8,True
9175334,294,3,-1,2092,287484291,1,1,0,376.82,1,936717.69,4,3,4,9,True
9324248,1481,4,-1,4502,287484291,1,2,0,377.0,4,936717.69,24,3,8,9,False
9473061,438,1,10,8142,287484291,1,0,0,377.05,6,937094.74,24,5,14,9,True
9985735,1377,0,10,9990,287484291,1,0,0,377.05,0,937471.79,16,0,17,11,True
1259758,571,4,30,7048,673057255,1,0,0,606.02,8,499463.98,11,2,0,1,True
1261539,569,4,451,5189,673057255,1,0,0,606.16,7,498857.82,11,1,10,2,True
1973559,916,0,-1,6494,673057255,1,1,0,605.93,4,498857.82,18,3,7,2,True
2038041,916,0,-1,1009,673057255,1,2,0,605.95,4,498857.82,18,2,21,3,True
2382529,1075,0,10,7048,673057255,1,0,0,606.05,0,499463.87,18,1,7,4,True
2453638,834,0,10,6494,673057255,1,0,0,605.96,6,500069.83,5,5,10,5,True
2525969,730,4,25,3410,673057255,1,0,0,605.81,8,499464.02,11,6,13,5,False
2537870,607,2,25,5189,673057255,1,0,0,605.97,8,498858.05,24,5,1,6,True
2567233,569,4,30,7517,673057255,1,0,0,606.03,8,498252.02,11,3,20,6,True
2625295,448,0,20,7212,673057255,1,0,0,605.76,5,497646.26,13,5,4,7,True
2752487,372,0,20,6311,673057255,1,0,0,605.72,3,497040.54,25,6,19,7,True
2790543,916,0,451,7517,673057255,1,0,0,606.04,7,496434.5,18,5,22,8,True
2817982,571,4,30,5977,673057255,1,0,0,605.85,8,495828.65,11,1,8,9,True
2954685,607,2,451,5977,673057255,1,0,0,606.06,7,495222.59,24,0,11,10,True
2993458,569,4,451,2224,673057255,1,0,0,605.65,7,494616.94,11,6,2,11,True
3235437,571,4,-1,1696,673057255,1,1,0,606.13,4,494616.94,11,2,6,11,True
3255519,98,0,10,3410,673057255,1,0,0,605.88,6,495222.82,3,0,6,12,True
3267335,607,2,30,2784,673057255,1,0,0,606.12,8,494616.7,24,2,4,12,True
3625766,574,2,451,7517,673057255,1,0,0,606.24,7,494010.46,11,1,17,12,True
3867846,735,1,10,7212,673057255,1,0,0,606.13,6,494616.59,11,0,19,1,True
3992108,730,4,25,9594,673057255,1,0,0,606.17,8,494010.42,11,2,16,3,True
4223433,574,2,30,5896,673057255,1,0,0,605.98,8,493404.44,11,0,12,4,True
4437969,842,2,20,8803,673057255,1,0,0,605.9,5,492798.54,5,6,11,6,True
4586672,571,4,30,2224,673057255,1,0,0,606.02,8,492192.52,11,6,20,6,True
4756989,525,0,10,7100,673057255,1,0,0,606.0,6,492798.52,18,0,17,6,True
5388150,1284,2,20,1696,673057255,1,0,0,606.04,3,492192.48,24,3,7,6,True
5407840,314,0,20,5896,673057255,1,0,0,605.88,5,491586.6,4,4,4,8,True
5412059,607,2,-1,8602,673057255,1,1,0,606.05,4,491586.6,24,5,13,8,True
5667650,569,4,451,6311,673057255,1,0,0,606.01,7,490980.59,11,4,4,9,True
5845709,569,4,25,6311,673057255,1,0,0,606.25,8,490374.34,11,1,5,9,True
6087699,910,0,451,2784,673057255,1,0,0,605.87,7,489768.47,18,3,1,9,True
6139687,574,2,30,2784,673057255,1,0,0,606.34,8,489162.13,11,6,8,9,True
6194177,394,0,20,2748,673057255,1,0,0,605.95,5,488556.18,10,1,10,10,True
6320089,832,3,-1,7048,673057255,1,1,0,606.33,4,488556.18,5,4,9,10,True
6497419,910,0,451,5896,673057255,1,0,0,606.01,7,487950.17,18,2,7,10,True
6537554,574,2,25,7133,673057255,1,0,0,605.93,8,487344.24,11,3,4,11,True
7006282,480,0,10,7714,673057255,1,0,0,605.65,6,487949.89,5,4,4,11,True
7302948,832,3,25,6494,673057255,1,0,0,606.1,8,487343.79,5,1,16,11,True
7305024,607,2,451,5896,673057255,1,0,0,605.63,7,486738.16,24,3,12,11,True
7350844,910,0,25,7714,673057255,1,0,0,606.04,8,486132.12,18,5,19,12,True
7471414,910,0,-1,6311,673057255,1,1,0,605.9,4,486132.12,18,4,14,12,True
7668366,569,4,25,1009,673057255,1,0,0,605.69,8,485526.43,11,2,11,1,True
8117172,916,0,25,6311,673057255,1,0,0,605.78,8,484920.65,18,3,21,2,True
8254409,574,2,25,5896,673057255,1,0,0,606.16,8,484314.49,11,4,7,3,True
8372794,320,1,10,1696,673057255,1,0,0,605.98,6,484920.47,11,6,13,3,True
8396694,569,4,-1,2784,673057255,1,1,0,606.08,4,484920.47,11,5,16,4,True
8803964,916,0,451,5157,673057255,1,0,0,606.01,7,484314.46,18,1,10,5,True
8957007,607,2,451,5618,673057255,1,0,0,606.26,7,483708.2,24,6,14,6,True
9213441,574,2,451,4648,673057255,1,0,0,605.91,7,483102.29,11,4,11,7,True
9275336,574,2,30,5618,673057255,1,0,0,606.15,8,482496.14,11,0,19,8,True
9323732,910,0,451,7090,673057255,1,0,0,605.84,7,481890.3,18,3,15,8,True
9493081,574,2,25,6494,673057255,1,0,0,606.13,8,481284.17,11,0,22,9,False
9501317,916,0,-1,7714,673057255,1,1,0,605.93,4,481284.17,18,4,20,9,True
9508881,910,0,25,5189,673057255,1,0,0,606.06,8,480678.11,18,2,1,10,True
1059631,304,0,30,8461,353511595,1,0,0,480.84,8,202336.16,4,3,16,1,True
1066353,304,0,25,4430,353511595,1,0,0,481.14,8,201855.02,4,2,16,1,True
1121329,1211,4,25,4406,353511595,1,0,0,481.15,8,201373.87,24,6,17,2,True
1196773,1111,0,20,4317,353511595,1,0,0,481.11,5,200892.76,0,6,4,3,True
1303567,1242,4,30,3697,353511595,1,0,0,480.93,8,200411.83,18,3,3,5,True
1369442,716,0,20,8461,353511595,1,0,0,480.96,5,199930.87,18,4,10,5,True
1453923,304,0,30,3064,353511595,1,0,0,480.97,8,199449.9,4,0,10,5,True
1483195,588,0,10,9525,353511595,1,0,0,480.97,6,199930.87,24,5,14,6,True
1566619,1233,0,451,5067,353511595,1,0,0,480.83,7,199450.04,18,6,5,6,True
1716764,1242,4,25,4430,353511595,1,0,0,481.02,8,198969.02,18,5,2,6,True
2173177,995,1,30,9082,353511595,1,0,0,480.84,8,198488.18,22,0,6,7,True
2175762,130,0,10,8835,353511595,1,0,0,480.97,6,198969.15,18,6,15,7,True
2393861,1242,4,25,6211,353511595,1,0,0,480.93,8,198488.22,18,5,6,7,True
2660402,715,0,10,5348,353511595,1,0,0,480.82,0,198969.04,18,1,5,7,False
2690888,1156,1,10,3697,353511595,1,0,0,481.04,6,199450.08,15,3,12,8,True
2808101,1211,4,30,6211,353511595,1,0,0,481.18,8,198968.9,24,2,16,8,True
3072874,15,4,25,6796,353511595,1,0,0,481.31,8,198487.59,24,2,9,9,True
3085075,1144,2,20,7397,353511595,1,0,0,480.97,3,198006.62,15,4,5,10,True
3326566,1234,3,30,5348,353511595,1,0,0,481.08,8,197525.54,18,2,7,10,True
3412127,1063,0,10,8461,353511595,1,0,0,481.03,6,198006.57,11,5,5,10,True
3493423,1234,3,451,3778,353511595,1,0,0,481.05,7,197525.52,18,0,7,10,True
3511496,583,2,20,4430,353511595,1,0,0,480.82,5,197044.7,11,1,10,11,True
3593099,675,2,20,4406,353511595,1,0,0,481.14,3,196563.56,24,3,19,12,True
3837585,1234,3,30,9082,353511595,1,0,0,481.06,8,196082.5,18,0,21,12,True
4085891,1233,0,451,4317,353511595,1,0,0,480.83,7,195601.67,18,3,12,1,True
4173972,865,0,20,5348,353511595,1,0,0,481.03,5,195120.64,24,3,4,2,True
4231677,1260,0,20,8693,353511595,1,0,0,481.02,5,194639.62,23,0,8,3,True
4447851,548,2,20,8835,353511595,1,0,0,480.98,5,194158.64,17,5,4,4,True
4493929,1167,4,25,4636,353511595,1,0,0,480.97,8,193677.67,24,2,20,4,True
4632208,1399,0,10,3770,353511595,1,0,0,480.74,6,194158.41,24,5,12,5,True
4801455,708,2,20,1739,353511595,1,0,0,480.94,5,193677.47,18,2,21,5,True
5014180,1233,0,451,2626,353511595,1,0,0,481.06,7,193196.41,18,0,18,5,False
5057669,1012,0,10,5133,353511595,1,0,0,480.92,0,193677.33,26,2,10,6,True
5249952,1167,4,451,6796,353511595,1,0,0,480.91,7,193196.42,24,2,5,6,True
5503828,304,0,451,1739,353511595,1,0,0,480.95,7,192715.47,4,5,14,7,True
5771625,995,1,451,3778,353511595,1,0,0,480.99,7,192234.48,22,6,6,7,True
5793675,201,1,10,4636,353511595,1,0,0,481.18,0,192715.66,9,6,0,7,True
6169592,15,4,30,7905,353511595,1,0,0,481.05,8,192234.61,24,5,16,7,True
6237712,1038,3,451,3723,353511595,1,0,0,480.98,7,191753.63,11,2,17,9,True
6500782,1105,2,20,3697,353511595,1,0,0,481.15,5,191272.48,0,3,5,11,True
6527617,652,0,10,3064,353511595,1,0,0,480.99,0,191753.47,24,5,18,12,True
6754922,1234,3,451,3723,353511595,1,0,0,480.97,7,191272.5,18,5,9,12,True
6903193,1390,0,10,5133,353511595,1,0,0,480.67,0,191753.17,24,0,10,1,True
7030276,399,2,20,2626,353511595,1,0,0,480.78,5,191272.39,10,1,18,1,True
7337776,1242,4,-1,8835,353511595,1,1,0,481.08,4,191272.39,18,4,0,1,True
7370152,1038,3,451,4636,353511595,1,0,0,480.91,7,190791.48,11,4,20,4,True
7388173,535,0,10,8835,353511595,1,0,0,481.13,0,191272.61,18,3,11,5,True
7625732,1242,4,-1,3697,353511595,1,1,0,480.81,4,191272.61,18,4,10,6,True
8015680,1233,0,25,4317,353511595,1,0,0,481.01,8,190791.6,18,5,6,6,True
8027898,665,2,20,3770,353511595,1,0,0,480.98,5,190310.62,18,0,23,7,True
8183048,1211,4,451,4636,353511595,1,0,0,481.03,7,189829.59,24,1,2,7,True
8298423,15,4,451,9082,353511595,1,0,0,481.11,7,189348.48,24,5,11,7,True
8325363,1233,0,451,7905,353511595,1,0,0,481.34,7,188867.14,18,4,14,7,True
8399291,995,1,25,8835,353511595,1,0,0,481.03,8,188386.11,22,1,19,7,True
8645879,995,1,451,8693,353511595,1,0,0,480.96,7,187905.15,22,2,1,8,True
8713223,1454,1,10,8835,353511595,1,0,0,480.99,6,188386.14,11,1,8,8,True
8960772,1211,4,451,3723,353511595,1,0,0,480.8,7,187905.34,24,4,3,8,True
9482137,1205,0,10,3697,353511595,1,0,0,481.02,0,188386.36,24,6,22,11,True
9862071,1167,4,451,8835,353511595,1,0,0,480.85,7,187905.51,24,0,10,11,True
1055205,484,0,10,3939,108083730,0,0,0,128.35,6,381886.35,5,3,16,2,True
1207876,591,0,451,6588,108083730,0,0,0,128.3,7,381758.05,24,1,1,2,True
1306255,736,1,-1,3830,108083730,0,1,0,128.08,4,381758.05,11,4,6,2,True
1320691,640,4,451,9541,108083730,0,0,0,128.06,7,381629.99,24,2,20,3,True
1514218,372,0,10,4725,108083730,0,0,0,127.68,6,381757.67,25,4,18,4,True
1567911,736,1,451,8935,108083730,0,0,0,128.07,7,381629.6,11,0,16,4,True
1588972,1000,0,20,6723,108083730,0,0,0,128.23,3,381501.37,26,0,13,5,True
1639873,640,4,30,6256,108083730,0,0,0,128.07,8,381373.3,24,1,22,6,True
1723757,991,1,30,8935,108083730,0,0,0,128.21,8,381245.09,22,1,6,7,True
1899856,564,0,10,8935,108083730,0,0,0,128.04,6,381373.13,17,0,5,8,True
2083415,343,1,10,6256,108083730,0,0,0,128.01,0,381501.14,24,0,7,8,True
2424235,64,0,10,4725,108083730,0,0,0,128.18,6,381629.32,20,5,0,9,True
2439141,736,1,451,9541,108083730,0,0,0,128.19,7,381501.13,11,0,15,9,True
2520210,1231,2,-1,5921,108083730,0,1,0,127.85,1,381501.13,18,0,11,10,True
2536103,1474,0,10,1425,108083730,0,0,0,128.13,6,381629.26,24,0,22,11,True
2746460,991,1,-1,4725,108083730,0,1,0,128.14,4,381629.26,22,0,1,11,True
2966993,1231,2,451,3830,108083730,0,0,0,127.73,7,381501.53,18,6,6,12,True
3011022,497,0,451,7096,108083730,0,0,0,127.84,7,381373.69,12,2,9,1,True
3044959,1000,0,20,3918,108083730,0,0,0,127.92,3,381245.77,26,4,6,1,True
3352880,542,0,25,3967,108083730,0,0,0,127.97,8,381117.8,17,4,10,2,True
3366574,640,4,451,7131,108083730,0,0,0,127.82,7,380989.98,24,6,20,3,True
3651488,27,0,10,7131,108083730,0,0,0,128.11,0,381118.09,11,1,11,3,True
3746181,1069,1,10,7096,108083730,0,0,0,127.98,0,381246.07,18,6,11,3,True
3843845,542,0,451,7131,108083730,0,0,0,128.0,7,381118.07,17,3,1,3,True
4186892,1312,0,10,6256,108083730,0,0,0,128.07,0,381246.14,5,1,0,4,True
4294523,991,1,30,3939,108083730,0,0,0,127.78,8,381118.36,22,5,2,5,True
4405593,787,0,20,7096,108083730,0,0,0,127.92,5,380990.44,14,1,8,5,True
4421900,1485,0,20,4251,108083730,0,0,0,127.98,3,380862.46,24,1,22,6,False
4652313,991,1,451,5921,108083730,0,0,0,127.72,7,380734.74,22,0,12,6,True
4716556,991,1,-1,3967,108083730,0,1,0,128.27,4,380734.74,22,3,3,7,True
4812073,76,0,20,4725,108083730,0,0,0,127.97,3,380606.77,20,3,7,7,True
5187453,991,1,451,3918,108083730,0,0,0,127.97,7,380478.8,22,3,13,7,True
5372826,497,0,451,6085,108083730,0,0,0,128.1,7,380350.7,12,5,23,8,True
5630073,591,0,30,8935,108083730,0,0,0,128.0,8,380222.7,24,5,15,9,True
5706406,640,4,-1,8048,108083730,0,1,0,127.99,1,380222.7,24,5,3,9,True
5797378,991,1,-1,7096,108083730,0,2,0,128.03,4,380222.7,22,1,0,11,True
5809919,736,1,25,5095,108083730,0,0,0,127.82,8,380094.88,11,3,10,11,True
6240910,542,0,30,5921,108083730,0,0,0,128.26,8,379966.62,17,0,9,1,True
6412288,591,0,30,7096,108083730,0,0,0,128.16,8,379838.46,24,5,6,2,True
6691506,834,0,20,3967,108083730,0,0,0,127.87,5,379710.59,5,2,8,2,True
6991513,591,0,451,9388,108083730,0,0,0,128.05,7,379582.54,24,2,0,2,True
7209945,497,0,30,3918,108083730,0,0,0,128.37,8,379454.17,12,2,1,3,True
7308028,1231,2,25,9976,108083730,0,0,0,127.79,8,379326.38,18,2,23,5,True
7387842,991,1,30,6085,108083730,0,0,0,127.9,8,379198.48,22,3,0,6,True
7415054,591,0,451,7171,108083730,0,0,0,128.16,7,379070.32,24,0,8,6,True
7537630,497,0,30,3830,108083730,0,0,0,127.8,8,378942.52,12,2,12,6,True
7572275,497,0,451,7131,108083730,0,0,0,127.89,7,378814.63,12,0,15,7,True
7660546,591,0,30,6588,108083730,0,0,0,127.92,8,378686.71,24,5,17,7,True
7745727,42,2,20,9976,108083730,0,0,0,127.97,3,378558.74,24,3,20,8,True
7859081,1231,2,25,4251,108083730,0,0,0,127.99,8,378430.75,18,3,10,8,True
7869747,497,0,-1,4251,108083730,0,1,0,127.82,4,378430.75,12,2,10,8,True
8475014,497,0,451,4725,108083730,0,0,0,128.06,7,378302.69,12,4,15,9,True
8636584,736,1,-1,8935,108083730,0,1,0,128.09,4,378302.69,11,0,20,9,True
9053356,640,4,-1,6256,108083730,0,2,0,128.06,1,378302.69,24,2,8,10,True
9233326,640,4,451,7096,108083730,0,0,0,128.19,7,378174.5,24,6,11,10,True
9301621,1231,2,25,9541,108083730,0,0,0,127.97,8,378046.53,18,4,8,10,True
9470104,542,0,30,9541,108083730,0,0,0,128.22,8,377918.31,17,5,11,10,True
9480029,497,0,25,1425,108083730,0,0,0,127.97,8,377790.34,12,3,17,10,True
9890807,1231,2,451,9976,108083730,0,0,0,128.19,7,377662.15,18,0,15,11,True
1182619,1377,0,451,6153,888966004,0,0,0,1090.81,7,767159.19,16,6,11,1,True
1287986,27,0,30,6507,888966004,0,0,0,1091.06,8,766068.13,11,2,10,2,True
1294433,1168,3,30,8774,888966004,0,0,0,1091.11,8,764977.02,24,5,6,2,True
1411625,1377,0,10,6197,888966004,0,0,0,1091.02,0,766068.04,16,3,14,3,True
1480905,1382,0,10,8774,888966004,0,0,0,1090.97,6,767159.01,16,1,10,3,True
1554299,1495,3,-1,1994,888966004,0,1,0,1090.79,4,767159.01,24,0,11,4,True
1726364,1495,3,451,3390,888966004,0,0,0,1091.08,7,766067.93,24,0,1,4,True
1787987,1354,0,-1,1997,888966004,0,1,0,1091.02,4,766067.93,24,2,19,4,True
1911543,27,0,25,3050,888966004,0,0,0,1091.01,8,764976.92,11,5,2,4,True
1967249,1435,2,20,5079,888966004,0,0,0,1090.82,5,763886.1,24,1,2,7,True
2049545,27,0,25,6507,888966004,0,0,0,1091.14,8,762794.96,11,2,20,8,True
2260545,1354,0,30,6140,888966004,0,0,0,1090.9,8,761704.06,24,6,11,8,True
2404470,1168,3,451,9395,888966004,0,0,0,1091.19,7,760612.87,24,2,21,8,False
2475892,1354,0,-1,1786,888966004,0,1,0,1091.02,4,760612.87,24,0,13,9,True
2685457,49,3,30,3942,888966004,0,0,0,1091.03,8,759521.84,20,1,5,9,True
3016191,703,0,10,3050,888966004,0,0,0,1091.06,6,760612.9,18,0,20,10,True
3158942,1217,0,10,9310,888966004,0,0,0,1091.1,6,761704.0,24,1,1,11,True
3209082,844,1,-1,3974,888966004,0,1,0,1091.22,1,761704.0,5,6,7,12,True
3334745,1495,3,30,9395,888966004,0,0,0,1091.12,8,760612.88,24,4,2,1,True
3343728,49,3,451,6507,888966004,0,0,0,1090.96,7,759521.92,20,2,16,2,True
3459015,170,4,451,1102,888966004,0,0,0,1091.11,7,758430.81,24,0,15,2,True
3610923,76,0,10,1209,888966004,0,0,0,1090.69,6,759521.5,20,1,21,2,True
3938632,325,0,10,6197,888966004,0,0,0,1091.04,6,760612.54,11,0,4,3,True
4042894,180,0,10,6153,888966004,0,0,0,1091.31,0,761703.85,18,2,6,3,True
4102057,49,3,25,3390,888966004,0,0,0,1090.91,8,760612.94,20,2,22,4,True
4197759,1354,0,25,1209,888966004,0,0,0,1090.84,8,759522.1,24,4,18,4,True
4494666,1354,0,451,5619,888966004,0,0,0,1091.16,7,758430.94,24,0,5,5,True
4661359,1495,3,25,4854,888966004,0,0,0,1091.0,8,757339.94,24,5,21,8,True
4821463,1201,0,20,5619,888966004,0,0,0,1091.11,5,756248.83,24,0,1,10,True
4875745,27,0,-1,1997,888966004,0,1,0,1091.06,1,756248.83,11,0,1,10,True
4945906,804,0,20,1102,888966004,0,0,0,1090.96,5,755157.87,11,3,0,10,True
5076347,27,0,30,2868,888966004,0,0,0,1091.06,8,754066.81,11,0,5,11,True
5564379,1168,3,451,1997,888966004,0,0,0,1090.84,7,752975.97,24,2,9,11,True
5744497,1495,3,451,9137,888966004,0,0,0,1091.18,7,751884.79,24,3,21,11,True
6014974,529,2,20,4854,888966004,0,0,0,1091.11,3,750793.68,18,6,22,11,True
6500744,27,0,451,6507,888966004,0,0,0,1090.92,7,749702.76,11,4,4,12,True
6794612,1093,0,20,3628,888966004,0,0,0,1090.8,5,748611.96,18,4,19,12,True
6946697,1377,0,-1,3390,888966004,0,1,0,1090.9,4,748611.96,16,0,22,12,True
6950383,170,4,25,3974,888966004,0,0,0,1091.09,8,747520.87,24,4,7,12,True
7024876,1354,0,451,9310,888966004,0,0,0,1090.89,7,746429.98,24,2,22,1,True
7075332,1168,3,451,4854,888966004,0,0,0,1091.01,7,745338.97,24,6,20,1,True
7614469,1495,3,30,5459,888966004,0,0,0,1090.79,8,744248.18,24,5,17,2,True
8041179,27,0,25,1209,888966004,0,0,0,1091.01,8,743157.17,11,1,9,2,True
8066414,1429,0,20,6140,888966004,0,0,0,1090.93,3,742066.24,24,1,17,2,True
8210423,1354,0,30,1994,888966004,0,0,0,1091.04,8,740975.2,24,0,9,3,True
8235753,714,2,20,3050,888966004,0,0,0,1091.19,5,739884.01,18,5,11,3,True
8374090,1273,0,10,1997,888966004,0,0,0,1091.06,0,740975.07,24,1,7,4,True
8565773,553,1,10,6189,888966004,0,0,0,1091.01,6,742066.08,17,5,20,4,True
8809061,341,0,10,1997,888966004,0,0,0,1091.05,6,743157.13,24,4,20,5,True
8979022,1354,0,451,2868,888966004,0,0,0,1091.09,7,742066.04,24,2,3,5,True
9059645,1354,0,-1,2663,888966004,0,1,0,1090.89,4,742066.04,24,6,23,5,True
9140467,49,3,25,1209,888966004,0,0,0,1091.17,8,740974.87,20,6,21,6,True
9208958,1377,0,451,7684,888966004,0,0,0,1090.89,7,739883.98,16,0,16,7,True
9228694,27,0,30,7513,888966004,0,0,0,1090.96,8,738793.02,11,4,21,8,True
9606357,844,1,25,1994,888966004,0,0,0,1090.73,8,737702.29,5,5,20,8,True
9781383,844,1,30,5079,888966004,0,0,0,1090.64,8,736611.65,5,0,13,9,True
9872756,1377,0,451,3628,888966004,0,0,0,1091.16,7,735520.49,16,3,12,9,True
9904291,49,3,-1,6507,888966004,0,1,0,1091.01,1,735520.49,20,0,18,10,True
9939873,1377,0,-1,1994,888966004,0,2,0,1090.91,4,735520.49,16,4,23,11,True
1197467,783,0,20,8534,602408706,0,0,0,1174.07,5,76944.93,14,2,15,1,True
1258259,18,4,30,5109,602408706,0,0,0,1174.3,8,75770.63,24,1,12,2,True
1330237,1186,2,30,5318,602408706,0,0,0,1173.84,8,74596.79,24,0,14,2,True
1390266,18,4,451,2899,602408706,0,0,0,1174.2,7,73422.59,24,1,5,4,True
1435930,1277,2,-1,2899,602408706,0,1,0,1173.95,4,73422.59,24,1,11,5,True
1528515,1186,2,30,7951,602408706,0,0,0,1174.26,8,72248.33,24,5,17,7,True
1628856,129,0,10,9753,602408706,0,0,0,1174.13,0,73422.46,18,3,11,7,True
1912356,790,0,20,7091,602408706,0,0,0,1174.28,5,72248.18,11,6,9,7,True
2322584,1307,0,30,5417,602408706,0,0,0,1173.99,8,71074.19,5,6,9,10,True
2434983,1277,2,451,8534,602408706,0,0,0,1174.01,7,69900.18,24,3,22,10,True
2639729,1186,2,25,2944,602408706,0,0,0,1174.07,8,68726.11,24,1,5,10,True
2899715,1277,2,-1,5417,602408706,0,1,0,1173.96,4,68726.11,24,1,20,11,True
3078420,1307,0,451,1995,602408706,0,0,0,1174.02,7,67552.09,5,2,11,11,True
3388791,1186,2,451,2843,602408706,0,0,0,1173.87,7,66378.22,24,1,22,12,True
3396387,385,1,10,4470,602408706,0,0,0,1173.96,6,67552.18,25,0,9,12,True
3460171,303,0,20,3084,602408706,0,0,0,1174.15,5,66378.03,4,1,17,12,True
3785891,1307,0,-1,1918,602408706,0,1,0,1174.16,4,66378.03,5,2,0,1,True
4035068,159,2,20,4470,602408706,0,0,0,1174.41,5,65203.62,24,3,14,2,True
4227435,1277,2,30,1007,602408706,0,0,0,1174.02,8,64029.6,24,0,12,2,True
4352405,219,0,20,8612,602408706,0,0,0,1174.09,3,62855.51,9,1,16,2,True
4381104,1277,2,451,1007,602408706,0,0,0,1174.13,7,61681.38,24,4,8,2,True
4471189,1186,2,451,5318,602408706,0,0,0,1174.04,7,60507.34,24,3,21,3,True
4521865,211,0,20,6082,602408706,0,0,0,1174.0,3,59333.34,9,1,17,4,True
4585870,820,1,10,3707,602408706,0,0,0,1173.78,0,60507.12,18,1,22,4,True
4621325,1277,2,451,8257,602408706,0,0,0,1173.89,7,59333.23,24,2,21,6,True
4643992,18,4,25,1918,602408706,0,0,0,1173.9,8,58159.33,24,3,13,6,True
5420281,1277,2,451,9753,602408706,0,0,0,1173.8,7,56985.53,24,5,12,6,True
5506344,1307,0,25,3707,602408706,0,0,0,1173.89,8,55811.64,5,0,16,6,True
5576820,1399,0,20,9006,602408706,0,0,0,1174.22,5,54637.42,24,1,21,6,True
5706524,1277,2,25,9753,602408706,0,0,0,1174.03,8,53463.39,24,1,2,6,True
5778396,1307,0,451,1023,602408706,0,0,0,1173.95,7,52289.44,5,5,0,7,True
6060973,1062,3,30,7091,602408706,0,0,0,1173.91,8,51115.53,11,3,15,7,True
6307207,1062,3,451,3084,602408706,0,0,0,1174.32,7,49941.21,11,3,23,8,True
7104813,1382,0,10,9006,602408706,0,0,0,1174.02,6,51115.23,16,1,8,8,True
7114897,1277,2,30,2570,602408706,0,0,0,1173.76,8,49941.47,24,1,6,9,True
7125356,1307,0,30,2944,602408706,0,0,0,1174.17,8,48767.3,5,3,17,9,True
7344366,1186,2,451,1023,602408706,0,0,0,1174.01,7,47593.29,24,2,3,9,True
7611539,18,4,30,9753,602408706,0,0,0,1173.78,8,46419.51,24,5,13,11,True
8060961,1062,3,30,5109,602408706,0,0,0,1174.04,8,45245.47,11,5,21,11,True
8082597,1277,2,30,1007,602408706,0,0,0,1173.69,8,44071.78,24,2,2,12,True
8330861,1307,0,30,1946,602408706,0,0,0,1173.96,8,42897.82,5,3,3,12,True
8419258,1277,2,25,4470,602408706,0,0,0,1173.92,8,41723.9,24,4,15,2,True
8460622,1277,2,30,1946,602408706,0,0,0,1174.09,8,40549.81,24,5,3,3,True
8564603,1307,0,451,3084,602408706,0,0,0,1173.88,7,39375.93,5,1,6,5,True
8649296,20,0,10,9006,602408706,0,0,0,1174.01,6,40549.94,24,2,0,5,True
8665229,1277,2,451,7091,602408706,0,0,0,1173.77,7,39376.17,24,1,13,7,True
8666367,1307,0,451,1995,602408706,0,0,0,1174.02,7,38202.15,5,1,22,7,True
8686260,18,4,451,8292,602408706,0,0,0,1173.74,7,37028.41,24,4,10,8,True
8727351,1039,1,10,8534,602408706,0,0,0,1173.8,6,38202.21,11,6,9,8,True
9091599,1307,0,451,2899,602408706,0,0,0,1173.86,7,37028.35,5,3,17,8,True
9203953,1277,2,451,5109,602408706,0,0,0,1174.12,7,35854.23,24,5,16,8,True
9237151,883,0,10,3707,602408706,0,0,0,1173.82,6,37028.05,24,0,9,9,True
9359041,1062,3,451,1946,602408706,0,0,0,1174.01,7,35854.04,11,4,4,10,True
9442488,1307,0,25,7688,602408706,0,0,0,1173.65,8,34680.39,5,6,1,10,True
9667700,18,4,25,8292,602408706,0,0,0,1173.74,8,33506.65,24,3,3,11,True
9734026,287,0,20,2843,602408706,0,0,0,1173.81,3,32332.84,24,5,19,11,True
1140697,1361,2,451,2170,483265191,1,0,0,154.88,7,835836.12,16,4,6,2,True
2196400,574,2,20,4575,483265191,1,0,0,154.84,5,835681.28,11,4,15,3,True
2248248,377,4,30,4575,483265191,1,0,0,155.12,8,835526.16,25,1,1,3,False
2252461,260,0,20,4575,483265191,1,0,0,154.92,3,835371.24,6,2,23,3,True
2507260,1361,2,30,3590,483265191,1,0,0,154.87,8,835216.37,16,4,13,4,True
2524426,201,1,10,4575,483265191,1,0,0,154.79,6,835371.16,9,1,23,4,True
2826220,41,2,20,8434,483265191,1,0,0,154.92,3,835216.24,11,5,8,4,True
2945625,866,0,30,3590,483265191,1,0,0,154.96,8,835061.28,24,5,11,4,True
3012849,1361,2,451,2103,483265191,1,0,0,154.73,7,834906.55,16,1,5,5,True
3170262,371,3,25,6635,483265191,1,0,0,155.14,8,834751.41,25,0,3,6,True
3257605,1146,2,20,3332,483265191,1,0,0,155.21,5,834596.2,15,2,17,6,True
3299677,1255,0,20,3332,483265191,1,0,0,154.94,5,834441.26,23,1,15,7,True
3314809,371,3,30,8557,483265191,1,0,0,155.15,8,834286.11,25,6,7,7,True
3365602,377,4,451,2350,483265191,1,0,0,154.74,7,834131.37,25,1,20,8,True
3368157,1267,2,20,2103,483265191,1,0,0,155.01,5,833976.36,23,6,19,8,True
3549098,1467,0,20,1068,483265191,1,0,0,155.11,5,833821.25,11,4,16,9,True
3583071,377,4,451,2794,483265191,1,0,0,155.03,7,833666.22,25,3,15,9,True
3676289,377,4,25,4575,483265191,1,0,0,154.87,8,833511.35,25,0,22,10,True
3725385,399,2,451,1993,483265191,1,0,0,154.89,7,833356.46,10,1,3,11,True
4477191,399,2,451,8434,483265191,1,0,0,154.9,7,833201.56,10,4,23,11,True
4901029,866,0,30,8434,483265191,1,0,0,154.83,8,833046.73,24,6,7,12,True
4911161,399,2,451,2673,483265191,1,0,0,155.14,7,832891.59,10,4,3,1,True
5018468,377,4,30,2350,483265191,1,0,0,154.89,8,832736.7,25,4,16,1,True
5573673,399,2,451,1993,483265191,1,0,0,155.06,7,832581.64,10,4,5,1,True
5747223,1434,0,20,4575,483265191,1,0,0,155.06,5,832426.58,24,5,10,1,True
6021689,377,4,-1,5137,483265191,1,1,0,154.74,1,832426.58,25,3,3,2,True
6044574,1339,2,20,8434,483265191,1,0,0,154.97,5,832271.61,18,1,1,2,True
6562735,377,4,451,1993,483265191,1,0,0,154.87,7,832116.74,25,1,10,2,True
6655879,866,0,30,1562,483265191,1,0,0,154.84,8,831961.9,24,4,1,2,True
7272829,399,2,30,7070,483265191,1,0,0,155.12,8,831806.78,10,4,12,2,True
7319472,1361,2,451,7070,483265191,1,0,0,154.92,7,831651.86,16,4,0,5,True
7530284,377,4,451,1993,483265191,1,0,0,154.88,7,831496.98,25,2,22,6,True
7553359,1037,0,10,4575,483265191,1,0,0,154.81,6,831651.79,11,6,11,6,True
7565840,399,2,30,1993,483265191,1,0,0,154.9,8,831496.89,10,4,2,7,True
7575293,1041,0,20,8434,483265191,1,0,0,155.28,5,831341.61,11,4,9,8,True
7818969,842,2,20,2170,483265191,1,0,0,154.96,5,831186.65,5,6,1,8,True
7969821,818,1,10,2350,483265191,1,0,0,155.2,0,831341.85,18,2,9,9,True
8108202,1361,2,451,7070,483265191,1,0,0,154.8,7,831187.05,16,2,7,1,True
8241118,249,0,10,7070,483265191,1,0,0,155.16,6,831342.21,6,4,4,2,True
8241833,866,0,451,2103,483265191,1,0,0,154.92,7,831187.29,24,0,5,3,True
8318431,399,2,451,5137,483265191,1,0,0,155.16,7,831032.13,10,4,4,4,True
8475034,866,0,-1,8557,483265191,1,1,0,155.19,4,831032.13,24,6,13,5,True
8664022,1361,2,-1,7070,483265191,1,2,0,155.09,1,831032.13,16,0,5,5,True
8771475,371,3,451,6635,483265191,1,0,0,155.02,7,830877.11,25,4,15,7,True
9049074,399,2,25,1068,483265191,1,0,0,155.11,8,830722.0,10,1,12,7,True
9104226,1461,0,20,2103,483265191,1,0,0,155.04,5,830566.96,11,1,8,9,True
9144873,371,3,-1,2794,483265191,1,1,0,155.15,1,830566.96,25,5,9,9,True
9530794,182,1,10,2673,483265191,1,0,0,154.94,6,830721.9,18,0,22,9,True
9599104,1361,2,30,1562,483265191,1,0,0,154.86,8,830567.04,16,4,15,10,True
9880452,399,2,30,3332,483265191,1,0,0,154.99,8,830412.05,10,2,3,10,True
9896009,736,1,10,1562,483265191,1,0,0,155.0,6,830567.05,11,2,17,11,True
9915009,525,0,20,2103,483265191,1,0,0,154.86,3,830412.19,18,0,22,11,True
1195626,866,0,10,9538,163811167,0,0,0,1118.94,6,414523.94,24,2,0,2,True
1468828,1170,0,10,3370,163811167,0,0,0,1118.87,6,415642.81,24,4,19,2,True
1630328,940,1,30,6765,163811167,0,0,0,1119.12,8,414523.69,24,1,16,2,True
1674336,1159,0,451,6765,163811167,0,0,0,1119.05,7,413404.64,15,1,2,2,True
1682971,116,0,451,9538,163811167,0,0,0,1119.15,7,412285.49,3,3,11,2,True
1723160,627,0,10,4040,163811167,0,0,0,1118.95,6,413404.44,11,6,18,3,True
1775918,919,4,451,1867,163811167,0,0,0,1119.15,7,412285.29,18,1,11,4,True
1785904,1255,0,451,4480,163811167,0,0,0,1119.45,7,411165.84,23,2,23,4,True
2126879,627,0,451,9441,163811167,0,0,0,1119.12,7,410046.72,11,4,5,5,True
2277584,1474,0,10,3203,163811167,0,0,0,1118.98,6,411165.7,24,0,12,5,True
2324891,645,0,25,6765,163811167,0,0,0,1118.75,8,410046.95,24,0,8,6,True
2383159,940,1,451,3203,163811167,0,0,0,1119.14,7,408927.81,24,0,20,6,True
2410751,645,0,25,5479,163811167,0,0,0,1119.24,8,407808.57,24,6,8,8,True
2468784,1159,0,451,3370,163811167,0,0,0,1118.94,7,406689.63,15,2,13,8,True
2639049,1377,0,20,7249,163811167,0,0,0,1118.82,3,405570.81,16,1,3,8,True
2704953,1044,0,20,9432,163811167,0,0,0,1118.88,5,404451.93,11,1,1,9,True
2726570,116,0,451,9442,163811167,0,0,0,1118.86,7,403333.07,3,5,6,10,True
2925175,1159,0,451,8460,163811167,0,0,0,1119.1,7,402213.97,15,6,21,1,True
2949691,947,2,-1,3203,163811167,0,1,0,1119.11,4,402213.97,24,3,6,1,True
3310221,116,0,30,8460,163811167,0,0,0,1119.18,8,401094.79,3,5,4,3,True
3410750,1159,0,30,9432,163811167,0,0,0,1119.1,8,399975.69,15,1,0,3,True
3508070,1159,0,-1,8277,163811167,0,1,0,1118.93,1,399975.69,15,6,4,4,True
4156903,185,1,25,2854,163811167,0,0,0,1118.97,8,398856.72,18,4,16,4,False
4173277,940,1,25,8245,163811167,0,0,0,1118.68,8,397738.04,24,1,7,5,True
4521313,940,1,451,9442,163811167,0,0,0,1118.9,7,396619.14,24,0,4,6,True
4583380,940,1,30,4040,163811167,0,0,0,1118.88,8,395500.26,24,0,3,7,True
4692943,1255,0,-1,3731,163811167,0,1,0,1119.26,1,395500.26,23,1,9,7,True
4702336,627,0,30,2854,163811167,0,0,0,1118.94,8,394381.32,11,1,22,8,True
4777085,627,0,25,9432,163811167,0,0,0,1119.01,8,393262.31,11,4,14,8,True
4948498,673,0,10,6765,163811167,0,0,0,1118.8,6,394381.11,18,3,1,8,True
5348877,185,1,30,3370,163811167,0,0,0,1118.88,8,393262.23,18,3,21,9,True
5362507,627,0,30,8486,163811167,0,0,0,1119.17,8,392143.06,11,1,18,9,False
5628353,116,0,25,7357,163811167,0,0,0,1119.14,8,391023.92,3,5,7,10,True
5941419,947,2,-1,7357,163811167,0,1,0,1118.66,4,391023.92,24,5,4,10,True
6007068,1169,0,20,2177,163811167,0,0,0,1118.92,5,389905.0,24,3,2,1,True
6279078,185,1,-1,8486,163811167,0,1,0,1119.01,4,389905.0,18,0,11,2,True
6353515,20,0,10,8788,163811167,0,0,0,1119.05,6,391024.05,24,6,19,3,True
6436337,1425,0,10,8460,163811167,0,0,0,1119.25,6,392143.3,24,0,18,5,True
6974299,1255,0,25,6506,163811167,0,0,0,1118.94,8,391024.36,23,0,20,5,True
7002051,185,1,30,8788,163811167,0,0,0,1118.82,8,389905.54,18,6,9,5,True
7032326,535,0,10,1867,163811167,0,0,0,1118.97,6,391024.51,18,0,13,6,True
7105034,448,0,10,9432,163811167,0,0,0,1119.02,6,392143.53,13,4,1,6,True
7114389,185,1,-1,3731,163811167,0,1,0,1118.77,1,392143.53,18,4,18,6,True
7211695,627,0,-1,1054,163811167,0,2,0,1119.07,4,392143.53,11,3,17,7,True
7822931,1201,0,20,9432,163811167,0,0,0,1119.08,5,391024.45,24,3,3,7,True
7899570,185,1,25,6765,163811167,0,0,0,1119.22,8,389905.23,18,5,21,8,True
8321593,1159,0,30,8277,163811167,0,0,0,1118.87,8,388786.36,15,6,5,9,True
8645960,645,0,451,1716,163811167,0,0,0,1119.15,7,387667.21,24,1,16,9,True
8648424,1277,2,20,9538,163811167,0,0,0,1118.72,5,386548.49,24,3,12,9,True
8713667,1454,1,10,1716,163811167,0,0,0,1119.07,0,387667.56,11,4,17,9,True
8765205,297,0,20,1867,163811167,0,0,0,1118.78,5,386548.78,4,0,18,9,True
8856838,940,1,451,3731,163811167,0,0,0,1118.99,7,385429.79,24,2,17,9,True
8986549,947,2,451,7357,163811167,0,0,0,1119.06,7,384310.73,24,1,4,10,True
9183230,947,2,30,9538,163811167,0,0,0,1118.71,8,383192.02,24,0,15,10,True
9708182,940,1,451,4480,163811167,0,0,0,1119.13,7,382072.89,24,0,18,10,True
9988483,947,2,25,5479,163811167,0,0,0,1118.78,8,380954.11,24,4,9,10,True
1301367,907,0,25,7256,253533366,0,0,0,384.09,8,717022.91,2,2,1,1,True
1312650,1134,1,451,5695,253533366,0,0,0,383.82,7,716639.09,24,0,1,1,True
2170936,1172,3,451,6280,253533366,0,0,0,383.81,7,716255.28,24,5,18,2,True
2400779,1227,0,20,7860,253533366,0,0,0,384.15,3,715871.13,18,3,20,2,True
2526645,1172,3,-1,2398,253533366,0,1,0,384.14,4,715871.13,24,3,3,2,True
2538904,1264,0,30,8796,253533366,0,0,0,384.11,8,715487.02,23,5,19,3,True
2541009,641,0,10,6280,253533366,0,0,0,384.1,0,715871.12,24,5,6,4,True
2636543,1170,0,10,6630,253533366,0,0,0,383.8,6,716254.92,24,2,16,4,True
2844766,585,2,30,7853,253533366,0,0,0,383.96,8,715870.96,11,5,11,5,True
3204689,548,2,451,2630,253533366,0,0,0,383.87,7,715487.09,17,0,21,5,True
3283227,1409,1,10,7860,253533366,0,0,0,383.97,0,715871.06,24,2,14,6,False
3414544,907,0,-1,2630,253533366,0,1,0,383.89,1,715871.06,2,4,19,6,True
3447860,910,0,10,8796,253533366,0,0,0,383.58,6,716254.64,18,5,6,6,True
3519323,1413,0,20,2200,253533366,0,0,0,383.96,3,715870.68,24,2,10,6,True
3553903,585,2,30,2398,253533366,0,0,0,383.97,8,715486.71,11,2,12,8,True
3665486,548,2,451,7956,253533366,0,0,0,384.26,7,715102.45,17,6,15,10,True
3745487,913,0,20,2630,253533366,0,0,0,383.73,5,714718.72,18,5,7,11,True
4415986,548,2,451,2200,253533366,0,0,0,384.02,7,714334.7,17,0,17,11,True
4759874,502,0,451,2706,253533366,0,0,0,384.21,7,713950.49,12,1,22,11,True
4937507,275,0,20,2630,253533366,0,0,0,384.14,3,713566.35,24,2,5,12,True
5038709,860,1,10,8068,253533366,0,0,0,384.12,6,713950.47,24,6,8,12,True
5101365,1134,1,451,7767,253533366,0,0,0,383.93,7,713566.54,24,3,19,12,True
5347104,907,0,25,7256,253533366,0,0,0,383.98,8,713182.56,2,1,9,1,True
5405884,907,0,25,5695,253533366,0,0,0,384.1,8,712798.46,2,1,15,1,True
6100627,1264,0,30,7956,253533366,0,0,0,384.27,8,712414.19,23,2,5,3,True
6132241,907,0,25,8068,253533366,0,0,0,383.99,8,712030.2,2,0,21,4,True
6252969,656,2,25,6280,253533366,0,0,0,383.91,8,711646.29,18,6,7,6,True
6420273,1134,1,451,7256,253533366,0,0,0,383.82,7,711262.47,24,1,2,6,True
6842329,1123,2,20,6630,253533366,0,0,0,384.32,3,710878.15,24,5,22,6,True
7298207,1264,0,25,2630,253533366,0,0,0,383.9,8,710494.25,23,2,3,7,True
7345201,1377,0,20,5695,253533366,0,0,0,384.19,3,710110.06,16,1,20,10,True
7359038,652,0,20,9115,253533366,0,0,0,384.08,5,709725.98,24,3,7,11,True
7612374,1264,0,-1,8068,253533366,0,1,0,383.75,4,709725.98,23,4,16,1,True
7674231,502,0,451,2398,253533366,0,0,0,384.11,7,709341.87,12,0,16,3,True
7689672,548,2,-1,7956,253533366,0,1,0,383.72,1,709341.87,17,0,5,3,True
7790787,656,2,25,2398,253533366,0,0,0,383.91,8,708957.96,18,0,8,4,True
7869760,577,0,10,5695,253533366,0,0,0,384.08,0,709342.04,11,5,21,4,True
7895452,1246,0,20,2630,253533366,0,0,0,384.21,3,708957.83,23,4,21,5,True
8021367,548,2,451,8796,253533366,0,0,0,383.96,7,708573.87,17,6,21,5,True
8464557,204,0,10,2706,253533366,0,0,0,383.86,6,708957.73,9,3,11,6,True
8492795,548,2,-1,7860,253533366,0,1,0,383.72,4,708957.73,17,6,13,6,True
8618161,548,2,-1,7767,253533366,0,2,0,384.26,4,708957.73,17,0,16,6,True
8919605,907,0,451,7860,253533366,0,0,0,384.07,7,708573.66,2,1,13,6,True
8984804,1134,1,-1,8796,253533366,0,1,0,384.14,4,708573.66,24,5,1,8,True
9000465,656,2,451,7860,253533366,0,0,0,384.19,7,708189.47,18,0,20,8,True
9233140,1134,1,-1,2630,253533366,0,1,0,383.78,1,708189.47,24,1,19,8,True
9273413,1134,1,25,7767,253533366,0,0,0,383.97,8,707805.5,24,4,8,9,True
9545275,502,0,30,6630,253533366,0,0,0,383.88,8,707421.62,12,4,1,9,True
9605835,548,2,30,2398,253533366,0,0,0,384.21,8,707037.41,17,4,19,10,True
9665929,585,2,451,2200,253533366,0,0,0,384.05,7,706653.36,11,2,20,11,True
9793898,585,2,451,7956,253533366,0,0,0,384.0,7,706269.36,11,3,11,11,True
9851081,907,0,451,7853,253533366,0,0,0,383.9,7,705885.46,2,1,17,11,True
1511204,1122,1,-1,4894,294921463,0,1,0,394.97,1,73472.0,24,3,13,1,True
1930506,1356,2,-1,7218,294921463,0,2,0,395.04,4,73472.0,24,5,2,1,True
2089377,26,3,451,9734,294921463,0,0,0,394.85,7,73077.15,11,5,1,1,True
2444723,1488,0,10,2083,294921463,0,0,0,394.96,0,73472.11,24,5,5,2,True
2462482,204,0,25,2228,294921463,0,0,0,394.64,8,73077.47,9,2,9,2,True
2533699,1356,2,30,3758,294921463,0,0,0,395.01,8,72682.46,24,4,16,3,True
2615515,1306,4,451,4771,294921463,0,0,0,395.12,7,72287.34,5,6,10,5,True
2716304,1289,1,10,5167,294921463,0,0,0,394.88,6,72682.22,24,5,8,6,True
2748129,1145,4,451,3758,294921463,0,0,0,395.1,7,72287.12,15,3,15,6,True
2756908,26,3,30,4894,294921463,0,0,0,395.13,8,71891.99,11,3,7,7,True
3001213,1145,4,451,7218,294921463,0,0,0,394.85,7,71497.14,15,3,7,8,True
3078421,1306,4,451,4671,294921463,0,0,0,394.91,7,71102.23,5,6,3,9,True
3115423,204,0,30,4894,294921463,0,0,0,394.93,8,70707.3,9,0,9,9,True
3179159,204,0,30,5167,294921463,0,0,0,395.26,8,70312.04,9,6,0,11,True
3520364,1306,4,-1,6643,294921463,0,1,0,395.07,4,70312.04,5,0,12,12,True
3633195,1145,4,451,6301,294921463,0,0,0,394.95,7,69917.09,15,1,4,12,True
3843013,26,3,25,6658,294921463,0,0,0,394.8,8,69522.29,11,4,16,12,True
3931082,1122,1,451,9734,294921463,0,0,0,394.73,7,69127.56,24,6,2,1,True
3945399,117,1,10,1298,294921463,0,0,0,394.73,0,69522.29,18,3,21,1,True
3976897,116,0,-1,8234,294921463,0,1,0,394.84,4,69522.29,3,6,14,3,True
4307539,114,0,10,7580,294921463,0,0,0,395.22,6,69917.51,3,5,2,3,True
4432725,1306,4,451,4771,294921463,0,0,0,394.98,7,69522.53,5,1,4,4,True
4611798,204,0,451,5167,294921463,0,0,0,394.9,7,69127.63,9,4,18,4,True
4734052,26,3,30,8234,294921463,0,0,0,395.35,8,68732.28,11,5,4,5,True
5058800,116,0,25,6643,294921463,0,0,0,395.09,8,68337.19,3,6,7,5,True
5178727,573,0,10,3254,294921463,0,0,0,394.87,0,68732.06,11,1,17,5,True
5183015,1122,1,25,5167,294921463,0,0,0,394.84,8,68337.22,24,2,16,5,False
5255441,1015,0,10,3254,294921463,0,0,0,395.08,6,68732.3,26,3,12,6,True
5316580,465,0,10,8226,294921463,0,0,0,394.86,0,69127.16,13,5,20,6,True
5911588,204,0,451,4073,294921463,0,0,0,395.02,7,68732.14,9,3,5,8,True
6237067,1306,4,25,6301,294921463,0,0,0,395.05,8,68337.09,5,4,16,8,True
6489654,26,3,30,6658,294921463,0,0,0,394.97,8,67942.12,11,1,8,8,False
6642043,204,0,451,3824,294921463,0,0,0,394.86,7,67547.26,9,2,4,8,True
6657345,26,3,-1,5167,294921463,0,1,0,394.8,1,67547.26,11,5,0,8,True
6787612,1145,4,451,4304,294921463,0,0,0,395.01,7,67152.25,15,2,5,9,True
6965647,204,0,30,1298,294921463,0,0,0,394.89,8,66757.36,9,4,4,10,True
7753887,1122,1,451,2083,294921463,0,0,0,395.18,7,66362.18,24,4,17,10,True
7785913,116,0,451,1729,294921463,0,0,0,395.17,7,65967.01,3,6,16,12,True
7830099,1122,1,25,1729,294921463,0,0,0,394.95,8,65572.06,24,1,7,1,True
7834362,204,0,25,9734,294921463,0,0,0,395.08,8,65176.98,9,0,22,1,False
8053951,116,0,-1,2228,294921463,0,1,0,395.08,4,65176.98,3,5,21,1,True
8208621,1306,4,25,2496,294921463,0,0,0,395.16,8,64781.82,5,1,20,2,True
8334608,1145,4,-1,7392,294921463,0,1,0,394.98,4,64781.82,15,1,0,3,True
8487636,97,0,10,3624,294921463,0,0,0,394.85,0,65176.67,3,6,9,3,False
8856461,848,2,20,2083,294921463,0,0,0,394.96,5,64781.71,5,5,5,3,True
9047802,1306,4,30,1729,294921463,0,0,0,394.93,8,64386.78,5,0,4,4,True
9106985,1356,2,30,4073,294921463,0,0,0,394.51,8,63992.27,24,6,3,6,True
9324176,1145,4,30,2496,294921463,0,0,0,394.93,8,63597.34,15,2,5,6,True
9452638,1145,4,451,3549,294921463,0,0,0,394.92,7,63202.42,15,3,22,7,True
9455291,1145,4,30,2496,294921463,0,0,0,394.99,8,62807.43,15,6,7,8,True
9518839,1052,0,20,8234,294921463,0,0,0,395.07,5,62412.36,11,4,7,9,True
9601882,585,2,20,2083,294921463,0,0,0,395.12,5,62017.24,11,2,23,11,True
1040449,1280,3,451,8545,287317654,0,0,0,424.93,7,361160.07,24,0,7,5,True
1055987,675,2,20,3529,287317654,0,0,0,425.1,5,360734.97,24,5,11,8,True
1194253,1090,0,30,8545,287317654,0,0,0,424.91,8,360310.06,18,3,0,8,True
1676504,314,0,20,4766,287317654,0,0,0,425.17,3,359884.89,4,5,19,7,True
1983080,997,3,-1,8986,287317654,0,1,0,425.07,4,359884.89,26,6,10,8,True
2163283,1019,0,-1,2396,287317654,0,2,0,425.12,1,359884.89,26,4,13,5,True
2321105,1090,0,-1,2756,287317654,0,3,1,425.11,1,0.0,18,4,8,7,True
1210863,14,2,20,4919,771706384,0,0,0,921.01,3,210078.99,24,0,20,2,True
1561433,1482,3,-1,6471,771706384,0,1,0,920.91,4,210078.99,24,5,2,2,True
1769954,394,0,30,6868,771706384,0,0,0,920.95,8,209158.04,10,6,23,2,True
1779165,394,0,451,6388,771706384,0,0,0,921.18,7,208236.86,10,6,4,2,True
1810460,1482,3,25,1677,771706384,0,0,0,921.12,8,207315.74,24,0,5,3,True
2219717,880,1,10,8367,771706384,0,0,0,920.94,6,208236.68,27,6,16,5,True
2546245,202,4,451,5357,771706384,0,0,0,920.94,7,207315.74,9,1,14,5,True
2768710,1482,3,-1,7440,771706384,0,1,0,920.75,4,207315.74,24,1,19,7,True
2894168,1352,1,25,4919,771706384,0,0,0,920.88,8,206394.86,24,1,7,7,True
2914149,202,4,25,3301,771706384,0,0,0,920.7,8,205474.16,9,6,5,7,True
2942226,482,1,30,6306,771706384,0,0,0,921.14,8,204553.02,5,5,6,8,True
2976433,482,1,30,6038,771706384,0,0,0,921.11,8,203631.91,5,2,22,8,True
3093339,394,0,25,7591,771706384,0,0,0,920.87,8,202711.04,10,0,3,9,True
3110313,1352,1,25,1841,771706384,0,0,0,920.9,8,201790.14,24,2,21,9,True
3113533,482,1,30,6388,771706384,0,0,0,921.16,8,200868.98,5,2,4,10,True
3490294,723,1,-1,6471,771706384,0,1,0,920.9,4,200868.98,11,2,12,10,True
3695902,20,0,20,1677,771706384,0,0,0,921.1,5,199947.88,24,6,6,10,True
4035765,202,4,451,1677,771706384,0,0,0,920.99,7,199026.89,9,6,23,11,True
4168944,883,0,10,6863,771706384,0,0,0,921.05,6,199947.94,24,5,1,11,True
4410783,723,1,451,6868,771706384,0,0,0,920.95,7,199026.99,11,1,21,12,True
4662854,1318,0,10,9488,771706384,0,0,0,921.28,0,199948.27,18,2,0,12,True
4937206,202,4,-1,7418,771706384,0,1,0,920.99,4,199948.27,9,5,5,1,True
5033237,394,0,30,8647,771706384,0,0,0,921.08,8,199027.19,10,6,7,1,True
5055636,482,1,451,6400,771706384,0,0,0,921.08,7,198106.11,5,0,5,1,True
5079594,482,1,25,8367,771706384,0,0,0,921.02,8,197185.09,5,0,18,3,True
5249720,1113,1,10,8783,771706384,0,0,0,921.07,0,198106.16,0,5,8,4,True
5398061,538,0,10,6038,771706384,0,0,0,921.18,6,199027.34,18,3,13,5,True
5504634,394,0,451,6471,771706384,0,0,0,921.02,7,198106.32,10,1,22,6,True
5670627,202,4,25,1677,771706384,0,0,0,920.9,8,197185.42,9,6,20,6,True
5928566,967,1,10,6306,771706384,0,0,0,921.09,6,198106.51,13,5,7,7,True
6379316,1264,0,20,9488,771706384,0,0,0,920.99,5,197185.52,23,5,8,7,True
6757362,1352,1,451,6388,771706384,0,0,0,920.96,7,196264.56,24,4,1,7,True
6969071,1412,2,20,2635,771706384,0,0,0,921.12,5,195343.44,24,5,15,9,True
7209243,723,1,451,7418,771706384,0,0,0,920.79,7,194422.65,11,2,5,9,True
7288822,1122,1,10,8647,771706384,0,0,0,920.8,0,195343.45,24,2,6,10,True
7378113,202,4,-1,7591,771706384,0,1,0,920.99,1,195343.45,9,1,2,10,True
7575294,723,1,451,6868,771706384,0,0,0,920.96,7,194422.49,11,4,9,10,True
7596065,1380,0,20,8797,771706384,0,0,0,921.05,3,193501.44,16,2,15,11,True
7652207,723,1,451,1677,771706384,0,0,0,920.8,7,192580.64,11,0,21,11,True
7673680,723,1,451,7591,771706384,0,0,0,920.93,7,191659.71,11,4,3,11,True
7910159,1482,3,25,1677,771706384,0,0,0,920.87,8,190738.84,24,4,3,1,True
7926872,1482,3,30,8647,771706384,0,0,0,920.79,8,189818.05,24,1,12,1,True
8140248,135,2,20,7418,771706384,0,0,0,920.95,3,188897.1,18,2,6,1,True
8155092,1352,1,30,2635,771706384,0,0,0,920.83,8,187976.27,24,5,8,2,True
8156501,1352,1,25,6132,771706384,0,0,0,920.94,8,187055.33,24,3,22,3,True
8582172,1482,3,-1,7591,771706384,0,1,0,920.92,1,187055.33,24,1,2,3,True
8647123,182,1,10,5803,771706384,0,0,0,920.98,6,187976.31,18,3,19,4,True
8666845,482,1,-1,4919,771706384,0,1,0,921.29,4,187976.31,5,1,18,7,True
8668319,1449,0,10,6471,771706384,0,0,0,921.09,0,188897.4,11,2,7,7,True
9096811,202,4,-1,6038,771706384,0,1,0,920.94,1,188897.4,9,4,11,9,True
9210578,202,4,-1,1841,771706384,0,2,0,921.0,1,188897.4,9,4,3,9,True
9221000,723,1,-1,7452,771706384,0,3,1,920.94,1,0.0,11,3,6,10,True
1084773,865,0,-1,1083,333026073,0,1,0,300.13,4,936444.0,24,0,15,1,True
1089574,1205,0,451,4849,333026073,0,0,0,299.96,7,936144.04,24,6,19,1,True
1450172,1111,0,451,7597,333026073,0,0,0,299.68,7,935844.36,0,6,20,1,True
1827009,1111,0,451,7420,333026073,0,0,0,300.07,7,935544.29,0,2,3,1,True
1851032,1111,0,25,5138,333026073,0,0,0,300.05,8,935244.24,0,1,7,3,True
1951339,64,0,20,7597,333026073,0,0,0,299.95,5,934944.29,20,6,11,4,True
2136524,428,0,451,6293,333026073,0,0,0,299.99,7,934644.3,18,6,19,4,True
2180244,511,1,25,3443,333026073,0,0,0,300.1,8,934344.2,12,6,4,5,True
2320089,160,0,10,9832,333026073,0,0,0,299.96,6,934644.16,24,0,21,5,True
3101992,726,0,20,1793,333026073,0,0,0,299.96,5,934344.2,11,3,16,5,True
3462324,736,1,10,5352,333026073,0,0,0,300.22,6,934644.42,11,6,0,6,True
3754447,30,4,451,1350,333026073,0,0,0,300.19,7,934344.23,11,6,15,6,True
3934535,130,0,10,2126,333026073,0,0,0,299.97,0,934644.2,18,1,11,7,True
4098270,1111,0,25,1083,333026073,0,0,0,299.85,8,934344.35,0,2,23,7,True
4159601,1205,0,25,2262,333026073,0,0,0,299.98,8,934044.37,24,6,4,8,True
4386538,865,0,-1,4849,333026073,0,1,0,299.98,4,934044.37,24,5,22,9,True
4783551,1205,0,-1,6349,333026073,0,2,0,300.08,4,934044.37,24,0,10,9,True
4866232,341,0,20,3999,333026073,0,0,0,300.06,5,933744.31,24,0,22,10,True
4928657,511,1,25,9248,333026073,0,0,0,300.05,8,933444.26,12,1,0,11,True
4951089,781,1,30,3999,333026073,0,0,0,299.85,8,933144.41,14,3,23,3,True
4978855,428,0,30,1966,333026073,0,0,0,300.13,8,932844.28,18,5,21,5,True
4979912,30,4,-1,1793,333026073,0,1,0,299.72,4,932844.28,11,0,7,6,True
4985946,1111,0,30,7597,333026073,0,0,0,299.79,8,932544.49,0,3,19,7,True
5114688,30,4,-1,5211,333026073,0,1,0,300.02,4,932544.49,11,6,21,7,True
5127611,865,0,451,6349,333026073,0,0,0,299.9,7,932244.59,24,0,3,7,True
5241585,1111,0,25,1593,333026073,0,0,0,299.76,8,931944.83,0,1,20,8,True
5309186,428,0,30,3443,333026073,0,0,0,299.86,8,931644.97,18,1,8,8,True
5316697,781,1,451,2792,333026073,0,0,0,299.97,7,931345.0,14,4,5,9,True
5527846,30,4,451,2262,333026073,0,0,0,300.02,7,931044.98,11,1,20,10,True
5605669,511,1,451,1793,333026073,0,0,0,300.21,7,930744.77,12,4,0,10,False
5730513,30,4,30,4462,333026073,0,0,0,300.22,8,930444.55,11,2,19,10,False
5733431,1112,1,10,1423,333026073,0,0,0,299.9,0,930744.45,0,6,2,10,True
5789691,865,0,-1,3977,333026073,0,1,0,300.0,4,930744.45,24,6,12,10,True
6099564,865,0,30,2126,333026073,0,0,0,300.21,8,930444.24,24,4,11,11,True
6102476,1127,0,10,1350,333026073,0,0,0,300.05,6,930744.29,24,6,0,11,True
6209664,1238,0,20,3999,333026073,0,0,0,300.04,5,930444.25,18,6,19,11,True
6224647,1205,0,451,3443,333026073,0,0,0,300.1,7,930144.15,24,5,21,12,True
6265833,865,0,451,4871,333026073,0,0,0,299.86,7,929844.29,24,5,4,3,True
6592786,1111,0,30,4871,333026073,0,0,0,300.04,8,929544.25,0,2,12,4,True
6737247,511,1,25,1423,333026073,0,0,0,299.8,8,929244.45,12,6,12,4,True
7606369,1111,0,25,8185,333026073,0,0,0,299.82,8,928944.63,0,0,3,4,True
8438983,1205,0,451,2262,333026073,0,0,0,299.9,7,928644.73,24,4,14,5,True
8612207,1408,1,10,1350,333026073,0,0,0,299.77,0,928944.5,24,4,4,5,False
8657343,276,0,10,5211,333026073,0,0,0,299.95,0,929244.45,24,6,4,7,True
8811174,30,4,25,6349,333026073,0,0,0,300.26,8,928944.19,11,6,6,8,True
8902171,865,0,-1,2126,333026073,0,1,0,299.86,4,928944.19,24,1,8,8,True
8936721,781,1,-1,5138,333026073,0,2,0,300.2,4,928944.19,14,0,18,8,True
8959300,1205,0,30,7597,333026073,0,0,0,300.06,8,928644.13,24,2,5,9,True
9151488,1205,0,451,1083,333026073,0,0,0,300.14,7,928343.99,24,2,21,9,True
9254002,428,0,25,4871,333026073,0,0,0,300.19,8,928043.8,18,3,2,9,True
9467703,428,0,-1,3977,333026073,0,1,0,300.11,4,928043.8,18,4,19,9,True
9567916,781,1,30,5138,333026073,0,0,0,299.77,8,927744.03,14,2,1,9,True
9667159,428,0,30,5211,333026073,0,0,0,300.11,8,927443.92,18,6,10,10,True
9774490,1111,0,-1,4462,333026073,0,1,0,299.96,4,927443.92,0,3,13,11,True
1253424,176,3,451,5356,699190134,0,0,0,982.93,7,865366.07,24,1,13,1,True
1412618,204,0,451,3617,699190134,0,0,0,983.24,7,864382.83,9,5,18,3,True
1480426,907,0,451,9001,699190134,0,0,0,983.06,7,863399.77,2,0,16,3,True
1556797,1246,0,10,3950,699190134,0,0,0,983.01,6,864382.78,23,0,11,3,True
1606573,1180,1,25,5881,699190134,0,0,0,982.92,8,863399.86,24,3,0,5,True
1656277,204,0,30,7887,699190134,0,0,0,983.0,8,862416.86,9,3,9,5,True
1702248,795,4,30,7887,699190134,0,0,0,983.12,8,861433.74,11,6,14,6,True
1787906,795,4,451,7940,699190134,0,0,0,983.11,7,860450.63,11,3,1,6,True
1905210,795,4,451,5881,699190134,0,0,0,982.81,7,859467.82,11,0,3,6,True
2577273,799,2,20,9860,699190134,0,0,0,982.94,5,858484.88,11,5,8,7,True
2718402,907,0,-1,9551,699190134,0,1,0,983.16,4,858484.88,2,4,14,8,True
2749241,204,0,25,9001,699190134,0,0,0,982.69,8,857502.19,9,5,0,8,True
2846810,734,0,20,9860,699190134,0,0,0,983.09,3,856519.1,11,1,10,8,True
2999836,1180,1,30,3950,699190134,0,0,0,982.81,8,855536.29,24,0,23,9,True
3022901,907,0,451,3950,699190134,0,0,0,983.08,7,854553.21,2,6,14,10,True
3072137,1206,0,10,6342,699190134,0,0,0,983.02,0,855536.23,24,0,18,10,True
3530612,587,2,20,9860,699190134,0,0,0,982.74,3,854553.49,24,1,14,11,True
3616819,723,1,10,9860,699190134,0,0,0,982.9,6,855536.39,11,5,4,11,True
3809757,1180,1,30,9551,699190134,0,0,0,982.95,8,854553.44,24,5,12,11,True
4259425,1419,1,10,7215,699190134,0,0,0,982.95,6,855536.39,24,3,11,11,True
4325139,281,1,10,3950,699190134,0,0,0,982.92,6,856519.31,24,3,16,12,True
4335117,882,0,10,9001,699190134,0,0,0,983.03,0,857502.34,27,5,23,12,False
4344944,767,0,10,2158,699190134,0,0,0,983.19,6,858485.53,14,4,22,1,True
4356173,645,0,20,7979,699190134,0,0,0,983.03,3,857502.5,24,4,7,2,True
4384671,1219,1,10,5881,699190134,0,0,0,982.8,0,858485.3,24,5,20,2,True
4589422,1180,1,25,6342,699190134,0,0,0,983.06,8,857502.24,24,2,15,3,True
4899659,1177,4,451,5881,699190134,0,0,0,982.89,7,856519.35,24,2,17,4,True
4925235,819,2,20,8020,699190134,0,0,0,982.97,5,855536.38,18,3,0,4,True
5385176,52,4,30,8020,699190134,0,0,0,983.08,8,854553.3,20,2,15,5,True
5455377,1180,1,451,8690,699190134,0,0,0,983.21,7,853570.09,24,3,17,5,True
5513812,1075,0,20,9551,699190134,0,0,0,983.03,5,852587.06,18,4,1,6,True
5686833,1180,1,451,5356,699190134,0,0,0,983.06,7,851604.0,24,4,14,7,True
5738701,176,3,30,9860,699190134,0,0,0,983.11,8,850620.89,24,2,18,10,True
5814783,687,0,20,2810,699190134,0,0,0,983.09,5,849637.8,24,3,12,10,True
5835587,728,1,10,8690,699190134,0,0,0,983.13,0,850620.93,11,6,9,10,True
5920414,176,3,451,3950,699190134,0,0,0,983.29,7,849637.64,24,2,20,11,True
6000992,176,3,30,8690,699190134,0,0,0,983.04,8,848654.6,24,4,10,11,True
6048272,531,0,10,2158,699190134,0,0,0,982.7,6,849637.3,18,2,5,12,True
6134694,52,4,451,3617,699190134,0,0,0,983.2,7,848654.1,20,6,13,12,True
6286049,907,0,-1,2158,699190134,0,1,0,982.81,1,848654.1,2,2,13,1,True
6877874,795,4,-1,5356,699190134,0,2,0,983.24,4,848654.1,11,0,20,1,True
7092575,907,0,25,5356,699190134,0,0,0,983.13,8,847670.97,2,4,7,1,True
7176059,907,0,30,9860,699190134,0,0,0,983.29,8,846687.68,2,6,21,2,True
7418746,176,3,451,7887,699190134,0,0,0,983.02,7,845704.66,24,1,10,2,True
7463728,1380,0,20,7940,699190134,0,0,0,982.89,5,844721.77,16,4,5,2,True
7692237,176,3,25,7386,699190134,0,0,0,982.91,8,843738.86,24,6,13,3,True
7834425,1180,1,25,7386,699190134,0,0,0,983.12,8,842755.74,24,5,16,5,True
7993564,176,3,-1,7940,699190134,0,1,0,983.16,4,842755.74,24,0,16,5,True
8068040,52,4,451,8020,699190134,0,0,0,982.94,7,841772.8,20,3,4,5,True
8443015,176,3,25,9001,699190134,0,0,0,982.95,8,840789.85,24,0,17,6,True
9109263,1180,1,-1,5274,699190134,0,1,0,983.09,4,840789.85,24,3,11,6,True
9145573,795,4,451,8690,699190134,0,0,0,982.94,7,839806.91,11,2,21,7,False
9216270,1065,0,20,6342,699190134,0,0,0,983.03,3,838823.88,11,4,7,7,True
9244763,1180,1,25,7940,699190134,0,0,0,982.98,8,837840.9,24,3,5,10,True
9543305,1177,4,451,7979,699190134,0,0,0,983.19,7,836857.71,24,5,2,10,True
9731237,1297,0,10,2158,699190134,0,0,0,983.0,6,837840.71,5,3,14,11,True
9948319,1177,4,30,9818,699190134,0,0,0,982.98,8,836857.73,24,1,3,11,True
1033664,1297,0,10,6697,398288192,0,0,0,904.92,6,222344.92,5,6,2,1,True
1038018,594,0,30,4772,398288192,0,0,0,905.1,8,221439.82,24,1,3,1,True
1378492,1044,0,20,3027,398288192,0,0,0,904.96,5,220534.86,11,2,17,1,True
1478077,1483,0,20,1016,398288192,0,0,0,905.25,3,219629.61,24,5,5,1,True
1680428,467,0,10,9526,398288192,0,0,0,905.09,6,220534.7,5,6,14,1,True
1698654,594,0,30,9526,398288192,0,0,0,904.67,8,219630.03,24,3,22,1,True
1793188,739,1,10,7513,398288192,0,0,0,905.05,6,220535.08,24,2,11,2,True
2352672,1150,0,-1,3027,398288192,0,1,0,905.26,4,220535.08,15,2,6,8,True
2611979,838,4,30,4876,398288192,0,0,0,905.11,8,219629.97,5,3,4,8,True
2654491,1150,0,451,2888,398288192,0,0,0,904.76,7,218725.21,15,3,3,9,True
2879926,1322,2,20,1532,398288192,0,0,0,905.01,3,217820.2,18,2,10,11,True
3184322,1000,0,30,8355,398288192,0,0,0,904.95,8,216915.25,26,1,3,12,True
3336717,594,0,451,5767,398288192,0,0,0,904.91,7,216010.34,24,0,18,1,True
3577984,838,4,25,9526,398288192,0,0,0,904.82,8,215105.52,5,2,5,1,True
3713220,1238,0,20,1016,398288192,0,0,0,905.0,3,214200.52,18,3,2,2,True
3760493,1325,0,10,3027,398288192,0,0,0,905.02,6,215105.54,18,3,13,3,True
3769297,1150,0,25,2931,398288192,0,0,0,904.87,8,214200.67,15,1,10,4,True
3807237,1150,0,451,1532,398288192,0,0,0,905.07,7,213295.6,15,2,11,5,True
4190274,727,0,10,7740,398288192,0,0,0,904.74,6,214200.34,11,3,23,6,True
4204684,116,0,20,7740,398288192,0,0,0,905.18,5,213295.16,3,5,5,6,True
4700314,594,0,451,3027,398288192,0,0,0,904.94,7,212390.22,24,4,3,7,True
4893600,1250,1,451,4083,398288192,0,0,0,905.22,7,211485.0,23,6,12,8,True
5348737,838,4,451,1016,398288192,0,0,0,905.1,7,210579.9,5,2,17,8,True
5961661,838,4,-1,8393,398288192,0,1,0,904.83,1,210579.9,5,2,18,8,True
6167912,708,2,20,4083,398288192,0,0,0,905.03,3,209674.87,18,5,18,8,True
6362629,605,0,30,6289,398288192,0,0,0,904.99,8,208769.88,24,1,4,8,True
6516167,594,0,30,1532,398288192,0,0,0,905.01,8,207864.87,24,2,19,8,True
6522887,1250,1,-1,6464,398288192,0,1,0,904.94,1,207864.87,23,4,18,9,True
6585808,1250,1,451,9526,398288192,0,0,0,905.07,7,206959.8,23,5,9,9,True
6931707,1150,0,-1,6843,398288192,0,1,0,904.91,1,206959.8,15,0,22,9,True
7224074,1000,0,-1,4083,398288192,0,2,0,904.9,4,206959.8,26,4,20,9,True
7289225,1160,0,20,6092,398288192,0,0,0,904.98,5,206054.82,15,2,15,10,True
7370007,1278,0,10,2024,398288192,0,0,0,905.13,6,206959.95,24,2,23,11,True
7708898,312,0,20,5795,398288192,0,0,0,905.12,5,206054.83,4,0,23,11,True
7986127,603,0,20,5950,398288192,0,0,0,904.87,5,205149.96,24,3,7,11,True
8104033,1015,0,20,1053,398288192,0,0,0,904.7,5,204245.26,26,0,20,1,True
8124223,838,4,30,5423,398288192,0,0,0,904.91,8,203340.35,5,5,2,1,True
8405447,838,4,451,3027,398288192,0,0,0,905.18,7,202435.17,5,4,3,1,True
8424746,1250,1,451,9526,398288192,0,0,0,904.83,7,201530.34,23,6,20,2,True
8458508,1150,0,451,5767,398288192,0,0,0,904.81,7,200625.53,15,0,21,2,True
8604722,605,0,-1,4083,398288192,0,1,0,905.08,1,200625.53,24,6,19,3,True
8792513,594,0,451,5950,398288192,0,0,0,905.11,7,199720.42,24,5,20,3,True
8857005,1000,0,30,4482,398288192,0,0,0,904.83,8,198815.59,26,6,4,4,True
9006736,594,0,451,6289,398288192,0,0,0,905.06,7,197910.53,24,2,15,4,True
9048019,917,0,10,2024,398288192,0,0,0,905.02,0,198815.55,18,3,14,5,True
9222382,1000,0,451,8355,398288192,0,0,0,905.02,7,197910.53,26,0,10,7,True
9712721,594,0,-1,1016,398288192,0,1,0,904.69,4,197910.53,24,0,8,7,True
9781192,1250,1,-1,5902,398288192,0,2,0,904.84,1,197910.53,23,5,20,8,True
9887456,1307,0,20,6289,398288192,0,0,0,904.98,3,197005.55,5,0,12,9,True
9938996,443,2,20,5767,398288192,0,0,0,905.15,5,196100.4,24,0,5,9,True
9978887,605,0,451,6289,398288192,0,0,0,905.17,7,195195.23,24,1,5,10,True
1051022,329,1,10,6607,680005319,1,0,0,747.25,6,566165.25,11,5,9,1,True
1091511,1273,0,30,2282,680005319,1,0,0,746.85,8,565418.4,24,0,5,2,True
1137478,87,3,451,1766,680005319,1,0,0,747.08,7,564671.32,1,2,16,2,True
1142317,208,0,-1,4766,680005319,1,1,0,747.27,1,564671.32,9,6,2,3,True
1620738,208,0,25,7872,680005319,1,0,0,746.82,8,563924.5,9,0,12,3,True
1777998,208,0,30,4128,680005319,1,0,0,746.88,8,563177.62,9,1,10,3,True
1855216,216,4,-1,4557,680005319,1,1,0,746.79,4,563177.62,9,0,7,4,True
2033047,1273,0,30,1330,680005319,1,0,0,746.68,8,562430.94,24,0,11,5,True
2081392,780,0,10,6607,680005319,1,0,0,747.14,6,563178.08,14,0,4,5,True
2150237,1196,4,30,2861,680005319,1,0,0,747.21,8,562430.87,24,5,9,6,True
2222169,1471,0,20,3860,680005319,1,0,0,746.94,5,561683.93,24,2,21,6,True
2614155,1273,0,-1,8884,680005319,1,1,0,746.94,4,561683.93,24,1,18,8,True
2822314,1273,0,30,1035,680005319,1,0,0,746.82,8,560937.11,24,5,17,8,True
2956018,208,0,25,6607,680005319,1,0,0,747.02,8,560190.09,9,1,8,8,True
2958498,208,0,-1,4557,680005319,1,1,0,747.19,4,560190.09,9,2,13,9,True
3249213,208,0,451,2113,680005319,1,0,0,746.85,7,559443.24,9,5,3,10,True
3419415,1180,1,30,2113,680005319,1,0,0,746.84,8,558696.4,24,2,10,11,True
3424341,1196,4,451,1766,680005319,1,0,0,747.07,7,557949.33,24,6,12,11,True
3449131,1273,0,30,1035,680005319,1,0,0,747.06,8,557202.27,24,0,0,11,True
3489978,208,0,451,4128,680005319,1,0,0,747.17,7,556455.1,9,2,12,11,True
3548748,1273,0,451,4186,680005319,1,0,0,746.96,7,555708.14,24,2,3,1,True
3695846,858,1,-1,1330,680005319,1,1,0,746.96,4,555708.14,24,4,11,2,True
3794944,216,4,451,8884,680005319,1,0,0,747.05,7,554961.09,9,0,3,2,True
3891890,1196,4,25,9945,680005319,1,0,0,747.09,8,554214.0,24,1,9,2,False
3944133,1196,4,451,8069,680005319,1,0,0,746.99,7,553467.01,24,3,12,2,True
4204334,1196,4,25,3957,680005319,1,0,0,746.92,8,552720.09,24,2,7,3,True
4254433,858,1,25,5534,680005319,1,0,0,747.08,8,551973.01,24,3,2,4,True
4375984,1009,0,20,9050,680005319,1,0,0,747.0,5,551226.01,26,1,22,4,True
4887505,858,1,451,1035,680005319,1,0,0,746.87,7,550479.14,24,1,11,5,True
4892143,1273,0,25,1035,680005319,1,0,0,747.15,8,549731.99,24,6,8,5,True
5062062,1000,0,10,1441,680005319,1,0,0,747.01,6,550479.0,26,6,13,5,False
5078497,208,0,25,3931,680005319,1,0,0,747.04,8,549731.96,9,2,6,7,True
5100636,342,0,10,2282,680005319,1,0,0,747.17,6,550479.13,24,3,1,8,False
5139067,208,0,25,6172,680005319,1,0,0,746.88,8,549732.25,9,4,0,10,True
5237006,502,0,10,1035,680005319,1,0,0,747.08,6,550479.33,12,4,10,10,True
5307362,716,0,10,4128,680005319,1,0,0,746.88,0,551226.21,18,4,17,11,True
5363089,87,3,451,8884,680005319,1,0,0,747.15,7,550479.06,1,1,2,11,False
5457265,1196,4,25,5534,680005319,1,0,0,746.97,8,549732.09,24,1,4,11,True
5576668,1180,1,451,6607,680005319,1,0,0,746.97,7,548985.12,24,3,16,11,True
5594167,1322,2,20,7872,680005319,1,0,0,747.04,5,548238.08,18,5,7,12,True
5736426,1273,0,451,9945,680005319,1,0,0,747.17,7,547490.91,24,5,23,12,True
6642712,216,4,25,6607,680005319,1,0,0,747.06,8,546743.85,9,3,21,1,True
6805282,1345,2,20,3931,680005319,1,0,0,746.91,5,545996.94,24,3,2,2,True
7475830,208,0,30,4186,680005319,1,0,0,746.98,8,545249.96,9,3,4,2,True
7508379,1196,4,25,3957,680005319,1,0,0,747.07,8,544502.89,24,6,15,3,True
7967018,882,0,20,7670,680005319,1,0,0,746.77,5,543756.12,27,6,20,3,True
8341780,208,0,25,4557,680005319,1,0,0,747.08,8,543009.04,9,2,17,3,True
8349894,208,0,30,2861,680005319,1,0,0,746.86,8,542262.18,9,2,7,5,True
8721402,183,1,10,9050,680005319,1,0,0,747.04,6,543009.22,18,3,10,6,True
8739013,1180,1,451,2282,680005319,1,0,0,746.8,7,542262.42,24,1,9,6,True
8784758,1111,0,20,6877,680005319,1,0,0,747.11,5,541515.31,0,0,6,7,True
8971126,216,4,30,3860,680005319,1,0,0,747.09,8,540768.22,9,6,12,7,False
9065758,208,0,-1,9536,680005319,1,1,0,746.98,1,540768.22,9,0,16,7,True
9173233,117,1,10,6607,680005319,1,0,0,747.07,6,541515.29,18,3,22,10,True
9919493,1273,0,451,8069,680005319,1,0,0,746.94,7,540768.35,24,5,8,11,True
9980631,621,2,20,3957,680005319,1,0,0,746.82,5,540021.53,11,5,1,11,True
1017045,454,1,451,9574,505946081,1,0,0,719.96,7,216885.04,13,5,3,1,True
1472788,392,4,-1,4181,505946081,1,1,0,720.31,4,216885.04,10,1,6,1,True
1585344,1316,3,25,6641,505946081,1,0,0,719.92,8,216165.12,5,5,13,1,True
1923839,1015,0,10,3158,505946081,1,0,0,719.96,6,216885.08,26,2,16,3,True
2022807,1111,0,10,9860,505946081,1,0,0,720.0,6,217605.08,0,4,0,4,True
2175694,963,4,30,8767,505946081,1,0,0,720.18,8,216884.9,13,0,6,5,True
2319858,607,2,20,2866,505946081,1,0,0,720.19,5,216164.71,24,0,3,5,True
2652233,101,3,451,5887,505946081,1,0,0,719.84,7,215444.87,3,2,2,6,True
2933912,392,4,451,9574,505946081,1,0,0,719.95,7,214724.92,10,1,6,6,True
2986577,1212,0,20,9933,505946081,1,0,0,719.99,3,214004.93,24,6,20,6,True
3112828,220,0,10,7217,505946081,1,0,0,719.81,0,214724.74,26,6,0,7,True
3225430,963,4,25,2866,505946081,1,0,0,719.8,8,214004.94,13,3,2,7,True
3348286,484,0,20,3563,505946081,1,0,0,720.4,3,213284.54,5,5,14,9,True
3361933,963,4,-1,9574,505946081,1,1,0,719.97,1,213284.54,13,0,18,9,True
3415776,1316,3,30,3786,505946081,1,0,0,719.99,8,212564.55,5,5,9,9,True
3442260,101,3,451,6684,505946081,1,0,0,720.0,7,211844.55,3,1,15,9,True
3891968,937,0,10,8038,505946081,1,0,0,719.88,6,212564.43,24,3,7,9,True
3926013,1170,0,20,1506,505946081,1,0,0,719.92,5,211844.51,24,6,23,10,True
3980345,1411,0,20,3563,505946081,1,0,0,720.02,3,211124.49,24,3,14,12,True
4013362,963,4,451,3158,505946081,1,0,0,720.07,7,210404.42,13,4,19,12,True
4043673,1316,3,-1,2866,505946081,1,1,0,720.12,4,210404.42,5,1,3,1,True
4138390,897,0,10,2029,505946081,1,0,0,720.15,6,211124.57,24,6,11,1,True
4568591,1316,3,25,8767,505946081,1,0,0,719.92,8,210404.65,5,4,20,1,True
4670859,1316,3,-1,1506,505946081,1,1,0,720.13,4,210404.65,5,6,9,2,True
4688016,392,4,30,7217,505946081,1,0,0,719.84,8,209684.81,10,1,20,5,True
4723648,220,0,10,1506,505946081,1,0,0,719.78,0,210404.59,26,6,17,5,True
4738056,101,3,451,3563,505946081,1,0,0,719.98,7,209684.61,3,4,8,6,True
5321297,1316,3,25,7217,505946081,1,0,0,719.84,8,208964.77,5,1,19,7,True
5436583,287,0,20,2866,505946081,1,0,0,719.83,5,208244.94,24,2,23,7,True
5461698,454,1,25,3158,505946081,1,0,0,719.91,8,207525.03,13,2,9,9,True
5583257,316,2,20,9860,505946081,1,0,0,719.84,5,206805.19,4,4,2,9,True
5666350,963,4,25,1506,505946081,1,0,0,720.0,8,206085.19,13,6,2,9,True
5792171,963,4,451,3563,505946081,1,0,0,720.08,7,205365.11,13,2,13,11,True
5993346,101,3,30,7217,505946081,1,0,0,720.1,8,204645.01,3,6,14,11,True
6067211,1316,3,451,2722,505946081,1,0,0,720.05,7,203924.96,5,2,17,11,True
6273708,950,0,20,3067,505946081,1,0,0,720.37,5,203204.59,24,6,8,12,True
6626335,101,3,25,9933,505946081,1,0,0,720.04,8,202484.55,3,2,7,12,True
6741636,1316,3,30,1506,505946081,1,0,0,719.8,8,201764.75,5,0,21,12,True
7092362,454,1,30,5887,505946081,1,0,0,720.26,8,201044.49,13,5,6,1,True
7566292,1255,0,10,6641,505946081,1,0,0,720.35,6,201764.84,23,6,7,1,True
7589032,963,4,25,8038,505946081,1,0,0,720.0,8,201044.84,13,3,16,5,True
7618814,963,4,30,5887,505946081,1,0,0,720.01,8,200324.83,13,3,0,5,True
7693618,101,3,25,9933,505946081,1,0,0,719.8,8,199605.03,3,4,9,5,True
7747814,963,4,30,3786,505946081,1,0,0,720.19,8,198884.84,13,6,6,5,True
8035634,1436,0,20,2866,505946081,1,0,0,719.96,5,198164.88,24,4,6,5,True
8193938,101,3,30,8767,505946081,1,0,0,719.94,8,197444.94,3,2,23,5,True
8258437,963,4,25,5461,505946081,1,0,0,719.93,8,196725.01,13,1,23,6,True
8534670,1316,3,30,2866,505946081,1,0,0,719.71,8,196005.3,5,4,20,7,True
8673876,1305,2,20,2029,505946081,1,0,0,720.02,3,195285.28,5,6,8,8,False
8895537,1166,2,20,6641,505946081,1,0,0,720.07,5,194565.21,24,3,0,8,True
9091033,1316,3,451,2866,505946081,1,0,0,720.04,7,193845.17,5,1,2,10,True
9634148,392,4,451,5887,505946081,1,0,0,720.22,7,193124.95,10,6,21,11,True
9871300,747,1,10,2866,505946081,1,0,0,719.82,6,193844.77,24,1,18,11,True
9955156,1316,3,-1,6684,505946081,1,1,0,719.91,4,193844.77,5,3,6,11,False
1070651,997,3,25,2366,279698076,1,0,0,924.03,8,880664.97,26,1,13,2,True
1210788,1128,2,451,9238,279698076,1,0,0,923.93,7,879741.04,24,2,11,3,False
1253391,471,0,451,8318,279698076,1,0,0,923.92,7,878817.12,5,0,21,5,True
1446015,1128,2,451,2054,279698076,1,0,0,923.98,7,877893.14,24,5,19,5,True
1581372,471,0,25,2054,279698076,1,0,0,924.0,8,876969.14,5,5,3,6,True
1669055,471,0,-1,8827,279698076,1,1,0,924.0,4,876969.14,5,2,23,7,True
2015539,1093,0,10,5138,279698076,1,0,0,923.81,0,877892.95,18,4,17,7,True
2674499,997,3,25,2650,279698076,1,0,0,923.88,8,876969.07,26,2,19,7,True
2732621,212,4,30,9238,279698076,1,0,0,924.17,8,876044.9,9,3,16,7,True
3509717,1267,2,20,8827,279698076,1,0,0,924.32,5,875120.58,23,2,11,8,True
3511139,1115,1,451,6685,279698076,1,0,0,923.93,7,874196.65,0,2,13,9,True
3631071,997,3,30,9595,279698076,1,0,0,924.0,8,873272.65,26,3,13,10,True
3933594,1041,0,10,2054,279698076,1,0,0,923.75,0,874196.4,11,1,14,11,True
3941929,212,4,25,3827,279698076,1,0,0,924.05,8,873272.35,9,0,18,11,True
4094535,292,1,451,3807,279698076,1,0,0,923.93,7,872348.42,4,5,15,11,True
4161582,211,0,10,2366,279698076,1,0,0,924.02,0,873272.44,9,4,18,1,True
4371604,726,0,451,9595,279698076,1,0,0,924.24,7,872348.2,11,0,23,1,True
4424404,128,0,20,9428,279698076,1,0,0,923.94,5,871424.26,18,0,1,1,True
4472029,1115,1,30,3807,279698076,1,0,0,924.45,8,870499.81,0,6,7,2,True
4602428,1115,1,-1,2650,279698076,1,1,0,924.01,4,870499.81,0,6,20,2,True
4636759,1485,0,20,5882,279698076,1,0,0,924.07,5,869575.74,24,1,19,2,True
4642331,464,1,10,1468,279698076,1,0,0,923.89,6,870499.63,13,5,5,5,True
5064837,130,0,10,5882,279698076,1,0,0,924.32,6,871423.95,18,4,13,5,True
5155904,427,2,20,6685,279698076,1,0,0,923.75,5,870500.2,18,5,4,6,True
5214457,471,0,451,9428,279698076,1,0,0,924.15,7,869576.05,5,4,7,6,True
5792727,275,0,10,2807,279698076,1,0,0,924.15,0,870500.2,24,3,17,7,True
5800072,1380,0,20,7560,279698076,1,0,0,923.93,5,869576.27,16,6,13,7,True
5981164,1115,1,451,8827,279698076,1,0,0,923.66,7,868652.61,0,0,22,7,True
6222888,212,4,451,8827,279698076,1,0,0,924.17,7,867728.44,9,3,9,7,True
6490253,997,3,30,2650,279698076,1,0,0,923.78,8,866804.66,26,4,13,8,True
6528921,212,4,451,9428,279698076,1,0,0,924.04,7,865880.62,9,3,4,8,True
6590384,1128,2,-1,3807,279698076,1,1,0,924.05,1,865880.62,24,3,21,8,True
7025162,292,1,25,2650,279698076,1,0,0,923.98,8,864956.64,4,2,8,9,True
7055096,997,3,451,3807,279698076,1,0,0,924.01,7,864032.63,26,1,22,10,True
7110358,465,0,10,9595,279698076,1,0,0,924.02,6,864956.65,13,0,15,10,True
7277043,212,4,25,1468,279698076,1,0,0,924.03,8,864032.62,9,3,12,11,True
7328352,724,3,-1,2366,279698076,1,1,0,924.26,4,864032.62,11,3,12,11,True
7585152,726,0,30,1085,279698076,1,0,0,924.2,8,863108.42,11,5,0,12,True
7866753,212,4,25,8318,279698076,1,0,0,924.27,8,862184.15,9,5,1,12,True
7916852,726,0,-1,9428,279698076,1,1,0,924.0,4,862184.15,11,4,20,1,True
7921746,931,0,10,9238,279698076,1,0,0,924.13,6,863108.28,24,2,0,1,True
8278120,997,3,30,6685,279698076,1,0,0,924.25,8,862184.03,26,3,18,2,True
8652023,1128,2,451,2650,279698076,1,0,0,923.93,7,861260.1,24,0,5,3,True
8671096,1115,1,451,8318,279698076,1,0,0,924.05,7,860336.05,0,5,1,5,True
8924111,724,3,451,2807,279698076,1,0,0,923.87,7,859412.18,11,5,14,6,True
8941316,997,3,25,3664,279698076,1,0,0,923.88,8,858488.3,26,0,18,6,True
8979693,1449,0,20,2881,279698076,1,0,0,924.1,3,857564.2,11,0,11,7,True
9153193,1128,2,-1,9428,279698076,1,1,0,923.77,4,857564.2,24,0,4,7,True
9385992,212,4,-1,2366,279698076,1,2,0,924.14,1,857564.2,9,1,0,8,True
9446773,1115,1,451,1536,279698076,1,0,0,924.04,7,856640.16,0,6,3,9,True
9559612,997,3,451,9595,279698076,1,0,0,924.04,7,855716.12,26,2,11,9,True
9590780,1115,1,451,3827,279698076,1,0,0,924.12,7,854792.0,0,1,4,10,True
9630533,726,0,451,6685,279698076,1,0,0,924.24,7,853867.76,11,2,2,11,True
9632815,738,2,20,9428,279698076,1,0,0,923.85,5,852943.91,11,6,15,11,True
1061902,766,4,30,3447,711071753,1,0,0,315.92,8,195100.08,14,4,7,1,True
1215511,282,2,-1,7935,711071753,1,1,0,315.95,4,195100.08,24,2,17,1,False
1325533,20,0,20,6794,711071753,1,0,0,315.85,3,194784.23,24,3,23,2,True
1348973,282,2,451,4534,711071753,1,0,0,316.24,7,194467.99,24,2,5,3,True
1477895,779,4,451,4887,711071753,1,0,0,315.84,7,194152.15,14,1,14,4,True
1737550,1124,0,20,2443,711071753,1,0,0,316.0,3,193836.15,24,5,9,4,True
2290850,341,0,20,1402,711071753,1,0,0,315.93,5,193520.22,24,2,21,4,True
2630029,147,0,20,6593,711071753,1,0,0,316.07,5,193204.15,18,3,15,4,True
2875864,766,4,451,3447,711071753,1,0,0,316.33,7,192887.82,14,0,16,4,True
3016120,1355,4,25,3447,711071753,1,0,0,315.91,8,192571.91,24,4,18,5,True
3209988,343,1,30,8058,711071753,1,0,0,315.9,8,192256.01,24,5,6,5,True
3377683,282,2,30,7935,711071753,1,0,0,316.13,8,191939.88,24,5,16,6,True
3516540,779,4,25,3735,711071753,1,0,0,315.87,8,191624.01,14,6,21,7,True
3541163,282,2,451,1402,711071753,1,0,0,316.11,7,191307.9,24,1,3,7,True
3704959,282,2,30,1402,711071753,1,0,0,315.78,8,190992.12,24,5,2,8,True
3721710,779,4,25,5226,711071753,1,0,0,316.11,8,190676.01,14,4,2,8,True
3777740,341,0,451,7935,711071753,1,0,0,315.81,7,190360.2,24,6,12,9,True
3866812,1355,4,30,1760,711071753,1,0,0,316.06,8,190044.14,24,0,2,10,True
4221416,766,4,30,3752,711071753,1,0,0,316.07,8,189728.07,14,1,13,11,True
4255136,1315,0,10,3470,711071753,1,0,0,315.78,6,190043.85,5,4,9,12,True
4269604,779,4,30,3447,711071753,1,0,0,316.01,8,189727.84,14,5,18,1,True
4459401,766,4,25,1760,711071753,1,0,0,315.89,8,189411.95,14,6,3,1,True
4523620,343,1,25,2443,711071753,1,0,0,316.09,8,189095.86,24,0,8,1,True
4600969,652,0,10,6593,711071753,1,0,0,316.19,6,189412.05,24,1,9,1,True
4652410,341,0,30,4534,711071753,1,0,0,316.1,8,189095.95,24,2,16,2,True
4693097,282,2,30,3735,711071753,1,0,0,315.81,8,188780.14,24,5,1,3,True
4947938,865,0,20,3752,711071753,1,0,0,315.91,5,188464.23,24,5,8,3,True
5046496,1355,4,25,3470,711071753,1,0,0,315.86,8,188148.37,24,6,16,3,True
5573580,980,1,10,1450,711071753,1,0,0,316.2,6,188464.57,22,0,18,4,True
5582490,135,2,20,8058,711071753,1,0,0,316.09,5,188148.48,18,1,19,4,True
5662825,341,0,451,3447,711071753,1,0,0,315.72,7,187832.76,24,2,14,4,True
5776758,931,0,10,2443,711071753,1,0,0,316.06,0,188148.82,24,6,20,4,True
6050291,282,2,-1,3752,711071753,1,1,0,316.01,4,188148.82,24,5,16,7,True
6080590,1471,0,20,3752,711071753,1,0,0,316.08,3,187832.74,24,3,11,8,True
6621872,282,2,451,1760,711071753,1,0,0,316.02,7,187516.72,24,2,11,9,True
6673899,1063,0,10,1760,711071753,1,0,0,315.8,0,187832.52,11,6,9,9,True
6768508,779,4,451,4887,711071753,1,0,0,316.24,7,187516.28,14,2,5,10,True
6805847,542,0,20,3732,711071753,1,0,0,316.22,5,187200.06,17,4,18,10,True
7143807,560,2,20,7935,711071753,1,0,0,316.22,3,186883.84,17,5,18,10,True
7226628,1134,1,10,3752,711071753,1,0,0,315.91,6,187199.75,24,1,15,11,True
7344056,766,4,25,6593,711071753,1,0,0,315.81,8,186883.94,14,4,12,1,True
7402783,343,1,30,4534,711071753,1,0,0,315.86,8,186568.08,24,5,19,2,True
7610374,1355,4,-1,3447,711071753,1,1,0,316.02,4,186568.08,24,0,23,2,True
7707810,1336,2,20,4534,711071753,1,0,0,316.04,5,186252.04,18,4,10,2,False
8203753,824,2,20,5226,711071753,1,0,0,316.04,3,185936.0,18,2,20,2,True
8579628,282,2,-1,8058,711071753,1,1,0,316.13,4,185936.0,24,1,9,3,True
8659842,766,4,-1,6593,711071753,1,2,0,316.36,4,185936.0,14,3,8,3,True
8794087,343,1,451,5226,711071753,1,0,0,315.67,7,185620.33,24,1,13,7,True
8835076,343,1,30,2443,711071753,1,0,0,315.94,8,185304.39,24,2,7,7,True
8846251,343,1,25,3752,711071753,1,0,0,315.98,8,184988.41,24,1,3,7,True
8849989,341,0,30,1450,711071753,1,0,0,315.86,8,184672.55,24,1,17,9,True
8867951,679,0,20,1450,711071753,1,0,0,316.19,5,184356.36,24,5,20,9,True
9122605,255,2,20,8058,711071753,1,0,0,315.94,5,184040.42,6,4,11,10,True
9131920,269,0,20,4887,711071753,1,0,0,315.91,3,183724.51,24,0,18,11,True
9538584,766,4,451,3470,711071753,1,0,0,315.98,7,183408.53,14,3,15,11,True
1028604,819,2,20,1097,235538404,0,0,0,512.35,5,66140.65,18,1,19,2,False
1134056,312,0,25,1683,235538404,0,0,0,512.13,8,65628.52,4,5,23,2,True
1249974,1203,4,25,2916,235538404,0,0,0,512.12,8,65116.4,24,0,0,3,True
1482287,1000,0,30,2916,235538404,0,0,0,511.95,8,64604.45,26,4,15,3,False
1526733,558,0,30,6033,235538404,0,0,0,511.87,8,64092.58,17,6,4,3,True
1533962,1203,4,451,8104,235538404,0,0,0,512.02,7,63580.56,24,3,16,3,True
1569894,1203,4,30,8104,235538404,0,0,0,512.09,8,63068.47,24,0,7,4,True
1633762,312,0,451,8104,235538404,0,0,0,511.86,7,62556.61,4,2,21,4,True
1671679,558,0,-1,5919,235538404,0,1,0,512.13,4,62556.61,17,3,5,4,True
2520336,1203,4,30,4653,235538404,0,0,0,512.32,8,62044.29,24,6,19,5,True
2535423,1460,2,20,3384,235538404,0,0,0,512.11,3,61532.18,11,6,22,5,False
2570544,900,1,30,8665,235538404,0,0,0,511.68,8,61020.5,24,0,19,5,True
2867033,900,1,451,8711,235538404,0,0,0,511.77,7,60508.73,24,1,19,5,True
3921503,219,0,10,1097,235538404,0,0,0,511.69,6,61020.42,9,5,4,6,True
4028781,1000,0,30,5800,235538404,0,0,0,512.09,8,60508.33,26,6,22,6,True
4136594,558,0,-1,2916,235538404,0,1,0,512.28,4,60508.33,17,1,10,6,True
4188226,1234,3,30,6649,235538404,0,0,0,512.01,8,59996.32,18,5,14,7,True
4279608,1234,3,30,4213,235538404,0,0,0,512.19,8,59484.13,18,0,2,8,True
4368324,900,1,451,8665,235538404,0,0,0,511.79,7,58972.34,24,2,14,9,True
4513661,312,0,30,4389,235538404,0,0,0,511.71,8,58460.63,4,3,6,9,True
4689637,558,0,30,2704,235538404,0,0,0,511.77,8,57948.86,17,6,15,11,True
4711709,318,0,20,4389,235538404,0,0,0,512.05,5,57436.81,11,0,5,12,True
4865262,480,0,20,9142,235538404,0,0,0,511.95,5,56924.86,5,6,14,2,True
4914593,1203,4,451,3072,235538404,0,0,0,512.2,7,56412.66,24,6,16,3,True
5014998,443,2,20,5919,235538404,0,0,0,512.06,5,55900.6,24,3,1,3,True
5039457,1234,3,451,4653,235538404,0,0,0,512.15,7,55388.45,18,6,13,3,True
5337198,312,0,451,6425,235538404,0,0,0,512.32,7,54876.13,4,3,3,4,True
5472897,1203,4,25,4301,235538404,0,0,0,511.79,8,54364.34,24,2,13,5,True
5601114,900,1,-1,5252,235538404,0,1,0,512.02,4,54364.34,24,5,6,5,True
5634219,312,0,451,1683,235538404,0,0,0,512.05,7,53852.29,4,5,23,6,True
6089549,1234,3,451,4218,235538404,0,0,0,512.38,7,53339.91,18,4,9,7,True
6143752,900,1,30,1683,235538404,0,0,0,511.86,8,52828.05,24,0,12,8,True
6167851,29,0,10,4301,235538404,0,0,0,512.11,6,53340.16,11,2,0,9,True
6232892,1065,0,20,6033,235538404,0,0,0,511.94,3,52828.22,11,3,14,9,True
6647894,1425,0,20,4301,235538404,0,0,0,511.77,5,52316.45,24,4,20,10,True
6680596,558,0,25,5919,235538404,0,0,0,512.08,8,51804.37,17,2,18,11,True
6930199,558,0,25,8104,235538404,0,0,0,511.83,8,51292.54,17,0,6,12,True
7127353,312,0,25,5252,235538404,0,0,0,511.81,8,50780.73,4,3,0,12,True
7194042,669,2,20,1097,235538404,0,0,0,512.13,5,50268.6,18,1,7,12,True
7224714,1234,3,451,4218,235538404,0,0,0,512.18,7,49756.42,18,0,1,1,True
7232441,900,1,30,7433,235538404,0,0,0,512.27,8,49244.15,24,1,14,2,True
7312078,649,0,20,9226,235538404,0,0,0,511.9,5,48732.25,24,5,18,3,True
7334189,1000,0,30,6649,235538404,0,0,0,511.98,8,48220.27,26,3,22,4,True
7336281,900,1,30,7433,235538404,0,0,0,511.93,8,47708.34,24,5,3,4,True
7462232,1315,0,20,3083,235538404,0,0,0,511.96,5,47196.38,5,0,11,5,True
7673484,701,2,20,5919,235538404,0,0,0,512.05,3,46684.33,18,6,4,6,True
7990387,312,0,451,2916,235538404,0,0,0,511.82,7,46172.51,4,5,16,6,True
8215199,312,0,-1,5919,235538404,0,1,0,512.34,1,46172.51,4,2,8,7,True
8241757,900,1,25,2704,235538404,0,0,0,512.3,8,45660.21,24,2,12,8,True
8766405,312,0,451,8104,235538404,0,0,0,511.99,7,45148.22,4,4,21,8,True
8777839,558,0,451,4653,235538404,0,0,0,512.03,7,44636.19,17,6,19,9,True
8978956,714,2,20,1097,235538404,0,0,0,512.12,5,44124.07,18,4,11,9,True
9231014,312,0,451,4213,235538404,0,0,0,512.03,7,43612.04,4,4,0,10,False
9644922,1025,1,10,1336,235538404,0,0,0,511.81,0,44123.85,11,6,5,11,True
9976688,1195,1,10,1336,235538404,0,0,0,512.18,6,44636.03,24,3,4,11,True
1045576,1406,0,10,9723,365039055,0,0,0,775.98,6,203330.98,24,1,4,1,True
1315106,470,1,10,8771,365039055,0,0,0,776.15,6,204107.13,5,2,19,2,True
1362854,697,3,30,3783,365039055,0,0,0,776.05,8,203331.08,24,0,2,3,True
1470312,1213,2,20,6517,365039055,0,0,0,776.15,5,202554.93,24,1,4,3,True
1586426,1062,3,451,5199,365039055,0,0,0,776.06,7,201778.87,11,1,12,4,True
1640162,300,0,20,6517,365039055,0,0,0,775.92,3,201002.95,4,2,3,4,True
1759306,216,4,30,2292,365039055,0,0,0,775.92,8,200227.03,9,3,12,5,True
1823729,1062,3,-1,3783,365039055,0,1,0,776.15,4,200227.03,11,3,7,5,True
2109160,1026,4,30,6517,365039055,0,0,0,776.14,8,199450.89,11,0,12,5,True
2557565,1026,4,451,6612,365039055,0,0,0,776.07,7,198674.82,11,3,10,6,True
2679118,375,4,25,8180,365039055,0,0,0,776.06,8,197898.76,25,6,4,6,True
2747059,697,3,25,6612,365039055,0,0,0,776.16,8,197122.6,24,2,6,6,True
2812820,375,4,451,8157,365039055,0,0,0,776.3,7,196346.3,25,6,2,7,True
2846574,51,0,20,2292,365039055,0,0,0,775.94,5,195570.36,20,4,2,9,True
2967344,1092,1,10,8180,365039055,0,0,0,776.0,0,196346.36,18,2,20,9,True
3143538,208,0,10,6612,365039055,0,0,0,776.38,6,197122.74,9,4,0,10,True
3278002,1296,4,451,8180,365039055,0,0,0,776.07,7,196346.67,5,5,22,10,True
3355456,1119,0,451,8853,365039055,0,0,0,775.64,7,195571.03,24,1,4,10,True
3384895,787,0,20,8180,365039055,0,0,0,776.21,3,194794.82,14,0,4,10,True
3427971,1026,4,-1,8180,365039055,0,1,0,776.2,4,194794.82,11,3,5,11,True
3457806,655,3,451,8853,365039055,0,0,0,776.07,7,194018.75,18,4,16,12,True
3540229,499,3,25,8853,365039055,0,0,0,776.04,8,193242.71,12,6,1,12,True
3699585,655,3,-1,9336,365039055,0,1,0,776.17,1,193242.71,18,6,17,12,True
3832505,499,3,-1,8157,365039055,0,2,0,775.8,4,193242.71,12,1,1,1,True
3983641,375,4,30,8157,365039055,0,0,0,775.9,8,192466.81,25,5,23,1,True
4068696,705,1,10,6517,365039055,0,0,0,775.82,0,193242.63,18,2,5,2,True
4082510,1119,0,30,9336,365039055,0,0,0,775.97,8,192466.66,24,6,13,2,True
4363297,459,1,10,7473,365039055,0,0,0,776.04,0,193242.7,13,2,16,2,True
4421151,1062,3,451,8771,365039055,0,0,0,775.9,7,192466.8,11,6,16,2,True
4579450,1296,4,-1,8853,365039055,0,1,0,775.96,1,192466.8,5,5,13,6,True
4907997,655,3,-1,6213,365039055,0,2,0,775.96,4,192466.8,18,2,0,6,True
5086988,1119,0,25,9723,365039055,0,0,0,776.18,8,191690.62,24,2,17,7,True
5290544,1026,4,-1,9336,365039055,0,1,0,776.04,4,191690.62,11,1,19,8,True
5708519,697,3,451,8180,365039055,0,0,0,775.86,7,190914.76,24,3,8,8,True
5969163,499,3,25,6517,365039055,0,0,0,776.06,8,190138.7,12,3,16,8,True
6048382,499,3,-1,8771,365039055,0,1,0,776.08,4,190138.7,12,4,5,10,True
6157666,1119,0,25,2292,365039055,0,0,0,776.17,8,189362.53,24,2,1,11,True
6186701,348,0,10,6213,365039055,0,0,0,776.1,6,190138.63,24,5,7,11,True
6306117,14,2,20,8771,365039055,0,0,0,776.26,5,189362.37,24,0,6,11,True
6322254,1485,0,10,6612,365039055,0,0,0,776.18,6,190138.55,24,5,20,12,True
6456004,913,0,20,9336,365039055,0,0,0,776.26,5,189362.29,18,4,18,1,True
6525299,471,0,10,3688,365039055,0,0,0,776.25,6,190138.54,5,2,18,2,True
6539679,1359,2,20,5199,365039055,0,0,0,776.14,3,189362.4,24,1,23,4,True
6547229,328,0,20,8853,365039055,0,0,0,776.05,3,188586.35,11,4,21,4,True
6717489,697,3,30,8180,365039055,0,0,0,775.81,8,187810.54,24,4,18,4,True
6794127,499,3,30,1922,365039055,0,0,0,775.94,8,187034.6,12,1,19,5,True
6856348,538,0,10,9336,365039055,0,0,0,775.98,6,187810.58,18,1,4,6,True
7244053,1278,0,20,6511,365039055,0,0,0,776.04,5,187034.54,24,5,13,7,True
7365313,1026,4,30,8157,365039055,0,0,0,775.96,8,186258.58,11,6,12,7,True
8017107,1114,1,10,9723,365039055,0,0,0,775.81,0,187034.39,0,0,5,8,True
8176989,697,3,-1,1922,365039055,0,1,0,775.93,4,187034.39,24,6,19,8,True
8289522,1296,4,30,6213,365039055,0,0,0,775.98,8,186258.41,5,2,16,8,True
8424754,1062,3,-1,3783,365039055,0,1,0,775.87,4,186258.41,11,2,1,9,True
8502262,499,3,25,9723,365039055,0,0,0,776.08,8,185482.33,12,5,1,9,True
9124119,697,3,25,2292,365039055,0,0,0,775.72,8,184706.61,24,2,14,9,True
9130224,499,3,451,2292,365039055,0,0,0,776.07,7,183930.54,12,0,1,9,True
9333405,655,3,-1,8853,365039055,0,1,0,776.1,1,183930.54,18,4,3,10,True
9599609,1062,3,451,3783,365039055,0,0,0,776.18,7,183154.36,11,0,22,11,True
9753302,1026,4,451,6517,365039055,0,0,0,775.93,7,182378.43,11,5,5,11,True
1287333,787,0,20,4283,142727949,0,0,0,131.01,5,374171.99,14,4,20,1,True
2340170,470,1,30,8048,142727949,0,0,0,131.08,8,374040.91,5,5,3,1,True
2582076,1473,4,30,7692,142727949,0,0,0,130.99,8,373909.92,24,5,7,3,True
2629143,728,1,30,1018,142727949,0,0,0,130.93,8,373778.99,11,2,14,3,False
2812579,405,4,-1,2149,142727949,0,1,0,131.06,1,373778.99,10,6,0,4,True
2866254,685,3,30,7682,142727949,0,0,0,131.0,8,373647.99,24,5,6,4,True
3086848,1068,2,451,2194,142727949,0,0,0,131.13,7,373516.86,18,1,8,4,True
3167576,1068,2,30,2132,142727949,0,0,0,131.11,8,373385.75,18,4,3,4,True
3296530,979,0,10,5252,142727949,0,0,0,131.02,6,373516.77,22,5,10,5,True
3439381,470,1,25,4283,142727949,0,0,0,130.84,8,373385.93,5,4,23,5,True
4253379,728,1,-1,9160,142727949,0,1,0,130.61,4,373385.93,11,1,14,5,True
4283752,405,4,25,3882,142727949,0,0,0,131.22,8,373254.71,10,0,8,5,True
4515953,685,3,30,5728,142727949,0,0,0,131.08,8,373123.63,24,4,8,6,True
4601611,385,1,10,5878,142727949,0,0,0,130.81,6,373254.44,25,4,22,9,True
4635360,348,0,30,5252,142727949,0,0,0,131.22,8,373123.22,24,2,2,10,True
4684347,348,0,25,2132,142727949,0,0,0,131.11,8,372992.11,24,6,2,11,True
4817224,728,1,25,5796,142727949,0,0,0,131.22,8,372860.89,11,6,22,11,True
4818737,28,1,10,5821,142727949,0,0,0,131.0,6,372991.89,11,3,11,12,True
5181507,1422,1,10,5716,142727949,0,0,0,130.77,0,373122.66,24,4,5,12,True
5257367,774,2,20,9096,142727949,0,0,0,131.29,5,372991.37,14,5,19,12,True
5737272,1473,4,451,2960,142727949,0,0,0,130.75,7,372860.62,24,2,0,2,True
5761423,728,1,25,5728,142727949,0,0,0,130.91,8,372729.71,11,0,20,2,True
5800624,728,1,30,1018,142727949,0,0,0,130.88,8,372598.83,11,1,2,2,True
6027977,723,1,10,5584,142727949,0,0,0,130.89,6,372729.72,11,6,17,3,True
6530429,405,4,451,6944,142727949,0,0,0,131.11,7,372598.61,10,2,10,4,True
6557603,1068,2,25,2194,142727949,0,0,0,130.97,8,372467.64,18,0,0,4,True
6673815,685,3,25,7792,142727949,0,0,0,131.17,8,372336.47,24,0,3,4,False
6772364,1473,4,-1,7052,142727949,0,1,0,131.19,4,372336.47,24,2,13,4,True
7025652,728,1,451,5878,142727949,0,0,0,131.0,7,372205.47,11,6,5,4,True
7355539,348,0,-1,9096,142727949,0,1,0,131.11,1,372205.47,24,5,22,6,True
7436992,405,4,25,5796,142727949,0,0,0,130.69,8,372074.78,10,6,17,7,True
7598959,348,0,30,2960,142727949,0,0,0,131.08,8,371943.7,24,1,20,9,True
7667826,685,3,451,4688,142727949,0,0,0,130.94,7,371812.76,24,3,22,9,True
7905055,728,1,25,6944,142727949,0,0,0,130.83,8,371681.93,11,2,15,10,True
7928491,405,4,-1,4653,142727949,0,1,0,130.98,4,371681.93,10,2,20,10,True
7999592,1210,0,10,8048,142727949,0,0,0,130.83,6,371812.76,24,2,13,12,True
8007513,550,0,20,2960,142727949,0,0,0,131.0,5,371681.76,17,4,13,2,True
8093837,685,3,25,9096,142727949,0,0,0,130.84,8,371550.92,24,3,20,3,True
8163441,685,3,30,5716,142727949,0,0,0,130.82,8,371420.1,24,2,10,3,True
8336590,470,1,25,5252,142727949,0,0,0,130.75,8,371289.35,5,4,18,3,True
8402165,685,3,30,5716,142727949,0,0,0,130.84,8,371158.51,24,1,14,4,True
8560373,76,0,20,4999,142727949,0,0,0,131.05,3,371027.46,20,3,2,6,True
8601109,470,1,25,4999,142727949,0,0,0,131.02,8,370896.44,5,2,1,7,True
8613087,470,1,25,7692,142727949,0,0,0,130.9,8,370765.54,5,3,1,7,True
8717262,464,1,10,7302,142727949,0,0,0,130.92,0,370896.46,13,6,4,7,True
8797221,405,4,30,5878,142727949,0,0,0,130.88,8,370765.58,10,0,15,7,True
8891026,1473,4,25,7302,142727949,0,0,0,130.86,8,370634.72,24,4,17,7,True
9032477,405,4,25,3882,142727949,0,0,0,130.95,8,370503.77,10,1,0,8,True
9060700,427,2,20,7682,142727949,0,0,0,130.69,3,370373.08,18,5,19,8,True
9560218,562,1,10,2960,142727949,0,0,0,131.0,6,370504.08,17,6,2,9,True
9626714,348,0,30,5584,142727949,0,0,0,131.22,8,370372.86,24,1,19,10,True
9716089,1473,4,-1,7792,142727949,0,1,0,130.85,4,370372.86,24,6,19,10,True
9732134,1068,2,25,5796,142727949,0,0,0,131.07,8,370241.79,18,0,16,11,True
9944362,759,0,10,7792,142727949,0,0,0,130.88,6,370372.67,24,2,20,11,True
1170678,1280,3,30,9474,650967804,1,0,0,252.82,8,699034.18,24,5,4,1,True
1247521,476,1,451,8455,650967804,1,0,0,252.92,7,698781.26,5,5,22,1,True
1376862,485,1,30,4063,650967804,1,0,0,253.0,8,698528.26,5,1,17,1,True
1716077,238,0,10,3590,650967804,1,0,0,253.29,6,698781.55,26,4,13,2,True
1951001,476,1,451,8046,650967804,1,0,0,253.19,7,698528.36,5,2,2,2,False
1959764,1015,0,30,7806,650967804,1,0,0,253.05,8,698275.31,26,6,4,4,True
2279466,570,2,20,8334,650967804,1,0,0,252.84,5,698022.47,11,4,13,4,True
2424505,476,1,451,3590,650967804,1,0,0,252.87,7,697769.6,5,6,3,5,True
2638589,522,0,10,8631,650967804,1,0,0,252.92,0,698022.52,18,4,0,5,True
2639131,341,0,-1,7489,650967804,1,1,0,253.2,4,698022.52,24,1,11,5,True
3249199,1264,0,20,1135,650967804,1,0,0,252.92,5,697769.6,23,0,18,6,True
3697705,641,0,20,7806,650967804,1,0,0,253.03,5,697516.57,24,4,21,6,True
3911864,485,1,-1,1438,650967804,1,1,0,253.33,4,697516.57,5,2,12,7,True
3943428,192,2,20,1530,650967804,1,0,0,252.68,5,697263.89,18,3,15,8,True
4081618,1015,0,25,4063,650967804,1,0,0,252.97,8,697010.92,26,2,5,10,True
4208136,1280,3,451,2889,650967804,1,0,0,252.89,7,696758.03,24,5,22,10,True
4371990,1015,0,30,8046,650967804,1,0,0,253.17,8,696504.86,26,6,5,11,True
4534182,1280,3,451,9474,650967804,1,0,0,253.15,7,696251.71,24,5,6,11,True
4719042,587,2,20,1460,650967804,1,0,0,252.97,5,695998.74,24,2,18,12,True
5134561,476,1,25,7489,650967804,1,0,0,253.15,8,695745.59,5,5,7,1,True
5200293,1072,0,10,1675,650967804,1,0,0,252.86,0,695998.45,18,1,9,1,True
5297034,806,1,10,2358,650967804,1,0,0,253.0,6,696251.45,11,6,7,1,True
5595023,1015,0,451,8994,650967804,1,0,0,253.3,7,695998.15,26,0,1,1,True
5698723,20,0,10,3590,650967804,1,0,0,253.09,6,696251.24,24,5,10,2,True
5816378,713,0,10,8334,650967804,1,0,0,253.09,0,696504.33,18,5,20,5,True
5896616,1227,0,20,1675,650967804,1,0,0,253.23,3,696251.1,18,0,22,5,True
5951061,476,1,451,5487,650967804,1,0,0,252.85,7,695998.25,5,0,19,6,True
6296687,485,1,451,4378,650967804,1,0,0,253.04,7,695745.21,5,2,9,8,True
6336150,1015,0,-1,4063,650967804,1,1,0,253.2,4,695745.21,26,0,2,8,True
6396023,341,0,451,2358,650967804,1,0,0,252.81,7,695492.4,24,4,19,8,True
6420615,234,0,10,4171,650967804,1,0,0,252.93,6,695745.33,26,0,19,8,True
6453411,1217,0,10,4063,650967804,1,0,0,252.71,6,695998.04,24,3,5,10,True
6879291,325,0,20,7877,650967804,1,0,0,253.06,5,695744.98,11,6,15,10,True
7191373,476,1,451,2712,650967804,1,0,0,252.86,7,695492.12,5,4,23,11,True
7495873,85,2,20,7806,650967804,1,0,0,252.95,5,695239.17,1,3,4,11,True
7519292,342,0,20,3590,650967804,1,0,0,252.93,5,694986.24,24,1,23,11,True
7579620,1127,0,10,1781,650967804,1,0,0,252.83,6,695239.07,24,0,5,12,True
7733601,476,1,-1,8046,650967804,1,1,0,253.36,4,695239.07,5,2,17,12,True
8146649,1297,0,20,8073,650967804,1,0,0,252.82,5,694986.25,5,6,18,1,True
8297160,1467,0,20,5487,650967804,1,0,0,253.02,5,694733.23,11,2,20,2,False
8509029,1280,3,30,1460,650967804,1,0,0,252.84,8,694480.39,24,0,8,3,True
8682685,485,1,25,8073,650967804,1,0,0,253.13,8,694227.26,5,2,2,4,False
8806522,476,1,451,2889,650967804,1,0,0,253.04,7,693974.22,5,6,20,4,True
8877014,1201,0,10,4378,650967804,1,0,0,253.16,6,694227.38,24,5,4,5,True
9039689,498,0,10,1135,650967804,1,0,0,252.82,6,694480.2,12,1,19,5,True
9052994,476,1,-1,4171,650967804,1,1,0,253.04,4,694480.2,5,5,8,6,True
9082122,1086,0,20,8631,650967804,1,0,0,253.17,5,694227.03,18,2,3,7,True
9279460,929,0,10,5487,650967804,1,0,0,252.95,6,694479.98,18,1,2,7,True
9346256,1015,0,30,8455,650967804,1,0,0,253.08,8,694226.9,26,2,10,7,True
9461602,485,1,30,8334,650967804,1,0,0,253.13,8,693973.77,5,0,17,9,True
9582979,341,0,451,4378,650967804,1,0,0,253.13,7,693720.64,24,4,23,11,True
9664886,931,0,10,1135,650967804,1,0,0,253.02,6,693973.66,24,0,20,11,True
9903101,341,0,30,8073,650967804,1,0,0,252.95,8,693720.71,24,5,4,11,True
9960607,476,1,30,5487,650967804,1,0,0,253.13,8,693467.58,5,5,23,11,True
1173573,794,2,20,2124,644062158,0,0,0,729.84,5,629793.16,11,5,10,2,True
1185622,994,4,30,1264,644062158,0,0,0,730.13,8,629063.03,22,4,23,3,True
1322297,1039,1,10,5635,644062158,0,0,0,730.15,6,629793.18,11,3,14,4,True
1446640,785,0,10,5467,644062158,0,0,0,730.13,6,630523.31,14,5,15,6,True
1501097,1255,0,25,2124,644062158,0,0,0,729.95,8,629793.36,23,0,3,6,True
1656397,588,0,10,6129,644062158,0,0,0,729.95,0,630523.31,24,1,19,6,True
1676920,404,1,10,9526,644062158,0,0,0,729.69,6,631253.0,10,5,5,9,True
1768020,1255,0,25,2917,644062158,0,0,0,729.99,8,630523.01,23,2,1,11,False
1893556,1102,2,20,2917,644062158,0,0,0,729.58,3,629793.43,0,4,13,12,True
1896276,1476,0,10,7537,644062158,0,0,0,729.94,6,630523.37,24,4,17,4,True
1936529,844,1,451,8297,644062158,0,0,0,730.12,7,629793.25,5,5,9,7,True
2229220,797,3,30,1923,644062158,0,0,0,730.06,8,629063.19,11,3,13,8,False
2582814,327,0,30,2023,644062158,0,0,0,730.13,8,628333.06,11,5,17,8,True
3015666,630,0,20,9526,644062158,0,0,0,730.04,3,627603.02,11,4,0,1,True
3018802,118,2,20,2734,644062158,0,0,0,730.09,5,626872.93,18,5,0,2,True
3053016,994,4,25,6129,644062158,0,0,0,730.24,8,626142.69,22,4,9,5,True
3234155,523,2,-1,1264,644062158,0,1,0,729.84,4,626142.69,18,4,18,5,True
3328157,523,2,-1,2917,644062158,0,2,0,730.06,4,626142.69,18,5,11,6,True
3366166,1255,0,-1,5635,644062158,0,3,1,730.12,4,0.0,23,0,15,8,True
1146236,1433,4,-1,5498,160991527,0,1,0,104.07,4,996184.0,24,6,0,2,True
1289351,553,1,25,9928,160991527,0,0,0,103.81,8,996080.19,17,0,1,3,True
1330281,553,1,451,3776,160991527,0,0,0,104.19,7,995976.0,17,0,11,4,True
1434535,1410,1,10,3637,160991527,0,0,0,103.85,6,996079.85,24,0,19,7,True
1854976,553,1,451,4797,160991527,0,0,0,103.79,7,995976.06,17,1,20,8,True
2005259,167,2,30,1487,160991527,0,0,0,104.37,8,995871.69,24,1,21,8,True
2326043,30,4,451,9928,160991527,0,0,0,103.89,7,995767.8,11,6,10,9,True
2944097,167,2,451,3309,160991527,0,0,0,104.09,7,995663.71,24,4,16,9,True
2957277,30,4,25,9437,160991527,0,0,0,104.01,8,995559.7,11,5,19,9,True
3102489,726,0,10,6299,160991527,0,0,0,103.94,6,995663.64,11,0,3,10,True
3655815,167,2,25,4881,160991527,0,0,0,103.83,8,995559.81,24,6,6,10,True
3699795,553,1,451,4583,160991527,0,0,0,103.87,7,995455.94,17,3,14,10,True
4175074,167,2,-1,4583,160991527,0,1,0,104.11,4,995455.94,24,0,10,10,False
4410288,1433,4,25,6458,160991527,0,0,0,104.17,8,995351.77,24,4,12,11,True
4732819,167,2,30,4881,160991527,0,0,0,103.7,8,995248.07,24,5,13,11,True
4746643,1115,1,451,5379,160991527,0,0,0,104.12,7,995143.95,0,6,4,11,False
4770539,811,0,20,4583,160991527,0,0,0,103.84,5,995040.11,18,4,15,12,True
4821524,167,2,451,3309,160991527,0,0,0,104.02,7,994936.09,24,5,15,12,True
4830951,1433,4,25,1487,160991527,0,0,0,104.1,8,994831.99,24,4,12,12,True
4905173,1352,1,10,8043,160991527,0,0,0,104.12,0,994936.11,24,5,3,1,True
5055566,1132,0,10,4119,160991527,0,0,0,103.85,6,995039.96,24,3,5,3,True
5436670,1115,1,451,3309,160991527,0,0,0,103.93,7,994936.03,0,1,21,3,True
5492765,1115,1,451,3637,160991527,0,0,0,103.96,7,994832.07,0,1,4,4,True
5563091,1086,0,20,1487,160991527,0,0,0,103.93,5,994728.14,18,6,18,6,True
5639799,167,2,25,9437,160991527,0,0,0,103.91,8,994624.23,24,0,6,6,True
5763392,503,0,20,7327,160991527,0,0,0,103.94,5,994520.29,12,1,10,7,True
5839813,553,1,-1,3776,160991527,0,1,0,104.13,1,994520.29,17,3,7,7,False
5862036,1115,1,25,9437,160991527,0,0,0,104.1,8,994416.19,0,0,13,8,True
6022827,1426,1,10,4583,160991527,0,0,0,103.93,6,994520.12,24,1,14,8,True
6092687,1115,1,451,3776,160991527,0,0,0,103.79,7,994416.33,0,5,22,8,True
6248739,167,2,30,6458,160991527,0,0,0,103.92,8,994312.41,24,0,21,10,True
6691878,1433,4,25,2199,160991527,0,0,0,104.03,8,994208.38,24,5,6,11,True
6798468,1433,4,451,4881,160991527,0,0,0,103.93,7,994104.45,24,6,14,11,True
7196244,320,1,10,4797,160991527,0,0,0,103.95,0,994208.4,11,2,11,11,True
7256607,952,0,20,3637,160991527,0,0,0,104.16,3,994104.24,13,5,5,12,True
7278844,30,4,25,1908,160991527,0,0,0,103.95,8,994000.29,11,5,21,12,True
7504633,30,4,451,9928,160991527,0,0,0,103.83,7,993896.46,11,1,16,1,True
8054967,167,2,30,4119,160991527,0,0,0,103.92,8,993792.54,24,6,9,3,False
8105341,1115,1,30,3309,160991527,0,0,0,104.03,8,993688.51,0,0,23,3,True
8172638,465,0,10,9928,160991527,0,0,0,104.01,6,993792.52,13,3,19,4,True
8226235,167,2,30,4797,160991527,0,0,0,103.95,8,993688.57,24,6,23,4,True
8296138,1115,1,-1,5379,160991527,0,1,0,104.04,4,993688.57,0,2,3,4,True
8448577,1433,4,451,1737,160991527,0,0,0,104.04,7,993584.53,24,3,6,6,True
8576028,1115,1,25,3776,160991527,0,0,0,104.08,8,993480.45,0,0,12,6,True
8611562,30,4,30,6664,160991527,0,0,0,104.08,8,993376.37,11,1,10,7,False
8692693,30,4,30,4119,160991527,0,0,0,104.1,8,993272.27,11,2,14,7,True
8940083,30,4,-1,1737,160991527,0,1,0,104.19,4,993272.27,11,1,3,8,True
9024489,1115,1,451,1487,160991527,0,0,0,104.3,7,993167.97,0,2,9,10,False
9169030,1277,2,20,9928,160991527,0,0,0,103.84,3,993064.13,24,2,6,10,True
9173334,1115,1,451,1487,160991527,0,0,0,103.87,7,992960.26,0,6,7,10,True
9287653,281,1,10,1908,160991527,0,0,0,104.05,0,993064.31,24,2,5,11,True
9526747,167,2,451,7327,160991527,0,0,0,103.84,7,992960.47,24,3,4,11,True
9909885,1247,0,10,1737,160991527,0,0,0,103.84,0,993064.31,23,2,3,11,True
1502168,848,2,25,1889,589825591,0,0,0,664.87,8,686177.13,5,4,11,1,True
1545386,424,1,30,1489,589825591,0,0,0,665.15,8,685511.98,18,0,12,2,False
1723241,444,2,20,7265,589825591,0,0,0,665.04,5,684846.94,24,1,14,2,True
2094286,424,1,451,6808,589825591,0,0,0,664.82,7,684182.12,18,2,13,3,True
2117997,848,2,451,5579,589825591,0,0,0,664.94,7,683517.18,5,4,4,4,True
2186358,372,0,10,4414,589825591,0,0,0,664.92,0,684182.1,25,5,12,5,True
2813063,634,1,-1,3135,589825591,0,1,0,664.87,4,684182.1,24,2,15,5,True
2871089,1411,0,10,3644,589825591,0,0,0,664.99,6,684847.09,24,0,1,6,True
2955272,424,1,-1,3874,589825591,0,1,0,664.96,4,684847.09,18,5,18,6,True
2988376,1010,0,10,4983,589825591,0,0,0,665.09,6,685512.18,26,2,14,8,False
3053855,634,1,451,1889,589825591,0,0,0,665.01,7,684847.17,24,2,0,8,True
3145980,278,1,10,7265,589825591,0,0,0,665.03,6,685512.2,24,3,17,8,False
3277056,634,1,30,5389,589825591,0,0,0,665.14,8,684847.06,24,4,12,8,True
3593530,154,4,451,1489,589825591,0,0,0,665.14,7,684181.92,18,0,2,9,True
3805060,848,2,-1,5389,589825591,0,1,0,664.79,1,684181.92,5,5,1,9,True
3814646,848,2,30,3193,589825591,0,0,0,665.17,8,683516.75,5,1,11,9,True
3882278,911,3,30,9099,589825591,0,0,0,664.98,8,682851.77,18,6,7,10,True
4005725,848,2,451,1489,589825591,0,0,0,665.19,7,682186.58,5,2,23,11,True
4587485,848,2,-1,3193,589825591,0,1,0,664.91,4,682186.58,5,2,16,12,True
4592387,911,3,-1,3874,589825591,0,2,0,664.98,4,682186.58,18,6,19,12,True
4600692,911,3,25,3135,589825591,0,0,0,664.87,8,681521.71,18,0,17,12,True
4753571,603,0,10,3215,589825591,0,0,0,664.93,6,682186.64,24,3,2,12,True
4969698,729,0,25,5389,589825591,0,0,0,664.92,8,681521.72,11,4,4,1,True
5021192,848,2,-1,3644,589825591,0,1,0,664.95,4,681521.72,5,1,0,3,True
5178439,471,0,20,2503,589825591,0,0,0,665.05,3,680856.67,5,3,20,3,True
5619868,634,1,-1,3135,589825591,0,1,0,665.15,1,680856.67,24,0,0,3,True
5737306,424,1,451,3193,589825591,0,0,0,665.07,7,680191.6,18,2,8,4,False
5815539,729,0,25,3193,589825591,0,0,0,664.89,8,679526.71,11,3,3,4,True
5960629,424,1,30,9826,589825591,0,0,0,665.35,8,678861.36,18,0,11,4,True
6058788,154,4,451,9099,589825591,0,0,0,664.82,7,678196.54,18,3,15,4,True
6373341,911,3,25,6191,589825591,0,0,0,664.98,8,677531.56,18,0,9,5,True
6493989,1483,0,10,6654,589825591,0,0,0,665.15,0,678196.71,24,4,3,7,True
6721312,1076,1,10,3135,589825591,0,0,0,665.12,6,678861.83,18,0,17,8,True
6730143,729,0,451,3874,589825591,0,0,0,665.11,7,678196.72,11,4,1,9,True
6857038,729,0,-1,6191,589825591,0,1,0,664.72,1,678196.72,11,2,1,10,True
7183847,411,2,20,5762,589825591,0,0,0,664.92,5,677531.8,18,6,10,10,True
7310873,1119,0,20,3135,589825591,0,0,0,664.88,5,676866.92,24,2,0,11,True
7400740,911,3,451,1248,589825591,0,0,0,664.87,7,676202.05,18,2,10,12,True
7517551,848,2,-1,3874,589825591,0,1,0,664.84,4,676202.05,5,6,0,1,True
7619559,634,1,451,3644,589825591,0,0,0,664.86,7,675537.19,24,6,14,2,True
7663556,729,0,25,1407,589825591,0,0,0,664.89,8,674872.3,11,6,18,2,True
7681597,154,4,25,9826,589825591,0,0,0,664.99,8,674207.31,18,6,1,3,True
7713658,729,0,30,1479,589825591,0,0,0,665.04,8,673542.27,11,6,12,3,True
7743387,911,3,451,6808,589825591,0,0,0,665.07,7,672877.2,18,6,15,4,True
8002964,154,4,25,8267,589825591,0,0,0,665.21,8,672211.99,18,1,19,4,False
8544094,502,0,10,4414,589825591,0,0,0,664.82,6,672876.81,12,6,21,5,True
8814118,228,0,10,3135,589825591,0,0,0,664.89,6,673541.7,26,6,9,6,True
9204089,529,2,20,6654,589825591,0,0,0,665.19,5,672876.51,18,1,20,6,True
9448847,726,0,10,3193,589825591,0,0,0,665.0,6,673541.51,11,2,2,6,True
9567685,634,1,30,1407,589825591,0,0,0,665.01,8,672876.5,24,3,14,6,False
9745424,729,0,451,9826,589825591,0,0,0,664.98,7,672211.52,11,4,11,7,False
9761510,729,0,25,5579,589825591,0,0,0,665.04,8,671546.48,11,5,12,8,True
9777500,424,1,30,6808,589825591,0,0,0,664.74,8,670881.74,18,1,2,8,False
9806211,424,1,451,4414,589825591,0,0,0,664.92,7,670216.82,18,1,16,9,True
9811795,218,0,10,8267,589825591,0,0,0,664.9,6,670881.72,9,1,7,10,True
9892338,952,0,20,6191,589825591,0,0,0,665.0,3,670216.72,13,4,13,10,True
1224069,360,0,451,2430,113863171,0,0,0,798.84,7,69281.16,24,5,23,1,True
1532369,769,3,451,5506,113863171,0,0,0,799.23,7,68481.93,14,0,4,2,True
1686586,553,1,10,9139,113863171,0,0,0,799.09,6,69281.02,17,4,22,3,True
2098865,988,3,-1,1278,113863171,0,1,0,798.93,4,69281.02,22,2,1,3,True
2117196,1446,1,10,5506,113863171,0,0,0,799.13,0,70080.15,24,4,19,3,True
2124232,996,0,-1,7511,113863171,0,1,0,798.79,1,70080.15,26,2,21,4,True
2234308,478,4,30,3764,113863171,0,0,0,799.13,8,69281.02,5,3,2,4,True
2337901,769,3,-1,3768,113863171,0,1,0,799.1,4,69281.02,14,3,8,5,True
2412582,478,4,451,1278,113863171,0,0,0,799.09,7,68481.93,5,5,4,5,True
2423214,769,3,451,5338,113863171,0,0,0,799.02,7,67682.91,14,0,5,5,True
3357079,1311,2,20,8927,113863171,0,0,0,798.86,5,66884.05,5,0,22,6,True
3482720,988,3,451,2430,113863171,0,0,0,799.1,7,66084.95,22,4,22,6,True
3511703,812,0,20,8157,113863171,0,0,0,798.92,5,65286.03,18,5,5,6,True
4026923,276,0,20,5338,113863171,0,0,0,799.08,3,64486.95,24,3,9,7,True
4113005,996,0,25,8109,113863171,0,0,0,799.16,8,63687.79,26,6,18,7,True
4205564,478,4,451,7385,113863171,0,0,0,798.79,7,62889.0,5,6,1,9,True
4305326,996,0,20,5846,113863171,0,0,0,798.77,5,62090.23,26,0,11,9,True
4406316,769,3,451,3764,113863171,0,0,0,799.12,7,61291.11,14,3,0,10,True
4533682,478,4,30,2430,113863171,0,0,0,799.22,8,60491.89,5,3,23,11,True
4590104,988,3,451,5506,113863171,0,0,0,798.81,7,59693.08,22,4,20,11,True
4608288,478,4,30,1188,113863171,0,0,0,799.02,8,58894.06,5,1,8,12,True
4814311,360,0,30,5613,113863171,0,0,0,798.82,8,58095.24,24,5,6,12,True
4950339,769,3,30,4284,113863171,0,0,0,799.25,8,57295.99,14,6,20,12,True
5149691,769,3,451,4061,113863171,0,0,0,798.95,7,56497.04,14,3,14,12,True
5319213,996,0,30,1278,113863171,0,0,0,799.0,8,55698.04,26,2,15,12,True
5412274,988,3,30,1278,113863171,0,0,0,799.23,8,54898.81,22,4,21,12,True
5437917,996,0,451,7494,113863171,0,0,0,798.75,7,54100.06,26,4,23,2,True
5526601,478,4,451,4284,113863171,0,0,0,798.67,7,53301.39,5,2,6,2,True
6089672,478,4,30,7385,113863171,0,0,0,798.66,8,52502.73,5,3,10,2,True
6145930,996,0,30,8927,113863171,0,0,0,798.99,8,51703.74,26,5,23,3,True
6412659,988,3,451,4061,113863171,0,0,0,799.0,7,50904.74,22,1,21,4,True
6555251,769,3,451,1717,113863171,0,0,0,798.86,7,50105.88,14,1,9,5,True
6579325,1116,0,20,7494,113863171,0,0,0,798.96,3,49306.92,24,0,20,5,True
6611395,360,0,-1,6832,113863171,0,1,0,798.93,1,49306.92,24,6,10,6,True
6639109,360,0,451,4284,113863171,0,0,0,798.76,7,48508.16,24,2,2,6,True
6861976,996,0,451,9139,113863171,0,0,0,799.08,7,47709.08,26,2,15,6,True
7029684,360,0,25,6832,113863171,0,0,0,799.11,8,46909.97,24,0,10,7,True
7408800,478,4,30,8927,113863171,0,0,0,799.17,8,46110.8,5,2,21,7,True
7409965,988,3,30,1717,113863171,0,0,0,799.0,8,45311.8,22,1,20,8,True
7543533,478,4,451,9139,113863171,0,0,0,799.37,7,44512.43,5,2,11,9,True
7597717,996,0,25,8157,113863171,0,0,0,799.08,8,43713.35,26,5,4,9,True
7706841,996,0,451,5338,113863171,0,0,0,799.04,7,42914.31,26,2,23,10,False
7731783,996,0,451,4061,113863171,0,0,0,798.93,7,42115.38,26,0,17,10,True
7942349,360,0,30,5677,113863171,0,0,0,799.25,8,41316.13,24,4,4,10,True
8410421,1108,1,10,1188,113863171,0,0,0,798.8,6,42114.93,0,2,0,11,True
8417047,988,3,-1,7511,113863171,0,1,0,798.98,4,42114.93,22,4,4,11,False
8446962,769,3,451,1188,113863171,0,0,0,798.94,7,41315.99,14,6,17,11,True
8621882,769,3,25,2430,113863171,0,0,0,798.9,8,40517.09,14,5,12,1,False
8787040,988,3,25,7494,113863171,0,0,0,799.01,8,39718.08,22,0,5,2,True
8889871,988,3,451,7494,113863171,0,0,0,799.0,7,38919.08,22,2,0,2,True
8934009,673,0,20,4284,113863171,0,0,0,799.05,5,38120.03,18,0,1,4,True
8947458,996,0,25,9139,113863171,0,0,0,798.97,8,37321.06,26,4,9,5,True
9009440,360,0,451,7385,113863171,0,0,0,798.85,7,36522.21,24,0,19,7,True
9102476,1180,1,10,5506,113863171,0,0,0,798.91,0,37321.12,24,3,5,7,True
9585415,895,0,10,5613,113863171,0,0,0,798.94,0,38120.06,24,5,13,9,True
9697448,360,0,-1,8109,113863171,0,1,0,798.98,1,38120.06,24,6,3,10,True
9738615,360,0,451,2430,113863171,0,0,0,798.87,7,37321.19,24,0,2,11,True
1127785,1026,4,25,7753,493866660,1,0,0,105.01,8,817687.99,11,3,23,1,True
1361687,194,1,25,2657,493866660,1,0,0,105.3,8,817582.69,18,0,2,1,True
1364493,664,2,30,5266,493866660,1,0,0,105.12,8,817477.57,18,0,14,2,True
1514793,474,4,25,1850,493866660,1,0,0,104.95,8,817372.62,5,3,14,3,True
1543942,194,1,451,5989,493866660,1,0,0,104.92,7,817267.7,18,3,16,4,True
1600274,664,2,30,5989,493866660,1,0,0,105.14,8,817162.56,18,1,15,5,True
1629730,194,1,-1,7753,493866660,1,1,0,105.27,4,817162.56,18,5,3,5,True
2069459,194,1,25,5460,493866660,1,0,0,105.02,8,817057.54,18,3,10,5,True
2081800,148,1,451,2310,493866660,1,0,0,105.02,7,816952.52,18,0,4,6,True
2358281,550,0,10,6152,493866660,1,0,0,104.89,0,817057.41,17,4,21,7,True
2941867,148,1,451,6797,493866660,1,0,0,104.6,7,816952.81,18,5,20,8,True
3267141,599,0,20,5267,493866660,1,0,0,104.86,3,816847.95,24,3,3,8,True
3527196,697,3,451,2722,493866660,1,0,0,104.9,7,816743.05,24,1,0,8,True
4120752,664,2,25,1074,493866660,1,0,0,105.01,8,816638.04,18,4,18,9,True
4139811,1026,4,25,1127,493866660,1,0,0,104.92,8,816533.12,11,4,14,10,True
4188913,474,4,-1,4014,493866660,1,1,0,105.09,4,816533.12,5,0,20,11,True
4243570,474,4,451,5519,493866660,1,0,0,104.99,7,816428.13,5,0,1,11,True
4407012,148,1,-1,8007,493866660,1,1,0,104.9,4,816428.13,18,0,11,1,True
4484262,348,0,10,2722,493866660,1,0,0,105.38,6,816533.51,24,6,16,2,True
4493314,1026,4,25,2722,493866660,1,0,0,104.88,8,816428.63,11,0,19,2,True
4832205,194,1,451,7753,493866660,1,0,0,105.17,7,816323.46,18,0,4,2,True
4869945,1026,4,25,6777,493866660,1,0,0,105.07,8,816218.39,11,4,13,2,True
5128621,1389,4,25,5599,493866660,1,0,0,105.19,8,816113.2,24,6,3,3,True
5338899,148,1,451,5266,493866660,1,0,0,105.09,7,816008.11,18,5,14,3,True
5392961,474,4,25,7753,493866660,1,0,0,105.13,8,815902.98,5,4,3,4,True
5523958,1026,4,451,1850,493866660,1,0,0,104.97,7,815798.01,11,0,4,4,True
5744698,194,1,25,1127,493866660,1,0,0,105.09,8,815692.92,18,0,6,4,True
5885204,148,1,30,2722,493866660,1,0,0,105.02,8,815587.9,18,5,9,5,True
6006679,694,2,20,2657,493866660,1,0,0,104.73,5,815483.17,24,3,12,5,True
6132105,300,0,10,2657,493866660,1,0,0,104.92,0,815588.09,4,1,7,6,True
6185939,697,3,30,2657,493866660,1,0,0,105.1,8,815482.99,24,0,23,6,True
6198776,1389,4,-1,3418,493866660,1,1,0,105.11,1,815482.99,24,5,18,7,True
6269833,474,4,451,5844,493866660,1,0,0,105.18,7,815377.81,5,3,1,8,False
6339875,1026,4,451,5844,493866660,1,0,0,105.17,7,815272.64,11,6,9,9,True
6547136,664,2,30,8007,493866660,1,0,0,105.16,8,815167.48,18,2,21,9,True
6760344,697,3,25,7878,493866660,1,0,0,104.9,8,815062.58,24,3,13,9,True
7003009,1160,0,10,2310,493866660,1,0,0,104.91,6,815167.49,15,5,3,9,True
7264531,53,0,10,5460,493866660,1,0,0,105.14,6,815272.63,20,1,20,10,True
7422953,115,2,20,5267,493866660,1,0,0,104.9,5,815167.73,3,1,3,11,True
7464658,1026,4,-1,2722,493866660,1,1,0,104.86,4,815167.73,11,6,9,11,True
7508262,1451,1,10,2722,493866660,1,0,0,105.07,6,815272.8,11,4,15,11,True
7681267,664,2,-1,6152,493866660,1,1,0,105.05,4,815272.8,18,6,1,11,True
7718197,664,2,-1,5266,493866660,1,2,0,105.15,4,815272.8,18,1,1,11,True
7844312,1389,4,30,2722,493866660,1,0,0,105.01,8,815167.79,24,1,14,12,True
8045147,998,0,10,7125,493866660,1,0,0,104.99,6,815272.78,26,5,20,12,True
8071756,1389,4,451,6777,493866660,1,0,0,104.78,7,815168.0,24,6,4,2,True
8175326,804,0,10,7125,493866660,1,0,0,105.12,6,815273.12,11,2,22,2,True
8416909,889,0,10,3418,493866660,1,0,0,104.89,6,815378.01,27,4,23,2,True
8417297,697,3,-1,7125,493866660,1,1,0,105.1,1,815378.01,24,1,14,2,False
8431683,253,2,20,1127,493866660,1,0,0,104.74,3,815273.27,6,6,21,3,True
8665047,697,3,451,5519,493866660,1,0,0,104.69,7,815168.58,24,4,14,4,True
8742863,416,2,20,6152,493866660,1,0,0,104.78,5,815063.8,18,5,21,5,True
9003016,1389,4,451,7364,493866660,1,0,0,104.88,7,814958.92,24,1,14,5,True
9248755,525,0,20,9753,493866660,1,0,0,104.83,3,814854.09,18,5,12,6,True
9488104,1170,0,10,6797,493866660,1,0,0,104.76,0,814958.85,24,2,0,6,True
9509952,1026,4,-1,2722,493866660,1,1,0,104.9,4,814958.85,11,4,21,9,True
9613352,664,2,451,5989,493866660,1,0,0,104.95,7,814853.9,18,5,10,9,True
9790759,697,3,-1,7878,493866660,1,1,0,104.95,1,814853.9,24,2,0,10,True
9823677,664,2,30,9753,493866660,1,0,0,104.94,8,814748.96,18,6,5,11,True
1293028,160,0,-1,1062,751624425,1,1,0,574.98,4,342347.0,24,4,16,1,True
1452826,735,1,10,1457,751624425,1,0,0,575.25,6,342922.25,11,3,21,2,True
1457289,1162,2,20,5707,751624425,1,0,0,575.08,5,342347.17,24,2,17,2,True
1485409,1342,3,30,3307,751624425,1,0,0,574.89,8,341772.28,24,3,11,3,True
1973202,10,4,30,8130,751624425,1,0,0,574.69,8,341197.59,24,5,12,3,True
2013292,86,4,451,5740,751624425,1,0,0,574.73,7,340622.86,1,0,0,3,True
2138023,1119,0,10,5707,751624425,1,0,0,574.55,6,341197.41,24,4,7,4,True
2201743,377,4,-1,3019,751624425,1,1,0,574.87,1,341197.41,25,2,15,4,True
2434651,866,0,20,6231,751624425,1,0,0,574.95,5,340622.46,24,5,13,5,True
2561845,1445,2,20,1062,751624425,1,0,0,574.75,5,340047.71,24,4,17,6,True
2642757,160,0,30,2574,751624425,1,0,0,574.88,8,339472.83,24,6,2,6,True
2680723,394,0,20,3307,751624425,1,0,0,575.29,5,338897.54,10,0,14,6,True
2788257,826,1,10,7485,751624425,1,0,0,574.97,6,339472.51,18,2,14,6,True
2908470,1342,3,30,2538,751624425,1,0,0,575.23,8,338897.28,24,6,5,7,True
3023245,86,4,451,2538,751624425,1,0,0,575.03,7,338322.25,1,5,4,8,True
3031567,86,4,451,9377,751624425,1,0,0,574.91,7,337747.34,1,5,5,9,True
3111143,86,4,30,1062,751624425,1,0,0,575.04,8,337172.3,1,1,7,11,True
3267117,1342,3,30,2574,751624425,1,0,0,574.92,8,336597.38,24,1,0,11,True
3386147,10,4,451,5707,751624425,1,0,0,574.94,7,336022.44,24,6,15,12,True
3395578,715,0,10,5952,751624425,1,0,0,574.82,6,336597.26,18,6,16,12,True
3729057,10,4,25,2538,751624425,1,0,0,574.96,8,336022.3,24,5,0,2,True
3853879,168,0,10,5511,751624425,1,0,0,574.87,0,336597.17,24,5,14,2,True
4052129,158,2,20,3019,751624425,1,0,0,574.85,5,336022.32,24,6,1,3,True
4165995,1389,4,25,3307,751624425,1,0,0,574.84,8,335447.48,24,4,13,3,True
4252022,377,4,25,2574,751624425,1,0,0,575.3,8,334872.18,25,3,1,3,True
4362960,1124,0,451,2304,751624425,1,0,0,574.89,7,334297.29,24,0,21,4,True
4418945,1342,3,451,5511,751624425,1,0,0,575.07,7,333722.22,24,3,0,4,True
4744396,160,0,30,7747,751624425,1,0,0,574.83,8,333147.39,24,4,22,4,True
4771969,1124,0,30,3959,751624425,1,0,0,574.9,8,332572.49,24,5,10,4,True
4974268,160,0,-1,2574,751624425,1,1,0,574.87,4,332572.49,24,5,6,5,True
5324445,1389,4,-1,9524,751624425,1,2,0,574.99,4,332572.49,24,6,19,5,True
5862779,1124,0,451,7747,751624425,1,0,0,575.03,7,331997.46,24,6,23,5,True
5880368,1124,0,30,3959,751624425,1,0,0,575.0,8,331422.46,24,6,14,7,True
5976533,160,0,451,2472,751624425,1,0,0,574.91,7,330847.55,24,2,15,8,True
6036471,1389,4,30,7205,751624425,1,0,0,574.95,8,330272.6,24,0,7,8,True
6064636,10,4,25,2486,751624425,1,0,0,575.33,8,329697.27,24,2,5,8,True
6120951,1342,3,451,2090,751624425,1,0,0,574.88,7,329122.39,24,0,0,11,True
6302760,679,0,20,6356,751624425,1,0,0,575.03,5,328547.36,24,1,9,11,True
6585180,10,4,30,9744,751624425,1,0,0,575.12,8,327972.24,24,3,13,11,True
6642242,1389,4,-1,5707,751624425,1,1,0,575.3,1,327972.24,24,3,23,12,True
6953110,958,2,20,5308,751624425,1,0,0,575.03,5,327397.21,13,1,7,12,True
6961669,377,4,451,8130,751624425,1,0,0,575.05,7,326822.16,25,3,0,1,True
7187889,160,0,451,9524,751624425,1,0,0,575.14,7,326247.02,24,0,13,1,True
7328113,10,4,-1,5511,751624425,1,1,0,575.03,4,326247.02,24,2,22,2,True
7424951,349,2,20,1560,751624425,1,0,0,574.88,5,325672.14,24,2,2,3,True
7606052,377,4,451,2538,751624425,1,0,0,574.99,7,325097.15,25,1,20,4,True
7909157,10,4,-1,6356,751624425,1,1,0,575.18,4,325097.15,24,0,1,4,True
7916630,1227,0,10,3307,751624425,1,0,0,574.81,6,325671.96,18,6,2,5,True
8096841,1389,4,-1,2401,751624425,1,1,0,574.96,4,325671.96,24,2,9,6,True
8172931,160,0,30,5511,751624425,1,0,0,575.02,8,325096.94,24,4,1,7,True
8888959,1377,0,20,7084,751624425,1,0,0,575.09,3,324521.85,16,5,6,7,True
9047652,86,4,451,1062,751624425,1,0,0,575.28,7,323946.57,1,2,0,8,True
9115454,998,0,10,2090,751624425,1,0,0,575.03,0,324521.6,26,1,16,9,True
9341353,1173,1,10,1560,751624425,1,0,0,575.07,6,325096.67,24,3,1,10,True
9889526,1389,4,30,5707,751624425,1,0,0,574.96,8,324521.71,24,6,0,11,True
9984405,1389,4,25,9524,751624425,1,0,0,575.11,8,323946.6,24,0,10,11,True
1053805,610,0,10,8110,778636778,1,0,0,992.81,6,104979.81,11,0,17,1,True
1101411,1461,0,-1,7476,778636778,1,1,0,993.09,1,104979.81,11,2,3,1,True
2157233,406,1,30,7873,778636778,1,0,0,993.04,8,103986.77,10,5,21,2,True
2280518,833,4,30,7873,778636778,1,0,0,992.95,8,102993.82,5,3,12,2,True
2352991,1461,0,25,8008,778636778,1,0,0,993.1,8,102000.72,11,2,13,3,True
2538357,662,1,10,4592,778636778,1,0,0,993.36,6,102994.08,18,2,0,4,True
2594019,1461,0,451,1498,778636778,1,0,0,993.21,7,102000.87,11,6,19,5,True
2831829,833,4,451,8008,778636778,1,0,0,992.98,7,101007.89,5,4,4,6,True
3561673,406,1,-1,9047,778636778,1,1,0,993.24,1,101007.89,10,4,11,6,True
3614761,833,4,-1,6639,778636778,1,2,0,993.18,4,101007.89,5,2,13,7,True
3937183,739,1,10,1498,778636778,1,0,0,992.99,6,102000.88,24,3,18,8,True
4193806,833,4,451,6267,778636778,1,0,0,992.86,7,101008.02,5,3,17,8,True
4354581,579,0,451,5769,778636778,1,0,0,992.8,7,100015.22,11,3,0,9,True
4514622,406,1,-1,3118,778636778,1,1,0,992.92,1,100015.22,10,4,3,10,True
4572382,833,4,25,5553,778636778,1,0,0,993.01,8,99022.21,5,6,5,12,True
4617733,1461,0,25,7873,778636778,1,0,0,992.9,8,98029.31,11,2,19,12,True
4830246,833,4,-1,8465,778636778,1,1,0,992.98,4,98029.31,5,1,12,12,True
4878785,457,0,10,1565,778636778,1,0,0,992.98,0,99022.29,13,5,16,1,True
5116738,1411,0,20,5417,778636778,1,0,0,993.12,5,98029.17,24,2,10,2,True
5479575,1043,4,30,4592,778636778,1,0,0,992.68,8,97036.49,11,4,21,2,True
5772736,406,1,30,4720,778636778,1,0,0,992.59,8,96043.9,10,2,9,4,True
5902850,406,1,-1,4391,778636778,1,1,0,993.09,1,96043.9,10,2,19,4,True
5906579,406,1,-1,5553,778636778,1,2,0,993.14,1,96043.9,10,3,8,5,True
6054985,1461,0,25,4720,778636778,1,0,0,992.95,8,95050.95,11,5,5,5,True
6248091,579,0,-1,6185,778636778,1,1,0,993.0,4,95050.95,11,6,5,5,True
6281210,1127,0,10,5874,778636778,1,0,0,992.89,6,96043.84,24,2,0,5,True
6493005,1043,4,451,6066,778636778,1,0,0,992.92,7,95050.92,11,6,6,6,True
6529702,579,0,451,9169,778636778,1,0,0,993.09,7,94057.83,11,0,11,6,True
6897641,1387,1,10,6443,778636778,1,0,0,993.06,0,95050.89,24,1,11,7,True
7001912,1227,0,10,5769,778636778,1,0,0,992.89,6,96043.78,18,5,4,7,True
7109114,833,4,451,7116,778636778,1,0,0,992.92,7,95050.86,5,0,20,8,False
7109656,833,4,-1,1962,778636778,1,1,0,992.83,1,95050.86,5,5,11,8,True
7179186,144,1,10,6185,778636778,1,0,0,992.91,0,96043.77,18,3,4,11,True
7551153,282,2,20,5769,778636778,1,0,0,993.2,5,95050.57,24,6,22,11,True
7863569,1043,4,451,8008,778636778,1,0,0,993.17,7,94057.4,11,2,9,12,True
7929510,1043,4,451,5769,778636778,1,0,0,993.05,7,93064.35,11,6,12,1,True
8006594,1043,4,30,1962,778636778,1,0,0,993.04,8,92071.31,11,0,18,2,True
8085162,1461,0,30,6443,778636778,1,0,0,993.21,8,91078.1,11,1,7,2,True
8235892,1311,2,20,4720,778636778,1,0,0,992.91,5,90085.19,5,3,17,3,True
8351274,833,4,25,2739,778636778,1,0,0,993.35,8,89091.84,5,0,3,6,True
8421604,1461,0,25,8110,778636778,1,0,0,992.92,8,88098.92,11,6,7,6,True
8814219,1043,4,30,8465,778636778,1,0,0,993.02,8,87105.9,11,4,7,7,True
8875557,833,4,451,2739,778636778,1,0,0,992.92,7,86112.98,5,0,20,7,True
9033410,579,0,-1,5128,778636778,1,1,0,992.93,1,86112.98,11,0,2,7,False
9037062,1043,4,-1,5824,778636778,1,2,0,992.78,1,86112.98,11,6,13,10,True
9321465,579,0,-1,9169,778636778,1,3,1,993.18,1,86112.98,11,0,15,10,True
1356204,1246,0,-1,4938,853427181,1,1,0,284.27,4,385910.0,23,6,6,1,True
1476923,681,2,20,9468,853427181,1,0,0,284.05,5,385625.95,24,2,20,1,True
1524414,205,0,10,9468,853427181,1,0,0,284.13,6,385910.08,9,1,19,1,True
1583915,1062,3,-1,5272,853427181,1,1,0,283.83,1,385910.08,11,4,7,2,True
1828798,919,4,-1,7583,853427181,1,2,0,284.3,1,385910.08,18,3,6,3,True
1878397,1477,2,20,3330,853427181,1,0,0,284.24,5,385625.84,24,4,16,3,False
2003820,919,4,451,7583,853427181,1,0,0,284.02,7,385341.82,18,2,0,3,True
2070204,1485,0,20,1753,853427181,1,0,0,284.04,5,385057.78,24,2,2,3,True
2732576,71,1,10,5952,853427181,1,0,0,284.14,6,385341.92,20,2,15,4,True
2811559,28,1,10,7466,853427181,1,0,0,283.87,0,385625.79,11,2,13,5,True
2849820,1062,3,30,9746,853427181,1,0,0,284.03,8,385341.76,11,1,8,5,True
2957246,1089,0,30,6359,853427181,1,0,0,284.1,8,385057.66,18,5,10,5,True
2965530,1089,0,30,5629,853427181,1,0,0,283.91,8,384773.75,18,6,10,6,True
2981604,869,2,25,7583,853427181,1,0,0,283.88,8,384489.87,24,6,15,8,True
3009267,869,2,451,8301,853427181,1,0,0,284.05,7,384205.82,24,1,2,11,True
3048581,71,1,451,8524,853427181,1,0,0,284.07,7,383921.75,20,4,4,11,True
3106145,71,1,30,9074,853427181,1,0,0,283.99,8,383637.76,20,2,5,1,True
3396588,1345,2,451,1753,853427181,1,0,0,284.25,7,383353.51,24,6,20,1,True
3495983,21,0,30,9746,853427181,1,0,0,283.9,8,383069.61,11,3,18,2,True
3679253,1062,3,30,1999,853427181,1,0,0,284.1,8,382785.51,11,4,6,2,True
3949582,21,0,451,6253,853427181,1,0,0,283.94,7,382501.57,11,6,14,3,True
4057722,1089,0,451,1530,853427181,1,0,0,284.02,7,382217.55,18,5,3,4,True
4080719,869,2,30,9746,853427181,1,0,0,283.99,8,381933.56,24,0,11,5,True
4156535,869,2,30,1999,853427181,1,0,0,283.91,8,381649.65,24,6,15,5,True
4652043,1089,0,-1,1999,853427181,1,1,0,283.82,4,381649.65,18,2,10,5,True
4873459,1062,3,451,2944,853427181,1,0,0,283.98,7,381365.67,11,4,11,6,True
4960994,1345,2,451,4938,853427181,1,0,0,283.82,7,381081.85,24,5,6,6,True
5169042,1089,0,25,9158,853427181,1,0,0,284.08,8,380797.77,18,6,23,6,True
5355627,644,0,20,4363,853427181,1,0,0,283.8,5,380513.97,24,0,17,7,True
5939239,869,2,451,3330,853427181,1,0,0,284.13,7,380229.84,24,5,19,7,True
5992473,372,0,20,7583,853427181,1,0,0,284.17,5,379945.67,25,5,9,9,True
6010297,1089,0,30,2508,853427181,1,0,0,283.98,8,379661.69,18,1,2,9,True
6015239,869,2,451,9158,853427181,1,0,0,283.84,7,379377.85,24,1,12,9,True
6251702,919,4,25,2508,853427181,1,0,0,283.87,8,379093.98,18,1,8,10,True
6508693,1246,0,30,4938,853427181,1,0,0,284.19,8,378809.79,23,5,20,10,True
7110476,525,0,20,4102,853427181,1,0,0,284.25,5,378525.54,18,3,10,11,True
7239792,366,0,20,8301,853427181,1,0,0,283.75,3,378241.79,25,0,1,11,True
7255964,919,4,451,5629,853427181,1,0,0,284.04,7,377957.75,18,6,20,12,True
7446285,1062,3,30,7466,853427181,1,0,0,283.97,8,377673.78,11,2,10,12,True
7483557,1044,0,10,4363,853427181,1,0,0,284.1,6,377957.88,11,2,12,12,True
7504508,993,0,20,2508,853427181,1,0,0,283.99,5,377673.89,22,1,2,12,True
7532807,1273,0,25,8301,853427181,1,0,0,283.85,8,377390.04,24,3,14,12,True
7643610,312,0,20,7466,853427181,1,0,0,283.89,3,377106.15,4,5,3,1,True
8012049,1246,0,25,3388,853427181,1,0,0,284.03,8,376822.12,23,2,22,1,True
8068735,1246,0,30,5272,853427181,1,0,0,283.99,8,376538.13,23,3,20,1,True
8161704,869,2,451,4102,853427181,1,0,0,283.88,7,376254.25,24,5,7,2,True
8472944,1246,0,451,5629,853427181,1,0,0,283.9,7,375970.35,23,1,16,3,True
8719007,869,2,-1,4363,853427181,1,1,0,284.29,4,375970.35,24,4,7,5,True
8744924,1246,0,451,4363,853427181,1,0,0,284.27,7,375686.08,23,4,21,6,True
8834604,1089,0,20,7466,853427181,1,0,0,283.77,5,375402.31,18,0,12,6,True
8836083,867,0,10,9468,853427181,1,0,0,284.23,6,375686.54,24,6,9,7,True
9034293,1062,3,451,6359,853427181,1,0,0,283.71,7,375402.83,11,5,5,8,True
9168536,71,1,451,2508,853427181,1,0,0,283.84,7,375118.99,20,5,2,8,True
9212659,869,2,451,8301,853427181,1,0,0,283.61,7,374835.38,24,0,1,9,True
9552920,1273,0,451,1530,853427181,1,0,0,283.87,7,374551.51,24,0,14,9,True
9788191,1246,0,451,1999,853427181,1,0,0,283.99,7,374267.52,23,0,8,9,True
9879215,1273,0,30,3388,853427181,1,0,0,284.29,8,373983.23,24,2,1,11,True
1096450,1463,2,-1,3330,685003976,1,1,0,870.86,1,138095.0,11,6,16,1,True
1246014,125,4,30,3993,685003976,1,0,0,870.8,8,137224.2,18,0,5,2,True
1478661,1463,2,30,5099,685003976,1,0,0,871.23,8,136352.97,11,4,7,3,True
1567472,177,4,30,3993,685003976,1,0,0,871.07,8,135481.9,24,5,16,3,True
1634702,1162,2,30,3397,685003976,1,0,0,871.02,8,134610.88,24,1,14,4,True
2137458,177,4,451,8689,685003976,1,0,0,871.06,7,133739.82,24,5,10,4,True
2163351,177,4,-1,9244,685003976,1,1,0,871.12,4,133739.82,24,6,22,5,True
2300278,841,1,451,1599,685003976,1,0,0,871.01,7,132868.81,5,0,10,5,True
2350675,1189,2,20,8434,685003976,1,0,0,870.84,5,131997.97,24,5,18,6,True
2594412,1162,2,25,6517,685003976,1,0,0,871.0,8,131126.97,24,0,16,6,True
2768482,498,0,20,8434,685003976,1,0,0,871.26,5,130255.71,12,4,15,7,True
2931451,254,0,10,4560,685003976,1,0,0,871.28,0,131126.99,6,4,8,7,True
3095715,200,0,10,3993,685003976,1,0,0,871.07,6,131998.06,9,5,0,7,True
3181112,125,4,30,5296,685003976,1,0,0,871.1,8,131126.96,18,2,15,7,True
3219252,177,4,-1,5351,685003976,1,1,0,871.08,1,131126.96,24,1,14,8,True
3323949,867,0,10,5099,685003976,1,0,0,870.99,6,131997.95,24,1,16,9,True
3485858,177,4,451,9367,685003976,1,0,0,870.86,7,131127.09,24,6,11,9,True
3629094,841,1,25,3993,685003976,1,0,0,871.07,8,130256.02,5,1,21,9,True
3690678,1463,2,-1,8522,685003976,1,1,0,871.11,1,130256.02,11,2,15,9,True
3748812,1463,2,25,5351,685003976,1,0,0,870.89,8,129385.13,11,2,5,10,True
4073736,1162,2,25,3397,685003976,1,0,0,871.02,8,128514.11,24,2,17,10,True
4187381,841,1,451,4480,685003976,1,0,0,871.01,7,127643.1,5,4,1,10,True
4219271,177,4,451,1086,685003976,1,0,0,871.21,7,126771.89,24,0,11,11,True
4324396,1468,1,30,1086,685003976,1,0,0,870.7,8,125901.19,11,6,10,1,True
4695008,1463,2,25,3397,685003976,1,0,0,870.82,8,125030.37,11,4,23,1,True
4790904,177,4,25,8522,685003976,1,0,0,870.8,8,124159.57,24,0,18,1,True
4967687,1463,2,451,8689,685003976,1,0,0,871.07,7,123288.5,11,6,16,2,True
5035443,1162,2,30,4563,685003976,1,0,0,870.78,8,122417.72,24,6,7,3,True
5302617,841,1,451,2794,685003976,1,0,0,871.1,7,121546.62,5,6,9,4,True
5372642,177,4,25,8434,685003976,1,0,0,870.87,8,120675.75,24,4,22,4,True
5620716,1315,0,10,8522,685003976,1,0,0,871.12,6,121546.87,5,4,9,5,True
5856597,1468,1,25,5786,685003976,1,0,0,870.92,8,120675.95,11,2,3,7,True
6189130,1468,1,25,3397,685003976,1,0,0,871.02,8,119804.93,11,5,12,7,True
6225336,1162,2,451,1599,685003976,1,0,0,870.88,7,118934.05,24,3,0,7,True
6468944,429,0,20,8689,685003976,1,0,0,871.01,3,118063.04,24,5,4,8,True
6538335,952,0,20,1012,685003976,1,0,0,871.0,5,117192.04,13,4,2,8,True
6615988,1255,0,10,5400,685003976,1,0,0,870.93,6,118062.97,23,6,22,8,True
7077203,1463,2,451,1599,685003976,1,0,0,870.9,7,117192.07,11,0,20,8,True
7101666,1162,2,30,9244,685003976,1,0,0,870.86,8,116321.21,24,3,12,8,True
7536564,1007,2,20,5086,685003976,1,0,0,871.28,3,115449.93,26,0,22,9,True
7617803,1363,0,20,2794,685003976,1,0,0,870.77,3,114579.16,16,6,18,11,True
7709257,887,2,25,5490,685003976,1,0,0,871.15,8,113708.01,27,6,9,1,True
7942842,1463,2,30,3397,685003976,1,0,0,870.96,8,112837.05,11,5,1,1,True
8212496,71,1,10,3397,685003976,1,0,0,870.76,0,113707.81,20,0,5,2,True
8935173,887,2,30,1599,685003976,1,0,0,870.91,8,112836.9,27,3,0,3,True
8959137,1468,1,451,6517,685003976,1,0,0,871.02,7,111965.88,11,3,2,3,True
9229397,1162,2,-1,6517,685003976,1,1,0,871.31,4,111965.88,24,6,23,3,True
9317079,1483,0,10,8434,685003976,1,0,0,870.8,6,112836.68,24,0,17,3,True
9448909,1162,2,-1,1034,685003976,1,1,0,871.17,1,112836.68,24,6,0,6,True
9509066,1162,2,25,5400,685003976,1,0,0,871.12,8,111965.56,24,3,23,8,True
9525136,1110,0,20,3330,685003976,1,0,0,871.21,3,111094.35,0,0,6,9,True
9760177,887,2,25,1599,685003976,1,0,0,870.9,8,110223.45,27,3,1,11,True
9895225,841,1,451,4480,685003976,1,0,0,870.98,7,109352.47,5,1,6,11,True
1267650,20,0,30,3263,120653269,0,0,0,170.05,8,812143.95,24,3,20,2,True
1283650,656,2,20,3263,120653269,0,0,0,170.07,3,811973.88,18,0,15,2,True
1346023,147,0,20,3701,120653269,0,0,0,169.91,5,811803.97,18,3,21,2,True
1462495,1226,2,20,4833,120653269,0,0,0,169.67,3,811634.3,18,0,6,4,True
1550606,589,1,10,9609,120653269,0,0,0,170.26,0,811804.56,24,2,21,4,True
2119445,20,0,30,1078,120653269,0,0,0,169.94,8,811634.62,24,3,9,5,True
2319656,633,4,25,3626,120653269,0,0,0,169.93,8,811464.69,11,2,7,6,True
2337049,982,4,451,9609,120653269,0,0,0,170.15,7,811294.54,22,1,13,7,True
2736498,1125,1,10,1310,120653269,0,0,0,169.86,6,811464.4,24,0,2,8,True
3138340,1082,3,30,1126,120653269,0,0,0,169.73,8,811294.67,18,6,13,9,True
3422002,20,0,25,6540,120653269,0,0,0,170.03,8,811124.64,24,2,7,10,True
3672672,1082,3,451,6449,120653269,0,0,0,169.89,7,810954.75,18,3,10,10,True
3892774,314,0,10,3414,120653269,0,0,0,169.85,6,811124.6,4,3,20,10,True
3976559,832,3,451,3701,120653269,0,0,0,170.41,7,810954.19,5,3,7,11,True
4013773,20,0,25,6449,120653269,0,0,0,170.03,8,810784.16,24,6,0,12,True
4067866,633,4,30,5223,120653269,0,0,0,170.02,8,810614.14,11,4,15,2,True
4273745,982,4,25,3626,120653269,0,0,0,169.81,8,810444.33,22,4,16,3,True
4305643,20,0,-1,3263,120653269,0,1,0,170.3,1,810444.33,24,1,23,4,True
4532027,633,4,25,9357,120653269,0,0,0,169.9,8,810274.43,11,4,19,4,True
4615246,832,3,-1,9609,120653269,0,1,0,170.08,1,810274.43,5,3,3,5,True
4633088,1140,0,20,1078,120653269,0,0,0,170.02,5,810104.41,15,4,17,6,True
4806295,1082,3,451,9609,120653269,0,0,0,170.4,7,809934.01,18,4,8,8,True
4856508,509,0,451,1509,120653269,0,0,0,169.95,7,809764.06,12,1,4,8,True
5129703,644,0,20,1126,120653269,0,0,0,169.97,3,809594.09,24,0,9,9,True
5277646,1082,3,-1,6768,120653269,0,1,0,169.98,4,809594.09,18,4,20,10,True
5417175,982,4,30,2558,120653269,0,0,0,169.81,8,809424.28,22,5,5,11,True
5554070,509,0,451,6540,120653269,0,0,0,169.89,7,809254.39,12,2,0,11,True
5890374,1082,3,25,2167,120653269,0,0,0,170.02,8,809084.37,18,6,11,12,True
6101440,1082,3,451,3701,120653269,0,0,0,170.12,7,808914.25,18,6,14,1,True
6139397,832,3,-1,1806,120653269,0,1,0,169.97,1,808914.25,5,3,15,2,True
6590770,580,0,10,6449,120653269,0,0,0,170.16,0,809084.41,11,3,23,2,False
6622353,509,0,25,4149,120653269,0,0,0,170.03,8,808914.38,12,4,5,2,True
7029901,982,4,451,1710,120653269,0,0,0,169.65,7,808744.73,22,1,9,2,True
7047846,1399,0,10,2724,120653269,0,0,0,170.04,6,808914.77,24,1,14,3,True
7071349,633,4,-1,2724,120653269,0,1,0,170.45,4,808914.77,11,0,20,4,True
7126749,982,4,-1,3414,120653269,0,2,0,169.95,4,808914.77,22,1,17,5,True
7168743,882,0,20,1633,120653269,0,0,0,169.75,5,808745.02,27,4,11,6,True
7221276,20,0,25,1806,120653269,0,0,0,170.18,8,808574.84,24,5,23,6,False
7286561,832,3,25,9609,120653269,0,0,0,169.96,8,808404.88,5,2,15,6,True
7324846,20,0,30,1126,120653269,0,0,0,169.99,8,808234.89,24,3,10,7,True
7375351,633,4,30,1710,120653269,0,0,0,170.1,8,808064.79,11,5,8,7,True
7674545,509,0,25,3414,120653269,0,0,0,170.04,8,807894.75,12,1,15,7,True
7881199,832,3,30,3701,120653269,0,0,0,170.05,8,807724.7,5,4,0,8,True
7890195,1082,3,30,6449,120653269,0,0,0,170.1,8,807554.6,18,4,16,8,True
8174730,865,0,20,4149,120653269,0,0,0,169.76,5,807384.84,24,5,9,9,True
8243300,96,0,20,3701,120653269,0,0,0,169.87,5,807214.97,1,6,7,9,True
8329606,633,4,451,2167,120653269,0,0,0,169.95,7,807045.02,11,1,12,10,True
8942316,982,4,30,2724,120653269,0,0,0,169.92,8,806875.1,22,2,18,10,True
8959491,1246,0,20,2558,120653269,0,0,0,169.97,3,806705.13,23,3,0,10,True
9205729,1460,2,20,3263,120653269,0,0,0,169.91,5,806535.22,11,5,2,10,True
9312314,633,4,-1,1126,120653269,0,1,0,170.09,1,806535.22,11,5,16,10,True
9541673,633,4,30,1126,120653269,0,0,0,169.91,8,806365.31,11,6,21,10,True
9734199,832,3,25,3685,120653269,0,0,0,170.22,8,806195.09,5,4,1,11,True
1202486,950,0,20,2251,315250952,0,0,0,742.17,5,936475.83,24,1,22,1,True
1330682,734,0,30,9271,315250952,0,0,0,742.31,8,935733.52,11,0,6,2,True
1434914,438,1,451,8952,315250952,0,0,0,741.82,7,934991.7,24,4,6,2,True
1679602,924,4,25,6665,315250952,0,0,0,742.12,8,934249.58,18,2,7,2,True
1743433,518,2,451,1448,315250952,0,0,0,742.09,7,933507.49,18,4,10,3,True
1831180,438,1,25,6917,315250952,0,0,0,741.79,8,932765.7,24,0,20,3,True
1849893,1422,1,10,3140,315250952,0,0,0,741.85,6,933507.55,24,2,5,4,True
2067081,1315,0,20,1448,315250952,0,0,0,741.81,5,932765.74,5,6,0,4,True
2611050,284,3,30,2492,315250952,0,0,0,742.37,8,932023.37,24,3,17,5,True
2779775,518,2,25,1448,315250952,0,0,0,742.01,8,931281.36,18,4,23,5,True
2866961,518,2,451,1448,315250952,0,0,0,741.99,7,930539.37,18,0,12,6,True
2983551,1027,0,20,2593,315250952,0,0,0,742.03,5,929797.34,11,0,22,7,True
3160830,924,4,30,1536,315250952,0,0,0,741.96,8,929055.38,18,1,2,8,True
3524491,1421,0,10,1448,315250952,0,0,0,742.07,6,929797.45,24,6,17,8,True
3580084,734,0,-1,8155,315250952,0,1,0,741.96,4,929797.45,11,2,5,8,True
3893299,704,3,25,2492,315250952,0,0,0,742.25,8,929055.2,18,3,11,9,True
3908181,502,0,20,9265,315250952,0,0,0,742.2,5,928313.0,12,1,14,11,True
3915437,734,0,30,8892,315250952,0,0,0,741.94,8,927571.06,11,0,7,11,True
4011193,704,3,25,2492,315250952,0,0,0,742.11,8,926828.95,18,1,10,11,True
4441753,979,0,10,2593,315250952,0,0,0,741.91,6,927570.86,22,1,11,12,True
4450280,76,0,10,6917,315250952,0,0,0,742.06,6,928312.92,20,1,0,12,True
4498740,438,1,-1,3140,315250952,0,1,0,742.1,1,928312.92,24,2,13,12,True
4559290,734,0,25,2593,315250952,0,0,0,742.11,8,927570.81,11,3,12,1,True
4903848,1425,0,10,2492,315250952,0,0,0,742.01,6,928312.82,24,0,1,3,True
5317000,887,2,20,8155,315250952,0,0,0,742.12,5,927570.7,27,6,21,3,True
5380197,1009,0,10,2693,315250952,0,0,0,741.98,6,928312.68,26,3,7,6,True
5383342,502,0,10,3140,315250952,0,0,0,742.05,6,929054.73,12,4,17,6,True
5458250,498,0,20,2593,315250952,0,0,0,741.98,5,928312.75,12,6,6,6,True
5586025,1264,0,20,9271,315250952,0,0,0,741.93,3,927570.82,23,2,21,7,True
5719403,284,3,30,1536,315250952,0,0,0,741.97,8,926828.85,24,5,12,7,True
5725918,734,0,25,6498,315250952,0,0,0,742.06,8,926086.79,11,4,9,8,True
6386969,284,3,30,6665,315250952,0,0,0,741.99,8,925344.8,24,2,1,9,True
6873158,511,1,10,2492,315250952,0,0,0,741.96,6,926086.76,12,6,1,9,True
6877344,734,0,451,2693,315250952,0,0,0,741.89,7,925344.87,11,3,11,11,False
6903473,734,0,30,2492,315250952,0,0,0,742.13,8,924602.74,11,4,5,12,True
6944206,704,3,30,2693,315250952,0,0,0,742.22,8,923860.52,18,4,13,12,False
6966539,734,0,451,2492,315250952,0,0,0,741.75,7,923118.77,11,6,16,12,True
6971803,1019,0,20,3140,315250952,0,0,0,741.94,3,922376.83,26,0,15,1,True
7097636,1116,0,10,2251,315250952,0,0,0,742.17,6,923119.0,24,2,4,2,True
7245761,1159,0,20,9271,315250952,0,0,0,741.98,5,922377.02,15,2,2,3,True
7250729,438,1,451,1448,315250952,0,0,0,742.14,7,921634.88,24,5,14,3,True
7271991,284,3,451,5901,315250952,0,0,0,741.94,7,920892.94,24,1,16,4,True
7525990,924,4,451,2593,315250952,0,0,0,741.82,7,920151.12,18,1,10,4,True
7584966,29,0,10,9265,315250952,0,0,0,741.85,6,920892.97,11,5,14,4,True
7648225,924,4,25,6917,315250952,0,0,0,741.75,8,920151.22,18,4,1,5,True
8015066,438,1,25,2693,315250952,0,0,0,742.13,8,919409.09,24,5,13,6,True
8245775,734,0,451,8952,315250952,0,0,0,741.92,7,918667.17,11,1,4,6,True
8619370,734,0,451,1536,315250952,0,0,0,742.1,7,917925.07,11,2,18,6,True
8853732,438,1,-1,1448,315250952,0,1,0,741.79,4,917925.07,24,3,4,6,True
8994094,704,3,451,6498,315250952,0,0,0,742.22,7,917182.85,18,3,15,6,True
9023795,438,1,-1,2492,315250952,0,1,0,741.98,4,917182.85,24,4,1,7,True
9081382,734,0,25,2492,315250952,0,0,0,741.92,8,916440.93,11,1,9,7,True
9376232,734,0,25,6498,315250952,0,0,0,741.71,8,915699.22,11,4,19,8,True
9441479,284,3,25,6498,315250952,0,0,0,742.15,8,914957.07,24,2,10,9,True
9524832,518,2,25,8952,315250952,0,0,0,741.89,8,914215.18,18,5,7,9,True
9568325,924,4,451,4523,315250952,0,0,0,741.91,7,913473.27,18,5,8,10,True
9655949,729,0,20,2593,315250952,0,0,0,741.97,5,912731.3,11,6,20,11,True
9973010,924,4,451,2693,315250952,0,0,0,742.17,7,911989.13,18,6,14,11,True
1005702,614,4,30,5845,208889256,0,0,0,1047.9,8,996097.1,11,1,5,1,False
1093464,227,4,451,2171,208889256,0,0,0,1048.12,7,995048.98,26,6,18,1,True
1261885,227,4,451,4631,208889256,0,0,0,1047.94,7,994001.04,26,3,15,3,True
1278139,614,4,25,8590,208889256,0,0,0,1048.05,8,992952.99,11,3,17,3,True
1324472,579,0,20,8280,208889256,0,0,0,1048.2,3,991904.79,11,6,22,3,True
1499023,616,1,10,6553,208889256,0,0,0,1048.02,6,992952.81,11,6,20,3,True
1844259,580,0,25,5845,208889256,0,0,0,1047.79,8,991905.02,11,0,8,3,True
2621430,1111,0,451,2350,208889256,0,0,0,1047.83,7,990857.19,0,1,20,3,True
2963222,30,4,451,8536,208889256,0,0,0,1048.16,7,989809.03,11,1,21,3,True
3647507,30,4,451,6902,208889256,0,0,0,1047.98,7,988761.05,11,6,12,4,True
4029290,1393,3,451,2126,208889256,0,0,0,1048.2,7,987712.85,24,0,2,5,True
4031088,110,4,-1,8280,208889256,0,1,0,1047.88,4,987712.85,3,1,7,5,True
4154824,110,4,30,8536,208889256,0,0,0,1047.91,8,986664.94,3,6,17,6,True
4168182,757,0,10,8536,208889256,0,0,0,1047.95,6,987712.89,24,2,20,6,True
4818919,580,0,451,1680,208889256,0,0,0,1047.82,7,986665.07,11,1,16,7,True
4965019,580,0,25,5845,208889256,0,0,0,1048.04,8,985617.03,11,4,5,8,True
5015988,1377,0,20,8590,208889256,0,0,0,1047.96,5,984569.07,16,6,0,9,True
5149011,523,2,30,6553,208889256,0,0,0,1048.06,8,983521.01,18,3,16,9,True
5292443,1142,2,20,8118,208889256,0,0,0,1048.13,3,982472.88,15,6,6,10,True
5397107,523,2,-1,8280,208889256,0,1,0,1048.09,4,982472.88,18,4,10,11,True
5402685,350,0,20,5845,208889256,0,0,0,1048.12,5,981424.76,24,1,22,11,True
5626232,780,0,20,5845,208889256,0,0,0,1047.87,5,980376.89,14,2,0,1,True
5685840,110,4,30,3608,208889256,0,0,0,1047.96,8,979328.93,3,3,3,1,True
5709850,580,0,451,3608,208889256,0,0,0,1048.15,7,978280.78,11,3,6,1,True
6050002,297,0,20,2397,208889256,0,0,0,1047.84,5,977232.94,4,2,10,5,True
6383204,1069,1,10,2312,208889256,0,0,0,1048.17,6,978281.11,18,1,12,6,True
6517321,960,3,451,6902,208889256,0,0,0,1047.9,7,977233.21,13,6,7,7,True
6672414,30,4,451,2664,208889256,0,0,0,1047.61,7,976185.6,11,0,23,7,True
6706790,227,4,30,2126,208889256,0,0,0,1047.99,8,975137.61,26,4,1,7,True
6720004,689,0,10,2171,208889256,0,0,0,1048.34,6,976185.95,24,3,9,8,True
6742038,1303,0,10,4631,208889256,0,0,0,1048.14,6,977234.09,5,5,17,8,True
6777541,1111,0,-1,2350,208889256,0,1,0,1047.86,1,977234.09,0,2,0,11,True
6871952,580,0,25,2350,208889256,0,0,0,1047.84,8,976186.25,11,0,19,11,True
6957736,523,2,451,4631,208889256,0,0,0,1048.11,7,975138.14,18,3,16,1,True
7248431,1035,0,10,2397,208889256,0,0,0,1048.04,6,976186.18,11,2,6,1,True
7405118,227,4,25,6642,208889256,0,0,0,1047.94,8,975138.24,26,1,19,1,True
7419127,227,4,25,8118,208889256,0,0,0,1048.18,8,974090.06,26,1,20,2,True
7566940,30,4,30,1680,208889256,0,0,0,1047.95,8,973042.11,11,6,13,3,True
7623506,30,4,451,2126,208889256,0,0,0,1048.24,7,971993.87,11,3,3,4,False
7876222,688,0,10,4631,208889256,0,0,0,1047.94,0,973041.81,24,0,17,4,True
7903161,1393,3,451,2126,208889256,0,0,0,1047.94,7,971993.87,24,6,11,4,True
8175611,580,0,451,2126,208889256,0,0,0,1047.98,7,970945.89,11,5,21,4,True
8199827,227,4,451,8280,208889256,0,0,0,1048.11,7,969897.78,26,2,13,5,True
8359810,110,4,30,2178,208889256,0,0,0,1047.99,8,968849.79,3,1,13,6,True
8477519,799,2,20,8118,208889256,0,0,0,1048.04,3,967801.75,11,4,10,7,True
8605667,960,3,30,1680,208889256,0,0,0,1048.14,8,966753.61,13,3,13,8,True
8888255,673,0,10,2664,208889256,0,0,0,1047.95,6,967801.56,18,0,13,8,True
9016094,292,1,10,4631,208889256,0,0,0,1048.09,6,968849.65,4,0,8,8,True
9048014,227,4,25,2171,208889256,0,0,0,1047.93,8,967801.72,26,6,18,9,True
9357282,1111,0,-1,8118,208889256,0,1,0,1048.0,1,967801.72,0,3,23,10,True
9362320,110,4,25,4631,208889256,0,0,0,1047.93,8,966753.79,3,0,16,11,True
9475133,993,0,10,2178,208889256,0,0,0,1047.75,6,967801.54,22,1,10,11,True
9893666,1454,1,10,5845,208889256,0,0,0,1047.97,6,968849.51,11,2,11,11,True
1123872,911,3,30,6590,467092648,0,0,0,348.08,8,854162.92,18,4,1,1,True
1166797,268,2,20,9464,467092648,0,0,0,348.03,3,853814.89,24,4,11,2,True
1284107,1121,3,-1,5761,467092648,0,1,0,347.84,1,853814.89,24,4,12,2,True
1744831,1195,1,10,4892,467092648,0,0,0,347.9,6,854162.79,24,6,23,2,True
2043895,1353,4,451,7667,467092648,0,0,0,348.32,7,853814.47,24,4,17,3,True
2119163,1121,3,30,5504,467092648,0,0,0,348.28,8,853466.19,24,4,2,3,True
2314608,997,3,25,7667,467092648,0,0,0,348.02,8,853118.17,26,4,21,3,False
2344064,1353,4,30,8279,467092648,0,0,0,347.87,8,852770.3,24,4,17,4,True
2419561,688,0,10,4887,467092648,0,0,0,347.86,6,853118.16,24,1,0,5,True
2806808,1353,4,30,4161,467092648,0,0,0,347.64,8,852770.52,24,2,23,5,True
2953786,649,0,10,5761,467092648,0,0,0,347.9,6,853118.42,24,2,9,6,True
2985195,911,3,30,4892,467092648,0,0,0,348.22,8,852770.2,18,2,10,6,True
3302855,997,3,25,9427,467092648,0,0,0,347.79,8,852422.41,26,2,4,8,True
3505194,151,4,451,3266,467092648,0,0,0,348.05,7,852074.36,18,5,20,9,True
3944112,1353,4,30,9854,467092648,0,0,0,347.85,8,851726.51,24,0,18,9,True
4737702,939,0,20,8363,467092648,0,0,0,347.61,5,851378.9,24,3,20,9,True
4863631,911,3,451,4207,467092648,0,0,0,347.85,7,851031.05,18,5,5,10,True
5097144,573,0,10,4161,467092648,0,0,0,348.15,6,851379.2,11,2,8,10,True
5198082,997,3,-1,8939,467092648,0,1,0,348.15,4,851379.2,26,2,23,10,True
5287962,226,4,451,5761,467092648,0,0,0,347.72,7,851031.48,26,4,19,11,True
5444072,1124,0,10,4301,467092648,0,0,0,347.76,6,851379.24,24,4,4,12,True
5643284,1410,1,10,4887,467092648,0,0,0,348.08,6,851727.32,24,5,11,1,True
5693336,701,2,-1,4301,467092648,0,1,0,347.96,4,851727.32,18,1,19,1,True
6093578,911,3,-1,4301,467092648,0,2,0,347.83,4,851727.32,18,4,0,3,True
6134209,226,4,30,5761,467092648,0,0,0,347.73,8,851379.59,26,6,18,3,True
6399071,1121,3,30,7244,467092648,0,0,0,348.12,8,851031.47,24,3,20,3,True
6573717,997,3,-1,4161,467092648,0,1,0,347.75,4,851031.47,26,3,23,5,True
6656484,1121,3,30,6109,467092648,0,0,0,347.75,8,850683.72,24,1,15,6,True
6737476,911,3,451,9829,467092648,0,0,0,348.07,7,850335.65,18,1,20,7,True
6847781,350,0,20,5504,467092648,0,0,0,347.96,3,849987.69,24,3,7,7,True
6913420,226,4,-1,5504,467092648,0,1,0,348.05,4,849987.69,26,5,6,8,True
7034906,911,3,25,9829,467092648,0,0,0,348.07,8,849639.62,18,0,9,9,True
7063800,275,0,20,7244,467092648,0,0,0,347.87,5,849291.75,24,3,17,11,True
7237193,1121,3,30,9464,467092648,0,0,0,347.83,8,848943.92,24,3,17,1,True
7240348,1380,0,20,4892,467092648,0,0,0,348.11,5,848595.81,16,3,3,1,True
7253448,628,0,10,7667,467092648,0,0,0,348.04,6,848943.85,11,6,3,1,True
7316697,1353,4,30,7244,467092648,0,0,0,348.31,8,848595.54,24,3,14,2,True
7342219,732,0,10,3266,467092648,0,0,0,348.0,0,848943.54,11,6,7,3,True
7643307,728,1,10,2854,467092648,0,0,0,347.86,0,849291.4,11,4,17,3,True
8269872,911,3,451,3796,467092648,0,0,0,347.96,7,848943.44,18,1,16,3,True
8341435,1116,0,10,4887,467092648,0,0,0,348.08,6,849291.52,24,1,0,5,True
8502176,1382,0,10,8939,467092648,0,0,0,347.98,6,849639.5,16,1,17,7,True
8786386,1353,4,30,3266,467092648,0,0,0,348.12,8,849291.38,24,2,21,7,True
8866132,1035,0,20,9829,467092648,0,0,0,347.98,3,848943.4,11,2,23,8,True
8939607,701,2,30,9464,467092648,0,0,0,348.42,8,848594.98,18,1,22,9,True
9401639,863,4,25,4207,467092648,0,0,0,347.87,8,848247.11,24,0,18,9,True
9416177,226,4,-1,9829,467092648,0,1,0,347.76,4,848247.11,26,3,18,10,True
9568735,1041,0,10,4207,467092648,0,0,0,347.73,6,848594.84,11,6,15,10,True
9918259,911,3,451,9332,467092648,0,0,0,348.11,7,848246.73,18,4,22,11,True
9979902,716,0,10,4301,467092648,0,0,0,348.01,0,848594.74,18,3,6,11,True
1055043,1240,4,-1,4848,624970335,1,1,0,1023.02,1,387156.0,18,6,20,1,True
1252730,1449,0,451,8707,624970335,1,0,0,1023.28,7,386132.72,11,1,13,1,True
1325348,251,4,-1,1818,624970335,1,1,0,1023.09,4,386132.72,6,5,7,2,True
1348536,1240,4,30,5925,624970335,1,0,0,1023.02,8,385109.7,18,2,16,3,True
1703748,1305,2,30,6167,624970335,1,0,0,1023.07,8,384086.63,5,1,17,4,True
1861321,1240,4,451,5671,624970335,1,0,0,1022.93,7,383063.7,18,4,5,5,False
2003782,1385,4,451,9793,624970335,1,0,0,1022.79,7,382040.91,24,3,9,5,True
2111515,1449,0,-1,1419,624970335,1,1,0,1022.99,4,382040.91,11,4,23,6,True
2172470,448,0,20,8265,624970335,1,0,0,1022.92,5,381017.99,13,6,9,7,True
2346123,404,1,10,9793,624970335,1,0,0,1022.95,6,382040.94,10,1,19,8,True
2393002,127,1,10,3352,624970335,1,0,0,1022.95,6,383063.89,18,5,13,9,True
2462177,1305,2,30,9109,624970335,1,0,0,1022.99,8,382040.9,5,0,13,9,True
2676015,1281,3,-1,3299,624970335,1,1,0,1023.0,4,382040.9,24,2,0,9,True
2687592,1240,4,30,1419,624970335,1,0,0,1022.99,8,381017.91,18,6,9,10,True
2888345,25,3,25,7898,624970335,1,0,0,1022.83,8,379995.08,11,5,19,10,True
3180776,584,0,10,7898,624970335,1,0,0,1022.89,6,381017.97,11,1,17,11,True
3279591,1380,0,20,9109,624970335,1,0,0,1023.13,5,379994.84,16,5,17,11,True
3475022,1039,1,10,5671,624970335,1,0,0,1022.97,6,381017.81,11,6,8,11,True
3818758,1305,2,-1,4542,624970335,1,1,0,1022.98,4,381017.81,5,5,0,11,True
3822456,1281,3,30,6428,624970335,1,0,0,1022.93,8,379994.88,24,0,1,12,True
4087540,51,0,20,8707,624970335,1,0,0,1023.02,5,378971.86,20,6,16,1,True
4138262,1385,4,451,7763,624970335,1,0,0,1023.25,7,377948.61,24,2,19,3,True
4284086,25,3,30,7763,624970335,1,0,0,1023.03,8,376925.58,11,6,6,3,True
4493957,251,4,25,9793,624970335,1,0,0,1022.95,8,375902.63,6,3,2,3,True
4668821,1449,0,25,1067,624970335,1,0,0,1022.92,8,374879.71,11,0,0,4,True
5014474,806,1,10,1818,624970335,1,0,0,1022.77,6,375902.48,11,1,10,4,True
5472181,1305,2,-1,1419,624970335,1,1,0,1022.92,4,375902.48,5,5,14,5,True
5502356,1443,4,451,6428,624970335,1,0,0,1022.92,7,374879.56,24,5,23,6,True
5567205,1305,2,-1,2684,624970335,1,1,0,1023.15,1,374879.56,5,5,16,7,True
5929573,752,0,10,2684,624970335,1,0,0,1023.07,6,375902.63,24,2,13,8,True
6293703,1354,0,20,1419,624970335,1,0,0,1022.6,3,374880.03,24,3,17,8,True
6414923,253,2,20,6167,624970335,1,0,0,1022.79,3,373857.24,6,4,4,8,True
6596008,677,0,10,6428,624970335,1,0,0,1022.83,0,374880.07,24,1,2,9,True
6767401,1305,2,25,6167,624970335,1,0,0,1023.05,8,373857.02,5,5,7,9,True
7095668,25,3,30,5671,624970335,1,0,0,1023.09,8,372833.93,11,0,8,10,True
7375343,869,2,20,6428,624970335,1,0,0,1022.81,5,371811.12,24,6,0,10,False
7542513,25,3,30,2836,624970335,1,0,0,1022.86,8,370788.26,11,0,1,10,False
7586730,251,4,-1,2684,624970335,1,1,0,1023.37,1,370788.26,6,0,16,10,True
7641629,251,4,25,8707,624970335,1,0,0,1023.23,8,369765.03,6,4,8,11,True
7799252,1305,2,30,2684,624970335,1,0,0,1023.0,8,368742.03,5,6,3,12,True
8069959,1385,4,451,1067,624970335,1,0,0,1022.83,7,367719.2,24,4,15,2,True
8282980,1116,0,20,1419,624970335,1,0,0,1022.77,3,366696.43,24,6,13,3,True
8569139,1449,0,-1,6167,624970335,1,1,0,1022.99,1,366696.43,11,4,11,3,True
8809902,1443,4,25,8591,624970335,1,0,0,1023.17,8,365673.26,24,5,22,3,True
8883197,1305,2,30,9793,624970335,1,0,0,1023.01,8,364650.25,5,2,11,4,True
8965569,251,4,451,4542,624970335,1,0,0,1023.01,7,363627.24,6,6,14,7,True
9107378,1305,2,-1,7898,624970335,1,1,0,1023.03,4,363627.24,5,5,9,8,True
9677634,1240,4,30,9793,624970335,1,0,0,1022.9,8,362604.34,18,5,13,8,True
9738039,1305,2,30,7763,624970335,1,0,0,1023.01,8,361581.33,5,5,9,9,True
9818727,1305,2,25,7738,624970335,1,0,0,1023.13,8,360558.2,5,5,16,10,True
9940071,268,2,20,8265,624970335,1,0,0,1022.85,5,359535.35,24,2,23,11,True
1236225,1256,2,20,8050,298056410,0,0,0,1007.99,5,562765.01,23,2,23,2,True
1391295,1039,1,10,2101,298056410,0,0,0,1007.83,6,563772.84,11,1,10,4,True
1435543,325,0,451,5362,298056410,0,0,0,1007.78,7,562765.06,11,0,8,6,True
1711399,824,2,20,6359,298056410,0,0,0,1008.17,5,561756.89,18,3,12,6,True
2128202,620,3,451,5692,298056410,0,0,0,1008.11,7,560748.78,11,2,14,8,True
2191987,1351,4,25,1672,298056410,0,0,0,1007.96,8,559740.82,24,2,11,9,True
2219293,325,0,451,5362,298056410,0,0,0,1007.81,7,558733.01,11,4,23,9,True
2402294,1449,0,20,3078,298056410,0,0,0,1008.12,5,557724.89,11,2,7,10,True
2644736,1140,0,451,8508,298056410,0,0,0,1007.86,7,556717.03,15,0,2,10,False
2971589,800,0,10,3672,298056410,0,0,0,1008.02,6,557725.05,11,5,18,11,True
3261064,583,2,20,2988,298056410,0,0,0,1008.03,5,556717.02,11,1,18,11,True
3337130,1140,0,451,4143,298056410,0,0,0,1007.71,7,555709.31,15,1,0,12,True
3348687,928,3,25,6359,298056410,0,0,0,1008.16,8,554701.15,18,6,16,1,False
3367384,979,0,10,1889,298056410,0,0,0,1008.18,6,555709.33,22,0,22,1,True
3651651,82,4,-1,2101,298056410,0,1,0,1008.09,1,555709.33,1,4,6,1,True
3914252,1140,0,451,3696,298056410,0,0,0,1008.02,7,554701.31,15,0,6,2,True
4236455,1148,4,451,6684,298056410,0,0,0,1008.04,7,553693.27,15,4,23,2,True
4509788,620,3,451,3696,298056410,0,0,0,1007.92,7,552685.35,11,3,3,3,True
4673006,712,0,10,7548,298056410,0,0,0,1007.83,0,553693.18,18,4,23,3,False
5043891,325,0,451,1672,298056410,0,0,0,1008.19,7,552684.99,11,5,20,3,True
5158412,1255,0,10,5618,298056410,0,0,0,1008.17,6,553693.16,23,4,20,4,True
5260915,182,1,10,1693,298056410,0,0,0,1008.01,0,554701.17,18,4,9,5,True
5437576,1140,0,30,6613,298056410,0,0,0,1007.78,8,553693.39,15,1,11,5,True
5465535,714,2,20,5362,298056410,0,0,0,1008.06,3,552685.33,18,2,7,5,True
5544200,1169,0,20,6684,298056410,0,0,0,1008.18,5,551677.15,24,2,20,5,True
5738273,1117,4,30,1565,298056410,0,0,0,1007.86,8,550669.29,24,2,22,5,True
5914400,82,4,451,3078,298056410,0,0,0,1007.97,7,549661.32,1,5,2,5,True
6004814,179,4,-1,3672,298056410,0,1,0,1008.07,4,549661.32,24,3,13,6,True
6037419,883,0,20,4090,298056410,0,0,0,1007.55,5,548653.77,24,6,2,6,True
6043875,928,3,30,6613,298056410,0,0,0,1008.05,8,547645.72,18,1,19,7,True
6402165,1170,0,10,6613,298056410,0,0,0,1007.97,6,548653.69,24,4,15,8,True
6420780,82,4,25,4143,298056410,0,0,0,1008.14,8,547645.55,1,5,23,8,True
6915768,1351,4,25,5618,298056410,0,0,0,1008.06,8,546637.49,24,1,23,8,True
7085905,1140,0,451,8528,298056410,0,0,0,1007.8,7,545629.69,15,6,12,9,True
7323255,82,4,30,5618,298056410,0,0,0,1008.06,8,544621.63,1,6,8,10,True
7491960,928,3,451,6613,298056410,0,0,0,1008.26,7,543613.37,18,6,22,10,True
8200362,1140,0,451,3078,298056410,0,0,0,1007.81,7,542605.56,15,2,2,10,True
8228979,366,0,20,7548,298056410,0,0,0,1008.1,5,541597.46,25,2,16,10,True
8524693,1148,4,30,1565,298056410,0,0,0,1007.96,8,540589.5,15,2,4,11,True
8684355,626,2,20,1693,298056410,0,0,0,1007.92,5,539581.58,11,1,11,11,True
8698091,325,0,451,5692,298056410,0,0,0,1008.27,7,538573.31,11,0,13,1,True
8740218,1140,0,30,8566,298056410,0,0,0,1008.08,8,537565.23,15,0,2,1,True
8927948,59,0,20,7548,298056410,0,0,0,1008.12,5,536557.11,20,5,9,3,True
8951057,1140,0,25,7158,298056410,0,0,0,1008.09,8,535549.02,15,5,20,5,True
8952552,1148,4,25,3672,298056410,0,0,0,1007.96,8,534541.06,15,2,0,5,True
9060901,1351,4,-1,4090,298056410,0,1,0,1007.91,4,534541.06,24,1,10,5,True
9135258,325,0,451,8528,298056410,0,0,0,1008.04,7,533533.02,11,5,7,6,True
9189698,1354,0,10,1693,298056410,0,0,0,1008.06,0,534541.08,24,3,11,7,True
9246800,346,0,10,1693,298056410,0,0,0,1008.06,0,535549.14,24,2,13,7,True
9415219,931,0,10,5618,298056410,0,0,0,1007.88,6,536557.02,24,0,15,8,True
9527343,579,0,10,3078,298056410,0,0,0,1007.9,6,537564.92,11,0,11,8,True
9701441,1117,4,451,3672,298056410,0,0,0,1008.11,7,536556.81,24,0,13,10,True
9896987,1351,4,-1,1117,298056410,0,1,0,1008.05,4,536556.81,24,3,19,10,True
9970392,1148,4,451,6613,298056410,0,0,0,1008.08,7,535548.73,15,2,8,10,True
1229746,1465,4,30,6267,189717612,1,0,0,190.81,8,899911.19,11,2,21,1,True
1268285,297,0,451,7948,189717612,1,0,0,190.86,7,899720.33,4,5,9,1,True
1446633,799,2,451,7948,189717612,1,0,0,191.07,7,899529.26,11,6,18,1,True
1579856,799,2,451,1628,189717612,1,0,0,190.8,7,899338.46,11,1,6,2,True
1686217,1425,0,10,7285,189717612,1,0,0,190.86,6,899529.32,24,2,10,2,True
1898259,1279,4,30,4721,189717612,1,0,0,190.98,8,899338.34,24,3,8,3,True
1904699,1279,4,-1,4721,189717612,1,1,0,191.04,4,899338.34,24,4,18,5,True
2061565,799,2,25,1143,189717612,1,0,0,190.88,8,899147.46,11,5,11,6,True
2160629,1465,4,451,1143,189717612,1,0,0,191.03,7,898956.43,11,5,17,6,True
2212362,866,0,20,9626,189717612,1,0,0,190.73,5,898765.7,24,0,11,6,True
2244693,1465,4,25,3662,189717612,1,0,0,190.96,8,898574.74,11,2,11,7,False
2285989,1465,4,451,7764,189717612,1,0,0,191.11,7,898383.63,11,3,11,7,True
2320958,802,2,451,1143,189717612,1,0,0,191.06,7,898192.57,11,3,19,8,True
2419570,802,2,30,8485,189717612,1,0,0,190.99,8,898001.58,11,0,19,8,False
2569754,752,0,10,6509,189717612,1,0,0,191.08,6,898192.66,24,4,21,9,True
2590725,297,0,-1,8792,189717612,1,1,0,190.51,4,898192.66,4,4,6,9,True
2926057,1195,1,10,8485,189717612,1,0,0,190.91,0,898383.57,24,1,3,10,True
3323463,530,0,20,7764,189717612,1,0,0,190.92,3,898192.65,18,5,9,12,True
3538331,1262,0,20,2257,189717612,1,0,0,190.79,5,898001.86,23,5,1,12,True
3707724,802,2,30,7723,189717612,1,0,0,190.91,8,897810.95,11,3,15,1,True
3747440,297,0,451,1628,189717612,1,0,0,191.17,7,897619.78,4,0,17,2,True
3758139,297,0,25,9048,189717612,1,0,0,191.31,8,897428.47,4,4,7,3,True
3848199,1279,4,451,5930,189717612,1,0,0,190.77,7,897237.7,24,6,6,3,True
3863075,802,2,30,3930,189717612,1,0,0,191.09,8,897046.61,11,0,18,3,True
4054315,1465,4,25,6689,189717612,1,0,0,190.88,8,896855.73,11,5,21,4,True
4058886,1279,4,451,6587,189717612,1,0,0,191.02,7,896664.71,24,4,13,6,True
4387106,599,0,20,5930,189717612,1,0,0,191.28,3,896473.43,24,0,3,6,True
4417418,802,2,451,6267,189717612,1,0,0,191.12,7,896282.31,11,1,16,6,False
4460900,1465,4,451,2952,189717612,1,0,0,191.11,7,896091.2,11,2,22,6,True
4510677,116,0,20,9048,189717612,1,0,0,191.08,5,895900.12,3,2,21,7,True
4775179,1336,2,20,3930,189717612,1,0,0,191.28,5,895708.84,18,5,17,7,True
4971430,1279,4,25,7515,189717612,1,0,0,191.15,8,895517.69,24,5,8,8,True
4978197,799,2,451,6509,189717612,1,0,0,190.9,7,895326.79,11,5,18,9,True
5029569,1279,4,30,7285,189717612,1,0,0,190.82,8,895135.97,24,3,11,10,True
5264674,564,0,10,8798,189717612,1,0,0,190.62,0,895326.59,17,0,14,10,True
5311349,1465,4,-1,7764,189717612,1,1,0,190.92,1,895326.59,11,1,17,10,True
5928020,802,2,25,7515,189717612,1,0,0,191.18,8,895135.41,11,0,3,11,False
6275891,799,2,25,6411,189717612,1,0,0,190.85,8,894944.56,11,1,10,11,True
6286799,799,2,451,6509,189717612,1,0,0,190.7,7,894753.86,11,3,2,12,True
6376615,1465,4,25,1086,189717612,1,0,0,190.94,8,894562.92,11,3,12,12,True
6381494,1465,4,-1,2257,189717612,1,1,0,190.93,4,894562.92,11,5,1,12,True
6861446,1279,4,25,3930,189717612,1,0,0,190.97,8,894371.95,24,5,3,12,True
7330335,1279,4,25,8485,189717612,1,0,0,190.81,8,894181.14,24,6,0,12,True
7390062,297,0,451,6591,189717612,1,0,0,190.84,7,893990.3,4,4,9,1,True
7568353,1279,4,451,2952,189717612,1,0,0,190.73,7,893799.57,24,1,9,1,True
7827269,1279,4,451,1143,189717612,1,0,0,190.96,7,893608.61,24,4,13,1,True
7986180,297,0,-1,7515,189717612,1,1,0,191.15,4,893608.61,4,1,3,2,True
8299643,297,0,25,6587,189717612,1,0,0,190.68,8,893417.93,4,2,22,3,True
8329636,297,0,451,2952,189717612,1,0,0,191.12,7,893226.81,4,6,19,3,True
8563921,319,0,10,6411,189717612,1,0,0,191.03,0,893417.84,11,5,18,4,True
8754734,679,0,10,8798,189717612,1,0,0,190.87,6,893608.71,24,5,10,5,True
8785863,677,0,10,7723,189717612,1,0,0,190.99,6,893799.7,24,0,19,5,True
9072938,297,0,451,3930,189717612,1,0,0,190.86,7,893608.84,4,2,12,5,True
9115760,570,2,20,7764,189717612,1,0,0,190.84,5,893418.0,11,2,9,6,True
9192243,297,0,451,4721,189717612,1,0,0,190.97,7,893227.03,4,6,10,8,True
9222312,802,2,451,9554,189717612,1,0,0,190.95,7,893036.08,11,1,13,8,True
9250975,799,2,30,8792,189717612,1,0,0,190.63,8,892845.45,11,4,14,9,True
9363642,802,2,-1,8792,189717612,1,1,0,190.99,4,892845.45,11,5,15,9,True
9796011,1279,4,451,4721,189717612,1,0,0,190.94,7,892654.51,24,0,1,11,True
1292242,858,1,451,6366,680800937,0,0,0,868.08,7,940557.92,24,3,9,1,True
1436420,76,0,20,8865,680800937,0,0,0,868.05,5,939689.87,20,6,1,1,True
1609136,267,0,10,9197,680800937,0,0,0,867.95,6,940557.82,6,5,16,2,True
1629862,858,1,-1,9197,680800937,0,1,0,867.8,4,940557.82,24,2,9,3,True
2139061,1445,2,451,1220,680800937,0,0,0,868.01,7,939689.81,24,6,22,4,True
2389261,858,1,-1,5534,680800937,0,1,0,867.93,4,939689.81,24,2,2,5,True
2953099,858,1,-1,7982,680800937,0,2,0,868.48,4,939689.81,24,2,7,5,True
3205336,858,1,25,1862,680800937,0,0,0,867.83,8,938821.98,24,4,2,5,True
3499291,180,0,25,7982,680800937,0,0,0,868.23,8,937953.75,18,6,0,5,True
3543945,207,4,25,6589,680800937,0,0,0,867.99,8,937085.76,9,4,6,6,True
3834199,1445,2,30,8525,680800937,0,0,0,867.82,8,936217.94,24,6,18,6,False
3898474,180,0,30,5293,680800937,0,0,0,867.9,8,935350.04,18,0,6,8,True
4016014,998,0,10,6589,680800937,0,0,0,867.86,0,936217.9,26,5,9,8,True
4328169,858,1,451,7380,680800937,0,0,0,867.86,7,935350.04,24,6,19,8,True
4428891,180,0,-1,2764,680800937,0,1,0,867.95,4,935350.04,18,3,5,9,True
4438214,207,4,30,7982,680800937,0,0,0,868.09,8,934481.95,9,4,0,9,True
4530893,1436,0,451,2764,680800937,0,0,0,867.97,7,933613.98,24,4,0,10,True
4693842,1025,1,10,5534,680800937,0,0,0,868.13,6,934482.11,11,6,1,10,True
5050022,130,0,20,7110,680800937,0,0,0,867.64,5,933614.47,18,3,13,10,False
5207389,1436,0,25,3107,680800937,0,0,0,868.05,8,932746.42,24,6,22,11,True
5408279,1436,0,451,8525,680800937,0,0,0,867.96,7,931878.46,24,6,8,11,True
5503445,1101,2,20,7886,680800937,0,0,0,868.05,5,931010.41,0,0,5,11,True
5582943,416,2,20,4145,680800937,0,0,0,868.03,5,930142.38,18,5,18,11,False
5868692,438,1,10,7982,680800937,0,0,0,868.16,0,931010.54,24,0,10,11,True
5934046,207,4,451,9197,680800937,0,0,0,868.07,7,930142.47,9,1,21,12,True
5945757,1436,0,30,7183,680800937,0,0,0,868.19,8,929274.28,24,4,2,12,True
6072090,1262,0,10,1537,680800937,0,0,0,867.98,6,930142.26,23,6,11,1,True
6092905,858,1,-1,8687,680800937,0,1,0,867.96,4,930142.26,24,3,11,2,True
6161039,207,4,451,8957,680800937,0,0,0,868.14,7,929274.12,9,2,19,2,True
6178628,180,0,451,8525,680800937,0,0,0,868.2,7,928405.92,18,5,23,2,False
6362007,1233,0,20,2764,680800937,0,0,0,868.3,3,927537.62,18,6,20,2,True
6415379,1436,0,-1,1220,680800937,0,1,0,868.18,4,927537.62,24,0,4,3,True
6424962,705,1,10,8865,680800937,0,0,0,868.16,6,928405.78,18,6,9,4,True
6839874,180,0,-1,7110,680800937,0,1,0,867.79,4,928405.78,18,0,13,5,True
6909755,1436,0,-1,3107,680800937,0,2,0,867.78,1,928405.78,24,2,7,5,False
7522338,1436,0,30,3107,680800937,0,0,0,867.88,8,927537.9,24,0,22,7,True
7526312,1445,2,30,1914,680800937,0,0,0,867.95,8,926669.95,24,5,6,8,True
7740234,207,4,451,1942,680800937,0,0,0,868.03,7,925801.92,9,3,18,8,True
8108152,1445,2,25,5534,680800937,0,0,0,867.93,8,924933.99,24,5,21,9,True
8278106,207,4,25,1942,680800937,0,0,0,868.02,8,924065.97,9,6,22,10,True
8385171,180,0,30,8674,680800937,0,0,0,868.27,8,923197.7,18,3,6,11,False
8765253,1086,0,10,5534,680800937,0,0,0,867.77,0,924065.47,18,0,10,12,True
9122351,1421,0,10,9197,680800937,0,0,0,868.2,6,924933.67,24,3,0,2,True
9449786,858,1,25,7886,680800937,0,0,0,867.73,8,924065.94,24,4,21,2,True
9473196,858,1,451,8957,680800937,0,0,0,868.18,7,923197.76,24,2,12,5,True
9492407,207,4,-1,7886,680800937,0,1,0,867.9,4,923197.76,9,5,18,6,True
9553754,858,1,25,1914,680800937,0,0,0,867.71,8,922330.05,24,1,22,7,True
9698027,1445,2,451,3868,680800937,0,0,0,868.02,7,921462.03,24,4,1,7,True
9742981,1339,2,20,2518,680800937,0,0,0,867.82,3,920594.21,18,2,23,10,True
9885672,858,1,25,7982,680800937,0,0,0,867.84,8,919726.37,24,0,1,11,True
1042772,1467,0,-1,7954,608706088,0,1,0,465.94,4,555182.0,11,5,14,1,True
1047949,116,0,10,2187,608706088,0,0,0,465.94,0,555647.94,3,3,8,1,True
1184563,1467,0,451,2353,608706088,0,0,0,466.11,7,555181.83,11,2,4,1,True
1432347,1467,0,30,8753,608706088,0,0,0,466.05,8,554715.78,11,1,3,2,True
1496218,667,4,451,9984,608706088,0,0,0,465.83,7,554249.95,18,1,11,2,True
1865625,701,2,25,5681,608706088,0,0,0,465.95,8,553784.0,18,2,12,3,True
1905348,681,2,25,2187,608706088,0,0,0,465.97,8,553318.03,24,4,7,4,True
2023320,1297,0,20,3069,608706088,0,0,0,465.96,3,552852.07,5,3,12,4,True
2092667,681,2,30,7394,608706088,0,0,0,466.36,8,552385.71,24,0,11,4,True
2267657,701,2,30,7143,608706088,0,0,0,465.78,8,551919.93,18,1,15,5,True
2503735,457,0,10,1692,608706088,0,0,0,465.8,6,552385.73,13,2,9,5,True
2648758,701,2,-1,7394,608706088,0,1,0,465.78,1,552385.73,18,3,6,5,True
2884190,406,1,30,5919,608706088,0,0,0,466.17,8,551919.56,10,3,21,6,False
2921454,29,0,10,1692,608706088,0,0,0,466.05,0,552385.61,11,3,1,6,True
2934986,1094,0,20,1692,608706088,0,0,0,465.82,5,551919.79,0,0,7,7,False
3139001,950,0,20,8753,608706088,0,0,0,465.83,5,551453.96,24,2,12,8,True
3536469,29,0,25,7208,608706088,0,0,0,466.22,8,550987.74,11,3,10,9,True
3692235,952,0,10,3119,608706088,0,0,0,465.86,0,551453.6,13,0,4,11,True
3830231,1467,0,451,4487,608706088,0,0,0,465.77,7,550987.83,11,1,5,11,True
3961526,445,0,20,7954,608706088,0,0,0,465.89,5,550521.94,13,2,11,11,True
4081862,29,0,30,9319,608706088,0,0,0,465.89,8,550056.05,11,6,11,12,True
4105728,406,1,30,4714,608706088,0,0,0,465.97,8,549590.08,10,2,5,1,True
4151476,701,2,30,8753,608706088,0,0,0,466.12,8,549123.96,18,2,13,1,True
4384762,1454,1,25,2798,608706088,0,0,0,466.07,8,548657.89,11,4,18,2,True
4448690,1123,2,20,1692,608706088,0,0,0,465.93,5,548191.96,24,3,5,3,True
4568868,204,0,20,7394,608706088,0,0,0,466.03,3,547725.93,9,2,8,4,True
4980914,1429,0,10,7143,608706088,0,0,0,466.11,6,548192.04,24,3,7,4,True
5258078,667,4,451,2187,608706088,0,0,0,465.87,7,547726.17,18,2,15,5,True
5445864,1467,0,30,2479,608706088,0,0,0,466.01,8,547260.16,11,6,8,6,True
5899473,1132,0,10,7394,608706088,0,0,0,465.58,6,547725.74,24,3,6,6,True
5991098,681,2,30,9984,608706088,0,0,0,466.23,8,547259.51,24,0,0,7,True
6021129,681,2,30,4915,608706088,0,0,0,466.0,8,546793.51,24,2,9,7,True
6369128,406,1,-1,4487,608706088,0,1,0,466.17,4,546793.51,10,1,19,9,True
6492498,767,0,10,9319,608706088,0,0,0,466.26,6,547259.77,14,4,3,9,True
6595116,406,1,25,3069,608706088,0,0,0,466.23,8,546793.54,10,1,20,10,True
6813160,916,0,10,2282,608706088,0,0,0,465.58,6,547259.12,18,3,11,10,True
7081586,1140,0,10,3119,608706088,0,0,0,466.03,6,547725.15,15,1,7,12,True
7086551,1352,1,10,7208,608706088,0,0,0,465.85,6,548191.0,24,6,0,12,True
7383342,667,4,451,2187,608706088,0,0,0,466.01,7,547724.99,18,4,10,1,True
7931525,29,0,25,9984,608706088,0,0,0,465.97,8,547259.02,11,1,20,1,True
8291528,1014,1,10,8753,608706088,0,0,0,465.98,6,547725.0,26,2,21,1,True
8355029,29,0,25,4487,608706088,0,0,0,465.94,8,547259.06,11,3,5,2,True
8391076,681,2,25,2798,608706088,0,0,0,466.19,8,546792.87,24,4,9,3,True
8838802,681,2,-1,4714,608706088,0,1,0,465.85,1,546792.87,24,3,5,4,True
8877449,406,1,451,4915,608706088,0,0,0,466.01,7,546326.86,10,6,8,4,True
8979648,689,0,10,2521,608706088,0,0,0,465.96,6,546792.82,24,0,2,5,True
9155616,931,0,20,4487,608706088,0,0,0,466.13,3,546326.69,24,4,2,5,True
9270815,29,0,30,4915,608706088,0,0,0,465.92,8,545860.77,11,4,3,6,True
9507417,297,0,20,5919,608706088,0,0,0,466.19,5,545394.58,4,0,12,6,True
9519238,29,0,30,1692,608706088,0,0,0,465.89,8,544928.69,11,6,3,8,True
9680813,406,1,451,7143,608706088,0,0,0,466.01,7,544462.68,10,4,5,11,True
9695005,1093,0,10,2521,608706088,0,0,0,466.06,0,544928.74,18,4,20,11,True
9872274,29,0,30,2353,608706088,0,0,0,466.13,8,544462.61,11,6,9,11,True
9961368,681,2,451,5919,608706088,0,0,0,465.84,7,543996.77,24,1,18,11,True
9985483,1217,0,20,7143,608706088,0,0,0,466.02,3,543530.75,24,4,18,11,True
1099065,983,3,30,4644,655971405,0,0,0,956.84,8,610813.16,22,1,1,1,True
1134059,369,1,-1,3819,655971405,0,1,0,957.09,1,610813.16,25,2,4,2,True
1211384,118,2,451,8355,655971405,0,0,0,957.11,7,609856.05,18,1,19,2,True
1269601,645,0,20,2615,655971405,0,0,0,956.85,5,608899.2,24,4,4,3,True
1307182,1312,0,20,8199,655971405,0,0,0,957.04,5,607942.16,5,2,14,5,True
1396551,1089,0,25,3976,655971405,0,0,0,956.89,8,606985.27,18,4,10,5,True
1695445,983,3,25,4644,655971405,0,0,0,957.08,8,606028.19,22,1,19,6,True
1826105,1369,3,25,5369,655971405,0,0,0,956.87,8,605071.32,16,3,22,6,True
2284959,816,0,-1,8133,655971405,0,1,0,957.12,4,605071.32,18,2,9,7,True
2352275,118,2,-1,3819,655971405,0,2,0,957.11,4,605071.32,18,6,18,7,True
2556592,118,2,30,9495,655971405,0,0,0,956.82,8,604114.5,18,5,13,7,True
2630483,857,1,10,2615,655971405,0,0,0,956.92,0,605071.42,24,5,10,7,True
2634525,979,0,20,4644,655971405,0,0,0,956.97,5,604114.45,22,6,5,8,True
2669212,1017,2,20,6159,655971405,0,0,0,957.08,3,603157.37,26,5,21,8,True
2683004,751,4,25,8199,655971405,0,0,0,957.18,8,602200.19,24,1,0,9,True
2842550,1476,0,20,9925,655971405,0,0,0,957.05,3,601243.14,24,1,21,10,True
2907738,1201,0,10,8420,655971405,0,0,0,957.09,0,602200.23,24,1,15,11,True
3704682,983,3,25,3819,655971405,0,0,0,956.94,8,601243.29,22,4,13,12,True
4036596,1075,0,10,6159,655971405,0,0,0,956.77,6,602200.06,18,2,0,12,True
4061603,1156,1,10,9495,655971405,0,0,0,956.94,6,603157.0,15,3,4,1,True
4102878,281,1,10,3819,655971405,0,0,0,956.88,6,604113.88,24,4,11,1,False
4364368,1369,3,451,2403,655971405,0,0,0,956.86,7,603157.02,16,6,18,1,True
4490815,935,1,10,8199,655971405,0,0,0,957.13,6,604114.15,24,1,0,3,True
4505649,118,2,30,5369,655971405,0,0,0,956.9,8,603157.25,18,3,22,4,True
4528119,1369,3,30,8355,655971405,0,0,0,957.02,8,602200.23,16,5,10,4,True
4715875,366,0,20,2615,655971405,0,0,0,956.91,3,601243.32,25,1,22,5,True
4886865,1369,3,30,6159,655971405,0,0,0,956.95,8,600286.37,16,2,13,5,True
5235784,303,0,20,8199,655971405,0,0,0,956.97,3,599329.4,4,5,5,5,True
5246864,118,2,451,2615,655971405,0,0,0,957.05,7,598372.35,18,6,17,5,True
5257031,1089,0,-1,2403,655971405,0,1,0,957.14,1,598372.35,18,0,20,6,True
5258907,1476,0,20,8199,655971405,0,0,0,956.92,3,597415.43,24,0,16,6,True
5569960,751,4,25,5369,655971405,0,0,0,957.1,8,596458.33,24,2,22,7,True
5778133,118,2,25,8199,655971405,0,0,0,956.91,8,595501.42,18,4,7,8,True
5815737,1089,0,451,2403,655971405,0,0,0,956.86,7,594544.56,18,1,23,8,True
5863184,428,0,20,5611,655971405,0,0,0,956.94,5,593587.62,18,3,11,10,True
6021291,1089,0,30,8133,655971405,0,0,0,956.9,8,592630.72,18,6,3,10,True
6255722,1278,0,20,5611,655971405,0,0,0,956.89,5,591673.83,24,3,15,11,True
6276710,816,0,451,1999,655971405,0,0,0,957.18,7,590716.65,18,4,2,11,True
6377459,1025,1,10,2615,655971405,0,0,0,956.94,6,591673.59,11,0,1,1,True
6620634,1369,3,-1,8199,655971405,0,1,0,956.86,4,591673.59,16,1,22,1,True
6871775,300,0,10,2615,655971405,0,0,0,956.77,0,592630.36,4,5,12,1,False
6881844,983,3,25,8355,655971405,0,0,0,956.96,8,591673.4,22,2,22,1,True
7033915,1270,1,25,9861,655971405,0,0,0,957.01,8,590716.39,23,1,11,1,True
7074410,118,2,451,8616,655971405,0,0,0,956.78,7,589759.61,18,0,15,2,True
7126621,1369,3,451,8355,655971405,0,0,0,957.05,7,588802.56,16,4,9,2,False
7528124,369,1,-1,8616,655971405,0,1,0,956.94,4,588802.56,25,4,12,3,True
7567959,1270,1,30,8133,655971405,0,0,0,957.16,8,587845.4,23,5,13,3,True
8021385,1468,1,10,8133,655971405,0,0,0,957.22,0,588802.62,11,5,14,5,True
8114302,118,2,25,5611,655971405,0,0,0,957.17,8,587845.45,18,5,9,6,True
8173514,84,4,25,9925,655971405,0,0,0,956.95,8,586888.5,1,6,19,6,True
8274945,1089,0,-1,5369,655971405,0,1,0,957.05,4,586888.5,18,0,23,6,True
8484747,751,4,25,9495,655971405,0,0,0,956.87,8,585931.63,24,0,3,6,True
8567370,1089,0,-1,9861,655971405,0,1,0,956.94,4,585931.63,18,5,15,7,True
8741800,228,0,20,2615,655971405,0,0,0,956.72,3,584974.91,26,3,1,8,True
9004257,118,2,451,8616,655971405,0,0,0,957.24,7,584017.67,18,0,3,8,True
9116323,983,3,25,9495,655971405,0,0,0,957.26,8,583060.41,22,0,20,9,True
9400061,312,0,20,8616,655971405,0,0,0,957.15,3,582103.26,4,4,10,9,True
9551521,983,3,451,8616,655971405,0,0,0,956.95,7,581146.31,22,2,5,9,True
9940770,1092,1,10,8616,655971405,0,0,0,957.12,6,582103.43,18,4,9,10,True
1117005,1109,4,451,4476,305375831,0,0,0,519.01,7,369247.99,0,4,6,1,True
1173813,1109,4,25,7606,305375831,0,0,0,518.95,8,368729.04,0,1,22,2,True
1449666,1087,4,451,8534,305375831,0,0,0,519.06,7,368209.98,18,4,21,2,True
1603723,1087,4,30,8534,305375831,0,0,0,518.97,8,367691.01,18,0,18,2,True
2090454,1109,4,451,1666,305375831,0,0,0,519.15,7,367171.86,0,2,5,3,True
2151021,1109,4,30,7351,305375831,0,0,0,518.98,8,366652.88,0,0,18,3,True
2694705,1087,4,451,5302,305375831,0,0,0,519.06,7,366133.82,18,3,3,4,True
2827972,529,2,30,5494,305375831,0,0,0,519.26,8,365614.56,18,3,9,6,True
2921642,1109,4,25,3620,305375831,0,0,0,519.25,8,365095.31,0,4,10,6,True
3029037,1109,4,451,3620,305375831,0,0,0,519.02,7,364576.29,0,5,6,6,True
3186002,529,2,25,2154,305375831,0,0,0,518.99,8,364057.3,18,6,3,7,True
3398723,304,0,20,5115,305375831,0,0,0,519.01,3,363538.29,4,6,19,7,True
3698236,151,4,30,7713,305375831,0,0,0,518.86,8,363019.43,18,6,15,7,True
3728888,1087,4,30,1924,305375831,0,0,0,519.14,8,362500.29,18,0,6,7,True
3753918,634,1,451,5874,305375831,0,0,0,519.06,7,361981.23,24,0,6,8,True
3771361,151,4,25,1669,305375831,0,0,0,519.07,8,361462.16,18,0,1,9,True
3791186,983,3,451,2154,305375831,0,0,0,518.96,7,360943.2,22,1,16,9,True
4034324,1116,0,10,9958,305375831,0,0,0,519.13,6,361462.33,24,1,21,10,True
4410555,1087,4,451,2311,305375831,0,0,0,518.92,7,360943.41,18,0,17,11,True
5054005,151,4,-1,9958,305375831,0,1,0,519.2,1,360943.41,18,2,8,11,True
5164400,512,0,20,4730,305375831,0,0,0,518.92,3,360424.49,12,5,3,12,True
5174117,529,2,25,1666,305375831,0,0,0,519.16,8,359905.33,18,6,22,2,True
5295267,681,2,20,2154,305375831,0,0,0,518.84,5,359386.49,24,2,23,4,True
5299856,983,3,451,2786,305375831,0,0,0,519.19,7,358867.3,22,3,6,4,True
5471219,151,4,451,2786,305375831,0,0,0,519.03,7,358348.27,18,0,23,4,True
5497545,529,2,-1,7351,305375831,0,1,0,519.02,1,358348.27,18,4,0,5,True
5590184,634,1,451,5115,305375831,0,0,0,518.9,7,357829.37,24,3,11,6,True
5726026,634,1,-1,4730,305375831,0,1,0,518.62,1,357829.37,24,5,12,6,True
5803799,983,3,451,4898,305375831,0,0,0,519.06,7,357310.31,22,3,18,7,True
5839357,944,2,20,2154,305375831,0,0,0,518.79,5,356791.52,24,3,12,7,True
5920376,1053,1,10,4657,305375831,0,0,0,519.13,0,357310.65,11,0,9,8,True
6074397,529,2,-1,7351,305375831,0,1,0,519.08,4,357310.65,18,6,17,9,True
6265683,983,3,-1,2499,305375831,0,2,0,519.13,1,357310.65,22,0,6,9,True
6378951,228,0,10,7713,305375831,0,0,0,519.08,6,357829.73,26,5,12,10,True
6574038,1087,4,25,1924,305375831,0,0,0,518.94,8,357310.79,18,3,11,10,True
6757719,151,4,-1,1669,305375831,0,1,0,519.09,4,357310.79,18,3,12,10,True
6891434,1109,4,30,2499,305375831,0,0,0,519.02,8,356791.77,0,5,5,10,True
7137002,1052,0,10,2311,305375831,0,0,0,519.19,6,357310.96,11,2,23,11,True
7144331,634,1,-1,5494,305375831,0,1,0,519.13,1,357310.96,24,3,16,11,True
7214968,29,0,20,4258,305375831,0,0,0,519.13,3,356791.83,11,3,12,1,True
7215364,687,0,10,7877,305375831,0,0,0,518.99,6,357310.82,24,3,5,2,True
7318405,983,3,451,2154,305375831,0,0,0,518.74,7,356792.08,22,1,7,2,True
7638758,1087,4,25,8534,305375831,0,0,0,518.94,8,356273.14,18,3,18,3,True
7897677,529,2,451,6610,305375831,0,0,0,519.05,7,355754.09,18,4,3,3,True
7898736,634,1,30,2499,305375831,0,0,0,519.15,8,355234.94,24,0,4,3,True
8028004,151,4,451,2786,305375831,0,0,0,519.03,7,354715.91,18,4,5,5,True
8137242,292,1,10,5494,305375831,0,0,0,519.33,0,355235.24,4,2,1,5,True
8226195,151,4,451,8901,305375831,0,0,0,519.19,7,354716.05,18,1,14,7,True
8555887,1087,4,-1,3620,305375831,0,1,0,518.76,4,354716.05,18,6,13,7,True
8739680,1109,4,451,1924,305375831,0,0,0,519.1,7,354196.95,0,2,1,7,True
8757993,529,2,451,1924,305375831,0,0,0,519.02,7,353677.93,18,3,10,8,True
8864595,634,1,30,2786,305375831,0,0,0,518.92,8,353159.01,24,0,1,9,True
9513798,529,2,25,5302,305375831,0,0,0,519.04,8,352639.97,18,3,6,9,True
9580846,498,0,20,1924,305375831,0,0,0,519.03,3,352120.94,12,5,8,9,True
9628562,151,4,451,9522,305375831,0,0,0,519.01,7,351601.93,18,0,2,10,True
9708171,1160,0,20,9522,305375831,0,0,0,519.25,5,351082.68,15,0,13,10,True
9883548,983,3,-1,1924,305375831,0,1,0,518.73,1,351082.68,22,0,14,11,True
9898241,1406,0,10,7284,305375831,0,0,0,519.21,0,351601.89,24,3,5,11,True
9967731,983,3,25,6610,305375831,0,0,0,519.16,8,351082.73,22,6,13,11,True
1336057,621,2,-1,4746,186200276,1,1,0,217.11,4,750640.0,11,4,15,1,True
1434664,612,4,30,6315,186200276,1,0,0,217.07,8,750422.93,11,5,3,1,True
1861716,674,4,-1,9563,186200276,1,1,0,216.54,4,750422.93,24,3,5,2,True
1908411,630,0,20,7422,186200276,1,0,0,216.99,5,750205.94,11,6,6,2,True
2130124,193,1,25,9563,186200276,1,0,0,216.97,8,749988.97,18,1,6,3,True
2300255,1007,2,20,3126,186200276,1,0,0,216.95,5,749772.02,26,3,20,3,True
2541750,416,2,20,8480,186200276,1,0,0,216.74,5,749555.28,18,5,13,4,True
2548111,329,1,10,2180,186200276,1,0,0,217.13,6,749772.41,11,1,14,4,True
2638545,550,0,10,3126,186200276,1,0,0,217.19,0,749989.6,17,1,22,4,True
3496795,869,2,20,4065,186200276,1,0,0,216.86,3,749772.74,24,2,17,5,True
3952740,724,3,30,6129,186200276,1,0,0,217.19,8,749555.55,11,4,10,6,False
4039274,211,0,10,7422,186200276,1,0,0,217.01,6,749772.56,9,6,16,7,True
4065284,621,2,30,8220,186200276,1,0,0,217.09,8,749555.47,11,1,17,8,True
4070784,193,1,25,5288,186200276,1,0,0,216.98,8,749338.49,18,0,15,8,True
4442844,612,4,25,9203,186200276,1,0,0,217.01,8,749121.48,11,2,19,10,True
4596059,1093,0,20,4065,186200276,1,0,0,216.86,5,748904.62,18,2,6,10,True
4678699,22,3,451,8480,186200276,1,0,0,216.97,7,748687.65,11,6,14,10,True
4860936,362,0,20,4746,186200276,1,0,0,217.01,5,748470.64,24,6,22,11,True
4951451,724,3,451,6315,186200276,1,0,0,217.11,7,748253.53,11,6,20,11,True
4957804,724,3,451,4065,186200276,1,0,0,217.26,7,748036.27,11,4,6,11,True
5010897,621,2,30,5594,186200276,1,0,0,217.1,8,747819.17,11,4,5,12,True
5254678,435,4,451,8220,186200276,1,0,0,216.86,7,747602.31,24,4,1,12,True
5381951,857,1,10,6129,186200276,1,0,0,217.06,6,747819.37,24,4,11,1,True
5430996,621,2,451,8480,186200276,1,0,0,216.95,7,747602.42,11,1,1,1,True
5505234,724,3,-1,6129,186200276,1,1,0,217.08,1,747602.42,11,5,3,2,True
5838435,612,4,30,4746,186200276,1,0,0,217.14,8,747385.28,11,3,13,3,True
6054854,724,3,451,8480,186200276,1,0,0,217.06,7,747168.22,11,5,2,4,True
6188282,193,1,451,8428,186200276,1,0,0,217.0,7,746951.22,18,5,17,4,True
6316734,621,2,451,5288,186200276,1,0,0,217.08,7,746734.14,11,1,18,5,True
6358251,674,4,451,4065,186200276,1,0,0,216.91,7,746517.23,24,0,21,5,True
6360063,435,4,451,5594,186200276,1,0,0,217.0,7,746300.23,24,5,23,6,True
6412110,916,0,10,6129,186200276,1,0,0,216.78,6,746517.01,18,6,7,6,True
6674862,435,4,451,6129,186200276,1,0,0,216.62,7,746300.39,24,2,1,7,True
6858471,362,0,20,7422,186200276,1,0,0,216.63,5,746083.76,24,1,0,7,True
6963475,724,3,30,2180,186200276,1,0,0,216.96,8,745866.8,11,4,15,8,True
6971032,1303,0,20,3394,186200276,1,0,0,216.88,3,745649.92,5,0,0,8,True
7111653,612,4,-1,2180,186200276,1,1,0,216.94,4,745649.92,11,6,3,9,True
7133059,53,0,20,1778,186200276,1,0,0,216.91,3,745433.01,20,6,17,10,True
7180950,435,4,30,5527,186200276,1,0,0,216.95,8,745216.06,24,1,19,10,True
7220735,548,2,20,8480,186200276,1,0,0,217.21,3,744998.85,17,3,1,12,True
7427003,634,1,10,7422,186200276,1,0,0,216.83,6,745215.68,24,0,9,1,True
7569941,22,3,451,8480,186200276,1,0,0,217.03,7,744998.65,11,5,9,1,True
7574542,612,4,-1,5527,186200276,1,1,0,217.33,1,744998.65,11,0,4,2,True
7589093,621,2,30,8428,186200276,1,0,0,217.1,8,744781.55,11,5,20,2,True
7785226,612,4,451,8354,186200276,1,0,0,217.17,7,744564.38,11,4,8,3,True
8007715,621,2,451,4746,186200276,1,0,0,217.02,7,744347.36,11,5,4,3,True
8103154,373,1,10,8480,186200276,1,0,0,217.04,6,744564.4,25,6,13,4,True
8115646,621,2,25,6129,186200276,1,0,0,217.0,8,744347.4,11,0,15,4,True
8408821,621,2,-1,9184,186200276,1,1,0,216.89,4,744347.4,11,6,0,5,True
8430235,621,2,451,1778,186200276,1,0,0,216.87,7,744130.53,11,1,17,5,True
8454355,1093,0,20,6315,186200276,1,0,0,217.22,5,743913.31,18,2,8,6,True
8528367,193,1,451,4746,186200276,1,0,0,217.19,7,743696.12,18,1,9,7,True
9084931,612,4,451,7044,186200276,1,0,0,217.06,7,743479.06,11,3,0,7,True
9338797,1429,0,10,3394,186200276,1,0,0,216.75,0,743695.81,24,0,19,9,True
9791435,1315,0,10,5288,186200276,1,0,0,216.95,6,743912.76,5,5,13,9,True
9890901,724,3,30,8220,186200276,1,0,0,216.88,8,743695.88,11,2,23,10,True
9968388,612,4,25,8354,186200276,1,0,0,217.06,8,743478.82,11,6,10,11,True
1110472,1007,2,20,4647,598568833,0,0,0,618.76,5,893213.24,26,6,18,1,True
1130261,1144,2,-1,4781,598568833,0,1,0,619.12,4,893213.24,15,2,2,2,True
1408744,835,4,25,4647,598568833,0,0,0,618.85,8,892594.39,5,0,19,2,False
2120320,832,3,-1,7563,598568833,0,1,0,619.19,4,892594.39,5,5,22,3,True
2223567,996,0,20,1533,598568833,0,0,0,619.1,5,891975.29,26,1,9,4,True
2236136,484,0,10,5800,598568833,0,0,0,619.03,6,892594.32,5,4,6,4,True
2397612,1326,3,451,6636,598568833,0,0,0,619.2,7,891975.12,18,1,19,5,True
2495755,1144,2,451,6848,598568833,0,0,0,619.09,7,891356.03,15,4,15,5,False
2668227,835,4,25,7259,598568833,0,0,0,619.02,8,890737.01,5,3,8,5,True
3640743,664,2,20,4647,598568833,0,0,0,618.95,5,890118.06,18,6,22,5,True
3804072,1326,3,25,2608,598568833,0,0,0,619.4,8,889498.66,18,4,0,6,True
3881806,835,4,451,7259,598568833,0,0,0,618.96,7,888879.7,5,4,16,6,True
3921679,1144,2,-1,2608,598568833,0,1,0,619.06,4,888879.7,15,2,7,7,True
3967478,128,0,10,1658,598568833,0,0,0,618.7,6,889498.4,18,5,15,7,True
3974157,405,4,25,1658,598568833,0,0,0,618.89,8,888879.51,10,6,16,7,True
3995402,1326,3,25,1658,598568833,0,0,0,619.09,8,888260.42,18,2,14,8,True
4055244,1326,3,25,6848,598568833,0,0,0,619.07,8,887641.35,18,6,19,9,True
4087717,1144,2,451,7563,598568833,0,0,0,618.9,7,887022.45,15,0,18,9,True
4121529,1144,2,-1,7563,598568833,0,1,0,619.08,4,887022.45,15,1,9,11,False
4303900,832,3,-1,4647,598568833,0,2,0,618.91,4,887022.45,5,2,11,12,True
4440187,1156,1,10,6848,598568833,0,0,0,619.2,0,887641.65,15,3,5,12,True
4472919,1338,0,20,5800,598568833,0,0,0,618.98,3,887022.67,18,1,4,1,True
4664521,832,3,451,9262,598568833,0,0,0,618.76,7,886403.91,5,0,11,1,True
4703349,832,3,451,6848,598568833,0,0,0,618.88,7,885785.03,5,2,1,2,True
4804754,832,3,451,4038,598568833,0,0,0,619.16,7,885165.87,5,0,7,2,True
5071167,1326,3,30,6848,598568833,0,0,0,618.88,8,884546.99,18,5,0,3,True
5235617,1144,2,30,9398,598568833,0,0,0,618.77,8,883928.22,15,2,7,4,True
5326888,1326,3,451,6636,598568833,0,0,0,619.09,7,883309.13,18,1,23,5,True
5422536,1144,2,451,6848,598568833,0,0,0,619.12,7,882690.01,15,5,20,6,True
5495407,405,4,451,5650,598568833,0,0,0,618.97,7,882071.04,10,6,2,7,True
6275971,1064,0,10,4038,598568833,0,0,0,618.88,6,882689.92,11,2,13,7,False
6340099,405,4,30,1236,598568833,0,0,0,619.05,8,882070.87,10,4,1,7,True
6549261,1144,2,-1,6636,598568833,0,1,0,619.26,4,882070.87,15,3,17,7,True
7191372,1144,2,451,2006,598568833,0,0,0,619.02,7,881451.85,15,6,7,8,True
7264116,405,4,25,7259,598568833,0,0,0,618.8,8,880833.05,10,2,17,9,True
7266839,835,4,25,5650,598568833,0,0,0,618.93,8,880214.12,5,3,7,9,True
7761281,362,0,10,4781,598568833,0,0,0,619.24,6,880833.36,24,0,15,9,True
7810173,1436,0,20,6636,598568833,0,0,0,618.98,3,880214.38,24,6,18,10,True
8091774,490,4,-1,4647,598568833,0,1,0,619.12,1,880214.38,12,2,13,11,True
8280231,511,1,10,1236,598568833,0,0,0,619.06,6,880833.44,12,5,5,12,True
8591176,832,3,25,2827,598568833,0,0,0,618.74,8,880214.7,5,6,6,12,True
8610199,405,4,30,6848,598568833,0,0,0,618.94,8,879595.76,10,4,8,1,True
8703226,1044,0,20,6636,598568833,0,0,0,619.0,5,878976.76,11,2,23,1,True
8808532,1144,2,451,9533,598568833,0,0,0,618.79,7,878357.97,15,0,11,2,True
8915474,835,4,451,2526,598568833,0,0,0,619.26,7,877738.71,5,3,19,3,True
8959667,490,4,451,2006,598568833,0,0,0,619.11,7,877119.6,12,0,12,4,True
9000536,1326,3,25,7259,598568833,0,0,0,619.32,8,876500.28,18,5,18,7,True
9242465,832,3,451,6848,598568833,0,0,0,619.23,7,875881.05,5,5,2,7,True
9527772,490,4,30,9262,598568833,0,0,0,618.74,8,875262.31,12,3,15,8,True
9652465,405,4,451,5800,598568833,0,0,0,618.9,7,874643.41,10,0,20,8,True
9681105,405,4,30,4647,598568833,0,0,0,619.12,8,874024.29,10,0,13,9,True
9683063,832,3,-1,1658,598568833,0,1,0,619.25,4,874024.29,5,1,19,10,True
9710287,490,4,451,2608,598568833,0,0,0,619.0,7,873405.29,12,0,19,11,True
1042247,40,4,451,8543,633690968,0,0,0,846.03,7,208743.97,11,1,1,1,True
1191698,158,2,-1,4809,633690968,0,1,0,845.83,1,208743.97,24,5,17,1,True
1502287,40,4,451,4013,633690968,0,0,0,845.82,7,207898.15,11,2,4,1,True
1522055,34,1,10,5463,633690968,0,0,0,846.17,0,208744.32,11,2,20,2,True
1631682,158,2,30,7990,633690968,0,0,0,846.13,8,207898.19,24,0,7,2,True
1912908,40,4,451,4013,633690968,0,0,0,845.87,7,207052.32,11,0,14,2,True
2110884,484,0,20,8751,633690968,0,0,0,846.09,5,206206.23,5,4,0,3,True
2219327,1184,4,30,4026,633690968,0,0,0,845.97,8,205360.26,24,2,22,6,True
2267755,1184,4,-1,4979,633690968,0,1,0,845.97,1,205360.26,24,6,15,7,True
2386481,220,0,20,2397,633690968,0,0,0,846.03,3,204514.23,26,0,17,8,True
2479588,1012,0,30,6507,633690968,0,0,0,845.99,8,203668.24,26,5,6,8,True
2515075,464,1,25,7903,633690968,0,0,0,846.11,8,202822.13,13,1,14,10,True
2809799,1012,0,451,7990,633690968,0,0,0,846.09,7,201976.04,26,5,8,10,True
3319966,1012,0,25,8751,633690968,0,0,0,846.06,8,201129.98,26,6,20,10,True
3342328,1012,0,451,4773,633690968,0,0,0,845.91,7,200284.07,26,1,19,12,True
3717688,40,4,30,6507,633690968,0,0,0,845.94,8,199438.13,11,5,1,12,True
3827296,1164,0,20,4013,633690968,0,0,0,845.87,5,198592.26,24,6,16,12,True
3838687,464,1,451,4773,633690968,0,0,0,846.27,7,197745.99,13,6,22,12,True
3940060,1213,2,20,3065,633690968,0,0,0,845.97,5,196900.02,24,1,20,12,True
4317347,1322,2,20,4809,633690968,0,0,0,846.25,3,196053.77,18,0,6,1,True
4697086,464,1,451,7903,633690968,0,0,0,845.91,7,195207.86,13,2,16,2,True
4966505,158,2,-1,6830,633690968,0,1,0,846.36,1,195207.86,24,5,2,3,True
5016055,464,1,30,8543,633690968,0,0,0,845.84,8,194362.02,13,5,20,4,True
5110608,1184,4,451,2397,633690968,0,0,0,846.07,7,193515.95,24,5,10,5,True
5249762,40,4,451,4979,633690968,0,0,0,846.08,7,192669.87,11,4,16,5,True
5625826,464,1,451,4809,633690968,0,0,0,846.41,7,191823.46,13,5,16,5,True
5628712,1164,0,20,2731,633690968,0,0,0,846.11,5,190977.35,24,4,5,6,False
5860369,464,1,30,5191,633690968,0,0,0,846.21,8,190131.14,13,0,19,6,True
6012487,1184,4,451,4809,633690968,0,0,0,845.95,7,189285.19,24,1,12,6,True
6041373,1012,0,-1,4979,633690968,0,1,0,846.18,4,189285.19,26,6,18,7,True
6203281,42,2,20,5463,633690968,0,0,0,846.1,5,188439.09,24,3,1,7,True
6308614,708,2,20,7990,633690968,0,0,0,845.98,3,187593.11,18,5,1,8,True
6427588,1012,0,451,8751,633690968,0,0,0,845.94,7,186747.17,26,4,13,9,True
6593610,158,2,-1,9181,633690968,0,1,0,846.0,1,186747.17,24,1,18,10,True
7258856,464,1,-1,2203,633690968,0,2,0,846.06,4,186747.17,13,1,8,1,True
7461607,1421,0,20,4679,633690968,0,0,0,846.2,5,185900.97,24,6,20,1,True
7508828,1322,2,20,4809,633690968,0,0,0,845.89,3,185055.08,18,4,12,2,True
7587923,40,4,451,4679,633690968,0,0,0,845.82,7,184209.26,11,4,3,3,True
7603768,1012,0,30,8543,633690968,0,0,0,846.1,8,183363.16,26,1,19,3,True
7746772,1184,4,25,4809,633690968,0,0,0,846.2,8,182516.96,24,0,13,3,False
7926509,1184,4,30,3065,633690968,0,0,0,845.92,8,181671.04,24,2,21,4,True
7968174,464,1,-1,6830,633690968,0,1,0,845.88,4,181671.04,13,1,11,4,True
8096503,40,4,25,4013,633690968,0,0,0,845.65,8,180825.39,11,1,9,5,False
8205919,40,4,451,6507,633690968,0,0,0,845.99,7,179979.4,11,5,20,6,True
8392713,1184,4,-1,2397,633690968,0,1,0,845.94,4,179979.4,24,2,9,6,True
8594162,1184,4,25,7990,633690968,0,0,0,846.17,8,179133.23,24,2,3,7,True
8692606,40,4,25,4773,633690968,0,0,0,845.74,8,178287.49,11,4,18,7,True
8858189,158,2,-1,2203,633690968,0,1,0,846.03,1,178287.49,24,1,18,7,True
8959843,1184,4,451,4026,633690968,0,0,0,846.04,7,177441.45,24,0,22,7,True
9102055,1184,4,451,4026,633690968,0,0,0,846.08,7,176595.37,24,3,20,8,True
9268394,503,0,10,3866,633690968,0,0,0,846.18,0,177441.55,12,3,10,8,True
9740533,1012,0,451,2769,633690968,0,0,0,846.16,7,176595.39,26,6,18,9,True
9860366,1184,4,451,4013,633690968,0,0,0,845.95,7,175749.44,24,5,17,10,True
9887974,464,1,-1,4013,633690968,0,1,0,846.0,4,175749.44,13,1,18,11,True
1134452,1297,0,451,9544,196155834,0,0,0,920.83,7,761441.17,5,0,1,3,True
1379040,917,0,10,8663,196155834,0,0,0,920.95,0,762362.12,18,5,9,3,True
1560865,1297,0,451,8692,196155834,0,0,0,921.49,7,761440.63,5,4,11,3,True
1686621,911,3,25,2528,196155834,0,0,0,920.93,8,760519.7,18,2,22,4,True
1838033,418,4,25,9803,196155834,0,0,0,920.77,8,759598.93,18,5,4,4,True
1916054,572,0,10,4679,196155834,0,0,0,920.87,0,760519.8,11,6,1,5,True
1989768,1391,2,-1,4679,196155834,0,1,0,921.01,1,760519.8,24,3,17,5,True
2176355,1391,2,451,1204,196155834,0,0,0,920.98,7,759598.82,24,6,0,5,True
2187842,911,3,30,7893,196155834,0,0,0,921.08,8,758677.74,18,4,13,6,True
2412543,1391,2,-1,8663,196155834,0,1,0,921.02,1,758677.74,24,4,14,6,True
2598208,911,3,451,2528,196155834,0,0,0,920.93,7,757756.81,18,1,2,8,True
2678585,1297,0,30,4256,196155834,0,0,0,920.99,8,756835.82,5,1,18,8,True
2736760,1227,0,451,9803,196155834,0,0,0,920.88,7,755914.94,18,1,6,8,True
2811946,1391,2,451,7013,196155834,0,0,0,921.21,7,754993.73,24,5,14,9,True
2847933,787,0,10,1204,196155834,0,0,0,920.94,0,755914.67,14,1,10,9,False
2903565,418,4,25,9803,196155834,0,0,0,921.08,8,754993.59,18,1,10,10,True
3104430,1297,0,25,3834,196155834,0,0,0,921.19,8,754072.4,5,2,8,10,True
3266340,1227,0,30,4679,196155834,0,0,0,920.87,8,753151.53,18,3,2,10,False
3574843,1391,2,451,5476,196155834,0,0,0,921.04,7,752230.49,24,0,15,11,True
3857175,1312,0,20,3834,196155834,0,0,0,921.34,5,751309.15,5,4,6,1,True
4439477,1485,0,20,8692,196155834,0,0,0,921.14,5,750388.01,24,4,17,1,True
4468865,428,0,10,9544,196155834,0,0,0,920.91,6,751308.92,18,1,13,3,True
4958224,1297,0,30,5620,196155834,0,0,0,920.94,8,750387.98,5,2,13,3,True
5061513,991,1,10,6536,196155834,0,0,0,920.9,6,751308.88,22,5,16,4,True
5150912,1297,0,25,1204,196155834,0,0,0,920.86,8,750388.02,5,6,20,4,True
5286191,318,0,20,6536,196155834,0,0,0,921.07,5,749466.95,11,3,13,5,True
5303397,1297,0,451,3834,196155834,0,0,0,920.77,7,748546.18,5,2,9,8,True
5319158,418,4,-1,1204,196155834,0,1,0,920.89,1,748546.18,18,2,15,8,True
5471542,911,3,451,8663,196155834,0,0,0,920.83,7,747625.35,18,5,3,9,True
6027300,418,4,451,6536,196155834,0,0,0,921.03,7,746704.32,18,5,17,10,False
6188068,911,3,-1,8581,196155834,0,1,0,921.05,1,746704.32,18,5,16,11,True
6249412,1227,0,-1,9803,196155834,0,2,0,920.97,4,746704.32,18,4,14,12,True
6308523,1270,1,10,2528,196155834,0,0,0,920.99,6,747625.31,23,0,6,1,True
6333889,1227,0,20,5620,196155834,0,0,0,921.04,5,746704.27,18,2,16,1,True
6617314,1391,2,30,3834,196155834,0,0,0,921.01,8,745783.26,24,0,18,1,True
6673758,1233,0,20,3834,196155834,0,0,0,920.82,5,744862.44,18,4,21,2,True
6865808,1356,2,20,9544,196155834,0,0,0,921.18,5,743941.26,24,6,23,2,True
7064412,1391,2,30,5476,196155834,0,0,0,920.98,8,743020.28,24,3,8,2,True
7148045,418,4,-1,7013,196155834,0,1,0,921.04,1,743020.28,18,2,0,3,True
7799665,1297,0,30,6536,196155834,0,0,0,920.92,8,742099.36,5,3,20,3,True
7832055,418,4,30,7893,196155834,0,0,0,921.04,8,741178.32,18,0,12,4,True
7850954,116,0,20,8692,196155834,0,0,0,920.88,3,740257.44,3,4,14,4,True
7912701,1227,0,25,7893,196155834,0,0,0,920.89,8,739336.55,18,5,13,5,True
7974894,1297,0,451,7893,196155834,0,0,0,920.79,7,738415.76,5,4,16,5,True
8042896,736,1,10,4256,196155834,0,0,0,920.93,6,739336.69,11,5,7,6,True
8927475,1086,0,20,4679,196155834,0,0,0,921.14,3,738415.55,18,5,15,6,True
9230438,1297,0,25,9803,196155834,0,0,0,921.12,8,737494.43,5,1,16,9,True
9767910,1297,0,-1,9544,196155834,0,1,0,920.95,4,737494.43,5,5,3,10,True
9861515,1391,2,30,9803,196155834,0,0,0,920.77,8,736573.66,24,6,22,10,True
9901418,1297,0,-1,2528,196155834,0,1,0,921.02,4,736573.66,5,5,20,11,True
9961910,911,3,30,1204,196155834,0,0,0,921.23,8,735652.43,18,3,11,11,True
1143385,1061,2,25,8680,414035214,1,0,0,271.85,8,796517.15,11,0,13,4,True
1336254,1249,2,20,8531,414035214,1,0,0,272.16,5,796244.99,23,1,23,4,True
1466419,167,2,25,4276,414035214,1,0,0,272.01,8,795972.98,24,4,17,4,True
1941369,291,3,25,8861,414035214,1,0,0,271.83,8,795701.15,24,1,21,5,True
2047192,167,2,25,4793,414035214,1,0,0,271.9,8,795429.25,24,0,4,5,True
2139768,1066,4,451,8680,414035214,1,0,0,271.86,7,795157.39,11,4,2,6,True
2307375,939,0,20,1759,414035214,1,0,0,271.94,5,794885.45,24,4,3,8,True
2523745,1061,2,-1,4276,414035214,1,1,0,271.86,4,794885.45,11,6,18,8,True
2534718,1061,2,30,8680,414035214,1,0,0,272.03,8,794613.42,11,2,9,10,True
2942406,675,2,20,4276,414035214,1,0,0,271.98,5,794341.44,24,6,20,11,False
2943072,194,1,10,8313,414035214,1,0,0,271.97,6,794613.41,18,6,2,11,False
2968818,145,0,25,8313,414035214,1,0,0,271.96,8,794341.45,18,2,11,12,True
3067936,291,3,30,4550,414035214,1,0,0,271.95,8,794069.5,24,3,19,12,True
3148751,291,3,30,8680,414035214,1,0,0,272.18,8,793797.32,24,2,16,12,True
3394610,1066,4,451,8680,414035214,1,0,0,272.04,7,793525.28,11,5,4,2,True
3487303,319,0,20,5327,414035214,1,0,0,272.02,5,793253.26,11,2,16,2,True
3981259,1061,2,25,3166,414035214,1,0,0,272.15,8,792981.11,11,1,0,3,True
4474755,145,0,451,8313,414035214,1,0,0,272.07,7,792709.04,18,0,13,4,True
4652054,844,1,10,5327,414035214,1,0,0,271.83,6,792980.87,5,6,4,4,True
4718989,291,3,451,4276,414035214,1,0,0,272.23,7,792708.64,24,4,5,4,True
5051573,359,2,20,6584,414035214,1,0,0,272.12,5,792436.52,24,5,15,4,True
5129452,1061,2,25,6210,414035214,1,0,0,271.86,8,792164.66,11,6,13,5,True
5290711,1061,2,451,8861,414035214,1,0,0,272.02,7,791892.64,11,2,8,5,True
5498474,1128,2,20,8680,414035214,1,0,0,271.95,5,791620.69,24,5,17,6,True
5566233,145,0,25,8313,414035214,1,0,0,272.05,8,791348.64,18,0,4,6,False
5852371,1066,4,-1,6584,414035214,1,1,0,272.05,4,791348.64,11,0,19,7,True
6230058,186,4,30,1388,414035214,1,0,0,271.91,8,791076.73,18,6,1,8,True
6312721,304,0,20,9165,414035214,1,0,0,271.97,5,790804.76,4,3,3,8,True
6500864,282,2,451,3166,414035214,1,0,0,272.13,7,790532.63,24,3,0,9,True
6514370,857,1,451,4276,414035214,1,0,0,272.01,7,790260.62,24,2,23,9,True
6718939,1325,0,25,6210,414035214,1,0,0,271.88,8,789988.74,18,3,22,9,True
6759314,145,0,451,3166,414035214,1,0,0,272.2,7,789716.54,18,4,16,9,True
6772806,186,4,451,8680,414035214,1,0,0,271.97,7,789444.57,18,3,1,11,True
6833712,1060,1,10,8531,414035214,1,0,0,271.81,0,789716.38,11,0,16,11,True
7134494,857,1,-1,8313,414035214,1,1,0,271.96,1,789716.38,24,4,11,1,True
7199630,282,2,30,8680,414035214,1,0,0,272.26,8,789444.12,24,4,13,2,True
7229162,167,2,451,8313,414035214,1,0,0,271.93,7,789172.19,24,4,14,2,True
7306389,1483,0,10,5327,414035214,1,0,0,271.93,0,789444.12,24,2,14,2,True
7636651,1325,0,451,3166,414035214,1,0,0,272.2,7,789171.92,18,6,22,3,True
8118794,282,2,30,8531,414035214,1,0,0,272.1,8,788899.82,24,3,10,3,True
8355957,1066,4,25,8861,414035214,1,0,0,272.13,8,788627.69,11,4,14,3,False
8360098,21,0,20,8861,414035214,1,0,0,271.96,5,788355.73,11,5,11,4,True
8402365,167,2,451,3166,414035214,1,0,0,272.05,7,788083.68,24,4,22,4,True
8593641,282,2,451,8861,414035214,1,0,0,272.27,7,787811.41,24,0,3,5,True
8703794,282,2,30,4550,414035214,1,0,0,272.42,8,787538.99,24,5,7,5,True
8864345,167,2,25,4276,414035214,1,0,0,272.12,8,787266.87,24,0,14,7,True
8901145,1066,4,451,4550,414035214,1,0,0,272.05,7,786994.82,11,0,8,7,True
9114369,951,0,10,8680,414035214,1,0,0,271.92,6,787266.74,24,2,17,7,True
9209095,167,2,451,5327,414035214,1,0,0,271.95,7,786994.79,24,0,18,8,True
9267116,681,2,20,8861,414035214,1,0,0,272.09,5,786722.7,24,0,22,8,True
9656785,416,2,20,1388,414035214,1,0,0,272.0,5,786450.7,18,0,9,9,True
9987081,1061,2,451,8313,414035214,1,0,0,271.94,7,786178.76,11,5,10,10,True
1039695,309,0,451,9377,960126463,0,0,0,940.98,7,833218.02,4,6,15,1,True
1414293,639,4,-1,7018,960126463,0,1,0,940.98,4,833218.02,24,6,9,1,True
1516679,879,1,25,7018,960126463,0,0,0,941.09,8,832276.93,27,2,9,2,True
1546508,879,1,25,4535,960126463,0,0,0,941.12,8,831335.81,27,0,7,2,True
1556576,309,0,-1,8958,960126463,0,1,0,940.81,4,831335.81,4,4,8,3,True
1938579,309,0,451,2928,960126463,0,0,0,940.92,7,830394.89,4,1,8,4,True
2028527,879,1,451,8712,960126463,0,0,0,941.18,7,829453.71,27,2,15,4,True
2431473,1287,4,451,5225,960126463,0,0,0,940.97,7,828512.74,24,1,11,4,True
2522036,879,1,451,6910,960126463,0,0,0,941.0,7,827571.74,27,5,23,6,True
2540403,1446,1,451,9377,960126463,0,0,0,941.06,7,826630.68,24,6,0,6,True
2559065,1014,1,10,9539,960126463,0,0,0,940.63,6,827571.31,26,4,20,7,True
2798073,1287,4,30,4535,960126463,0,0,0,941.2,8,826630.11,24,0,3,10,True
2979092,309,0,451,6910,960126463,0,0,0,940.47,7,825689.64,4,1,15,10,True
3070379,309,0,451,7018,960126463,0,0,0,941.0,7,824748.64,4,3,8,10,True
3392854,639,4,-1,7018,960126463,0,1,0,940.99,4,824748.64,24,4,1,10,True
3415314,309,0,30,4535,960126463,0,0,0,940.96,8,823807.68,4,4,11,10,False
3417357,249,0,10,5775,960126463,0,0,0,940.96,6,824748.64,6,0,14,11,False
3437193,1459,1,451,5775,960126463,0,0,0,940.72,7,823807.92,11,0,8,11,True
3469295,429,0,10,9377,960126463,0,0,0,940.92,6,824748.84,24,2,16,11,True
3757245,1067,4,25,5871,960126463,0,0,0,941.02,8,823807.82,11,1,14,12,True
4198077,712,0,451,7790,960126463,0,0,0,941.08,7,822866.74,18,2,7,1,False
4222848,1067,4,25,7498,960126463,0,0,0,940.99,8,821925.75,11,6,12,2,True
4303519,1264,0,20,7018,960126463,0,0,0,941.03,3,820984.72,23,3,8,3,True
4351493,86,4,30,6278,960126463,0,0,0,940.91,8,820043.81,1,1,3,4,True
4496506,887,2,20,6278,960126463,0,0,0,940.8,5,819103.01,27,1,3,5,True
4545146,1287,4,-1,5775,960126463,0,1,0,940.73,4,819103.01,24,4,12,5,True
4655683,1287,4,25,9539,960126463,0,0,0,940.77,8,818162.24,24,5,6,5,True
4780546,1321,0,10,8958,960126463,0,0,0,940.9,6,819103.14,18,0,10,5,True
5035571,879,1,451,4535,960126463,0,0,0,940.79,7,818162.35,27,6,1,6,True
5067305,86,4,-1,6910,960126463,0,1,0,940.94,4,818162.35,1,1,21,6,True
5191176,1459,1,25,7874,960126463,0,0,0,941.22,8,817221.13,11,0,4,6,True
5368075,639,4,30,2928,960126463,0,0,0,941.03,8,816280.1,24,3,9,6,True
5454002,879,1,451,9539,960126463,0,0,0,941.41,7,815338.69,27,4,11,7,True
6016646,1067,4,451,5922,960126463,0,0,0,941.09,7,814397.6,11,4,18,7,True
6300685,1459,1,-1,2928,960126463,0,1,0,940.97,4,814397.6,11,2,1,9,False
6350208,712,0,451,3474,960126463,0,0,0,940.95,7,813456.65,18,2,15,10,True
6483668,309,0,25,9983,960126463,0,0,0,941.13,8,812515.52,4,6,0,10,True
6647064,879,1,-1,1271,960126463,0,1,0,941.08,1,812515.52,27,3,0,11,True
6741688,198,0,20,5946,960126463,0,0,0,940.71,5,811574.81,18,4,16,12,True
7156655,398,0,20,5225,960126463,0,0,0,940.94,3,810633.87,10,2,23,12,True
7189841,712,0,25,9062,960126463,0,0,0,941.0,8,809692.87,18,6,23,12,True
7229645,1459,1,30,4535,960126463,0,0,0,941.24,8,808751.63,11,0,11,12,True
7334772,712,0,30,8712,960126463,0,0,0,940.98,8,807810.65,18,4,13,1,True
7370675,879,1,30,1271,960126463,0,0,0,940.81,8,806869.84,27,2,20,2,True
7700677,309,0,451,9539,960126463,0,0,0,940.97,7,805928.87,4,2,22,2,True
7717711,309,0,-1,1271,960126463,0,1,0,941.08,1,805928.87,4,5,12,4,True
8064564,551,0,10,2952,960126463,0,0,0,941.01,0,806869.88,17,3,14,5,True
8142513,1067,4,451,2928,960126463,0,0,0,940.99,7,805928.89,11,0,2,5,True
8172125,879,1,451,5871,960126463,0,0,0,941.06,7,804987.83,27,1,0,5,True
8399465,95,2,20,8586,960126463,0,0,0,940.98,5,804046.85,1,2,14,6,True
8776580,309,0,30,9062,960126463,0,0,0,940.65,8,803106.2,4,0,18,6,True
9150646,86,4,451,5946,960126463,0,0,0,941.12,7,802165.08,1,6,15,6,True
9313956,86,4,-1,2928,960126463,0,1,0,941.12,4,802165.08,1,1,22,7,True
9609703,194,1,10,6278,960126463,0,0,0,940.92,6,803106.0,18,5,11,7,True
9821684,639,4,451,5871,960126463,0,0,0,941.02,7,802164.98,24,0,20,7,True
9840836,1277,2,20,9539,960126463,0,0,0,941.1,5,801223.88,24,1,17,9,True
9883570,1446,1,451,2928,960126463,0,0,0,941.24,7,800282.64,24,2,13,10,True
9948045,1446,1,451,1389,960126463,0,0,0,941.22,7,799341.42,24,5,2,11,True
1022212,1152,0,20,4268,960540992,1,0,0,666.74,3,808308.26,15,1,12,1,True
1368965,96,0,20,5562,960540992,1,0,0,667.09,3,807641.17,1,1,0,3,True
1427603,584,0,20,9115,960540992,1,0,0,667.11,5,806974.06,11,6,16,3,True
1572629,1019,0,-1,3394,960540992,1,1,0,667.12,4,806974.06,26,3,18,4,True
1658886,1035,0,30,6348,960540992,1,0,0,666.87,8,806307.19,11,1,12,4,True
1829925,376,0,25,2455,960540992,1,0,0,667.02,8,805640.17,25,0,22,5,True
1927592,289,4,451,6967,960540992,1,0,0,667.09,7,804973.08,24,1,7,6,True
1932482,1035,0,-1,6348,960540992,1,1,0,666.94,4,804973.08,11,0,0,8,True
1994825,1019,0,25,9274,960540992,1,0,0,667.06,8,804306.02,26,2,4,8,True
2095196,1019,0,451,8475,960540992,1,0,0,667.3,7,803638.72,26,3,8,9,True
2899560,376,0,30,7207,960540992,1,0,0,666.87,8,802971.85,25,3,0,9,True
3108803,939,0,-1,9274,960540992,1,1,0,667.26,4,802971.85,24,4,17,10,True
3141430,991,1,30,9115,960540992,1,0,0,666.96,8,802304.89,22,2,2,11,True
3197901,376,0,-1,5329,960540992,1,1,0,667.16,4,802304.89,25,0,18,11,True
3515144,376,0,451,2455,960540992,1,0,0,666.81,7,801638.08,25,6,19,12,True
4384156,434,3,-1,2584,960540992,1,1,0,666.88,4,801638.08,24,2,15,2,True
5310091,398,0,10,8475,960540992,1,0,0,667.19,6,802305.27,10,6,21,4,True
5338279,1019,0,30,5157,960540992,1,0,0,666.77,8,801638.5,26,3,20,5,True
5358343,1035,0,30,2455,960540992,1,0,0,667.01,8,800971.49,11,6,4,5,True
5417817,289,4,451,6348,960540992,1,0,0,666.85,7,800304.64,24,1,14,6,False
5891956,222,2,20,3805,960540992,1,0,0,667.0,5,799637.64,26,1,12,7,True
5972460,939,0,451,7179,960540992,1,0,0,666.72,7,798970.92,24,1,22,7,True
6005679,1035,0,451,3805,960540992,1,0,0,667.09,7,798303.83,11,6,10,7,True
6117544,342,0,20,2865,960540992,1,0,0,666.93,5,797636.9,24,6,14,8,True
6232996,939,0,451,5562,960540992,1,0,0,667.13,7,796969.77,24,6,9,9,True
6427004,1433,4,30,5562,960540992,1,0,0,667.31,8,796302.46,24,2,19,9,True
6604833,457,0,20,6348,960540992,1,0,0,667.11,5,795635.35,13,2,9,11,True
6844820,1433,4,451,6967,960540992,1,0,0,666.98,7,794968.37,24,2,21,11,True
7102791,939,0,451,3491,960540992,1,0,0,666.74,7,794301.63,24,5,16,12,True
7103125,939,0,30,4541,960540992,1,0,0,667.16,8,793634.47,24,1,9,12,True
7279450,641,0,20,7179,960540992,1,0,0,666.7,5,792967.77,24,5,9,12,True
7350541,991,1,25,8591,960540992,1,0,0,667.09,8,792300.68,22,5,18,2,True
7382479,1090,0,20,9115,960540992,1,0,0,666.9,3,791633.78,18,4,21,2,True
7407308,1035,0,25,2455,960540992,1,0,0,667.04,8,790966.74,11,5,6,3,True
7561277,939,0,30,3394,960540992,1,0,0,667.13,8,790299.61,24,1,16,3,True
7687094,1433,4,30,9115,960540992,1,0,0,666.97,8,789632.64,24,3,13,3,False
8127646,1019,0,25,6967,960540992,1,0,0,666.79,8,788965.85,26,0,17,4,True
8240748,991,1,25,9251,960540992,1,0,0,666.93,8,788298.92,22,4,19,5,True
8521815,939,0,451,5520,960540992,1,0,0,666.79,7,787632.13,24,4,2,5,True
8856979,1105,2,20,5329,960540992,1,0,0,666.99,3,786965.14,0,0,4,6,True
8939291,442,3,451,9251,960540992,1,0,0,667.1,7,786298.04,24,5,2,6,True
9092095,1192,2,20,4268,960540992,1,0,0,666.98,5,785631.06,24,1,12,8,True
9129689,939,0,25,9115,960540992,1,0,0,666.95,8,784964.11,24,2,0,9,True
9290213,442,3,-1,1617,960540992,1,1,0,666.79,4,784964.11,24,0,7,9,True
9299148,23,0,20,3961,960540992,1,0,0,667.02,5,784297.09,11,4,23,9,True
9342345,991,1,451,7207,960540992,1,0,0,667.12,7,783629.97,22,2,4,10,True
9348072,149,2,20,9274,960540992,1,0,0,667.02,5,782962.95,18,5,0,10,True
9447846,434,3,25,2584,960540992,1,0,0,667.08,8,782295.87,24,3,23,10,True
9460895,1433,4,25,2584,960540992,1,0,0,667.26,8,781628.61,24,3,9,10,True
9875697,1044,0,10,9480,960540992,1,0,0,667.14,0,782295.75,11,0,3,11,True
9970045,511,1,10,9251,960540992,1,0,0,666.69,6,782962.44,12,1,9,11,True
1123885,467,0,20,6874,373769158,1,0,0,923.03,5,642746.97,5,1,3,1,True
1263764,694,2,451,4626,373769158,1,0,0,923.12,7,641823.85,24,1,18,1,True
1599540,445,0,10,3924,373769158,1,0,0,923.0,6,642746.85,13,0,19,2,True
1673299,503,0,20,4559,373769158,1,0,0,923.07,3,641823.78,12,1,17,3,True
2066692,159,2,30,4586,373769158,1,0,0,923.1,8,640900.68,24,4,0,3,True
2457076,608,4,30,4626,373769158,1,0,0,922.91,8,639977.77,24,4,18,3,True
2705565,1115,1,10,7383,373769158,1,0,0,922.91,6,640900.68,0,1,5,3,False
2811929,608,4,451,9041,373769158,1,0,0,923.23,7,639977.45,24,6,1,4,False
2823088,1180,1,10,5513,373769158,1,0,0,923.02,6,640900.47,24,0,1,5,True
2987608,159,2,451,3626,373769158,1,0,0,922.73,7,639977.74,24,1,15,5,True
3151466,159,2,451,1412,373769158,1,0,0,923.16,7,639054.58,24,3,22,5,True
3162913,1184,4,30,8350,373769158,1,0,0,922.98,8,638131.6,24,3,15,6,True
3186331,608,4,-1,4626,373769158,1,1,0,923.02,4,638131.6,24,2,12,6,True
3409667,1184,4,30,2762,373769158,1,0,0,923.22,8,637208.38,24,4,3,8,True
3656800,694,2,451,3692,373769158,1,0,0,923.01,7,636285.37,24,1,9,9,True
3668376,729,0,20,4425,373769158,1,0,0,922.99,3,635362.38,11,4,19,12,True
3680112,1156,1,451,7597,373769158,1,0,0,923.15,7,634439.23,15,5,22,12,True
3824376,1184,4,30,6963,373769158,1,0,0,923.08,8,633516.15,24,3,6,12,True
3851564,1127,0,20,7108,373769158,1,0,0,923.13,5,632593.02,24,6,15,1,True
4017540,346,0,10,5513,373769158,1,0,0,923.03,6,633516.05,24,1,10,1,True
4804341,694,2,-1,9805,373769158,1,1,0,923.16,4,633516.05,24,4,23,3,True
5002208,1184,4,30,3692,373769158,1,0,0,923.12,8,632592.93,24,5,22,3,True
5035831,1184,4,-1,3626,373769158,1,1,0,922.75,1,632592.93,24,1,21,3,True
5057054,159,2,451,8350,373769158,1,0,0,922.91,7,631670.02,24,6,9,4,True
5221841,1184,4,30,5513,373769158,1,0,0,923.23,8,630746.79,24,6,22,4,True
5228047,608,4,25,4626,373769158,1,0,0,922.87,8,629823.92,24,6,9,5,True
5314693,1184,4,30,6963,373769158,1,0,0,922.87,8,628901.05,24,5,5,6,False
5324070,159,2,30,5513,373769158,1,0,0,923.1,8,627977.95,24,3,23,6,True
5500085,469,4,451,5513,373769158,1,0,0,923.26,7,627054.69,5,5,18,6,True
5616225,1156,1,25,3626,373769158,1,0,0,922.91,8,626131.78,15,2,6,6,True
5993554,608,4,30,6077,373769158,1,0,0,923.3,8,625208.48,24,6,8,6,True
6235310,159,2,451,9041,373769158,1,0,0,922.92,7,624285.56,24,4,5,7,True
6468395,608,4,25,3692,373769158,1,0,0,923.07,8,623362.49,24,1,23,7,False
6606352,1413,0,20,2762,373769158,1,0,0,923.12,3,622439.37,24,0,20,7,False
6788661,1156,1,25,4703,373769158,1,0,0,922.95,8,621516.42,15,4,11,8,True
6843186,159,2,25,8350,373769158,1,0,0,923.35,8,620593.07,24,4,21,8,True
6898992,937,0,10,7383,373769158,1,0,0,922.9,0,621515.97,24,2,5,9,True
7372178,626,2,20,4425,373769158,1,0,0,922.98,5,620592.99,11,5,17,9,True
7375314,608,4,-1,5025,373769158,1,1,0,922.96,4,620592.99,24,5,19,10,True
7379471,608,4,451,4559,373769158,1,0,0,922.96,7,619670.03,24,6,3,10,True
7452607,469,4,25,4626,373769158,1,0,0,923.02,8,618747.01,5,0,15,11,True
7631219,469,4,451,6963,373769158,1,0,0,923.06,7,617823.95,5,0,12,11,True
7716183,159,2,451,8350,373769158,1,0,0,922.96,7,616900.99,24,6,17,11,True
7958641,694,2,451,5587,373769158,1,0,0,923.03,7,615977.96,24,1,8,12,True
7963807,348,0,10,9041,373769158,1,0,0,922.93,6,616900.89,24,1,23,12,True
8016160,580,0,10,4559,373769158,1,0,0,922.99,0,617823.88,11,5,4,12,True
8321365,1436,0,20,9315,373769158,1,0,0,923.0,5,616900.88,24,2,0,3,True
8786679,608,4,451,9315,373769158,1,0,0,923.02,7,615977.86,24,3,11,4,True
8837278,159,2,25,5025,373769158,1,0,0,923.0,8,615054.86,24,6,17,5,True
8973399,34,1,10,3237,373769158,1,0,0,922.93,6,615977.79,11,6,1,6,True
8981563,694,2,30,9805,373769158,1,0,0,922.99,8,615054.8,24,4,13,7,True
9228624,1184,4,30,4425,373769158,1,0,0,922.85,8,614131.95,24,5,21,8,True
9492975,159,2,451,6874,373769158,1,0,0,922.93,7,613209.02,24,0,18,8,True
9557991,1184,4,451,2762,373769158,1,0,0,922.97,7,612286.05,24,2,2,9,True
9619680,1015,0,10,4703,373769158,1,0,0,923.05,6,613209.1,26,5,12,10,True
9955991,1012,0,10,5513,373769158,1,0,0,922.9,6,614132.0,26,4,7,10,True
9970838,608,4,451,3924,373769158,1,0,0,923.1,7,613208.9,24,4,12,11,True
1007519,1313,4,25,1716,963548109,0,0,0,906.66,8,472402.34,5,6,6,1,True
1244146,988,3,451,8456,963548109,0,0,0,907.05,7,471495.29,22,6,13,2,True
1602796,116,0,-1,6890,963548109,0,1,0,907.0,4,471495.29,3,5,22,2,True
1670980,1124,0,20,9461,963548109,0,0,0,907.21,5,470588.08,24,0,0,3,True
1757159,116,0,451,3011,963548109,0,0,0,907.06,7,469681.02,3,1,10,3,True
1779153,204,0,20,9410,963548109,0,0,0,907.24,5,468773.78,9,4,1,4,True
1848976,1313,4,25,8805,963548109,0,0,0,906.87,8,467866.91,5,3,17,4,True
2058280,1424,4,451,9410,963548109,0,0,0,906.63,7,466960.28,24,1,12,5,True
2208350,537,0,20,6798,963548109,0,0,0,907.04,3,466053.24,18,4,13,5,True
2237130,1424,4,451,8671,963548109,0,0,0,906.84,7,465146.4,24,5,12,5,True
2409375,1313,4,-1,8671,963548109,0,1,0,907.08,1,465146.4,5,0,2,5,True
2652939,1424,4,451,7708,963548109,0,0,0,907.42,7,464238.98,24,2,17,5,True
2947012,1313,4,30,8879,963548109,0,0,0,906.91,8,463332.07,5,4,20,5,True
3496523,1424,4,451,9012,963548109,0,0,0,907.13,7,462424.94,24,5,3,5,True
3525463,1424,4,30,3376,963548109,0,0,0,906.98,8,461517.96,24,0,20,5,True
3535642,146,4,-1,9853,963548109,0,1,0,906.68,1,461517.96,18,0,19,7,True
3647252,298,4,451,3173,963548109,0,0,0,906.96,7,460611.0,4,1,3,7,True
3661832,1424,4,451,9012,963548109,0,0,0,906.93,7,459704.07,24,5,5,8,True
4115780,146,4,30,5238,963548109,0,0,0,907.11,8,458796.96,18,0,1,8,True
4277432,298,4,451,8456,963548109,0,0,0,907.11,7,457889.85,4,2,22,11,True
4998988,116,0,30,4022,963548109,0,0,0,907.01,8,456982.84,3,2,16,11,True
5470442,1313,4,30,1852,963548109,0,0,0,906.9,8,456075.94,5,1,13,12,True
5569084,988,3,25,6798,963548109,0,0,0,906.86,8,455169.08,22,4,17,12,True
5593079,1424,4,451,4022,963548109,0,0,0,907.2,7,454261.88,24,1,14,1,True
5638865,298,4,25,1706,963548109,0,0,0,907.0,8,453354.88,4,2,11,1,True
5950994,346,0,20,3011,963548109,0,0,0,906.82,5,452448.06,24,4,6,1,True
6218551,146,4,30,1706,963548109,0,0,0,906.97,8,451541.09,18,3,16,2,False
6226678,988,3,451,9853,963548109,0,0,0,907.15,7,450633.94,22,0,19,3,True
6327459,988,3,451,9853,963548109,0,0,0,906.78,7,449727.16,22,6,1,3,False
6352558,1238,0,10,6798,963548109,0,0,0,907.08,6,450634.24,18,2,4,3,True
6821421,988,3,-1,4206,963548109,0,1,0,907.2,4,450634.24,22,1,13,4,True
6968226,116,0,25,5648,963548109,0,0,0,907.03,8,449727.21,3,6,4,4,True
7103948,116,0,451,1035,963548109,0,0,0,907.13,7,448820.08,3,3,9,4,True
7212218,298,4,30,8456,963548109,0,0,0,907.11,8,447912.97,4,5,18,5,False
7265718,116,0,451,3173,963548109,0,0,0,907.08,7,447005.89,3,4,13,5,True
7477196,298,4,451,4022,963548109,0,0,0,907.15,7,446098.74,4,5,1,5,True
7667536,752,0,10,8671,963548109,0,0,0,906.96,6,447005.7,24,3,21,6,True
7755282,146,4,451,6890,963548109,0,0,0,906.98,7,446098.72,18,5,22,7,True
7812045,1155,0,10,1852,963548109,0,0,0,907.21,6,447005.93,15,6,7,7,True
7892691,298,4,451,3011,963548109,0,0,0,906.9,7,446099.03,4,0,20,7,True
7988268,605,0,10,1080,963548109,0,0,0,906.87,0,447005.9,24,2,4,8,True
8230217,779,4,30,3011,963548109,0,0,0,906.81,8,446099.09,14,2,0,8,True
8313629,298,4,30,1035,963548109,0,0,0,906.92,8,445192.17,4,2,18,1,True
8436446,988,3,-1,4022,963548109,0,1,0,906.95,4,445192.17,22,3,20,2,True
8629248,146,4,25,3011,963548109,0,0,0,907.05,8,444285.12,18,2,6,3,True
8830262,1249,2,20,5238,963548109,0,0,0,906.93,5,443378.19,23,0,15,4,True
8838908,779,4,451,6798,963548109,0,0,0,906.78,7,442471.41,14,2,17,5,True
8884504,1313,4,451,3173,963548109,0,0,0,907.01,7,441564.4,5,3,0,5,True
9103074,1424,4,451,3376,963548109,0,0,0,907.18,7,440657.22,24,3,14,5,True
9205566,779,4,-1,8456,963548109,0,1,0,907.02,4,440657.22,14,5,22,6,True
9270147,298,4,25,2711,963548109,0,0,0,907.04,8,439750.18,4,5,9,6,True
9340595,298,4,30,9853,963548109,0,0,0,907.04,8,438843.14,4,5,20,8,True
9453181,1313,4,451,8879,963548109,0,0,0,906.79,7,437936.35,5,6,4,8,True
9542260,1313,4,451,1035,963548109,0,0,0,907.09,7,437029.26,5,1,18,9,True
9820786,1434,0,20,9853,963548109,0,0,0,907.04,5,436122.22,24,2,7,9,True
9882870,146,4,25,1852,963548109,0,0,0,906.82,8,435215.4,18,1,13,9,True
9992219,298,4,25,9853,963548109,0,0,0,907.03,8,434308.37,4,0,4,10,True
1040769,1455,2,451,9596,358837932,1,0,0,776.91,7,243131.09,11,5,16,1,True
1100821,824,2,20,3355,358837932,1,0,0,776.91,5,242354.18,18,0,19,2,True
1163094,98,0,451,5467,358837932,1,0,0,777.05,7,241577.13,3,5,7,2,True
1377442,457,0,10,6129,358837932,1,0,0,776.94,0,242354.07,13,5,22,2,True
1833435,185,1,30,8633,358837932,1,0,0,777.23,8,241576.84,18,1,5,2,True
2201021,1067,4,25,9557,358837932,1,0,0,776.97,8,240799.87,11,4,6,3,True
2362880,185,1,25,7110,358837932,1,0,0,777.04,8,240022.83,18,4,18,4,True
2384141,1067,4,451,6129,358837932,1,0,0,776.97,7,239245.86,11,3,15,5,True
2513184,1436,0,20,8633,358837932,1,0,0,776.96,5,238468.9,24,5,19,6,True
2637750,1068,2,30,3776,358837932,1,0,0,776.84,8,237692.06,18,3,10,7,True
2927589,1101,2,451,8540,358837932,1,0,0,776.99,7,236915.07,0,1,14,7,True
3059023,1488,0,451,3548,358837932,1,0,0,776.96,7,236138.11,24,6,15,7,True
3411668,1068,2,30,8484,358837932,1,0,0,776.94,8,235361.17,18,0,16,8,True
3554434,1068,2,30,7110,358837932,1,0,0,777.03,8,234584.14,18,4,15,8,True
3581364,1068,2,-1,3355,358837932,1,1,0,776.98,1,234584.14,18,2,3,8,True
3693930,98,0,25,5467,358837932,1,0,0,777.0,8,233807.14,3,1,8,9,True
3796390,98,0,30,9596,358837932,1,0,0,777.03,8,233030.11,3,1,21,9,True
3996978,1068,2,451,3441,358837932,1,0,0,776.96,7,232253.15,18,6,3,12,False
4316288,185,1,25,3776,358837932,1,0,0,776.87,8,231476.28,18,0,15,12,True
4553063,185,1,451,4105,358837932,1,0,0,776.87,7,230699.41,18,3,10,12,True
4559496,1455,2,30,4105,358837932,1,0,0,776.99,8,229922.42,11,6,14,4,True
4734628,1068,2,451,7504,358837932,1,0,0,776.83,7,229145.59,18,5,12,5,True
4878269,1101,2,30,7110,358837932,1,0,0,776.88,8,228368.71,0,3,7,5,True
5069500,1108,1,451,6129,358837932,1,0,0,776.95,7,227591.76,0,2,12,6,True
5177479,1488,0,25,3440,358837932,1,0,0,776.87,8,226814.89,24,5,20,6,True
5557193,1101,2,-1,7504,358837932,1,1,0,776.78,4,226814.89,0,2,21,6,True
5640096,1061,2,20,4420,358837932,1,0,0,777.01,5,226037.88,11,4,8,7,False
5725010,1455,2,30,3440,358837932,1,0,0,777.18,8,225260.7,11,2,1,7,True
5752281,373,1,10,7504,358837932,1,0,0,776.76,0,226037.46,25,3,5,8,True
6152987,879,1,10,3440,358837932,1,0,0,777.11,6,226814.57,27,0,6,8,True
6303835,98,0,25,5580,358837932,1,0,0,777.06,8,226037.51,3,0,22,9,True
6499256,1488,0,-1,4420,358837932,1,1,0,777.02,4,226037.51,24,2,3,9,True
6617708,1488,0,30,3355,358837932,1,0,0,776.81,8,225260.7,24,2,5,9,True
6654501,511,1,10,8633,358837932,1,0,0,776.64,6,226037.34,12,5,8,11,True
7436913,670,0,10,7504,358837932,1,0,0,776.98,6,226814.32,18,6,5,11,True
7448889,1239,1,10,8633,358837932,1,0,0,777.07,6,227591.39,18,2,20,12,True
7482708,1052,0,10,7504,358837932,1,0,0,777.02,6,228368.41,11,0,20,1,False
7644805,841,1,10,7504,358837932,1,0,0,776.77,6,229145.18,5,2,20,1,True
7866485,98,0,25,4856,358837932,1,0,0,777.1,8,228368.08,3,2,20,3,True
7961776,1488,0,-1,3440,358837932,1,1,0,776.78,4,228368.08,24,1,17,3,True
8096525,292,1,10,5874,358837932,1,0,0,776.96,6,229145.04,4,4,15,4,True
8121386,185,1,-1,7504,358837932,1,1,0,777.17,4,229145.04,18,3,21,5,True
8128351,222,2,20,9180,358837932,1,0,0,776.65,5,228368.39,26,4,1,6,False
8149276,1067,4,30,8633,358837932,1,0,0,776.85,8,227591.54,11,2,0,6,True
8195839,935,1,10,3355,358837932,1,0,0,777.14,0,228368.68,24,5,1,6,True
8342536,1108,1,25,8633,358837932,1,0,0,777.15,8,227591.53,0,0,2,7,True
8745103,1390,0,10,5798,358837932,1,0,0,776.87,6,228368.4,24,3,2,8,True
9022373,199,0,20,8540,358837932,1,0,0,777.13,3,227591.27,18,5,14,9,True
9425553,535,0,20,6329,358837932,1,0,0,777.19,5,226814.08,18,2,10,9,True
9522210,1156,1,10,4227,358837932,1,0,0,776.89,6,227590.97,15,1,18,9,True
9711310,1101,2,451,4830,358837932,1,0,0,776.99,7,226813.98,0,3,16,10,True
9717106,1101,2,-1,4227,358837932,1,1,0,777.08,4,226813.98,0,0,11,10,True
9756132,1067,4,-1,4227,358837932,1,2,0,777.21,4,226813.98,11,2,3,11,True
1164869,860,1,-1,5253,615378682,1,1,0,539.31,4,915177.0,24,1,12,1,True
1302903,58,2,20,5912,615378682,1,0,0,539.24,5,914637.76,20,4,9,1,True
1428976,860,1,-1,9272,615378682,1,1,0,539.22,4,914637.76,24,0,6,2,True
1524787,736,1,-1,5912,615378682,1,2,0,538.98,4,914637.76,11,0,0,4,True
1608941,414,4,451,3760,615378682,1,0,0,539.15,7,914098.61,18,2,3,5,True
1655332,532,4,30,3789,615378682,1,0,0,539.04,8,913559.57,18,1,18,5,True
1658570,414,4,451,6869,615378682,1,0,0,538.92,7,913020.65,18,0,1,6,True
1881058,414,4,451,5684,615378682,1,0,0,538.94,7,912481.71,18,0,7,6,False
2157874,390,4,25,9272,615378682,1,0,0,538.87,8,911942.84,10,0,9,7,True
2370847,433,4,25,5601,615378682,1,0,0,538.8,8,911404.04,24,5,20,8,True
2476715,390,4,30,1867,615378682,1,0,0,539.08,8,910864.96,10,3,20,8,True
2554812,390,4,25,1203,615378682,1,0,0,539.11,8,910325.85,10,6,19,8,True
2978418,414,4,30,9676,615378682,1,0,0,538.68,8,909787.17,18,0,20,8,True
3243496,287,0,10,3734,615378682,1,0,0,539.14,6,910326.31,24,1,3,8,True
3397759,414,4,25,3417,615378682,1,0,0,539.06,8,909787.25,18,3,17,9,True
3916221,564,0,20,9603,615378682,1,0,0,538.78,3,909248.47,17,3,19,9,True
4467600,532,4,25,1203,615378682,1,0,0,538.94,8,908709.53,18,5,3,10,True
4558932,1364,0,20,9228,615378682,1,0,0,538.91,3,908170.62,16,0,0,10,False
4808886,736,1,-1,7930,615378682,1,1,0,538.99,4,908170.62,11,0,23,11,True
4962406,860,1,25,7930,615378682,1,0,0,538.9,8,907631.72,24,5,17,2,True
4977450,711,2,20,7710,615378682,1,0,0,538.86,5,907092.86,18,4,15,2,True
5040369,522,0,20,3734,615378682,1,0,0,539.23,3,906553.63,18,1,18,3,True
5074145,1325,0,10,9676,615378682,1,0,0,539.17,6,907092.8,18,0,6,5,True
5452250,249,0,10,6123,615378682,1,0,0,539.2,6,907632.0,6,4,1,6,True
5486103,16,4,451,7710,615378682,1,0,0,538.84,7,907093.16,24,2,18,6,True
5572595,860,1,30,1203,615378682,1,0,0,539.13,8,906554.03,24,2,5,6,True
5592728,532,4,451,5702,615378682,1,0,0,538.91,7,906015.12,18,2,17,6,True
5653978,736,1,30,9603,615378682,1,0,0,538.98,8,905476.14,11,1,4,7,True
5844857,1482,3,25,2229,615378682,1,0,0,539.0,8,904937.14,24,2,13,7,False
6126578,414,4,451,7930,615378682,1,0,0,538.85,7,904398.29,18,4,1,9,True
6145475,860,1,30,1867,615378682,1,0,0,539.26,8,903859.03,24,0,19,10,True
6548176,239,1,10,5253,615378682,1,0,0,538.94,6,904397.97,26,0,16,10,True
6719146,390,4,-1,5155,615378682,1,1,0,539.22,1,904397.97,10,0,23,10,True
6726903,736,1,451,3760,615378682,1,0,0,539.15,7,903858.82,11,3,20,12,False
6859345,281,1,10,5155,615378682,1,0,0,539.02,6,904397.84,24,6,2,12,True
6912570,1482,3,451,6869,615378682,1,0,0,538.92,7,903858.92,24,3,12,1,True
6963372,1363,0,10,5155,615378682,1,0,0,538.75,0,904397.67,16,6,9,1,True
6999747,390,4,-1,3417,615378682,1,1,0,538.96,4,904397.67,10,4,12,1,True
7026098,860,1,25,5912,615378682,1,0,0,539.0,8,903858.67,24,6,1,1,True
7063946,860,1,25,7011,615378682,1,0,0,539.05,8,903319.62,24,0,8,3,True
7613601,562,1,10,4331,615378682,1,0,0,539.05,0,903858.67,17,2,16,4,True
7643803,414,4,25,2229,615378682,1,0,0,538.93,8,903319.74,18,4,4,4,True
7753664,1159,0,20,6123,615378682,1,0,0,538.78,3,902780.96,15,2,22,5,True
7848842,736,1,451,5617,615378682,1,0,0,538.95,7,902242.01,11,0,8,6,True
8047300,433,4,-1,3417,615378682,1,1,0,538.83,4,902242.01,24,3,1,6,True
8156459,860,1,25,5253,615378682,1,0,0,538.95,8,901703.06,24,1,23,6,True
8567618,871,0,20,7930,615378682,1,0,0,538.78,5,901164.28,24,2,5,7,True
8649001,211,0,10,7930,615378682,1,0,0,538.89,6,901703.17,9,0,16,7,True
9092047,433,4,30,3789,615378682,1,0,0,538.9,8,901164.27,24,3,20,7,True
9272331,390,4,25,7930,615378682,1,0,0,538.64,8,900625.63,10,4,19,7,True
9692465,860,1,451,3760,615378682,1,0,0,538.84,7,900086.79,24,2,18,7,True
9739867,1076,1,10,3734,615378682,1,0,0,539.21,0,900626.0,18,2,23,7,True
9934622,222,2,20,5682,615378682,1,0,0,539.27,3,900086.73,26,5,13,10,True
9987889,433,4,451,3734,615378682,1,0,0,538.83,7,899547.9,24,2,10,11,True
1544060,1187,4,30,1723,784914555,0,0,0,567.93,8,550888.07,24,0,19,4,True
1549725,929,0,20,2781,784914555,0,0,0,568.0,3,550320.07,18,0,5,5,True
1586448,703,0,20,8596,784914555,0,0,0,567.94,5,549752.13,18,2,12,6,True
1628200,302,1,10,5239,784914555,0,0,0,568.14,6,550320.27,4,2,18,6,True
1711959,1186,2,-1,8366,784914555,0,1,0,568.0,4,550320.27,24,2,12,12,True
1924065,1187,4,451,2781,784914555,0,0,0,567.9,7,549752.37,24,0,14,1,True
2323720,1187,4,30,8507,784914555,0,0,0,567.86,8,549184.51,24,5,19,6,True
2451022,1186,2,-1,8366,784914555,0,1,0,568.07,1,549184.51,24,1,6,7,True
2563725,951,0,20,3194,784914555,0,0,0,568.07,3,548616.44,24,4,17,9,True
2615572,1459,1,10,6375,784914555,0,0,0,567.99,6,549184.43,11,3,22,11,True
2858591,1023,2,30,1723,784914555,0,0,0,568.01,8,548616.42,11,1,9,11,False
2958198,517,4,-1,1705,784914555,0,1,0,567.85,4,548616.42,12,0,13,5,True
2989612,1186,2,-1,8596,784914555,0,2,0,567.98,4,548616.42,24,6,10,9,True
3217444,126,1,-1,4083,784914555,0,3,1,568.23,4,0.0,18,4,18,10,True
1064071,785,0,10,5239,875833352,0,0,0,424.88,6,968713.88,14,0,20,1,True
1290080,679,0,25,1654,875833352,0,0,0,425.12,8,968288.76,24,3,12,1,True
1452830,1044,0,10,8250,875833352,0,0,0,425.08,0,968713.84,11,2,22,1,True
1906990,867,0,-1,6269,875833352,0,1,0,424.63,1,968713.84,24,0,23,1,True
1968707,90,4,30,9350,875833352,0,0,0,425.33,8,968288.51,1,3,11,2,True
2026743,867,0,451,9353,875833352,0,0,0,425.2,7,967863.31,24,5,13,3,True
2738642,867,0,451,7419,875833352,0,0,0,424.98,7,967438.33,24,6,23,3,True
2860927,1252,4,451,5765,875833352,0,0,0,424.93,7,967013.4,23,4,7,4,True
2962864,90,4,30,5525,875833352,0,0,0,425.04,8,966588.36,1,1,7,6,True
3352601,679,0,451,7419,875833352,0,0,0,424.87,7,966163.49,24,0,8,6,True
3574749,867,0,451,9353,875833352,0,0,0,425.08,7,965738.41,24,2,14,7,True
3574823,14,2,20,6051,875833352,0,0,0,424.88,5,965313.53,24,1,1,8,True
3930022,867,0,30,6051,875833352,0,0,0,424.64,8,964888.89,24,5,23,8,True
3975006,1461,0,-1,9687,875833352,0,1,0,425.07,4,964888.89,11,1,13,8,True
4819428,1404,2,30,5163,875833352,0,0,0,425.17,8,964463.72,24,0,17,9,False
4841205,867,0,25,1654,875833352,0,0,0,424.92,8,964038.8,24,1,19,1,True
4846655,180,0,20,6978,875833352,0,0,0,425.03,3,963613.77,18,0,20,2,False
4849537,1404,2,30,9687,875833352,0,0,0,425.0,8,963188.77,24,0,23,4,True
5019746,81,0,20,9490,875833352,0,0,0,425.17,5,962763.6,1,6,1,4,True
5058820,679,0,25,1478,875833352,0,0,0,424.77,8,962338.83,24,3,5,4,True
5106699,1404,2,30,6978,875833352,0,0,0,425.13,8,961913.7,24,1,11,5,True
5435900,1252,4,30,1926,875833352,0,0,0,424.85,8,961488.85,23,3,19,5,True
5694306,1404,2,-1,8361,875833352,0,1,0,424.84,1,961488.85,24,6,8,5,True
5740134,1252,4,451,7453,875833352,0,0,0,424.98,7,961063.87,23,1,23,5,True
5859388,1252,4,25,9350,875833352,0,0,0,424.98,8,960638.89,23,2,18,6,False
6028907,198,0,20,7981,875833352,0,0,0,424.94,5,960213.95,18,0,4,7,True
6133329,736,1,10,5638,875833352,0,0,0,424.67,6,960638.62,11,2,5,8,True
6379321,218,0,10,1936,875833352,0,0,0,424.72,0,961063.34,9,0,20,8,True
6430938,610,0,20,8843,875833352,0,0,0,425.12,5,960638.22,11,5,16,9,True
6511765,956,1,10,5224,875833352,0,0,0,424.94,6,961063.16,13,0,8,9,True
6517114,90,4,451,7453,875833352,0,0,0,424.89,7,960638.27,1,4,17,10,True
6527822,867,0,30,5333,875833352,0,0,0,425.03,8,960213.24,24,2,5,10,True
6787369,867,0,-1,5638,875833352,0,1,0,425.04,1,960213.24,24,0,10,11,True
6832390,867,0,30,1654,875833352,0,0,0,424.9,8,959788.34,24,4,14,12,True
6871890,1338,0,20,3900,875833352,0,0,0,425.08,5,959363.26,18,2,7,12,True
7063032,334,0,20,9688,875833352,0,0,0,424.91,5,958938.35,11,2,19,1,True
7215590,1252,4,451,5246,875833352,0,0,0,424.72,7,958513.63,23,3,7,1,True
7215847,679,0,451,3900,875833352,0,0,0,424.89,7,958088.74,24,3,2,2,True
7430184,867,0,451,6269,875833352,0,0,0,425.08,7,957663.66,24,5,9,2,True
7842290,1404,2,451,8361,875833352,0,0,0,424.84,7,957238.82,24,5,5,3,True
7848554,867,0,30,6499,875833352,0,0,0,424.84,8,956813.98,24,1,6,4,True
8251295,867,0,30,8361,875833352,0,0,0,425.21,8,956388.77,24,1,11,4,True
8499926,747,1,10,9350,875833352,0,0,0,424.81,6,956813.58,24,6,3,5,True
8749684,1404,2,-1,9688,875833352,0,1,0,424.8,4,956813.58,24,6,5,5,True
8834120,1461,0,30,9687,875833352,0,0,0,424.94,8,956388.64,11,5,3,5,True
8888157,90,4,451,5333,875833352,0,0,0,425.14,7,955963.5,1,4,15,5,True
9086070,867,0,20,9688,875833352,0,0,0,425.16,3,955538.34,24,6,22,6,True
9134173,679,0,25,2014,875833352,0,0,0,424.91,8,955113.43,24,5,18,6,True
9157059,1461,0,30,9688,875833352,0,0,0,424.97,8,954688.46,11,0,11,7,True
9231872,867,0,30,5224,875833352,0,0,0,424.99,8,954263.47,24,3,15,7,True
9307227,889,0,10,2014,875833352,0,0,0,424.76,6,954688.23,27,3,2,8,True
9447845,497,0,10,5246,875833352,0,0,0,425.07,6,955113.3,12,0,11,9,True
9550292,1252,4,30,5525,875833352,0,0,0,425.05,8,954688.25,23,1,6,9,True
9806365,1404,2,451,7981,875833352,0,0,0,425.38,7,954262.87,24,3,7,9,True
9892384,679,0,30,6269,875833352,0,0,0,424.98,8,953837.89,24,0,12,10,True
9953853,95,2,20,7419,875833352,0,0,0,424.69,3,953413.2,1,5,7,10,True
9968540,1461,0,25,5638,875833352,0,0,0,425.12,8,952988.08,11,1,7,11,True
1277117,602,4,25,6617,389989706,0,0,0,1033.81,8,362920.19,24,6,18,1,True
1499092,497,0,-1,5258,389989706,0,1,0,1033.97,4,362920.19,12,6,10,2,True
1509101,734,0,10,1879,389989706,0,0,0,1033.96,6,363954.15,11,4,2,2,True
1720413,661,4,451,6048,389989706,0,0,0,1033.82,7,362920.33,18,4,4,3,True
1756557,662,1,25,1085,389989706,0,0,0,1034.24,8,361886.09,18,5,2,4,True
1841285,939,0,10,1079,389989706,0,0,0,1033.88,0,362919.97,24,1,8,4,True
1907307,661,4,30,1363,389989706,0,0,0,1034.03,8,361885.94,18,6,18,4,True
2014027,497,0,30,1879,389989706,0,0,0,1034.16,8,360851.78,12,2,4,5,True
2073429,661,4,451,6617,389989706,0,0,0,1033.87,7,359817.91,18,3,13,5,True
2175678,1273,0,20,7049,389989706,0,0,0,1033.88,5,358784.03,24,6,13,5,True
2296882,97,0,10,6090,389989706,0,0,0,1034.25,6,359818.28,3,6,20,6,True
2729211,482,1,10,2144,389989706,0,0,0,1034.04,6,360852.32,5,5,18,6,True
2746630,602,4,30,1819,389989706,0,0,0,1033.87,8,359818.45,24,5,22,7,True
2753292,602,4,30,4501,389989706,0,0,0,1033.95,8,358784.5,24,0,20,7,True
2865993,602,4,451,6617,389989706,0,0,0,1033.86,7,357750.64,24,0,21,8,True
2876078,602,4,30,5258,389989706,0,0,0,1033.9,8,356716.74,24,1,23,8,True
2976021,496,1,451,7075,389989706,0,0,0,1033.78,7,355682.96,12,4,20,9,True
3208421,497,0,25,7049,389989706,0,0,0,1034.12,8,354648.84,12,5,9,9,True
3677993,602,4,25,5152,389989706,0,0,0,1033.86,8,353614.98,24,6,15,10,True
3946401,496,1,25,5152,389989706,0,0,0,1033.82,8,352581.16,12,5,22,12,False
4005698,1116,0,10,6090,389989706,0,0,0,1034.22,6,353615.38,24,1,15,1,True
4105267,662,1,451,1879,389989706,0,0,0,1034.23,7,352581.15,18,4,8,1,False
4612802,662,1,-1,6090,389989706,0,1,0,1033.92,4,352581.15,18,5,4,1,True
4974203,602,4,451,6617,389989706,0,0,0,1034.12,7,351547.03,24,0,7,1,True
5210061,662,1,-1,7049,389989706,0,1,0,1034.09,4,351547.03,18,0,3,2,True
5264969,602,4,30,3534,389989706,0,0,0,1033.96,8,350513.07,24,5,7,4,True
5620924,496,1,451,1363,389989706,0,0,0,1034.01,7,349479.06,12,1,14,6,True
5635471,662,1,30,6048,389989706,0,0,0,1034.08,8,348444.98,18,1,13,6,True
5659863,602,4,25,2144,389989706,0,0,0,1033.93,8,347411.05,24,3,6,6,True
5867041,661,4,25,6617,389989706,0,0,0,1034.0,8,346377.05,18,4,23,9,True
6042345,602,4,30,1079,389989706,0,0,0,1033.76,8,345343.29,24,5,23,9,True
6165104,496,1,451,7075,389989706,0,0,0,1034.0,7,344309.29,12,1,13,10,True
6291516,573,0,20,1363,389989706,0,0,0,1033.93,5,343275.36,11,4,20,10,True
6418676,602,4,30,1819,389989706,0,0,0,1034.07,8,342241.29,24,2,22,11,True
6544760,665,2,20,7049,389989706,0,0,0,1034.07,3,341207.22,18,3,0,11,True
6546855,661,4,451,1879,389989706,0,0,0,1033.97,7,340173.25,18,6,0,11,True
6896717,602,4,-1,1079,389989706,0,1,0,1033.97,1,340173.25,24,6,18,11,True
6941261,661,4,451,4501,389989706,0,0,0,1033.99,7,339139.26,18,4,14,12,True
7236896,602,4,451,5258,389989706,0,0,0,1034.06,7,338105.2,24,1,14,1,True
7525643,1034,1,10,7049,389989706,0,0,0,1033.97,6,339139.17,11,6,3,1,True
7626092,497,0,20,5258,389989706,0,0,0,1033.92,5,338105.25,12,5,0,1,True
7712279,602,4,30,1085,389989706,0,0,0,1034.05,8,337071.2,24,6,1,4,True
7752061,496,1,451,1079,389989706,0,0,0,1033.88,7,336037.32,12,5,11,4,True
7767153,662,1,25,1819,389989706,0,0,0,1034.01,8,335003.31,18,2,7,5,False
7796435,602,4,30,6090,389989706,0,0,0,1034.0,8,333969.31,24,2,23,5,True
7857121,1142,2,20,1819,389989706,0,0,0,1033.93,3,332935.38,15,2,16,5,False
8075880,1255,0,20,3534,389989706,0,0,0,1034.11,3,331901.27,23,6,17,6,True
8220327,51,0,20,1085,389989706,0,0,0,1034.11,3,330867.16,20,3,23,7,True
8325234,602,4,451,4501,389989706,0,0,0,1033.95,7,329833.21,24,5,9,8,True
8496943,497,0,451,1085,389989706,0,0,0,1034.01,7,328799.2,12,3,0,8,True
8685538,1017,2,20,6090,389989706,0,0,0,1034.04,5,327765.16,26,5,1,8,True
8773205,661,4,25,7075,389989706,0,0,0,1033.85,8,326731.31,18,3,10,9,True
8906018,497,0,25,3534,389989706,0,0,0,1034.09,8,325697.22,12,5,3,9,True
9378783,1382,0,20,5152,389989706,0,0,0,1033.95,5,324663.27,16,6,11,9,True
9578599,1460,2,20,4501,389989706,0,0,0,1034.23,5,323629.04,11,5,6,10,True
9675075,385,1,10,7075,389989706,0,0,0,1034.08,6,324663.12,25,5,16,10,True
1416859,358,4,-1,3219,897188633,0,1,0,145.16,4,427987.0,24,6,13,1,True
1588856,887,2,451,9525,897188633,0,0,0,144.87,7,427842.13,27,6,1,2,True
1777029,1012,0,10,2986,897188633,0,0,0,144.91,6,427987.04,26,4,11,2,True
2049999,628,0,10,7955,897188633,0,0,0,145.02,6,428132.06,11,3,3,2,True
2268251,530,0,451,6830,897188633,0,0,0,144.94,7,427987.12,18,1,14,3,True
2321693,442,3,25,7217,897188633,0,0,0,145.14,8,427841.98,24,4,20,4,True
2468671,482,1,30,6329,897188633,0,0,0,145.09,8,427696.89,5,0,8,5,True
2484929,442,3,25,1830,897188633,0,0,0,145.06,8,427551.83,24,4,10,5,False
2779154,482,1,451,7273,897188633,0,0,0,144.96,7,427406.87,5,0,22,6,True
3219521,1112,1,10,4652,897188633,0,0,0,144.89,0,427551.76,0,4,13,7,True
3313805,482,1,25,8129,897188633,0,0,0,145.07,8,427406.69,5,6,18,7,True
3568711,530,0,30,7217,897188633,0,0,0,144.91,8,427261.78,18,2,17,8,True
3715168,358,4,-1,1661,897188633,0,1,0,144.99,1,427261.78,24,5,18,9,True
4053487,530,0,451,9525,897188633,0,0,0,145.07,7,427116.71,18,3,11,9,True
4081492,530,0,25,7273,897188633,0,0,0,144.91,8,426971.8,18,1,20,9,True
4231361,417,3,25,3666,897188633,0,0,0,145.12,8,426826.68,18,5,7,10,True
4333421,1354,0,25,1830,897188633,0,0,0,144.78,8,426681.9,24,6,4,10,True
4489163,358,4,451,3666,897188633,0,0,0,144.81,7,426537.09,24,5,11,10,True
4674811,825,2,30,9525,897188633,0,0,0,145.25,8,426391.84,18,1,7,11,True
5019736,147,0,20,2250,897188633,0,0,0,145.17,3,426246.67,18,6,0,12,True
5060520,482,1,25,8591,897188633,0,0,0,145.04,8,426101.63,5,6,11,12,True
5200813,887,2,30,1634,897188633,0,0,0,145.03,8,425956.6,27,0,11,1,True
5844966,417,3,30,3219,897188633,0,0,0,145.0,8,425811.6,18,0,18,1,False
5946026,358,4,451,9765,897188633,0,0,0,145.16,7,425666.44,24,0,16,2,True
5957503,358,4,451,8129,897188633,0,0,0,144.97,7,425521.47,24,6,23,2,True
6251687,825,2,451,6329,897188633,0,0,0,144.77,7,425376.7,18,1,9,2,True
6308004,518,2,20,2140,897188633,0,0,0,145.21,5,425231.49,18,4,0,3,True
6327937,297,0,10,8591,897188633,0,0,0,145.12,0,425376.61,4,1,17,3,True
6370911,358,4,451,9525,897188633,0,0,0,144.99,7,425231.62,24,4,11,6,True
6448948,854,0,20,1238,897188633,0,0,0,144.84,3,425086.78,24,0,17,7,True
6577117,358,4,451,4638,897188633,0,0,0,145.07,7,424941.71,24,5,6,7,True
6632156,792,1,10,2140,897188633,0,0,0,144.81,0,425086.52,11,3,8,8,True
6919435,442,3,-1,4652,897188633,0,1,0,144.93,1,425086.52,24,2,15,8,True
7071680,442,3,30,4007,897188633,0,0,0,144.74,8,424941.78,24,3,20,9,True
7146743,530,0,-1,2986,897188633,0,1,0,145.16,1,424941.78,18,5,3,10,True
7212978,358,4,-1,6830,897188633,0,2,0,145.23,4,424941.78,24,2,1,11,True
7536837,825,2,25,9525,897188633,0,0,0,144.74,8,424797.04,18,2,8,12,True
7593588,825,2,451,1238,897188633,0,0,0,145.32,7,424651.72,18,5,22,12,True
7775766,417,3,-1,4638,897188633,0,1,0,145.07,4,424651.72,18,3,9,1,True
7840327,482,1,-1,4652,897188633,0,2,0,145.36,4,424651.72,5,1,9,3,True
8008815,1426,1,10,4652,897188633,0,0,0,145.19,6,424796.91,24,6,12,3,True
8042887,979,0,20,6830,897188633,0,0,0,145.01,5,424651.9,22,3,11,4,True
8203531,482,1,25,7955,897188633,0,0,0,145.17,8,424506.73,5,5,8,4,True
8286572,887,2,451,4638,897188633,0,0,0,145.15,7,424361.58,27,6,10,4,True
8388506,1354,0,-1,1238,897188633,0,1,0,144.9,4,424361.58,24,6,23,4,True
8422037,417,3,451,6979,897188633,0,0,0,145.04,7,424216.54,18,1,14,4,True
8488869,358,4,451,1661,897188633,0,0,0,145.14,7,424071.4,24,0,14,5,True
8558019,825,2,451,9765,897188633,0,0,0,145.06,7,423926.34,18,2,20,6,True
8709621,887,2,25,3666,897188633,0,0,0,145.01,8,423781.33,27,2,3,7,True
8745392,358,4,451,8129,897188633,0,0,0,145.07,7,423636.26,24,2,23,7,True
8914563,358,4,451,2250,897188633,0,0,0,144.99,7,423491.27,24,3,19,7,True
8921597,358,4,451,1661,897188633,0,0,0,145.12,7,423346.15,24,5,0,9,True
8931674,1445,2,20,8591,897188633,0,0,0,145.15,5,423201.0,24,3,0,10,True
8971878,442,3,451,9765,897188633,0,0,0,145.11,7,423055.89,24,0,7,10,True
9142055,947,2,20,5547,897188633,0,0,0,145.2,5,422910.69,24,6,16,10,True
9344031,1246,0,20,3666,897188633,0,0,0,145.05,5,422765.64,23,1,15,11,True
9910113,442,3,25,2140,897188633,0,0,0,144.65,8,422620.99,24,4,15,11,True
9974832,714,2,20,4638,897188633,0,0,0,144.98,3,422476.01,18,2,0,11,True
1037562,739,1,30,6961,592340189,1,0,0,711.12,8,565820.88,24,5,1,2,True
1292829,739,1,451,7382,592340189,1,0,0,710.95,7,565109.93,24,0,14,3,True
1428807,327,0,10,8987,592340189,1,0,0,710.94,6,565820.87,11,3,6,3,True
1445349,486,4,451,6146,592340189,1,0,0,710.95,7,565109.92,5,4,0,3,True
1804658,486,4,451,5038,592340189,1,0,0,710.93,7,564398.99,5,4,5,3,False
2612345,371,3,30,1165,592340189,1,0,0,710.93,8,563688.06,25,0,17,4,True
2793816,187,4,451,9269,592340189,1,0,0,710.92,7,562977.14,18,1,20,6,True
3036541,486,4,451,7125,592340189,1,0,0,711.0,7,562266.14,5,5,18,7,True
3133235,22,3,-1,3087,592340189,1,1,0,710.96,1,562266.14,11,5,17,7,True
3177489,739,1,-1,6146,592340189,1,2,0,711.07,4,562266.14,24,6,9,8,True
3313780,739,1,451,1907,592340189,1,0,0,710.92,7,561555.22,24,4,22,8,True
3315268,486,4,451,6961,592340189,1,0,0,711.05,7,560844.17,5,3,0,8,True
3451142,1285,1,10,1907,592340189,1,0,0,711.01,6,561555.18,24,4,15,8,True
3753742,1068,2,20,6721,592340189,1,0,0,711.04,3,560844.14,18,5,10,8,False
3963172,1159,0,-1,6721,592340189,1,1,0,711.08,1,560844.14,15,1,5,8,True
4032611,739,1,25,9139,592340189,1,0,0,711.51,8,560132.63,24,5,4,10,True
4035975,1159,0,30,9843,592340189,1,0,0,711.06,8,559421.57,15,2,12,10,True
4169237,739,1,30,9088,592340189,1,0,0,710.94,8,558710.63,24,0,21,10,True
4306093,1159,0,451,3087,592340189,1,0,0,711.24,7,557999.39,15,1,20,11,True
4354916,371,3,451,3739,592340189,1,0,0,710.69,7,557288.7,25,4,21,11,True
4686663,22,3,30,1907,592340189,1,0,0,711.25,8,556577.45,11,3,22,12,True
4693506,586,4,30,3966,592340189,1,0,0,711.38,8,555866.07,24,2,23,12,True
4943935,486,4,451,7729,592340189,1,0,0,711.24,7,555154.83,5,1,14,1,True
5228212,1159,0,451,3739,592340189,1,0,0,710.94,7,554443.89,15,1,19,1,True
5254386,486,4,-1,9088,592340189,1,1,0,711.01,4,554443.89,5,1,17,1,False
5629006,371,3,451,9269,592340189,1,0,0,711.11,7,553732.78,25,6,23,3,False
5732329,1150,0,10,9269,592340189,1,0,0,710.78,0,554443.56,15,2,21,3,True
6189409,22,3,451,5761,592340189,1,0,0,711.21,7,553732.35,11,2,13,5,True
6288933,889,0,20,3087,592340189,1,0,0,710.91,5,553021.44,27,3,7,6,True
6498560,1247,0,10,8987,592340189,1,0,0,710.85,0,553732.29,23,3,10,6,True
6845738,22,3,25,9139,592340189,1,0,0,711.0,8,553021.29,11,5,22,7,True
6936491,1000,0,10,9843,592340189,1,0,0,710.97,6,553732.26,26,6,1,7,True
7109081,739,1,-1,1165,592340189,1,1,0,710.81,4,553732.26,24,5,0,8,True
7116467,947,2,20,7729,592340189,1,0,0,710.92,5,553021.34,24,4,9,9,True
7213742,371,3,451,9088,592340189,1,0,0,710.94,7,552310.4,25,2,9,9,True
7372353,371,3,451,4419,592340189,1,0,0,710.99,7,551599.41,25,5,17,10,True
7604070,993,0,20,5723,592340189,1,0,0,711.18,5,550888.23,22,3,11,11,True
7620674,739,1,451,1459,592340189,1,0,0,711.1,7,550177.13,24,2,14,12,True
7728329,371,3,-1,7382,592340189,1,1,0,711.26,4,550177.13,25,0,11,1,True
8036336,1023,2,20,5723,592340189,1,0,0,711.16,5,549465.97,11,5,14,1,True
8048865,371,3,451,3739,592340189,1,0,0,710.92,7,548755.05,25,6,16,1,True
8090852,22,3,30,9843,592340189,1,0,0,710.86,8,548044.19,11,4,6,1,True
8123020,486,4,451,1165,592340189,1,0,0,711.0,7,547333.19,5,5,2,2,True
8596945,739,1,30,3087,592340189,1,0,0,710.84,8,546622.35,24,4,13,2,True
8603030,187,4,30,5761,592340189,1,0,0,711.16,8,545911.19,18,5,18,2,True
8674815,187,4,25,4419,592340189,1,0,0,711.25,8,545199.94,18,1,21,4,True
8780560,818,1,10,1459,592340189,1,0,0,710.94,6,545910.88,18,4,12,4,True
8856382,22,3,30,3966,592340189,1,0,0,711.01,8,545199.87,11,6,3,5,True
9239432,586,4,451,5761,592340189,1,0,0,710.8,7,544489.07,24,4,22,5,True
9307175,1297,0,10,5761,592340189,1,0,0,711.14,6,545200.21,5,1,19,9,True
9811967,538,0,10,8757,592340189,1,0,0,711.43,6,545911.64,18,2,7,10,True
1041609,635,2,30,9947,469987837,0,0,0,761.8,8,688230.2,24,1,2,1,True
1118758,1041,0,25,9457,469987837,0,0,0,761.85,8,687468.35,11,3,6,1,True
1133418,800,0,10,9947,469987837,0,0,0,761.97,0,688230.32,11,5,2,1,True
1218187,1041,0,451,8187,469987837,0,0,0,761.99,7,687468.33,11,1,0,1,True
1268263,757,0,25,1680,469987837,0,0,0,762.12,8,686706.21,24,3,22,6,True
1590182,1052,0,-1,9447,469987837,0,1,0,762.14,1,686706.21,11,3,14,7,True
1707295,734,0,20,7215,469987837,0,0,0,762.07,5,685944.14,11,2,0,7,True
1722639,635,2,-1,3769,469987837,0,1,0,761.94,4,685944.14,24,2,11,7,True
1808913,1254,4,30,3769,469987837,0,0,0,762.14,8,685182.0,23,0,0,8,True
1955432,117,1,10,9947,469987837,0,0,0,761.83,6,685943.83,18,5,0,8,True
2161360,132,2,20,3769,469987837,0,0,0,761.91,5,685181.92,18,2,5,8,True
2259229,607,2,20,8187,469987837,0,0,0,762.14,3,684419.78,24,3,7,8,True
2901854,235,4,451,9447,469987837,0,0,0,762.44,7,683657.34,26,1,2,8,True
2908591,757,0,25,6867,469987837,0,0,0,761.86,8,682895.48,24,2,13,8,True
3298787,1486,2,20,9947,469987837,0,0,0,761.88,5,682133.6,24,0,23,9,True
3494364,635,2,30,1680,469987837,0,0,0,761.89,8,681371.71,24,1,16,11,True
3509270,1052,0,30,1680,469987837,0,0,0,761.95,8,680609.76,11,1,12,11,True
3694183,472,4,451,1680,469987837,0,0,0,762.02,7,679847.74,5,2,16,11,True
3833418,1254,4,25,9947,469987837,0,0,0,762.02,8,679085.72,23,4,11,12,True
3945601,472,4,25,7215,469987837,0,0,0,761.83,8,678323.89,5,2,23,1,True
3976356,1052,0,30,5337,469987837,0,0,0,761.94,8,677561.95,11,2,0,2,True
4110013,1075,0,20,9038,469987837,0,0,0,761.86,3,676800.09,18,4,17,2,True
4542312,1254,4,30,8187,469987837,0,0,0,762.34,8,676037.75,23,4,14,2,True
4569890,635,2,30,3769,469987837,0,0,0,762.15,8,675275.6,24,1,11,3,True
5074631,635,2,25,7595,469987837,0,0,0,762.07,8,674513.53,24,5,4,3,True
5340347,1052,0,-1,9457,469987837,0,1,0,761.99,4,674513.53,11,4,17,3,True
5352924,1254,4,25,7595,469987837,0,0,0,762.07,8,673751.46,23,6,12,5,True
5353636,472,4,451,9457,469987837,0,0,0,761.74,7,672989.72,5,0,6,6,True
5536215,757,0,451,9457,469987837,0,0,0,761.95,7,672227.77,24,3,3,6,False
5554194,1089,0,10,5590,469987837,0,0,0,761.98,6,672989.75,18,0,7,6,True
5770541,472,4,451,8809,469987837,0,0,0,762.1,7,672227.65,5,1,11,6,True
6281975,1113,1,10,3769,469987837,0,0,0,761.9,6,672989.55,0,4,12,8,True
6928233,635,2,451,5965,469987837,0,0,0,761.89,7,672227.66,24,3,4,10,True
7504199,235,4,30,9692,469987837,0,0,0,761.98,8,671465.68,26,1,5,12,True
7589658,757,0,25,9457,469987837,0,0,0,761.99,8,670703.69,24,4,11,2,True
7640305,635,2,25,8187,469987837,0,0,0,761.95,8,669941.74,24,1,1,2,True
7746496,757,0,30,5337,469987837,0,0,0,762.15,8,669179.59,24,1,9,2,True
7909388,472,4,451,8187,469987837,0,0,0,762.12,7,668417.47,5,6,2,3,True
8079371,1052,0,30,9692,469987837,0,0,0,761.93,8,667655.54,11,0,17,3,True
8252370,635,2,451,8187,469987837,0,0,0,761.82,7,666893.72,24,2,6,3,True
8274744,914,2,20,9038,469987837,0,0,0,761.88,5,666131.84,18,1,9,4,True
8457869,1041,0,-1,5590,469987837,0,1,0,761.78,1,666131.84,11,3,14,4,True
8731522,235,4,25,5337,469987837,0,0,0,762.0,8,665369.84,26,6,12,7,True
8797770,235,4,-1,6867,469987837,0,1,0,761.79,1,665369.84,26,4,2,7,True
8882183,757,0,30,6867,469987837,0,0,0,762.01,8,664607.83,24,2,23,8,True
9003121,262,2,20,8809,469987837,0,0,0,762.1,5,663845.73,6,3,8,8,True
9215722,472,4,30,8809,469987837,0,0,0,762.12,8,663083.61,5,1,4,9,True
9276979,757,0,-1,5480,469987837,0,1,0,762.09,4,663083.61,24,0,21,9,True
9329734,1063,0,20,5965,469987837,0,0,0,762.14,5,662321.47,11,4,11,10,True
9466807,1206,0,20,7595,469987837,0,0,0,762.11,5,661559.36,24,1,1,10,True
9731122,635,2,451,5337,469987837,0,0,0,762.03,7,660797.33,24,1,6,11,True
9886129,944,2,20,5965,469987837,0,0,0,762.13,3,660035.2,24,0,1,11,True
9937093,757,0,25,7215,469987837,0,0,0,762.03,8,659273.17,24,0,9,11,True
1462298,60,4,451,4176,986872878,0,0,0,494.12,7,981595.88,20,6,22,1,True
1473187,207,4,25,3525,986872878,0,0,0,494.01,8,981101.87,9,2,4,2,True
1565182,1098,4,-1,7654,986872878,0,1,0,493.96,1,981101.87,0,0,2,2,True
1658456,958,2,20,3832,986872878,0,0,0,493.93,5,980607.94,13,5,17,3,True
2048191,1098,4,451,5989,986872878,0,0,0,493.86,7,980114.08,0,6,0,4,True
2448514,207,4,25,6041,986872878,0,0,0,494.21,8,979619.87,9,1,10,4,True
2478731,1334,3,451,1367,986872878,0,0,0,493.94,7,979125.93,18,1,4,5,True
2598875,1334,3,451,1708,986872878,0,0,0,494.04,7,978631.89,18,2,8,6,True
2625813,1098,4,451,2488,986872878,0,0,0,494.11,7,978137.78,0,2,2,6,True
2695397,60,4,30,4832,986872878,0,0,0,493.64,8,977644.14,20,2,5,8,True
3034824,1334,3,25,6041,986872878,0,0,0,494.14,8,977150.0,18,3,19,8,False
3177650,1098,4,-1,1367,986872878,0,1,0,493.94,1,977150.0,0,0,19,9,True
3343801,60,4,25,4832,986872878,0,0,0,494.01,8,976655.99,20,3,11,9,True
3385852,1098,4,-1,8435,986872878,0,1,0,494.18,1,976655.99,0,0,18,9,True
3486054,60,4,25,1176,986872878,0,0,0,494.14,8,976161.85,20,2,12,9,True
3632613,207,4,451,1708,986872878,0,0,0,493.87,7,975667.98,9,5,10,12,True
3642601,1334,3,451,3638,986872878,0,0,0,493.88,7,975174.1,18,3,23,12,True
4018663,1098,4,451,3631,986872878,0,0,0,494.1,7,974680.0,0,6,1,1,True
4283325,300,0,20,9309,986872878,0,0,0,493.77,5,974186.23,4,6,17,1,True
4466169,603,0,20,3525,986872878,0,0,0,494.08,5,973692.15,24,0,12,2,True
4487687,594,0,20,8203,986872878,0,0,0,494.16,5,973197.99,24,3,9,2,True
4492839,28,1,10,3631,986872878,0,0,0,494.22,6,973692.21,11,4,19,2,True
4756628,1334,3,25,5989,986872878,0,0,0,494.11,8,973198.1,18,4,5,3,True
4978697,943,4,30,8190,986872878,0,0,0,494.34,8,972703.76,24,5,15,3,True
5124642,1098,4,451,1367,986872878,0,0,0,494.3,7,972209.46,0,1,9,6,True
5162640,60,4,30,1941,986872878,0,0,0,493.79,8,971715.67,20,3,20,6,False
5185362,60,4,30,6108,986872878,0,0,0,494.05,8,971221.62,20,0,11,6,True
5404773,943,4,451,9870,986872878,0,0,0,493.9,7,970727.72,24,0,13,7,True
5632670,943,4,451,3832,986872878,0,0,0,493.94,7,970233.78,24,4,8,8,True
5699776,1017,2,20,8435,986872878,0,0,0,493.96,3,969739.82,26,1,9,8,True
5759176,1334,3,30,1941,986872878,0,0,0,493.88,8,969245.94,18,1,3,8,True
5913216,207,4,-1,6786,986872878,0,1,0,494.0,1,969245.94,9,5,4,8,True
5950349,1098,4,25,3631,986872878,0,0,0,494.16,8,968751.78,0,5,20,9,True
6225426,1233,0,10,7219,986872878,0,0,0,493.73,0,969245.51,18,1,12,9,True
6358360,943,4,30,3832,986872878,0,0,0,493.96,8,968751.55,24,1,18,9,True
6570838,1334,3,451,7219,986872878,0,0,0,494.07,7,968257.48,18,6,18,10,True
7004874,60,4,451,8190,986872878,0,0,0,493.89,7,967763.59,20,3,6,10,True
7023931,60,4,30,1153,986872878,0,0,0,494.24,8,967269.35,20,1,17,10,True
7076885,889,0,20,3631,986872878,0,0,0,494.1,5,966775.25,27,2,14,11,True
7376944,60,4,25,2033,986872878,0,0,0,494.03,8,966281.22,20,3,1,11,True
7431653,943,4,30,7100,986872878,0,0,0,493.91,8,965787.31,24,6,15,12,True
7839426,1090,0,10,1153,986872878,0,0,0,493.86,6,966281.17,18,3,11,1,True
8039372,943,4,-1,6786,986872878,0,1,0,493.8,1,966281.17,24,4,16,3,True
8222074,1467,0,10,8435,986872878,0,0,0,493.95,0,966775.12,11,0,9,4,True
8387858,207,4,451,1941,986872878,0,0,0,494.45,7,966280.67,9,1,2,4,True
8676045,739,1,10,6108,986872878,0,0,0,493.97,6,966774.64,24,5,3,5,True
8785959,943,4,25,1708,986872878,0,0,0,494.21,8,966280.43,24,4,7,5,True
8911599,428,0,20,9483,986872878,0,0,0,494.03,5,965786.4,18,5,11,6,True
8980925,207,4,451,6041,986872878,0,0,0,493.85,7,965292.55,9,2,17,7,True
9045081,652,0,10,7607,986872878,0,0,0,493.67,6,965786.22,24,2,3,8,True
9161393,1098,4,-1,7100,986872878,0,1,0,494.03,1,965786.22,0,1,7,8,True
9267245,398,0,20,1153,986872878,0,0,0,493.72,3,965292.5,10,2,9,9,True
9750440,207,4,30,7219,986872878,0,0,0,493.75,8,964798.75,9,3,10,10,True
1121375,897,0,451,7061,841138163,1,0,0,940.26,7,146795.74,24,3,11,2,True
1160247,879,1,10,9002,841138163,1,0,0,940.26,6,147736.0,27,3,12,3,True
1490676,402,3,-1,3540,841138163,1,1,0,940.14,1,147736.0,10,0,2,3,True
1680146,1319,1,451,3540,841138163,1,0,0,939.91,7,146796.09,18,5,5,3,True
1812875,305,1,10,3595,841138163,1,0,0,939.9,0,147735.99,4,5,20,3,True
1952121,303,0,25,4612,841138163,1,0,0,939.7,8,146796.29,4,5,13,4,True
2500754,128,0,451,8874,841138163,1,0,0,940.01,7,145856.28,18,1,6,4,True
2501069,79,4,25,2492,841138163,1,0,0,940.29,8,144915.99,1,0,12,5,True
2634372,353,1,10,8544,841138163,1,0,0,940.09,6,145856.08,24,1,21,5,True
2676469,79,4,30,2741,841138163,1,0,0,939.79,8,144916.29,1,5,12,7,True
3294767,318,0,10,8906,841138163,1,0,0,939.8,0,145856.09,11,3,19,7,True
3356974,670,0,20,3484,841138163,1,0,0,939.89,3,144916.2,18,6,20,7,True
3410386,79,4,25,1111,841138163,1,0,0,939.88,8,143976.32,1,0,21,7,True
3453488,1319,1,30,2492,841138163,1,0,0,940.2,8,143036.12,18,2,2,8,True
3758932,599,0,20,8874,841138163,1,0,0,940.02,3,142096.1,24,1,17,8,True
4070843,1429,0,10,9002,841138163,1,0,0,939.72,6,143035.82,24,1,18,8,True
4073079,1391,2,20,9292,841138163,1,0,0,940.02,3,142095.8,24,2,11,8,True
4130943,128,0,30,8906,841138163,1,0,0,939.87,8,141155.93,18,1,10,9,True
4136588,79,4,451,6946,841138163,1,0,0,939.76,7,140216.17,1,0,1,10,True
4448835,734,0,20,8544,841138163,1,0,0,940.21,5,139275.96,11,2,7,11,True
4450175,358,4,30,7379,841138163,1,0,0,939.99,8,138335.97,24,6,17,11,True
4862441,1217,0,-1,9711,841138163,1,1,0,940.21,4,138335.97,24,4,7,12,True
4941463,897,0,451,3540,841138163,1,0,0,939.75,7,137396.22,24,3,9,12,True
4971922,1217,0,451,7036,841138163,1,0,0,940.29,7,136455.93,24,3,13,12,True
5063750,145,0,10,2857,841138163,1,0,0,940.21,0,137396.14,18,2,19,12,True
5193291,1319,1,25,2492,841138163,1,0,0,939.96,8,136456.18,18,0,9,1,True
5215336,1319,1,451,2741,841138163,1,0,0,940.06,7,135516.12,18,4,2,3,True
5316295,79,4,25,2022,841138163,1,0,0,939.97,8,134576.15,1,2,1,3,True
5336688,117,1,451,7956,841138163,1,0,0,939.91,7,133636.24,18,3,18,4,True
5472567,79,4,451,2022,841138163,1,0,0,939.91,7,132696.33,1,4,8,4,True
5722049,897,0,451,2741,841138163,1,0,0,939.88,7,131756.45,24,3,2,5,True
5796420,117,1,30,4612,841138163,1,0,0,940.1,8,130816.35,18,3,21,6,True
6007592,1336,2,20,2492,841138163,1,0,0,939.9,5,129876.45,18,2,8,8,True
6091232,402,3,451,7956,841138163,1,0,0,939.95,7,128936.5,10,1,14,10,True
6396694,1217,0,25,2022,841138163,1,0,0,939.64,8,127996.86,24,1,1,11,True
6505685,262,2,20,6946,841138163,1,0,0,939.87,5,127056.99,6,6,6,11,True
6576052,303,0,25,9172,841138163,1,0,0,940.09,8,126116.9,4,2,1,12,True
6915295,715,0,10,8874,841138163,1,0,0,940.11,0,127057.01,18,4,21,1,True
7714003,1352,1,10,4612,841138163,1,0,0,939.98,0,127996.99,24,0,9,1,True
8151694,732,0,10,6946,841138163,1,0,0,940.08,0,128937.07,11,6,15,2,True
8177133,234,0,20,4612,841138163,1,0,0,940.14,5,127996.93,26,3,22,2,True
8270790,79,4,-1,9711,841138163,1,1,0,939.94,4,127996.93,1,6,4,3,True
8597932,79,4,30,2857,841138163,1,0,0,940.1,8,127056.83,1,1,15,4,True
8702977,897,0,30,9002,841138163,1,0,0,940.06,8,126116.77,24,0,22,4,True
8733900,117,1,-1,8906,841138163,1,1,0,940.19,4,126116.77,18,4,7,4,True
9159212,128,0,-1,2741,841138163,1,2,0,939.94,4,126116.77,18,1,15,4,True
9223472,358,4,451,2741,841138163,1,0,0,939.95,7,125176.82,24,2,6,6,True
9389960,402,3,30,9292,841138163,1,0,0,940.18,8,124236.64,10,4,0,8,True
9657329,303,0,25,7379,841138163,1,0,0,940.06,8,123296.58,4,3,21,8,True
9676247,1217,0,25,7379,841138163,1,0,0,939.82,8,122356.76,24,3,23,9,True
9678060,117,1,451,2492,841138163,1,0,0,940.23,7,121416.53,18,4,1,10,True
1431175,1169,0,10,9608,141742574,0,0,0,141.17,0,921187.17,24,3,13,1,True
1576297,147,0,30,3671,141742574,0,0,0,140.98,8,921046.19,18,5,4,1,True
1612681,1116,0,451,4162,141742574,0,0,0,140.94,7,920905.25,24,5,13,2,True
1822758,503,0,10,3671,141742574,0,0,0,140.68,6,921045.93,12,4,3,5,True
2185512,1069,1,451,5492,141742574,0,0,0,140.86,7,920905.07,18,1,13,7,True
2323747,667,4,30,9608,141742574,0,0,0,140.87,8,920764.2,18,2,0,7,True
2487191,667,4,451,4979,141742574,0,0,0,141.0,7,920623.2,18,6,6,7,True
2506281,644,0,-1,7136,141742574,0,1,0,141.1,4,920623.2,24,4,3,9,True
2583312,644,0,25,5304,141742574,0,0,0,140.89,8,920482.31,24,5,9,10,True
3022118,222,2,20,4955,141742574,0,0,0,140.99,5,920341.32,26,4,2,11,True
3058114,438,1,10,4023,141742574,0,0,0,140.84,6,920482.16,24,4,15,12,True
3078066,1436,0,20,8878,141742574,0,0,0,140.79,5,920341.37,24,2,12,12,True
3090944,644,0,451,7136,141742574,0,0,0,141.2,7,920200.17,24,0,19,1,True
3236295,667,4,451,5446,141742574,0,0,0,140.86,7,920059.31,18,0,9,1,True
3448465,667,4,25,7136,141742574,0,0,0,140.91,8,919918.4,18,0,10,2,True
3520902,644,0,25,9816,141742574,0,0,0,140.98,8,919777.42,24,5,20,2,True
3572098,1411,0,10,9812,141742574,0,0,0,141.12,0,919918.54,24,6,21,2,True
3581773,1364,0,20,6067,141742574,0,0,0,141.06,5,919777.48,16,0,20,3,True
3591422,1116,0,451,4910,141742574,0,0,0,141.2,7,919636.28,24,1,14,5,True
3836608,1069,1,-1,3378,141742574,0,1,0,141.13,4,919636.28,18,6,23,5,True
4087112,1069,1,451,4654,141742574,0,0,0,141.04,7,919495.24,18,1,18,6,True
4506667,644,0,30,5242,141742574,0,0,0,141.05,8,919354.19,24,4,1,6,True
4582391,1065,0,10,6708,141742574,0,0,0,141.02,0,919495.21,11,3,10,6,True
4695791,667,4,451,4955,141742574,0,0,0,141.03,7,919354.18,18,5,12,7,True
4716953,644,0,-1,5304,141742574,0,1,0,141.13,1,919354.18,24,6,16,8,True
4782317,1027,0,-1,6276,141742574,0,2,0,140.9,1,919354.18,11,2,11,9,True
5418499,1000,0,20,9178,141742574,0,0,0,141.12,5,919213.06,26,2,17,10,True
5462931,644,0,451,3378,141742574,0,0,0,140.94,7,919072.12,24,3,2,10,True
5605313,1039,1,10,9816,141742574,0,0,0,140.99,6,919213.11,11,3,6,11,True
6056330,644,0,30,4955,141742574,0,0,0,141.05,8,919072.06,24,4,3,12,True
6101172,667,4,-1,4979,141742574,0,1,0,140.93,4,919072.06,18,2,20,12,True
6166241,667,4,451,1294,141742574,0,0,0,141.04,7,918931.02,18,1,17,12,True
6386427,955,4,451,5359,141742574,0,0,0,140.94,7,918790.08,13,0,6,1,True
6386720,848,2,20,4955,141742574,0,0,0,141.07,5,918649.01,5,6,18,1,True
6399253,428,0,10,4955,141742574,0,0,0,140.84,0,918789.85,18,6,10,3,True
6667652,955,4,25,3378,141742574,0,0,0,140.97,8,918648.88,13,2,3,3,True
6712891,147,0,451,9421,141742574,0,0,0,141.06,7,918507.82,18,0,4,3,True
7023611,667,4,25,9608,141742574,0,0,0,140.91,8,918366.91,18,6,2,3,True
7030777,1027,0,-1,4910,141742574,0,1,0,141.06,4,918366.91,11,2,23,4,True
7407013,1069,1,-1,5304,141742574,0,2,0,141.1,4,918366.91,18,0,15,4,True
7563047,1027,0,30,9478,141742574,0,0,0,140.81,8,918226.1,11,3,10,5,True
7648791,667,4,-1,9460,141742574,0,1,0,141.02,1,918226.1,18,5,9,5,True
8019372,1356,2,20,9665,141742574,0,0,0,141.25,3,918084.85,24,5,4,5,True
8039334,1116,0,25,3671,141742574,0,0,0,140.77,8,917944.08,24,5,18,5,True
8134239,1116,0,451,1322,141742574,0,0,0,140.96,7,917803.12,24,0,13,5,True
8179605,667,4,-1,4023,141742574,0,1,0,141.05,4,917803.12,18,1,2,5,True
8337537,1027,0,451,1294,141742574,0,0,0,141.25,7,917661.87,11,5,3,6,True
8491279,1069,1,451,5359,141742574,0,0,0,141.31,7,917520.56,18,4,14,6,True
8555416,147,0,-1,4162,141742574,0,1,0,141.14,1,917520.56,18,0,5,7,True
8585462,955,4,25,4162,141742574,0,0,0,140.93,8,917379.63,13,1,7,7,True
9426113,312,0,20,5492,141742574,0,0,0,140.72,3,917238.91,4,2,2,9,True
9555180,1116,0,25,5304,141742574,0,0,0,140.99,8,917097.92,24,4,15,9,True
9595690,147,0,451,5304,141742574,0,0,0,140.76,7,916957.16,18,3,21,9,True
9766415,23,0,20,3671,141742574,0,0,0,140.69,5,916816.47,11,5,21,9,True
9890713,147,0,451,6708,141742574,0,0,0,141.01,7,916675.46,18,4,12,10,True
9944398,147,0,25,9608,141742574,0,0,0,141.02,8,916534.44,18,0,17,11,True
9990209,1116,0,-1,5492,141742574,0,1,0,141.17,4,916534.44,24,2,12,11,True
1017291,224,3,-1,4943,891345584,1,1,0,584.02,1,102411.0,26,6,18,1,True
1114127,1189,2,20,5941,891345584,1,0,0,583.95,5,101827.05,24,2,14,3,True
1196281,1315,0,451,8982,891345584,1,0,0,583.82,7,101243.23,5,5,23,4,True
1251534,254,0,10,2153,891345584,1,0,0,584.12,6,101827.35,6,5,7,4,True
1352626,1426,1,10,4969,891345584,1,0,0,583.92,6,102411.27,24,0,13,5,True
1371042,594,0,20,7582,891345584,1,0,0,583.86,5,101827.41,24,2,8,5,True
1415009,1315,0,451,2436,891345584,1,0,0,584.13,7,101243.28,5,6,1,5,True
1435828,1127,0,10,7582,891345584,1,0,0,584.15,6,101827.43,24,0,23,6,True
1849284,1086,0,20,7214,891345584,1,0,0,584.01,3,101243.42,18,4,5,6,True
2255913,175,3,30,6884,891345584,1,0,0,584.0,8,100659.42,24,2,9,6,True
2851546,137,2,30,4943,891345584,1,0,0,583.74,8,100075.68,18,6,16,7,True
2865600,193,1,10,2153,891345584,1,0,0,584.12,6,100659.8,18,0,22,7,True
3173724,1388,1,25,3626,891345584,1,0,0,584.21,8,100075.59,24,6,9,7,True
3330494,1380,0,20,4943,891345584,1,0,0,584.0,5,99491.59,16,4,0,8,True
3898638,175,3,451,4969,891345584,1,0,0,584.12,7,98907.47,24,1,1,8,True
4208314,224,3,30,9125,891345584,1,0,0,583.89,8,98323.58,26,0,22,8,True
4240255,942,0,-1,8487,891345584,1,1,0,584.15,4,98323.58,24,1,4,10,True
4564177,1315,0,30,6746,891345584,1,0,0,583.82,8,97739.76,5,2,17,10,True
4625784,224,3,25,2436,891345584,1,0,0,584.2,8,97155.56,26,5,5,10,True
4722647,550,0,10,8971,891345584,1,0,0,584.11,0,97739.67,17,2,5,11,True
4752341,175,3,451,2436,891345584,1,0,0,583.89,7,97155.78,24,4,11,11,True
4883183,224,3,30,7126,891345584,1,0,0,583.91,8,96571.87,26,3,18,12,True
5156015,137,2,30,6884,891345584,1,0,0,584.04,8,95987.83,18,6,21,12,True
5172322,942,0,-1,3626,891345584,1,1,0,584.02,4,95987.83,24,4,9,12,True
5263210,224,3,25,7582,891345584,1,0,0,583.76,8,95404.07,26,5,17,12,True
5272870,137,2,451,8982,891345584,1,0,0,583.92,7,94820.15,18,0,22,12,True
5460491,224,3,30,3626,891345584,1,0,0,583.99,8,94236.16,26,3,17,2,True
5503057,224,3,451,4943,891345584,1,0,0,584.0,7,93652.16,26,6,16,3,True
5546430,942,0,451,4045,891345584,1,0,0,584.02,7,93068.14,24,4,15,4,True
5802835,224,3,30,5941,891345584,1,0,0,583.92,8,92484.22,26,6,17,4,True
6315422,1388,1,451,7582,891345584,1,0,0,583.96,7,91900.26,24,2,0,5,True
6392467,711,2,20,5665,891345584,1,0,0,584.08,5,91316.18,18,6,3,5,True
6487704,1315,0,451,4943,891345584,1,0,0,584.14,7,90732.04,5,3,20,5,True
6672253,1388,1,-1,8982,891345584,1,1,0,583.85,1,90732.04,24,4,8,6,True
6716268,1364,0,10,2153,891345584,1,0,0,584.24,6,91316.28,16,2,0,8,True
6743414,1315,0,451,5941,891345584,1,0,0,583.94,7,90732.34,5,5,3,10,True
7383551,1278,0,10,2345,891345584,1,0,0,583.97,6,91316.31,24,6,16,10,True
7728398,942,0,25,8487,891345584,1,0,0,584.03,8,90732.28,24,0,21,12,True
7811977,224,3,-1,3873,891345584,1,1,0,584.09,4,90732.28,26,2,20,1,True
8043377,1388,1,25,8487,891345584,1,0,0,584.13,8,90148.15,24,5,16,2,True
8090928,1315,0,451,4045,891345584,1,0,0,583.99,7,89564.16,5,1,17,2,True
8593034,64,0,20,4943,891345584,1,0,0,584.07,5,88980.09,20,6,19,3,True
8703621,942,0,451,8270,891345584,1,0,0,583.98,7,88396.11,24,6,22,3,True
8880544,137,2,451,5941,891345584,1,0,0,583.93,7,87812.18,18,3,4,3,True
8881799,254,0,20,8982,891345584,1,0,0,583.7,5,87228.48,6,3,5,4,True
8944401,1023,2,20,2345,891345584,1,0,0,583.9,5,86644.58,11,6,8,7,True
9027207,1388,1,30,7126,891345584,1,0,0,583.78,8,86060.8,24,1,21,7,True
9259755,942,0,-1,5941,891345584,1,1,0,584.08,1,86060.8,24,3,6,7,True
9308242,818,1,10,4701,891345584,1,0,0,583.79,6,86644.59,18,1,3,8,True
9766734,224,3,-1,3501,891345584,1,1,0,584.09,1,86644.59,26,2,12,9,True
9919406,1315,0,30,3501,891345584,1,0,0,584.18,8,86060.41,5,2,17,9,True
9953392,1315,0,451,3873,891345584,1,0,0,584.18,7,85476.23,5,5,18,10,True
9992847,812,0,20,7126,891345584,1,0,0,584.06,5,84892.17,18,4,3,11,True
1006393,749,4,30,3547,607670112,1,0,0,819.97,8,552373.03,24,5,5,1,True
1040404,939,0,-1,1327,607670112,1,1,0,819.99,1,552373.03,24,1,11,1,True
1224881,240,4,-1,6729,607670112,1,2,0,820.0,4,552373.03,26,0,22,1,True
1288987,749,4,30,3362,607670112,1,0,0,820.05,8,551552.98,24,5,17,3,True
1294704,1215,3,30,7325,607670112,1,0,0,819.9,8,550733.08,24,5,20,3,True
1338787,428,0,30,5144,607670112,1,0,0,820.05,8,549913.03,18,3,2,3,True
1481814,1247,0,20,4158,607670112,1,0,0,819.73,5,549093.3,23,6,19,4,True
1542716,626,2,20,5144,607670112,1,0,0,820.13,3,548273.17,11,2,10,4,True
1933777,240,4,25,6729,607670112,1,0,0,820.29,8,547452.88,26,2,11,5,True
2254765,240,4,25,2718,607670112,1,0,0,820.17,8,546632.71,26,3,18,5,True
2656893,939,0,25,2718,607670112,1,0,0,820.06,8,545812.65,24,0,17,6,True
3003440,421,3,30,6729,607670112,1,0,0,819.87,8,544992.78,18,4,5,7,True
3074977,1215,3,451,4763,607670112,1,0,0,820.1,7,544172.68,24,4,2,7,True
3090265,421,3,451,4763,607670112,1,0,0,820.08,7,543352.6,18,2,6,8,True
3124550,474,4,30,5144,607670112,1,0,0,819.88,8,542532.72,5,1,2,9,True
3494556,749,4,451,3547,607670112,1,0,0,819.76,7,541712.96,24,6,15,9,True
3981032,785,0,10,4416,607670112,1,0,0,820.26,6,542533.22,14,6,7,9,True
4183693,749,4,25,3674,607670112,1,0,0,820.03,8,541713.19,24,6,15,10,True
4215294,240,4,451,1527,607670112,1,0,0,820.06,7,540893.13,26,1,10,10,False
4256461,1215,3,30,5144,607670112,1,0,0,820.15,8,540072.98,24,5,2,11,True
4469350,428,0,451,4158,607670112,1,0,0,819.81,7,539253.17,18,2,23,11,True
4908041,1215,3,30,7325,607670112,1,0,0,819.88,8,538433.29,24,3,22,12,True
4949827,1215,3,451,4763,607670112,1,0,0,820.21,7,537613.08,24,4,3,2,True
5010620,428,0,30,6729,607670112,1,0,0,819.86,8,536793.22,18,4,15,3,True
5392644,51,0,20,7260,607670112,1,0,0,820.03,5,535973.19,20,6,23,3,True
5647078,240,4,30,7653,607670112,1,0,0,820.19,8,535153.0,26,3,6,3,True
5739804,939,0,451,2770,607670112,1,0,0,819.81,7,534333.19,24,6,10,4,True
6013535,749,4,30,4158,607670112,1,0,0,820.02,8,533513.17,24,4,20,5,True
6173592,1215,3,30,8384,607670112,1,0,0,819.92,8,532693.25,24,4,22,5,True
6180131,240,4,-1,3362,607670112,1,1,0,820.02,1,532693.25,26,2,1,6,True
6441754,749,4,451,4763,607670112,1,0,0,820.23,7,531873.02,24,5,7,6,True
6512760,421,3,451,3547,607670112,1,0,0,819.81,7,531053.21,18,6,1,7,True
6519605,474,4,25,2500,607670112,1,0,0,820.29,8,530232.92,5,4,14,8,True
6651415,428,0,451,3362,607670112,1,0,0,819.78,7,529413.14,18,2,13,9,True
6870200,749,4,-1,8374,607670112,1,1,0,820.02,1,529413.14,24,5,21,10,True
6942447,939,0,451,5886,607670112,1,0,0,819.87,7,528593.27,24,1,2,11,True
7014861,474,4,-1,4158,607670112,1,1,0,820.17,1,528593.27,5,5,6,12,True
7113445,421,3,25,7325,607670112,1,0,0,820.12,8,527773.15,18,0,19,12,True
7373879,421,3,-1,9475,607670112,1,1,0,820.13,1,527773.15,18,6,12,12,True
7375642,1215,3,451,1527,607670112,1,0,0,819.9,7,526953.25,24,2,12,1,True
7709044,428,0,30,3547,607670112,1,0,0,820.2,8,526133.05,18,5,10,1,True
7719632,939,0,25,3547,607670112,1,0,0,819.96,8,525313.09,24,0,14,1,True
7926736,1205,0,20,7260,607670112,1,0,0,820.09,5,524493.0,24,0,16,2,True
7986408,421,3,30,5144,607670112,1,0,0,819.99,8,523673.01,18,4,6,3,True
8072778,240,4,451,7260,607670112,1,0,0,819.78,7,522853.23,26,1,5,3,True
8321515,474,4,25,4771,607670112,1,0,0,819.93,8,522033.3,5,1,16,4,True
8380060,421,3,-1,7653,607670112,1,1,0,820.18,4,522033.3,18,0,10,5,True
8431747,474,4,451,8374,607670112,1,0,0,819.94,7,521213.36,5,4,23,5,True
8451295,421,3,30,7260,607670112,1,0,0,820.08,8,520393.28,18,2,1,7,True
8571814,1140,0,20,4771,607670112,1,0,0,819.95,3,519573.33,15,5,17,7,True
8939754,474,4,25,3547,607670112,1,0,0,820.32,8,518753.01,5,1,20,9,True
9106933,421,3,25,1231,607670112,1,0,0,820.05,8,517932.96,18,6,9,9,True
9563891,1215,3,451,4200,607670112,1,0,0,820.06,7,517112.9,24,2,17,9,True
9992851,1175,2,20,6729,607670112,1,0,0,820.11,5,516292.79,24,0,4,11,True
1150484,428,0,-1,3323,621991980,1,1,0,835.94,4,714027.0,18,5,21,1,True
1278702,108,2,20,1042,621991980,1,0,0,836.03,3,713190.97,3,2,4,3,True
1320483,428,0,451,1834,621991980,1,0,0,836.01,7,712354.96,18,1,10,3,True
1756981,215,0,10,8177,621991980,1,0,0,836.01,6,713190.97,9,3,3,4,True
2523346,618,3,30,1042,621991980,1,0,0,836.01,8,712354.96,11,3,11,5,True
2675834,618,3,-1,7028,621991980,1,1,0,836.17,1,712354.96,11,0,18,5,True
2679204,428,0,30,1959,621991980,1,0,0,835.92,8,711519.04,18,5,11,6,True
2939536,811,0,-1,4697,621991980,1,1,0,835.92,4,711519.04,18,5,20,7,True
3100740,618,3,-1,7177,621991980,1,2,0,836.09,1,711519.04,11,0,1,7,True
3517921,618,3,25,7028,621991980,1,0,0,835.91,8,710683.13,11,6,9,8,True
3653688,198,0,451,1834,621991980,1,0,0,836.2,7,709846.93,18,5,16,8,True
3844525,428,0,451,7591,621991980,1,0,0,836.29,7,709010.64,18,6,10,9,True
4120726,1119,0,25,3323,621991980,1,0,0,835.88,8,708174.76,24,6,9,10,True
4242508,618,3,30,1042,621991980,1,0,0,836.45,8,707338.31,11,0,14,10,True
4341076,618,3,451,7177,621991980,1,0,0,835.92,7,706502.39,11,6,6,10,True
4574157,956,1,10,7177,621991980,1,0,0,835.98,6,707338.37,13,0,19,10,True
4590854,599,0,10,7177,621991980,1,0,0,836.26,6,708174.63,24,3,8,11,True
4621281,1093,0,20,4691,621991980,1,0,0,835.81,5,707338.82,18,1,12,1,True
4639049,1004,4,451,1834,621991980,1,0,0,835.87,7,706502.95,26,3,11,2,True
4997318,618,3,-1,1042,621991980,1,1,0,835.93,4,706502.95,11,5,14,2,True
5059645,618,3,451,1959,621991980,1,0,0,835.98,7,705666.97,11,0,9,2,True
5070456,703,0,25,4697,621991980,1,0,0,836.23,8,704830.74,18,5,4,3,False
5220713,1119,0,30,8177,621991980,1,0,0,836.06,8,703994.68,24,5,13,3,True
5807727,512,0,10,3323,621991980,1,0,0,835.93,6,704830.61,12,1,0,4,True
5870800,594,0,10,4697,621991980,1,0,0,836.1,6,705666.71,24,3,9,4,True
5876164,198,0,451,7177,621991980,1,0,0,836.0,7,704830.71,18,4,7,4,False
6090254,703,0,451,4185,621991980,1,0,0,836.11,7,703994.6,18,5,14,4,True
6289879,299,1,10,7177,621991980,1,0,0,836.19,6,704830.79,4,3,7,4,True
6451291,459,1,10,1959,621991980,1,0,0,835.99,6,705666.78,13,6,4,5,True
6488661,703,0,25,1042,621991980,1,0,0,836.22,8,704830.56,18,3,19,5,True
6579288,198,0,25,5719,621991980,1,0,0,836.16,8,703994.4,18,5,11,7,True
6850934,1119,0,30,4697,621991980,1,0,0,835.86,8,703158.54,24,2,14,7,True
6953566,1004,4,30,7313,621991980,1,0,0,836.02,8,702322.52,26,3,3,7,True
7238289,1004,4,451,1959,621991980,1,0,0,836.04,7,701486.48,26,3,17,8,True
7247547,198,0,-1,1959,621991980,1,1,0,836.14,4,701486.48,18,6,22,8,True
7469964,198,0,25,7591,621991980,1,0,0,835.95,8,700650.53,18,0,18,8,True
7686915,1029,0,10,3323,621991980,1,0,0,835.68,0,701486.21,11,4,9,9,True
7738610,703,0,25,7313,621991980,1,0,0,836.27,8,700649.94,18,0,14,9,True
7792252,1119,0,30,7028,621991980,1,0,0,835.91,8,699814.03,24,4,17,10,True
7845329,1004,4,451,7028,621991980,1,0,0,835.84,7,698978.19,26,0,17,11,True
7859613,1044,0,20,5719,621991980,1,0,0,836.26,5,698141.93,11,5,13,1,True
7880204,804,0,10,1834,621991980,1,0,0,836.14,6,698978.07,11,5,23,1,True
7891072,703,0,451,7177,621991980,1,0,0,836.24,7,698141.83,18,1,10,1,True
8029491,998,0,10,7591,621991980,1,0,0,835.87,0,698977.7,26,6,9,2,True
8354840,1004,4,30,3323,621991980,1,0,0,835.86,8,698141.84,26,2,9,2,True
8373162,428,0,451,7177,621991980,1,0,0,835.97,7,697305.87,18,1,6,3,True
8627867,343,1,10,8537,621991980,1,0,0,835.96,6,698141.83,24,6,0,3,True
8639244,1119,0,451,8567,621991980,1,0,0,836.17,7,697305.66,24,3,22,4,True
9079709,1004,4,-1,4697,621991980,1,1,0,835.99,4,697305.66,26,1,17,6,True
9397431,1119,0,25,1228,621991980,1,0,0,835.91,8,696469.75,24,1,8,8,True
9434124,428,0,451,1042,621991980,1,0,0,836.12,7,695633.63,18,2,7,8,True
9687201,811,0,451,7591,621991980,1,0,0,835.85,7,694797.78,18,1,12,9,True
9837916,1052,0,20,1129,621991980,1,0,0,835.85,5,693961.93,11,1,19,9,True
9952329,1119,0,30,8537,621991980,1,0,0,835.95,8,693125.98,24,0,18,11,True
1121200,549,1,10,4055,473887976,1,0,0,737.98,0,175497.98,17,5,17,1,True
1290732,1047,3,30,4055,473887976,1,0,0,737.94,8,174760.04,11,2,21,1,True
1384882,551,0,10,2487,473887976,1,0,0,738.12,6,175498.16,17,6,4,2,False
1455561,1047,3,451,6269,473887976,1,0,0,737.84,7,174760.32,11,0,14,3,True
1457127,810,4,-1,5365,473887976,1,1,0,737.83,1,174760.32,18,5,3,3,True
1507715,1035,0,20,2529,473887976,1,0,0,737.92,5,174022.4,11,1,1,3,True
1539453,1206,0,20,2529,473887976,1,0,0,738.16,3,173284.24,24,2,12,4,True
1652748,649,0,20,1866,473887976,1,0,0,737.99,5,172546.25,24,4,12,4,True
1763211,202,4,-1,2487,473887976,1,1,0,737.93,1,172546.25,9,0,23,8,True
1882842,1220,3,451,2601,473887976,1,0,0,738.05,7,171808.2,24,6,4,8,True
1981041,1047,3,25,7995,473887976,1,0,0,737.87,8,171070.33,11,2,16,9,True
2434559,810,4,451,4055,473887976,1,0,0,737.84,7,170332.49,18,0,23,9,True
2553597,1220,3,30,6566,473887976,1,0,0,738.13,8,169594.36,24,1,21,9,True
2753442,873,4,30,5365,473887976,1,0,0,738.0,8,168856.36,24,4,7,10,True
2851417,406,1,30,8298,473887976,1,0,0,738.25,8,168118.11,10,3,10,10,True
2869125,1266,4,451,9587,473887976,1,0,0,737.88,7,167380.23,23,1,22,11,True
2902970,705,1,10,4055,473887976,1,0,0,738.0,6,168118.23,18,3,15,12,True
3021228,1044,0,25,4425,473887976,1,0,0,738.07,8,167380.16,11,5,7,12,True
3679924,1044,0,25,1020,473887976,1,0,0,737.93,8,166642.23,11,6,7,1,True
3724387,1266,4,30,9587,473887976,1,0,0,737.84,8,165904.39,23,6,8,1,True
3974966,303,0,-1,9587,473887976,1,1,0,737.85,4,165904.39,4,1,0,2,True
4250854,406,1,451,5365,473887976,1,0,0,738.17,7,165166.22,10,1,1,4,False
4450208,1220,3,451,7346,473887976,1,0,0,737.8,7,164428.42,24,6,23,4,True
4520035,1044,0,-1,8882,473887976,1,1,0,738.09,1,164428.42,11,3,0,5,True
4587631,705,1,10,8677,473887976,1,0,0,737.97,6,165166.39,18,2,7,6,True
4890686,689,0,20,7418,473887976,1,0,0,737.91,5,164428.48,24,1,20,7,False
4894535,873,4,-1,1866,473887976,1,1,0,738.13,4,164428.48,24,1,12,8,True
5176269,873,4,451,5365,473887976,1,0,0,738.0,7,163690.48,24,4,8,9,True
5328101,1044,0,30,9290,473887976,1,0,0,737.99,8,162952.49,11,4,8,9,True
5426507,202,4,451,8298,473887976,1,0,0,737.8,7,162214.69,9,4,0,9,True
5439440,303,0,451,2601,473887976,1,0,0,738.26,7,161476.43,4,4,23,9,True
5645955,303,0,451,8882,473887976,1,0,0,737.86,7,160738.57,4,2,11,10,True
5697658,642,0,20,1933,473887976,1,0,0,737.76,3,160000.81,24,0,1,10,True
5711062,1266,4,451,9290,473887976,1,0,0,737.86,7,159262.95,23,1,11,10,True
5808138,1266,4,451,4055,473887976,1,0,0,738.01,7,158524.94,23,2,14,10,True
6229874,303,0,451,1785,473887976,1,0,0,738.1,7,157786.84,4,3,12,11,True
6251722,406,1,-1,1933,473887976,1,1,0,737.95,4,157786.84,10,5,11,11,True
6963786,679,0,20,7346,473887976,1,0,0,738.2,5,157048.64,24,5,0,12,True
7042813,320,1,10,5365,473887976,1,0,0,737.94,6,157786.58,11,0,15,12,False
7139608,202,4,451,2529,473887976,1,0,0,738.08,7,157048.5,9,0,18,1,True
7217998,126,1,10,7418,473887976,1,0,0,738.0,6,157786.5,18,6,9,1,True
7324303,531,0,10,4425,473887976,1,0,0,738.13,6,158524.63,18,5,3,2,True
7471149,303,0,451,2893,473887976,1,0,0,738.15,7,157786.48,4,0,11,2,True
7633060,1044,0,25,1785,473887976,1,0,0,738.06,8,157048.42,11,1,6,2,True
7646760,873,4,30,8882,473887976,1,0,0,738.01,8,156310.41,24,4,0,3,True
7922766,860,1,10,8298,473887976,1,0,0,737.98,6,157048.39,24,1,6,5,True
8060223,873,4,451,7346,473887976,1,0,0,738.15,7,156310.24,24,3,0,7,True
8380987,76,0,20,2601,473887976,1,0,0,737.66,3,155572.58,20,4,23,7,False
8710872,1266,4,30,2487,473887976,1,0,0,737.98,8,154834.6,23,5,8,7,True
8721623,1220,3,-1,6957,473887976,1,1,0,737.71,4,154834.6,24,0,11,9,True
9347243,202,4,451,4055,473887976,1,0,0,737.87,7,154096.73,9,0,0,9,True
9363365,1044,0,-1,4425,473887976,1,1,0,738.02,1,154096.73,11,3,19,11,True
9814831,810,4,25,4053,473887976,1,0,0,737.97,8,153358.76,18,4,3,11,True
9832211,1047,3,30,1785,473887976,1,0,0,738.5,8,152620.26,11,6,7,11,True
9909122,1220,3,30,4055,473887976,1,0,0,738.24,8,151882.02,24,2,14,11,True
1151267,1270,1,451,4518,184285368,0,0,0,1186.11,7,221948.89,23,1,5,1,True
1504261,736,1,30,6665,184285368,0,0,0,1185.88,8,220763.01,11,1,22,2,True
1505879,1410,1,451,1568,184285368,0,0,0,1186.06,7,219576.95,24,3,6,4,True
1688608,1246,0,30,2119,184285368,0,0,0,1185.85,8,218391.1,23,1,7,5,True
1930739,1410,1,25,6662,184285368,0,0,0,1185.87,8,217205.23,24,4,13,5,True
2082155,331,4,-1,7506,184285368,0,1,0,1186.08,1,217205.23,11,4,15,6,True
2089405,1000,0,20,9961,184285368,0,0,0,1185.85,5,216019.38,26,6,7,7,True
2133109,1065,0,10,8566,184285368,0,0,0,1185.95,0,217205.33,11,0,20,8,True
2419550,1270,1,451,8185,184285368,0,0,0,1186.0,7,216019.33,23,4,14,9,True
3093688,1270,1,30,8185,184285368,0,0,0,1186.18,8,214833.15,23,6,8,9,True
3152146,688,0,10,8820,184285368,0,0,0,1185.9,6,216019.05,24,4,9,9,True
3168397,644,0,20,2463,184285368,0,0,0,1185.98,5,214833.07,24,5,1,10,True
3171047,1246,0,30,5230,184285368,0,0,0,1186.2,8,213646.87,23,5,9,11,True
3330762,1410,1,451,2463,184285368,0,0,0,1185.76,7,212461.11,24,5,21,11,True
3464619,1246,0,451,6662,184285368,0,0,0,1185.96,7,211275.15,23,4,23,2,True
3557771,200,0,10,9961,184285368,0,0,0,1186.23,0,212461.38,9,0,10,2,True
3657401,1409,1,10,8566,184285368,0,0,0,1185.58,6,213646.96,24,4,7,3,True
4037160,1270,1,30,2119,184285368,0,0,0,1186.11,8,212460.85,23,3,13,4,True
4108290,346,0,451,1803,184285368,0,0,0,1185.98,7,211274.87,24,3,18,4,True
4198602,1270,1,451,9961,184285368,0,0,0,1186.03,7,210088.84,23,2,12,4,True
4593691,104,4,451,4518,184285368,0,0,0,1185.94,7,208902.9,3,2,6,5,True
4604556,1132,0,10,4518,184285368,0,0,0,1186.03,6,210088.93,24,4,9,5,True
4689949,1446,1,30,7673,184285368,0,0,0,1186.05,8,208902.88,24,6,21,5,True
4792577,1270,1,451,7984,184285368,0,0,0,1186.09,7,207716.79,23,0,18,6,True
5137392,1410,1,451,9801,184285368,0,0,0,1185.63,7,206531.16,24,2,16,7,True
5370535,1206,0,10,8820,184285368,0,0,0,1185.72,0,207716.88,24,3,0,7,False
5417306,588,0,20,4120,184285368,0,0,0,1185.98,5,206530.9,24,1,8,8,True
5717305,806,1,10,8236,184285368,0,0,0,1186.12,6,207717.02,11,1,2,8,True
5892499,645,0,10,4120,184285368,0,0,0,1186.23,6,208903.25,24,5,9,10,True
5904361,331,4,451,8820,184285368,0,0,0,1186.11,7,207717.14,11,2,18,11,True
5910621,104,4,25,8236,184285368,0,0,0,1185.91,8,206531.23,3,3,2,11,True
6360241,104,4,451,8820,184285368,0,0,0,1185.81,7,205345.42,3,5,6,12,True
6571175,1246,0,25,8185,184285368,0,0,0,1185.81,8,204159.61,23,5,6,1,True
6638563,1060,1,10,8820,184285368,0,0,0,1186.11,6,205345.72,11,3,0,2,True
6786014,1322,2,20,8236,184285368,0,0,0,1186.04,3,204159.68,18,1,11,2,True
6818981,331,4,451,8236,184285368,0,0,0,1186.17,7,202973.51,11,6,8,2,True
7688730,1102,2,20,4518,184285368,0,0,0,1185.91,3,201787.6,0,2,0,2,True
7818241,1410,1,451,8063,184285368,0,0,0,1186.12,7,200601.48,24,4,15,2,False
7888953,726,0,20,9961,184285368,0,0,0,1185.87,5,199415.61,11,6,22,3,True
7973718,104,4,-1,4804,184285368,0,1,0,1185.82,4,199415.61,3,6,14,5,True
8007184,1410,1,30,6662,184285368,0,0,0,1186.24,8,198229.37,24,4,11,6,True
8166326,1270,1,-1,8236,184285368,0,1,0,1186.16,4,198229.37,23,1,3,8,True
8253409,1446,1,451,5230,184285368,0,0,0,1186.02,7,197043.35,24,3,23,8,True
8344020,1122,1,10,7984,184285368,0,0,0,1186.07,0,198229.42,24,0,7,8,True
8459380,257,1,10,4120,184285368,0,0,0,1185.93,6,199415.35,6,4,4,8,True
8525500,736,1,451,6662,184285368,0,0,0,1186.06,7,198229.29,11,6,4,9,True
8568353,482,1,10,9961,184285368,0,0,0,1186.0,6,199415.29,5,2,6,10,True
8836689,104,4,30,4804,184285368,0,0,0,1186.29,8,198229.0,3,4,18,10,True
9335006,47,1,10,8566,184285368,0,0,0,1185.88,6,199414.88,24,6,3,11,True
9861013,104,4,451,4518,184285368,0,0,0,1186.11,7,198228.77,3,5,15,11,True
1099945,90,4,451,2025,874559244,0,0,0,870.01,7,251789.99,1,4,3,2,True
1365704,454,1,-1,6453,874559244,0,1,0,869.61,4,251789.99,13,1,1,2,True
1372049,32,3,25,1958,874559244,0,0,0,869.87,8,250920.12,11,6,16,3,True
1437781,998,0,30,4553,874559244,0,0,0,869.78,8,250050.34,26,1,21,3,True
1515568,178,4,25,3326,874559244,0,0,0,870.01,8,249180.33,24,2,16,3,True
2022451,253,2,20,4553,874559244,0,0,0,869.87,5,248310.46,6,6,12,3,True
3031367,90,4,-1,4241,874559244,0,1,0,869.87,4,248310.46,1,6,17,3,True
3036793,579,0,20,6718,874559244,0,0,0,870.23,5,247440.23,11,3,10,4,True
3278808,998,0,30,3818,874559244,0,0,0,869.76,8,246570.47,26,2,21,5,True
3298167,178,4,25,9993,874559244,0,0,0,870.13,8,245700.34,24,1,20,5,True
3384023,785,0,20,1619,874559244,0,0,0,869.79,5,244830.55,14,0,1,6,True
3395106,1025,1,10,9119,874559244,0,0,0,869.86,6,245700.41,11,4,4,7,True
3667557,1064,0,20,5709,874559244,0,0,0,869.97,3,244830.44,11,4,9,7,True
3714356,551,0,20,1265,874559244,0,0,0,869.9,5,243960.54,17,3,8,7,True
3813841,675,2,20,1619,874559244,0,0,0,869.75,3,243090.79,24,4,4,8,True
3866616,178,4,-1,4241,874559244,0,1,0,869.97,4,243090.79,24,5,16,8,True
3882099,454,1,30,3962,874559244,0,0,0,869.68,8,242221.11,13,1,20,9,True
3894548,32,3,30,9119,874559244,0,0,0,870.17,8,241350.94,11,1,0,9,True
4032952,1146,2,20,3962,874559244,0,0,0,870.27,3,240480.67,15,6,18,10,True
4099168,998,0,451,4423,874559244,0,0,0,869.7,7,239610.97,26,0,17,10,True
4216822,90,4,25,2025,874559244,0,0,0,870.0,8,238740.97,1,1,4,11,False
4241330,454,1,30,6272,874559244,0,0,0,869.84,8,237871.13,13,5,0,11,True
4332103,178,4,451,3992,874559244,0,0,0,870.05,7,237001.08,24,1,20,11,True
4544064,178,4,451,1958,874559244,0,0,0,869.94,7,236131.14,24,0,13,12,True
4636747,394,0,10,6272,874559244,0,0,0,870.1,6,237001.24,10,0,5,1,True
4744020,1485,0,20,2025,874559244,0,0,0,870.18,5,236131.06,24,1,12,1,True
5051465,32,3,451,1652,874559244,0,0,0,870.26,7,235260.8,11,2,15,2,True
5206156,90,4,-1,8001,874559244,0,1,0,870.07,4,235260.8,1,4,14,4,True
5290124,454,1,451,8858,874559244,0,0,0,870.09,7,234390.71,13,2,18,4,True
5306493,1140,0,20,3992,874559244,0,0,0,869.95,5,233520.76,15,4,6,5,True
5329758,32,3,451,8001,874559244,0,0,0,870.07,7,232650.69,11,5,0,5,True
5343955,178,4,451,4553,874559244,0,0,0,869.72,7,231780.97,24,4,1,5,True
5376316,834,0,20,3818,874559244,0,0,0,870.17,3,230910.8,5,2,3,8,True
5519977,1152,0,20,9512,874559244,0,0,0,870.19,3,230040.61,15,0,23,8,True
5816545,90,4,451,3326,874559244,0,0,0,870.01,7,229170.6,1,3,6,8,True
6021951,178,4,-1,7035,874559244,0,1,0,869.91,1,229170.6,24,4,9,10,True
6285109,1159,0,20,3962,874559244,0,0,0,869.66,5,228300.94,15,2,13,10,True
6354899,178,4,451,6962,874559244,0,0,0,869.73,7,227431.21,24,6,18,11,True
6663177,1401,1,10,4553,874559244,0,0,0,869.87,6,228301.08,24,6,20,11,True
6734477,90,4,-1,3818,874559244,0,1,0,870.33,4,228301.08,1,2,6,11,True
7089027,454,1,-1,8858,874559244,0,2,0,870.06,4,228301.08,13,0,12,12,False
7223122,580,0,10,4553,874559244,0,0,0,870.22,6,229171.3,11,4,14,12,True
7396935,178,4,-1,1652,874559244,0,1,0,869.88,4,229171.3,24,2,7,1,True
7489477,454,1,25,1958,874559244,0,0,0,870.19,8,228301.11,13,5,6,4,True
7502746,998,0,451,4423,874559244,0,0,0,870.09,7,227431.02,26,6,17,5,True
7655677,998,0,451,6962,874559244,0,0,0,869.92,7,226561.1,26,3,17,5,True
7679433,90,4,451,3992,874559244,0,0,0,869.96,7,225691.14,1,5,12,5,True
7808363,752,0,10,3818,874559244,0,0,0,870.03,6,226561.17,24,3,17,5,True
7890524,126,1,10,6962,874559244,0,0,0,869.96,0,227431.13,18,4,14,5,True
7991948,178,4,451,4456,874559244,0,0,0,869.95,7,226561.18,24,0,9,5,True
8128249,32,3,-1,1619,874559244,0,1,0,870.02,4,226561.18,11,3,23,7,False
8209299,46,1,10,6272,874559244,0,0,0,869.94,6,227431.12,24,6,19,7,True
8219204,1210,0,10,2025,874559244,0,0,0,870.03,6,228301.15,24,2,0,8,True
8317527,178,4,451,3962,874559244,0,0,0,869.87,7,227431.28,24,3,19,9,True
8831771,535,0,20,9993,874559244,0,0,0,869.93,3,226561.35,18,5,11,9,True
9407462,497,0,20,6718,874559244,0,0,0,870.2,5,225691.15,12,3,16,10,True
9610923,454,1,30,7797,874559244,0,0,0,869.75,8,224821.4,13,3,18,11,True
9710136,1213,2,20,4456,874559244,0,0,0,870.03,5,223951.37,24,2,6,11,True
1568477,1033,4,25,3301,981420604,1,0,0,886.82,8,174588.18,11,3,11,1,True
2158423,499,3,30,2911,981420604,1,0,0,886.93,8,173701.25,12,4,9,1,False
2371480,577,0,30,4660,981420604,1,0,0,887.18,8,172814.07,11,3,2,1,True
2382588,580,0,20,4660,981420604,1,0,0,887.11,5,171926.96,11,3,4,1,False
2440715,1033,4,451,1346,981420604,1,0,0,886.92,7,171040.04,11,6,6,1,True
2611490,873,4,451,9550,981420604,1,0,0,887.01,7,170153.03,24,6,23,1,True
2757368,267,0,20,4418,981420604,1,0,0,887.04,5,169265.99,6,5,18,3,True
2781310,203,0,10,7690,981420604,1,0,0,886.77,0,170152.76,9,5,10,3,True
2797366,739,1,10,3485,981420604,1,0,0,887.03,6,171039.79,24,5,13,3,True
2908839,996,0,25,1249,981420604,1,0,0,887.16,8,170152.63,26,5,5,4,True
3124189,873,4,451,6216,981420604,1,0,0,887.38,7,169265.25,24,5,16,4,True
3281412,60,4,25,9403,981420604,1,0,0,887.26,8,168377.99,20,0,3,4,True
3872172,996,0,25,4660,981420604,1,0,0,887.25,8,167490.74,26,6,11,5,True
3881860,577,0,-1,8487,981420604,1,1,0,887.1,4,167490.74,11,6,19,5,True
3890440,996,0,25,4794,981420604,1,0,0,887.18,8,166603.56,26,1,22,6,True
4148123,577,0,30,1131,981420604,1,0,0,887.25,8,165716.31,11,1,13,8,True
4542441,577,0,30,3301,981420604,1,0,0,886.77,8,164829.54,11,2,4,8,True
4775774,114,0,20,9714,981420604,1,0,0,886.99,3,163942.55,3,3,19,8,True
5099626,60,4,30,6216,981420604,1,0,0,887.1,8,163055.45,20,4,22,9,True
5143657,327,0,451,5152,981420604,1,0,0,887.06,7,162168.39,11,6,14,9,True
5507693,1150,0,20,1245,981420604,1,0,0,887.16,3,161281.23,15,3,18,10,True
5598632,696,2,20,1346,981420604,1,0,0,886.96,3,160394.27,24,0,9,11,False
5601288,327,0,30,7014,981420604,1,0,0,886.97,8,159507.3,11,3,8,1,True
6526339,577,0,-1,7583,981420604,1,1,0,887.16,4,159507.3,11,3,1,1,True
6539015,1325,0,20,7690,981420604,1,0,0,886.91,3,158620.39,18,0,3,1,True
6617543,1401,1,10,8948,981420604,1,0,0,886.93,0,159507.32,24,6,10,4,True
6651449,343,1,10,1131,981420604,1,0,0,886.82,0,160394.14,24,6,11,4,True
6675672,327,0,30,4203,981420604,1,0,0,887.22,8,159506.92,11,5,2,4,True
6688248,820,1,10,5152,981420604,1,0,0,887.1,6,160394.02,18,5,21,4,True
6712156,1260,0,20,1131,981420604,1,0,0,886.87,3,159507.15,23,2,18,5,True
6726427,873,4,451,1245,981420604,1,0,0,887.04,7,158620.11,24,4,21,5,True
6910256,577,0,451,3485,981420604,1,0,0,886.82,7,157733.29,11,5,4,5,True
7122247,577,0,451,9550,981420604,1,0,0,886.99,7,156846.3,11,0,4,7,True
7219272,327,0,451,9403,981420604,1,0,0,886.86,7,155959.44,11,1,10,8,True
7451324,499,3,451,2606,981420604,1,0,0,887.14,7,155072.3,12,2,6,8,True
7681935,499,3,451,9714,981420604,1,0,0,886.92,7,154185.38,12,2,13,9,True
7950531,497,0,20,3251,981420604,1,0,0,887.14,3,153298.24,12,1,19,9,True
7964607,60,4,25,2911,981420604,1,0,0,886.89,8,152411.35,20,5,23,10,True
8000497,1033,4,451,1346,981420604,1,0,0,887.01,7,151524.34,11,4,17,10,True
8123015,499,3,25,3251,981420604,1,0,0,887.03,8,150637.31,12,3,11,12,True
8178432,327,0,451,2606,981420604,1,0,0,887.0,7,149750.31,11,3,9,2,True
8394635,577,0,25,1249,981420604,1,0,0,886.9,8,148863.41,11,2,23,3,True
8416552,499,3,451,7764,981420604,1,0,0,886.93,7,147976.48,12,1,23,4,True
9133200,292,1,10,6216,981420604,1,0,0,887.16,6,148863.64,4,2,14,5,True
9151181,60,4,-1,3301,981420604,1,1,0,887.09,1,148863.64,20,0,17,6,True
9271419,499,3,30,1346,981420604,1,0,0,886.89,8,147976.75,12,1,15,6,True
9365817,873,4,451,1346,981420604,1,0,0,887.04,7,147089.71,24,5,22,8,True
9455451,60,4,451,7764,981420604,1,0,0,887.04,7,146202.67,20,1,2,8,True
9552227,499,3,451,2911,981420604,1,0,0,886.93,7,145315.74,12,1,20,8,False
9604404,1128,2,20,9062,981420604,1,0,0,886.87,5,144428.87,24,1,20,9,True
9651915,1297,0,10,7583,981420604,1,0,0,886.85,0,145315.72,5,6,7,10,True
9654776,577,0,30,3251,981420604,1,0,0,887.05,8,144428.67,11,6,20,11,True
1274192,822,4,30,7839,435579419,0,0,0,1069.01,8,184308.99,18,3,17,2,True
1287477,637,4,30,8178,435579419,0,0,0,1068.72,8,183240.27,24,2,3,3,True
1302173,822,4,451,2546,435579419,0,0,0,1069.0,7,182171.27,18,2,1,3,True
1581934,1325,0,10,7978,435579419,0,0,0,1069.03,0,183240.3,18,1,17,5,False
1783932,937,0,10,1573,435579419,0,0,0,1069.02,6,184309.32,24,0,15,5,True
1830630,991,1,451,1573,435579419,0,0,0,1068.97,7,183240.35,22,0,22,6,True
2148183,128,0,10,5576,435579419,0,0,0,1069.02,0,184309.37,18,0,7,7,False
2316764,1207,4,-1,6002,435579419,0,1,0,1069.18,4,184309.37,24,2,11,8,True
2449198,824,2,451,2546,435579419,0,0,0,1068.95,7,183240.42,18,0,17,8,True
2661332,1207,4,451,7978,435579419,0,0,0,1068.97,7,182171.45,24,1,17,8,True
2666977,991,1,451,6002,435579419,0,0,0,1068.63,7,181102.82,22,2,8,8,True
2855011,254,0,20,2546,435579419,0,0,0,1068.98,5,180033.84,6,0,16,9,True
2869902,824,2,25,1573,435579419,0,0,0,1068.95,8,178964.89,18,6,7,10,True
2896927,211,0,451,6947,435579419,0,0,0,1068.86,7,177896.03,9,0,18,12,True
2922820,1336,2,20,2398,435579419,0,0,0,1069.02,3,176827.01,18,1,6,12,True
3044158,211,0,451,7978,435579419,0,0,0,1068.97,7,175758.04,9,6,23,1,False
3313030,822,4,451,1573,435579419,0,0,0,1069.1,7,174688.94,18,0,10,1,True
3621531,991,1,-1,2546,435579419,0,1,0,1069.3,4,174688.94,22,4,11,2,True
4042552,314,0,20,2398,435579419,0,0,0,1069.0,5,173619.94,4,1,21,3,True
4098254,568,1,-1,9006,435579419,0,1,0,1069.28,4,173619.94,11,0,13,3,True
4150982,568,1,30,5677,435579419,0,0,0,1068.6,8,172551.34,11,2,1,3,True
4233965,1207,4,25,8920,435579419,0,0,0,1068.82,8,171482.52,24,0,15,3,True
4667534,824,2,25,2546,435579419,0,0,0,1069.09,8,170413.43,18,4,5,5,True
4888655,822,4,451,7978,435579419,0,0,0,1068.83,7,169344.6,18,1,0,5,True
4890205,570,2,20,6002,435579419,0,0,0,1069.08,5,168275.52,11,0,5,7,True
5017689,46,1,10,2398,435579419,0,0,0,1069.19,6,169344.71,24,1,13,7,True
5059612,822,4,25,9415,435579419,0,0,0,1068.89,8,168275.82,18,2,7,8,True
5059644,816,0,20,4489,435579419,0,0,0,1068.96,3,167206.86,18,4,10,8,True
5122521,1145,4,451,6947,435579419,0,0,0,1068.99,7,166137.87,15,5,3,8,True
5154106,1145,4,25,5677,435579419,0,0,0,1068.77,8,165069.1,15,5,18,9,True
5179399,730,4,30,8178,435579419,0,0,0,1069.1,8,164000.0,11,1,9,9,True
5183931,637,4,451,2421,435579419,0,0,0,1068.96,7,162931.04,24,6,0,10,True
5234193,1315,0,20,2421,435579419,0,0,0,1069.08,5,161861.96,5,1,11,10,True
5288896,730,4,-1,8178,435579419,0,1,0,1069.02,4,161861.96,11,3,17,10,True
5294000,1122,1,10,7978,435579419,0,0,0,1068.71,0,162930.67,24,3,19,11,True
5332147,730,4,30,6002,435579419,0,0,0,1068.94,8,161861.73,11,1,15,11,True
5542357,822,4,25,1573,435579419,0,0,0,1069.16,8,160792.57,18,6,12,11,True
5756679,1207,4,25,6947,435579419,0,0,0,1069.08,8,159723.49,24,0,0,12,True
5919739,211,0,451,6002,435579419,0,0,0,1069.22,7,158654.27,9,2,8,2,True
5969269,822,4,451,3397,435579419,0,0,0,1069.12,7,157585.15,18,6,15,2,True
6374508,991,1,451,2398,435579419,0,0,0,1068.95,7,156516.2,22,1,6,2,True
7183025,991,1,25,3397,435579419,0,0,0,1069.14,8,155447.06,22,4,19,3,True
7237769,1145,4,451,1573,435579419,0,0,0,1069.06,7,154378.0,15,6,13,3,True
7287848,1412,2,20,3397,435579419,0,0,0,1069.19,5,153308.81,24,5,3,3,True
7337178,734,0,10,5736,435579419,0,0,0,1069.13,6,154377.94,11,5,6,3,True
7974256,822,4,451,7839,435579419,0,0,0,1069.11,7,153308.83,18,1,11,4,True
8192128,1460,2,20,8920,435579419,0,0,0,1068.91,3,152239.92,11,6,1,6,True
8258052,211,0,-1,7978,435579419,0,1,0,1069.08,1,152239.92,9,0,10,9,True
8820249,824,2,25,6002,435579419,0,0,0,1069.01,8,151170.91,18,0,18,9,True
8975982,730,4,451,8920,435579419,0,0,0,1069.29,7,150101.62,11,2,22,10,True
9008628,497,0,20,5736,435579419,0,0,0,1068.89,5,149032.73,12,3,5,10,True
9191125,967,1,10,9415,435579419,0,0,0,1068.99,6,150101.72,13,5,11,10,True
9327502,991,1,451,8178,435579419,0,0,0,1068.99,7,149032.73,22,1,8,10,True
9333492,907,0,20,2546,435579419,0,0,0,1068.72,5,147964.01,2,5,22,11,True
9980134,568,1,451,2398,435579419,0,0,0,1068.8,7,146895.21,11,6,9,11,True
1086901,260,0,10,9967,114024738,1,0,0,862.91,6,741336.91,6,0,8,1,True
1206415,1206,0,30,2163,114024738,1,0,0,862.96,8,740473.95,24,0,13,1,True
1286696,1206,0,25,6068,114024738,1,0,0,862.97,8,739610.98,24,0,15,5,True
1317572,1285,1,451,8813,114024738,1,0,0,862.98,7,738748.0,24,6,15,6,True
1675289,547,4,451,3547,114024738,1,0,0,863.06,7,737884.94,17,3,23,6,True
2272179,1285,1,451,3491,114024738,1,0,0,862.85,7,737022.09,24,4,6,7,True
2393200,1218,4,451,6771,114024738,1,0,0,862.9,7,736159.19,24,1,11,7,True
2481145,1285,1,451,5221,114024738,1,0,0,863.2,7,735295.99,24,0,14,7,True
2487627,120,4,25,1220,114024738,1,0,0,863.02,8,734432.97,18,3,12,8,False
2638266,413,4,25,4198,114024738,1,0,0,863.13,8,733569.84,18,4,17,9,True
2839359,1218,4,30,1509,114024738,1,0,0,862.73,8,732707.11,24,1,0,9,False
2909250,1304,0,20,8728,114024738,1,0,0,863.23,5,731843.88,5,1,5,9,True
3200947,547,4,-1,3892,114024738,1,1,0,862.95,4,731843.88,17,6,21,11,True
3302485,587,2,20,9126,114024738,1,0,0,862.9,3,730980.98,24,0,22,11,True
3302521,573,0,20,3491,114024738,1,0,0,863.11,5,730117.87,11,2,17,11,True
3404172,1218,4,30,9126,114024738,1,0,0,862.94,8,729254.93,24,0,13,12,True
3746021,1486,2,20,3491,114024738,1,0,0,863.13,3,728391.8,24,5,11,12,True
3820036,120,4,30,7146,114024738,1,0,0,862.85,8,727528.95,18,0,9,1,True
3845259,858,1,10,7604,114024738,1,0,0,863.29,6,728392.24,24,3,21,2,True
4073464,547,4,451,3547,114024738,1,0,0,862.86,7,727529.38,17,4,10,2,True
4265681,594,0,10,6771,114024738,1,0,0,863.15,0,728392.53,24,4,23,3,True
4583506,822,4,451,1509,114024738,1,0,0,863.16,7,727529.37,18,1,2,3,True
4748772,822,4,25,3547,114024738,1,0,0,862.96,8,726666.41,18,4,1,4,True
5146207,120,4,451,1717,114024738,1,0,0,862.86,7,725803.55,18,1,3,5,False
5183472,822,4,451,4484,114024738,1,0,0,862.89,7,724940.66,18,0,0,6,True
5281175,547,4,25,2163,114024738,1,0,0,862.96,8,724077.7,17,0,14,6,False
5351088,627,0,20,6068,114024738,1,0,0,862.91,5,723214.79,11,2,12,6,True
5560371,413,4,451,9126,114024738,1,0,0,862.81,7,722351.98,18,4,1,6,True
5611631,413,4,25,1220,114024738,1,0,0,863.08,8,721488.9,18,2,10,7,True
5998740,428,0,20,9500,114024738,1,0,0,863.18,5,720625.72,18,2,1,7,True
6071429,120,4,451,1717,114024738,1,0,0,863.06,7,719762.66,18,1,14,9,True
6452947,1218,4,25,9967,114024738,1,0,0,862.9,8,718899.76,24,3,8,10,True
6552789,1186,2,20,9500,114024738,1,0,0,863.06,5,718036.7,24,5,11,10,True
6593765,1285,1,451,8813,114024738,1,0,0,862.84,7,717173.86,24,0,2,10,True
6644733,822,4,30,9500,114024738,1,0,0,863.16,8,716310.7,18,0,1,11,True
6721504,822,4,451,1717,114024738,1,0,0,863.01,7,715447.69,18,1,21,11,True
6899307,1027,0,20,3324,114024738,1,0,0,862.82,3,714584.87,11,6,11,12,True
7045733,1090,0,10,7146,114024738,1,0,0,862.88,6,715447.75,18,6,12,12,True
7065175,1206,0,451,5221,114024738,1,0,0,862.86,7,714584.89,24,4,9,12,True
7088467,822,4,451,2163,114024738,1,0,0,862.87,7,713722.02,18,0,16,1,True
7271885,1285,1,451,8728,114024738,1,0,0,862.65,7,712859.37,24,1,17,2,True
7382425,535,0,10,3324,114024738,1,0,0,862.78,6,713722.15,18,0,8,3,True
7558928,1206,0,25,4198,114024738,1,0,0,863.03,8,712859.12,24,3,4,5,True
7610327,1285,1,25,9015,114024738,1,0,0,862.76,8,711996.36,24,1,15,5,True
7981730,413,4,25,8813,114024738,1,0,0,862.91,8,711133.45,18,2,15,6,True
8045966,120,4,451,4484,114024738,1,0,0,862.97,7,710270.48,18,0,23,6,True
8117665,1206,0,451,7604,114024738,1,0,0,863.0,7,709407.48,24,4,21,7,True
8176579,1218,4,-1,6068,114024738,1,1,0,862.95,4,709407.48,24,3,5,7,True
8182038,1036,1,10,6771,114024738,1,0,0,863.14,6,710270.62,11,2,22,7,True
8272584,547,4,451,3491,114024738,1,0,0,863.31,7,709407.31,17,2,1,8,True
8697305,547,4,25,9126,114024738,1,0,0,863.02,8,708544.29,17,3,15,9,True
8863537,1206,0,30,4198,114024738,1,0,0,863.01,8,707681.28,24,0,18,9,True
8869931,413,4,-1,3324,114024738,1,1,0,862.96,1,707681.28,18,6,17,9,True
9090782,1169,0,20,4198,114024738,1,0,0,862.74,5,706818.54,24,6,1,10,True
9344988,413,4,25,9015,114024738,1,0,0,862.7,8,705955.84,18,0,18,11,True
9641302,1218,4,25,6771,114024738,1,0,0,862.83,8,705093.01,24,3,19,11,True
9798586,547,4,30,9500,114024738,1,0,0,862.85,8,704230.16,17,2,12,11,True
9902001,547,4,451,7341,114024738,1,0,0,862.94,7,703367.22,17,2,20,11,True
1063185,348,0,10,7995,762233158,1,0,0,679.89,0,800760.89,24,0,19,1,True
1221268,1439,4,451,7537,762233158,1,0,0,679.92,7,800080.97,24,5,1,1,True
1329566,287,0,25,8587,762233158,1,0,0,680.27,8,799400.7,24,3,3,4,True
1475974,438,1,10,3468,762233158,1,0,0,680.02,0,800080.72,24,4,13,4,True
1514426,375,4,451,5228,762233158,1,0,0,679.97,7,799400.75,25,1,2,4,True
1897858,287,0,25,1809,762233158,1,0,0,679.99,8,798720.76,24,2,17,5,True
1913937,942,0,20,1809,762233158,1,0,0,679.71,5,798041.05,24,3,18,5,True
2056362,616,1,10,9048,762233158,1,0,0,680.14,0,798721.19,11,5,12,5,True
2060539,1108,1,25,3539,762233158,1,0,0,679.76,8,798041.43,0,2,12,6,True
2343231,114,0,10,8051,762233158,1,0,0,679.93,0,798721.36,3,4,9,6,True
2743140,81,0,10,1852,762233158,1,0,0,680.0,6,799401.36,1,0,10,7,True
2775143,1108,1,451,3872,762233158,1,0,0,679.96,7,798721.4,0,3,23,8,True
2921052,375,4,451,3170,762233158,1,0,0,680.29,7,798041.11,25,1,7,8,True
2942679,525,0,20,3170,762233158,1,0,0,680.05,3,797361.06,18,4,11,8,True
3009035,592,4,30,9048,762233158,1,0,0,679.99,8,796681.07,24,5,18,10,False
3375316,287,0,451,3468,762233158,1,0,0,680.1,7,796000.97,24,0,0,10,True
3502112,287,0,25,7098,762233158,1,0,0,680.14,8,795320.83,24,5,12,11,True
3545390,375,4,25,1809,762233158,1,0,0,679.91,8,794640.92,25,6,17,12,False
3828755,1411,0,20,3872,762233158,1,0,0,679.89,5,793961.03,24,6,17,1,True
4003337,1037,0,10,3468,762233158,1,0,0,680.13,0,794641.16,11,0,20,2,True
4108843,319,0,10,3468,762233158,1,0,0,680.09,0,795321.25,11,4,0,2,True
4150135,211,0,-1,3468,762233158,1,1,0,680.3,1,795321.25,9,2,19,2,True
4248136,375,4,25,1852,762233158,1,0,0,680.0,8,794641.25,25,5,6,2,True
4420481,1108,1,-1,3539,762233158,1,1,0,679.82,4,794641.25,0,0,4,3,True
4483167,287,0,25,5228,762233158,1,0,0,680.12,8,793961.13,24,1,4,4,True
4871809,592,4,30,7995,762233158,1,0,0,679.98,8,793281.15,24,0,1,4,True
5121523,844,1,10,5228,762233158,1,0,0,679.79,0,793960.94,5,5,13,5,True
5265686,1037,0,20,5228,762233158,1,0,0,679.8,3,793281.14,11,0,21,5,True
5276601,1439,4,-1,5228,762233158,1,1,0,679.97,4,793281.14,24,5,23,5,True
5348148,1210,0,20,3872,762233158,1,0,0,679.91,3,792601.23,24,0,19,5,True
5587078,1090,0,20,3468,762233158,1,0,0,679.9,5,791921.33,18,5,20,7,True
5842939,592,4,25,3872,762233158,1,0,0,680.1,8,791241.23,24,2,22,7,True
5940221,211,0,451,8051,762233158,1,0,0,679.96,7,790561.27,9,5,11,7,True
6248417,211,0,25,1809,762233158,1,0,0,679.99,8,789881.28,9,1,9,8,True
6597202,1195,1,10,1809,762233158,1,0,0,680.24,0,790561.52,24,3,12,8,True
6643179,269,0,10,3170,762233158,1,0,0,680.18,6,791241.7,24,2,5,9,True
7317026,375,4,451,3539,762233158,1,0,0,680.08,7,790561.62,25,3,14,1,True
7372741,1264,0,10,3872,762233158,1,0,0,679.99,6,791241.61,23,0,4,1,True
7395622,1449,0,10,7020,762233158,1,0,0,679.76,6,791921.37,11,0,17,1,True
7462646,1132,0,10,4699,762233158,1,0,0,679.87,0,792601.24,24,4,6,2,True
7507899,1108,1,25,7995,762233158,1,0,0,679.95,8,791921.29,0,1,7,2,True
7861199,592,4,25,7995,762233158,1,0,0,680.12,8,791241.17,24,6,0,3,True
7924076,287,0,25,4699,762233158,1,0,0,679.94,8,790561.23,24,5,19,3,True
7954904,592,4,451,7020,762233158,1,0,0,680.24,7,789880.99,24,6,6,3,True
8045966,1108,1,25,8051,762233158,1,0,0,680.04,8,789200.95,0,5,11,5,True
8133402,1108,1,451,7995,762233158,1,0,0,680.07,7,788520.88,0,5,8,5,True
8507616,211,0,451,7537,762233158,1,0,0,680.08,7,787840.8,9,4,9,5,True
8604811,287,0,-1,3872,762233158,1,1,0,679.92,4,787840.8,24,6,12,6,True
9103357,979,0,20,7537,762233158,1,0,0,679.89,5,787160.91,22,5,18,7,True
9354942,1108,1,-1,3468,762233158,1,1,0,680.05,4,787160.91,0,3,15,7,True
9484583,1439,4,25,4699,762233158,1,0,0,679.79,8,786481.12,24,4,23,8,True
9556161,1439,4,451,7537,762233158,1,0,0,680.04,7,785801.08,24,3,4,9,True
9748784,287,0,451,3170,762233158,1,0,0,680.18,7,785120.9,24,2,12,9,True
9883008,309,0,20,9048,762233158,1,0,0,680.09,5,784440.81,4,2,19,10,True
9986114,375,4,451,3872,762233158,1,0,0,679.99,7,783760.82,25,6,17,10,True
9987436,1439,4,451,3468,762233158,1,0,0,680.02,7,783080.8,24,2,20,10,True
1210565,413,4,25,6305,381701386,1,0,0,767.86,8,677643.14,18,5,21,1,True
1570353,903,3,25,4636,381701386,1,0,0,767.89,8,676875.25,2,3,4,2,True
1880862,215,0,451,9962,381701386,1,0,0,768.04,7,676107.21,9,1,9,2,True
1978048,903,3,30,1817,381701386,1,0,0,767.95,8,675339.26,2,2,6,3,True
2087710,903,3,30,9184,381701386,1,0,0,768.06,8,674571.2,2,3,22,3,True
2196430,215,0,451,9962,381701386,1,0,0,768.07,7,673803.13,9,1,6,5,True
2956784,367,1,451,4959,381701386,1,0,0,767.79,7,673035.34,25,4,9,6,True
3047632,660,3,451,3103,381701386,1,0,0,767.87,7,672267.47,18,0,1,6,True
3088393,660,3,451,2580,381701386,1,0,0,767.7,7,671499.77,18,5,5,7,True
3126885,1113,1,10,9184,381701386,1,0,0,767.97,6,672267.74,0,0,3,7,True
3153453,305,1,10,3110,381701386,1,0,0,768.22,0,673035.96,4,1,14,7,True
3227335,564,0,20,9358,381701386,1,0,0,768.2,5,672267.76,17,0,10,9,True
3368585,955,4,451,1298,381701386,1,0,0,768.11,7,671499.65,13,6,1,9,True
3491764,367,1,25,4959,381701386,1,0,0,767.78,8,670731.87,25,3,2,11,True
4190674,955,4,451,1298,381701386,1,0,0,768.04,7,669963.83,13,5,10,11,True
4302053,670,0,10,2580,381701386,1,0,0,768.01,0,670731.84,18,2,6,11,True
4542083,413,4,451,5081,381701386,1,0,0,768.16,7,669963.68,18,4,3,11,True
4594950,903,3,451,4191,381701386,1,0,0,768.01,7,669195.67,2,3,16,12,False
4684192,367,1,30,2580,381701386,1,0,0,768.28,8,668427.39,25,5,2,1,True
4883920,903,3,451,4626,381701386,1,0,0,767.84,7,667659.55,2,6,16,2,True
4900909,413,4,-1,5081,381701386,1,1,0,767.78,1,667659.55,18,2,10,2,True
4926951,660,3,30,5566,381701386,1,0,0,768.17,8,666891.38,18,2,21,3,True
4977761,413,4,30,9345,381701386,1,0,0,768.15,8,666123.23,18,4,11,4,True
5331904,342,0,20,1817,381701386,1,0,0,768.19,5,665355.04,24,3,23,5,True
5388922,215,0,25,9184,381701386,1,0,0,767.9,8,664587.14,9,5,17,5,True
5450620,218,0,20,2925,381701386,1,0,0,767.93,5,663819.21,9,1,1,5,True
5479200,168,0,10,4626,381701386,1,0,0,768.14,6,664587.35,24,5,0,5,True
5587285,660,3,25,4579,381701386,1,0,0,767.81,8,663819.54,18,6,1,6,True
5679170,660,3,25,4959,381701386,1,0,0,768.2,8,663051.34,18,2,5,6,True
5738099,660,3,451,1298,381701386,1,0,0,768.24,7,662283.1,18,5,1,7,True
5779179,215,0,30,5566,381701386,1,0,0,767.84,8,661515.26,9,0,8,7,True
5898810,665,2,20,2283,381701386,1,0,0,767.92,3,660747.34,18,5,1,9,True
6065791,215,0,451,5081,381701386,1,0,0,767.73,7,659979.61,9,1,15,9,True
6501290,367,1,25,2497,381701386,1,0,0,768.06,8,659211.55,25,0,6,9,True
6555837,215,0,30,5566,381701386,1,0,0,768.01,8,658443.54,9,2,11,10,True
6885751,660,3,30,4636,381701386,1,0,0,768.11,8,657675.43,18,2,7,10,True
6931948,367,1,451,5566,381701386,1,0,0,767.96,7,656907.47,25,3,10,10,True
6973630,215,0,30,5081,381701386,1,0,0,768.03,8,656139.44,9,4,4,10,True
7203823,955,4,451,9345,381701386,1,0,0,768.14,7,655371.3,13,6,13,12,False
7277323,903,3,451,5566,381701386,1,0,0,768.05,7,654603.25,2,2,16,12,True
7476839,413,4,451,4959,381701386,1,0,0,768.09,7,653835.16,18,2,4,12,True
7665044,955,4,-1,9866,381701386,1,1,0,767.95,4,653835.16,13,5,5,12,False
7805664,955,4,451,3065,381701386,1,0,0,767.79,7,653067.37,13,3,4,12,True
7909619,903,3,30,3103,381701386,1,0,0,767.8,8,652299.57,2,5,6,2,True
8014527,413,4,451,2925,381701386,1,0,0,767.82,7,651531.75,18,6,10,5,True
8102891,903,3,-1,5081,381701386,1,1,0,768.22,1,651531.75,2,5,4,6,True
8507936,215,0,25,2283,381701386,1,0,0,767.95,8,650763.8,9,0,10,6,True
9093136,660,3,451,9962,381701386,1,0,0,767.87,7,649995.93,18,6,0,7,True
9129098,660,3,451,6305,381701386,1,0,0,768.16,7,649227.77,18,6,4,7,True
9138748,215,0,25,2283,381701386,1,0,0,768.12,8,648459.65,9,1,14,7,True
9336626,955,4,25,4636,381701386,1,0,0,767.85,8,647691.8,13,4,22,10,True
9469076,1364,0,20,2283,381701386,1,0,0,768.28,5,646923.52,16,5,21,11,True
1236273,1495,3,451,8546,240574938,1,0,0,238.85,7,665649.15,24,0,4,1,True
1333318,1289,1,-1,9665,240574938,1,1,0,238.79,1,665649.15,24,2,8,2,True
1558334,105,3,30,6672,240574938,1,0,0,238.81,8,665410.34,3,2,16,3,True
1594392,979,0,30,2174,240574938,1,0,0,239.18,8,665171.16,22,5,16,3,True
1733895,979,0,-1,4736,240574938,1,1,0,238.75,1,665171.16,22,6,2,4,True
1770841,1495,3,451,1884,240574938,1,0,0,238.95,7,664932.21,24,2,2,5,True
1819912,1495,3,451,3027,240574938,1,0,0,238.95,7,664693.26,24,0,0,5,True
1951173,1010,0,10,3155,240574938,1,0,0,239.11,0,664932.37,26,1,16,6,False
2323615,1289,1,451,7060,240574938,1,0,0,239.06,7,664693.31,24,1,17,7,True
2338857,105,3,451,2522,240574938,1,0,0,238.99,7,664454.32,3,1,16,7,True
2356063,1282,2,20,8960,240574938,1,0,0,238.82,5,664215.5,24,3,14,8,True
2390521,105,3,30,5888,240574938,1,0,0,238.87,8,663976.63,3,4,9,9,True
2450913,1495,3,-1,1950,240574938,1,1,0,238.94,1,663976.63,24,0,11,9,True
2515773,260,0,-1,2768,240574938,1,2,0,239.17,1,663976.63,6,2,5,9,True
2792430,979,0,30,6750,240574938,1,0,0,239.13,8,663737.5,22,6,23,10,True
2960167,260,0,25,9253,240574938,1,0,0,239.14,8,663498.36,6,0,0,11,True
3127170,1495,3,451,6457,240574938,1,0,0,239.06,7,663259.3,24,4,6,11,True
3216733,105,3,25,4852,240574938,1,0,0,238.9,8,663020.4,3,5,0,11,True
3580434,105,3,451,9665,240574938,1,0,0,238.91,7,662781.49,3,3,18,1,True
3845846,503,0,20,6750,240574938,1,0,0,239.05,5,662542.44,12,2,21,1,True
3847713,1102,2,20,6194,240574938,1,0,0,238.9,3,662303.54,0,6,2,2,True
3952223,1289,1,451,7060,240574938,1,0,0,239.06,7,662064.48,24,2,6,2,True
4128104,1037,0,10,2813,240574938,1,0,0,239.03,6,662303.51,11,6,10,3,True
4211713,1289,1,30,2522,240574938,1,0,0,239.07,8,662064.44,24,5,8,4,True
4699805,979,0,30,9665,240574938,1,0,0,238.86,8,661825.58,22,6,13,4,True
4707635,1289,1,25,5888,240574938,1,0,0,238.99,8,661586.59,24,3,1,4,True
5018536,1289,1,25,2813,240574938,1,0,0,238.86,8,661347.73,24,3,1,5,True
5377681,979,0,30,4736,240574938,1,0,0,238.97,8,661108.76,22,6,1,5,True
5887327,1476,0,20,1884,240574938,1,0,0,238.96,5,660869.8,24,0,21,6,True
6005151,1289,1,30,9665,240574938,1,0,0,239.2,8,660630.6,24,3,21,7,True
6022570,260,0,451,8546,240574938,1,0,0,239.07,7,660391.53,6,6,21,8,True
6023748,979,0,30,2522,240574938,1,0,0,239.0,8,660152.53,22,4,3,8,True
6183848,979,0,25,5544,240574938,1,0,0,238.89,8,659913.64,22,4,18,8,True
6384536,1289,1,25,2813,240574938,1,0,0,238.87,8,659674.77,24,5,7,9,True
6523346,979,0,25,9253,240574938,1,0,0,238.7,8,659436.07,22,0,8,10,True
6650427,979,0,25,7289,240574938,1,0,0,238.74,8,659197.33,22,4,10,10,True
6704864,1495,3,30,3803,240574938,1,0,0,238.81,8,658958.52,24,2,0,11,True
6735741,167,2,20,5888,240574938,1,0,0,239.03,5,658719.49,24,3,14,2,True
6898931,1495,3,451,7060,240574938,1,0,0,238.93,7,658480.56,24,5,8,3,True
6990407,1495,3,451,3027,240574938,1,0,0,239.06,7,658241.5,24,0,14,3,True
7183269,457,0,20,4736,240574938,1,0,0,238.82,5,658002.68,13,1,17,3,True
7621247,260,0,25,9665,240574938,1,0,0,239.06,8,657763.62,6,5,5,5,True
7709182,260,0,451,7289,240574938,1,0,0,238.97,7,657524.65,6,5,11,6,True
7888091,260,0,-1,2174,240574938,1,1,0,239.08,4,657524.65,6,6,8,6,True
7933624,1034,1,10,5888,240574938,1,0,0,238.86,6,657763.51,11,4,3,6,True
8274361,979,0,-1,3871,240574938,1,1,0,238.9,4,657763.51,22,4,18,6,True
8362256,979,0,30,2813,240574938,1,0,0,239.13,8,657524.38,22,5,1,7,True
8401459,531,0,10,9195,240574938,1,0,0,239.14,6,657763.52,18,2,14,7,True
8705079,1132,0,20,2531,240574938,1,0,0,238.98,5,657524.54,24,6,16,8,True
8779895,1495,3,30,8546,240574938,1,0,0,238.95,8,657285.59,24,5,0,9,True
8829039,594,0,10,6750,240574938,1,0,0,239.11,6,657524.7,24,6,12,9,True
8972521,1044,0,10,9195,240574938,1,0,0,238.83,6,657763.53,11,2,15,9,True
9047719,260,0,451,1950,240574938,1,0,0,238.93,7,657524.6,6,5,23,9,True
9207306,979,0,451,2522,240574938,1,0,0,238.99,7,657285.61,22,3,8,10,True
9566018,1289,1,25,3871,240574938,1,0,0,238.81,8,657046.8,24,0,9,10,True
9721603,105,3,25,8960,240574938,1,0,0,238.99,8,656807.81,3,4,12,11,True
1031017,661,4,30,5165,288824037,1,0,0,483.99,8,768560.01,18,1,15,1,False
1172171,854,0,20,4393,288824037,1,0,0,484.03,5,768075.98,24,3,8,2,True
1445052,1448,4,-1,8368,288824037,1,1,0,483.93,4,768075.98,11,1,18,3,True
1646558,1448,4,-1,8368,288824037,1,2,0,483.92,4,768075.98,11,2,18,4,True
1773198,1092,1,451,6036,288824037,1,0,0,483.91,7,767592.07,18,4,18,5,True
1963867,1451,1,10,6036,288824037,1,0,0,483.9,6,768075.97,11,3,15,6,True
2363943,1092,1,25,8368,288824037,1,0,0,484.16,8,767591.81,18,1,10,6,True
2393143,499,3,30,8500,288824037,1,0,0,484.1,8,767107.71,12,0,20,6,True
2402038,1160,0,20,2355,288824037,1,0,0,484.07,3,766623.64,15,3,20,6,True
2710265,715,0,-1,5369,288824037,1,1,0,484.17,1,766623.64,18,2,17,7,True
2926695,715,0,20,4116,288824037,1,0,0,484.04,5,766139.6,18,3,5,8,True
2991680,715,0,25,2490,288824037,1,0,0,484.15,8,765655.45,18,6,3,8,True
3090859,211,0,20,8362,288824037,1,0,0,483.59,5,765171.86,9,1,21,8,True
3131861,1166,2,20,8362,288824037,1,0,0,484.05,5,764687.81,24,3,23,9,True
3269146,1092,1,451,5901,288824037,1,0,0,484.02,7,764203.79,18,6,22,9,True
3374625,661,4,-1,4393,288824037,1,1,0,483.81,4,764203.79,18,2,4,9,True
3430278,537,0,10,4116,288824037,1,0,0,484.13,6,764687.92,18,0,10,10,True
3570075,715,0,30,9986,288824037,1,0,0,483.97,8,764203.95,18,0,0,11,True
3761980,1448,4,-1,7452,288824037,1,1,0,484.07,4,764203.95,11,5,21,12,True
3865779,499,3,451,6036,288824037,1,0,0,484.33,7,763719.62,12,2,6,1,True
3947471,715,0,25,8500,288824037,1,0,0,484.07,8,763235.55,18,4,13,1,True
4537191,1092,1,30,8362,288824037,1,0,0,483.95,8,762751.6,18,0,3,2,True
4736941,1092,1,451,9769,288824037,1,0,0,483.92,7,762267.68,18,3,18,2,True
4961140,1092,1,30,2490,288824037,1,0,0,483.99,8,761783.69,18,5,9,3,True
4978379,499,3,25,7535,288824037,1,0,0,484.19,8,761299.5,12,2,19,3,True
5196867,1092,1,25,8500,288824037,1,0,0,483.91,8,760815.59,18,3,9,3,True
5244277,1303,0,20,3457,288824037,1,0,0,483.98,3,760331.61,5,6,19,5,True
5279146,661,4,451,8368,288824037,1,0,0,483.95,7,759847.66,18,0,17,6,True
5739889,787,0,10,8362,288824037,1,0,0,483.78,6,760331.44,14,1,19,6,True
6043369,1069,1,10,4116,288824037,1,0,0,483.76,0,760815.2,18,5,7,8,True
6089745,1210,0,10,5369,288824037,1,0,0,483.97,6,761299.17,24,1,4,8,True
6135835,499,3,25,5369,288824037,1,0,0,483.86,8,760815.31,12,1,8,8,True
6262398,1092,1,-1,3538,288824037,1,1,0,483.87,4,760815.31,18,0,1,8,True
6301638,1092,1,25,4393,288824037,1,0,0,484.06,8,760331.25,18,4,18,9,False
6391237,1448,4,451,2355,288824037,1,0,0,483.83,7,759847.42,11,2,4,11,True
6517700,1448,4,451,8458,288824037,1,0,0,484.23,7,759363.19,11,1,13,11,True
6618144,1448,4,30,1667,288824037,1,0,0,483.86,8,758879.33,11,1,21,11,True
6647265,1092,1,-1,8362,288824037,1,1,0,484.06,1,758879.33,18,3,19,11,False
6663380,499,3,30,8458,288824037,1,0,0,484.07,8,758395.26,12,5,1,11,True
6742584,499,3,30,5081,288824037,1,0,0,483.97,8,757911.29,12,2,3,11,True
6885553,499,3,451,7279,288824037,1,0,0,484.02,7,757427.27,12,5,20,1,True
7058468,499,3,451,2490,288824037,1,0,0,484.38,7,756942.89,12,6,6,3,True
7124996,661,4,451,7279,288824037,1,0,0,483.89,7,756459.0,18,0,6,4,True
7429235,931,0,20,8362,288824037,1,0,0,483.94,5,755975.06,24,2,21,5,True
7582928,1304,0,20,7535,288824037,1,0,0,484.06,3,755491.0,5,0,22,5,True
7695897,1092,1,451,8458,288824037,1,0,0,483.99,7,755007.01,18,4,8,5,True
7959048,715,0,25,3457,288824037,1,0,0,484.0,8,754523.01,18,6,13,7,True
8120385,553,1,10,1667,288824037,1,0,0,483.89,6,755006.9,17,3,1,7,True
8298585,661,4,25,8458,288824037,1,0,0,483.83,8,754523.07,18,5,15,8,True
8437083,464,1,10,9769,288824037,1,0,0,483.9,6,755006.97,13,3,6,9,False
9136392,980,1,10,4393,288824037,1,0,0,484.2,6,755491.17,22,2,15,9,True
9296127,661,4,451,6036,288824037,1,0,0,483.77,7,755007.4,18,0,22,10,True
9812846,715,0,451,8368,288824037,1,0,0,484.15,7,754523.25,18,3,6,10,True
9826277,661,4,25,9769,288824037,1,0,0,483.88,8,754039.37,18,3,8,11,True
1001452,1019,0,451,3763,291763341,0,0,0,981.93,7,581515.07,26,6,1,1,True
1079920,663,4,-1,4035,291763341,0,1,0,981.84,4,581515.07,18,4,2,1,True
1106830,334,0,20,7992,291763341,0,0,0,981.86,5,580533.21,11,2,3,2,True
1174459,1014,1,451,3339,291763341,0,0,0,982.18,7,579551.03,26,4,19,2,True
1651385,530,0,10,4035,291763341,0,0,0,981.91,0,580532.94,18,5,22,2,False
1884043,174,3,25,9163,291763341,0,0,0,981.8,8,579551.14,24,5,20,3,True
1982808,480,0,10,5346,291763341,0,0,0,982.17,6,580533.31,5,6,16,4,True
2096589,294,3,451,7992,291763341,0,0,0,981.73,7,579551.58,4,5,2,4,True
2137227,294,3,-1,4605,291763341,0,1,0,982.0,4,579551.58,4,6,15,6,True
2184750,1217,0,20,5598,291763341,0,0,0,981.86,3,578569.72,24,4,15,6,True
2719389,663,4,451,4593,291763341,0,0,0,981.96,7,577587.76,18,2,22,6,True
3067254,663,4,25,4593,291763341,0,0,0,981.96,8,576605.8,18,5,1,7,True
3417156,663,4,451,7992,291763341,0,0,0,981.94,7,575623.86,18,4,16,8,True
3483546,174,3,451,9189,291763341,0,0,0,982.01,7,574641.85,24,0,9,8,True
3555647,572,0,10,1418,291763341,0,0,0,982.06,6,575623.91,11,6,23,8,True
3649455,1014,1,-1,4068,291763341,0,1,0,982.16,1,575623.91,26,2,0,8,True
4182198,294,3,30,1268,291763341,0,0,0,982.27,8,574641.64,4,0,6,8,True
4399336,1232,1,30,4036,291763341,0,0,0,982.05,8,573659.59,18,1,22,9,True
4497096,294,3,451,5598,291763341,0,0,0,982.12,7,572677.47,4,5,7,10,True
4607495,174,3,25,9189,291763341,0,0,0,981.96,8,571695.51,24,3,20,11,True
4811276,294,3,451,1268,291763341,0,0,0,982.22,7,570713.29,4,1,3,12,True
4842963,1014,1,25,1268,291763341,0,0,0,981.92,8,569731.37,26,3,4,12,True
4999713,1019,0,25,5346,291763341,0,0,0,982.11,8,568749.26,26,0,2,1,True
5096594,1232,1,-1,9189,291763341,0,1,0,981.95,4,568749.26,18,6,18,2,True
5125814,611,0,10,7636,291763341,0,0,0,982.34,0,569731.6,11,6,13,2,True
5300759,294,3,451,7992,291763341,0,0,0,981.96,7,568749.64,4,6,15,3,True
5336682,174,3,25,1045,291763341,0,0,0,982.18,8,567767.46,24,6,4,4,True
5376538,663,4,30,5598,291763341,0,0,0,981.89,8,566785.57,18,0,11,5,True
5504011,1445,2,20,3763,291763341,0,0,0,981.89,3,565803.68,24,2,18,5,True
5714507,294,3,30,9163,291763341,0,0,0,982.19,8,564821.49,4,4,0,5,True
5753606,1264,0,20,7992,291763341,0,0,0,982.01,3,563839.48,23,4,17,7,True
5923419,174,3,30,7762,291763341,0,0,0,982.05,8,562857.43,24,2,10,8,True
5936632,857,1,10,7762,291763341,0,0,0,981.97,6,563839.4,24,6,1,8,True
6079452,1014,1,30,3339,291763341,0,0,0,982.06,8,562857.34,26,2,6,9,True
7355399,174,3,25,5598,291763341,0,0,0,982.02,8,561875.32,24,6,2,9,False
7909974,1014,1,451,8979,291763341,0,0,0,982.15,7,560893.17,26,6,12,9,True
7980096,1232,1,-1,4593,291763341,0,1,0,982.0,4,560893.17,18,5,19,10,True
7984936,294,3,451,7166,291763341,0,0,0,981.87,7,559911.3,4,0,22,11,True
8037657,1014,1,30,3763,291763341,0,0,0,982.11,8,558929.19,26,4,4,11,True
8151320,174,3,30,7992,291763341,0,0,0,981.84,8,557947.35,24,0,1,12,True
8356935,294,3,451,4036,291763341,0,0,0,981.77,7,556965.58,4,6,15,1,True
8357690,174,3,30,3339,291763341,0,0,0,981.87,8,555983.71,24,1,18,2,True
8378199,1014,1,451,7992,291763341,0,0,0,981.99,7,555001.72,26,0,3,2,True
8548075,294,3,-1,3339,291763341,0,1,0,982.36,1,555001.72,4,1,20,2,True
8614154,353,1,10,5346,291763341,0,0,0,981.89,0,555983.61,24,0,0,3,True
8769044,572,0,10,3339,291763341,0,0,0,982.04,0,556965.65,11,4,18,3,True
8804647,663,4,25,1418,291763341,0,0,0,982.0,8,555983.65,18,1,18,3,True
8820483,294,3,25,1714,291763341,0,0,0,981.97,8,555001.68,4,1,5,4,True
9153904,1019,0,451,8979,291763341,0,0,0,982.12,7,554019.56,26,1,0,5,True
9213672,663,4,25,1418,291763341,0,0,0,982.03,8,553037.53,18,2,15,5,True
9265896,1019,0,25,1045,291763341,0,0,0,981.93,8,552055.6,26,5,15,6,True
9391392,663,4,25,4605,291763341,0,0,0,981.84,8,551073.76,18,1,20,6,True
9649743,1232,1,25,1268,291763341,0,0,0,981.97,8,550091.79,18,1,0,6,True
9723695,174,3,451,8979,291763341,0,0,0,981.87,7,549109.92,24,6,19,8,True
9863419,701,2,20,5346,291763341,0,0,0,981.83,5,548128.09,18,5,20,9,False
9976443,294,3,30,7762,291763341,0,0,0,982.07,8,547146.02,4,2,16,10,True
1244731,104,4,-1,3759,693751966,0,1,0,747.97,4,886096.0,3,2,17,1,True
1596616,950,0,30,3162,693751966,0,0,0,748.13,8,885347.87,24,6,18,1,True
1751961,1345,2,20,1510,693751966,0,0,0,748.18,5,884599.69,24,0,6,1,True
1963098,1086,0,20,9823,693751966,0,0,0,748.22,3,883851.47,18,2,5,1,True
2078193,738,2,20,2970,693751966,0,0,0,747.85,5,883103.62,11,0,21,2,True
2223090,1041,0,30,2970,693751966,0,0,0,747.72,8,882355.9,11,1,0,3,True
2276394,1041,0,451,3759,693751966,0,0,0,747.87,7,881608.03,11,3,2,4,True
2788498,154,4,-1,4822,693751966,0,1,0,747.97,1,881608.03,18,1,5,4,True
2917629,104,4,-1,4822,693751966,0,2,0,748.0,4,881608.03,3,4,18,4,True
2989628,1101,2,25,7085,693751966,0,0,0,747.75,8,880860.28,0,0,12,5,True
3021281,211,0,10,2970,693751966,0,0,0,748.13,6,881608.41,9,1,15,5,True
3389258,1101,2,30,7733,693751966,0,0,0,747.88,8,880860.53,0,5,10,7,True
3398128,1103,4,-1,7085,693751966,0,1,0,747.78,1,880860.53,0,4,8,7,True
3818073,1101,2,451,3408,693751966,0,0,0,747.88,7,880112.65,0,6,13,8,True
4416713,783,0,20,3408,693751966,0,0,0,748.22,5,879364.43,14,4,16,8,True
4523824,611,0,10,4822,693751966,0,0,0,748.06,6,880112.49,11,2,8,9,True
4643491,486,4,25,4330,693751966,0,0,0,748.11,8,879364.38,5,2,12,10,True
4732580,1103,4,25,1908,693751966,0,0,0,748.26,8,878616.12,0,6,8,10,True
4732743,950,0,451,5439,693751966,0,0,0,748.1,7,877868.02,24,2,6,11,True
4970466,309,0,10,1908,693751966,0,0,0,747.95,6,878615.97,4,5,18,11,True
5148340,867,0,10,9823,693751966,0,0,0,748.16,6,879364.13,24,1,2,11,True
5293733,1041,0,451,9823,693751966,0,0,0,748.1,7,878616.03,11,2,7,1,True
5411077,1103,4,30,2970,693751966,0,0,0,748.13,8,877867.9,0,0,13,2,True
5532925,1260,0,20,8018,693751966,0,0,0,748.11,5,877119.79,23,3,5,3,True
5565733,1101,2,451,4262,693751966,0,0,0,748.11,7,876371.68,0,4,11,3,True
5705602,154,4,451,1510,693751966,0,0,0,748.26,7,875623.42,18,1,21,4,True
6390071,1041,0,-1,1908,693751966,0,1,0,748.09,4,875623.42,11,0,14,5,True
6418977,104,4,-1,2095,693751966,0,2,0,748.17,4,875623.42,3,4,6,6,True
6439202,1103,4,30,4822,693751966,0,0,0,747.94,8,874875.48,0,4,12,7,True
6626395,1271,0,20,3805,693751966,0,0,0,748.25,3,874127.23,23,1,17,7,True
6827084,104,4,451,7733,693751966,0,0,0,748.31,7,873378.92,3,2,14,7,True
6883774,1103,4,30,2970,693751966,0,0,0,748.04,8,872630.88,0,2,17,8,True
7060864,1103,4,30,3162,693751966,0,0,0,747.94,8,871882.94,0,1,18,8,True
7272879,1162,2,20,7085,693751966,0,0,0,748.03,3,871134.91,24,3,4,9,True
7294595,1041,0,30,4822,693751966,0,0,0,747.84,8,870387.07,11,4,22,10,False
7411860,950,0,25,7085,693751966,0,0,0,748.14,8,869638.93,24,3,2,10,True
7491683,950,0,25,9823,693751966,0,0,0,747.87,8,868891.06,24,5,10,10,True
7509727,269,0,10,8018,693751966,0,0,0,748.01,6,869639.07,24,0,21,10,True
7587353,486,4,451,4262,693751966,0,0,0,748.02,7,868891.05,5,4,9,11,True
7876657,1041,0,30,4822,693751966,0,0,0,748.04,8,868143.01,11,2,8,12,True
7887109,950,0,25,7085,693751966,0,0,0,747.68,8,867395.33,24,0,8,12,True
7907730,104,4,25,3162,693751966,0,0,0,748.07,8,866647.26,3,6,10,12,True
7998887,1101,2,25,4822,693751966,0,0,0,748.16,8,865899.1,0,0,2,1,True
8353237,1101,2,451,4822,693751966,0,0,0,747.94,7,865151.16,0,6,6,2,True
8688858,1041,0,-1,4330,693751966,0,1,0,747.81,4,865151.16,11,6,1,2,False
8717337,1041,0,30,8018,693751966,0,0,0,748.08,8,864403.08,11,0,10,2,True
8721968,1041,0,451,3759,693751966,0,0,0,747.65,7,863655.43,11,1,6,2,True
8727995,104,4,451,7085,693751966,0,0,0,747.99,7,862907.44,3,0,23,2,True
8989783,1041,0,451,7085,693751966,0,0,0,748.09,7,862159.35,11,6,10,3,False
9000982,1103,4,451,7085,693751966,0,0,0,748.04,7,861411.31,0,2,4,5,True
9131751,1101,2,20,4330,693751966,0,0,0,747.98,5,860663.33,0,0,0,7,True
9289959,154,4,-1,4262,693751966,0,1,0,748.05,1,860663.33,18,6,1,8,True
9330933,826,1,10,9823,693751966,0,0,0,748.1,0,861411.43,18,0,2,9,True
9535230,727,0,10,7557,693751966,0,0,0,748.04,6,862159.47,11,1,22,9,True
9800771,303,0,20,4822,693751966,0,0,0,747.87,5,861411.6,4,2,15,10,True
9808819,653,1,10,8018,693751966,0,0,0,747.94,0,862159.54,24,5,8,11,True
9886025,1041,0,-1,4330,693751966,0,1,0,748.19,4,862159.54,11,0,13,11,True
1170945,312,0,20,5039,655241852,1,0,0,184.75,3,198328.25,4,5,14,1,True
1323717,20,0,451,5518,655241852,1,0,0,184.88,7,198143.37,24,1,23,1,False
1490956,266,2,20,7731,655241852,1,0,0,185.16,5,197958.21,6,2,5,2,False
1605829,134,4,451,7013,655241852,1,0,0,185.13,7,197773.08,18,2,7,2,True
1657951,602,4,25,7013,655241852,1,0,0,184.93,8,197588.15,24,0,17,2,False
1887100,319,0,10,1956,655241852,1,0,0,185.1,0,197773.25,11,1,17,2,True
1976025,1164,0,20,8603,655241852,1,0,0,184.95,5,197588.3,24,2,15,2,True
2240803,20,0,-1,3087,655241852,1,1,0,184.98,4,197588.3,24,0,23,4,True
2339515,1280,3,30,5511,655241852,1,0,0,185.09,8,197403.21,24,4,0,4,True
2510937,610,0,10,9088,655241852,1,0,0,184.87,6,197588.08,11,2,7,5,True
2818507,602,4,30,3285,655241852,1,0,0,184.78,8,197403.3,24,2,4,6,True
2908471,1189,2,20,7013,655241852,1,0,0,184.98,5,197218.32,24,4,10,6,True
2920512,20,0,451,8603,655241852,1,0,0,184.96,7,197033.36,24,1,3,8,True
3179117,1280,3,25,4629,655241852,1,0,0,185.0,8,196848.36,24,3,8,8,True
3252051,20,0,451,7321,655241852,1,0,0,185.19,7,196663.17,24,3,21,9,True
3468805,851,1,10,5039,655241852,1,0,0,185.27,0,196848.44,5,4,3,10,True
3485957,1239,1,451,3105,655241852,1,0,0,185.18,7,196663.26,18,5,10,10,True
3650555,1280,3,25,7013,655241852,1,0,0,184.73,8,196478.53,24,2,15,12,True
3671388,20,0,25,8603,655241852,1,0,0,185.07,8,196293.46,24,5,10,12,True
3676852,589,1,10,3087,655241852,1,0,0,185.22,6,196478.68,24,2,1,1,True
4062697,602,4,30,1956,655241852,1,0,0,184.89,8,196293.79,24,0,15,2,True
4156378,867,0,10,1689,655241852,1,0,0,184.94,6,196478.73,24,1,15,2,True
4209755,134,4,-1,4527,655241852,1,1,0,184.96,4,196478.73,18,6,7,3,True
4526388,1354,0,20,1689,655241852,1,0,0,184.99,5,196293.74,24,3,11,3,True
4544625,318,0,20,5276,655241852,1,0,0,184.94,5,196108.8,11,6,14,3,True
4552495,20,0,25,4527,655241852,1,0,0,185.11,8,195923.69,24,2,1,4,True
4881602,1101,2,20,7313,655241852,1,0,0,185.14,5,195738.55,0,2,4,4,True
4908139,727,0,10,5511,655241852,1,0,0,184.9,6,195923.45,11,2,13,4,True
5113990,1205,0,10,2358,655241852,1,0,0,184.9,0,196108.35,24,6,14,6,True
5268076,20,0,451,1956,655241852,1,0,0,184.91,7,195923.44,24,6,16,6,True
5275135,1280,3,-1,1956,655241852,1,1,0,184.99,4,195923.44,24,2,23,7,True
5317041,20,0,451,1689,655241852,1,0,0,184.88,7,195738.56,24,3,19,7,True
6212390,1280,3,451,5039,655241852,1,0,0,185.06,7,195553.5,24,1,3,7,True
6317854,1086,0,20,2358,655241852,1,0,0,185.04,5,195368.46,18,0,11,8,True
6449380,1239,1,-1,4527,655241852,1,1,0,184.89,4,195368.46,18,3,16,8,True
6488055,1280,3,451,3105,655241852,1,0,0,185.11,7,195183.35,24,4,22,8,True
6715016,502,0,20,7731,655241852,1,0,0,184.99,5,194998.36,12,4,10,10,True
6827257,1239,1,-1,3087,655241852,1,1,0,185.11,4,194998.36,18,4,15,10,True
7660880,602,4,451,6979,655241852,1,0,0,184.83,7,194813.53,24,3,18,11,True
7670832,602,4,451,2157,655241852,1,0,0,184.95,7,194628.58,24,1,4,11,True
7727615,602,4,451,2358,655241852,1,0,0,184.89,7,194443.69,24,4,1,11,True
7874512,20,0,30,3087,655241852,1,0,0,184.96,8,194258.73,24,3,23,11,True
8135585,116,0,20,3087,655241852,1,0,0,184.8,5,194073.93,3,1,4,12,True
8718944,602,4,-1,5518,655241852,1,1,0,185.1,1,194073.93,24,3,2,12,True
8935100,134,4,451,3507,655241852,1,0,0,184.95,7,193888.98,18,5,23,12,True
8949490,1239,1,451,2157,655241852,1,0,0,184.8,7,193704.18,18,1,16,1,True
8950006,602,4,451,1956,655241852,1,0,0,184.91,7,193519.27,24,4,9,2,True
8980007,1488,0,10,7731,655241852,1,0,0,184.89,6,193704.16,24,4,13,4,True
9168031,799,2,20,2358,655241852,1,0,0,184.96,5,193519.2,11,4,21,4,True
9322078,1270,1,10,6979,655241852,1,0,0,184.74,6,193703.94,23,4,21,5,True
9368288,134,4,25,4629,655241852,1,0,0,185.2,8,193518.74,18,6,10,6,True
9478528,312,0,10,1956,655241852,1,0,0,184.69,6,193703.43,4,1,22,7,True
9603598,134,4,451,2157,655241852,1,0,0,184.91,7,193518.52,18,6,20,8,True
9682585,1239,1,25,3105,655241852,1,0,0,184.86,8,193333.66,18,3,22,10,False
9798285,1282,2,20,7731,655241852,1,0,0,184.95,5,193148.71,24,4,1,11,True
1152744,118,2,20,3701,151225850,0,0,0,792.01,3,222000.99,18,0,4,1,False
1176232,445,0,20,7583,151225850,0,0,0,792.07,5,221208.92,13,5,9,2,True
1570604,871,0,451,1060,151225850,0,0,0,791.9,7,220417.02,24,6,1,2,True
1626776,730,4,25,2971,151225850,0,0,0,791.74,8,219625.28,11,0,0,2,True
1630699,1190,3,451,6822,151225850,0,0,0,792.13,7,218833.15,24,1,9,3,True
1980621,1190,3,451,3701,151225850,0,0,0,791.85,7,218041.3,24,0,23,3,False
2209198,312,0,10,8421,151225850,0,0,0,791.92,6,218833.22,4,6,20,3,True
2267518,1190,3,451,1293,151225850,0,0,0,791.74,7,218041.48,24,2,5,4,True
2307028,1190,3,30,6822,151225850,0,0,0,791.94,8,217249.54,24,3,6,4,True
2414216,421,3,25,1141,151225850,0,0,0,791.99,8,216457.55,18,6,7,5,True
2717998,533,2,25,8421,151225850,0,0,0,792.01,8,215665.54,18,0,9,6,True
2782484,21,0,10,3701,151225850,0,0,0,791.7,6,216457.24,11,1,6,6,True
2902686,1190,3,451,6822,151225850,0,0,0,792.34,7,215664.9,24,4,14,7,True
3060462,1113,1,25,1141,151225850,0,0,0,791.99,8,214872.91,0,4,2,7,True
3281681,538,0,20,1141,151225850,0,0,0,791.96,5,214080.95,18,1,11,7,True
3291138,175,3,451,5831,151225850,0,0,0,792.1,7,213288.85,24,4,11,8,True
3818470,369,1,10,1060,151225850,0,0,0,792.01,0,214080.86,25,1,21,8,True
3979036,730,4,451,8362,151225850,0,0,0,792.06,7,213288.8,11,0,0,10,True
4507692,175,3,30,2120,151225850,0,0,0,791.98,8,212496.82,24,4,21,11,True
4739884,730,4,30,1271,151225850,0,0,0,791.88,8,211704.94,11,0,19,12,True
4774576,421,3,25,1271,151225850,0,0,0,792.28,8,210912.66,18,5,7,12,True
5101446,79,4,-1,8362,151225850,0,1,0,792.1,4,210912.66,1,4,7,12,True
5108344,1134,1,10,2971,151225850,0,0,0,791.9,6,211704.56,24,3,6,12,True
5161651,175,3,-1,1060,151225850,0,1,0,791.81,4,211704.56,24,4,10,1,True
5250820,533,2,25,9712,151225850,0,0,0,791.87,8,210912.69,18,2,3,2,True
5888232,79,4,451,2971,151225850,0,0,0,792.07,7,210120.62,1,6,7,3,True
5971505,1260,0,10,9712,151225850,0,0,0,791.85,6,210912.47,23,6,23,3,True
6187295,603,0,10,6822,151225850,0,0,0,791.97,0,211704.44,24,4,18,3,True
6303975,1190,3,-1,5831,151225850,0,1,0,792.08,4,211704.44,24,2,11,3,True
6335526,1113,1,451,1060,151225850,0,0,0,792.07,7,210912.37,0,5,18,4,True
6405575,730,4,25,7604,151225850,0,0,0,791.82,8,210120.55,11,0,19,5,True
6560756,730,4,-1,6822,151225850,0,1,0,792.06,4,210120.55,11,4,6,6,True
6649193,871,0,451,1931,151225850,0,0,0,792.0,7,209328.55,24,4,11,7,True
6690799,1113,1,30,5413,151225850,0,0,0,792.2,8,208536.35,0,4,15,8,True
6855182,421,3,451,7583,151225850,0,0,0,792.0,7,207744.35,18,1,2,9,True
6925189,533,2,25,7583,151225850,0,0,0,791.8,8,206952.55,18,3,20,9,True
7028621,79,4,451,5831,151225850,0,0,0,792.16,7,206160.39,1,3,23,9,True
7131947,421,3,30,3237,151225850,0,0,0,791.95,8,205368.44,18,1,23,9,True
7446643,1093,0,20,2971,151225850,0,0,0,791.83,3,204576.61,18,5,11,9,True
7828949,1019,0,20,1271,151225850,0,0,0,792.03,3,203784.58,26,0,12,10,True
8338297,1072,0,20,2591,151225850,0,0,0,792.17,5,202992.41,18,6,13,11,True
8626674,913,0,20,5831,151225850,0,0,0,792.05,3,202200.36,18,3,17,11,True
9203439,1114,1,10,2971,151225850,0,0,0,792.25,6,202992.61,0,5,12,1,False
9241060,913,0,20,3237,151225850,0,0,0,791.99,3,202200.62,18,0,6,1,True
9336148,1113,1,30,9712,151225850,0,0,0,792.09,8,201408.53,0,6,12,6,True
9345828,871,0,451,5831,151225850,0,0,0,792.08,7,200616.45,24,6,23,8,False
9409518,97,0,20,3701,151225850,0,0,0,792.07,5,199824.38,3,0,13,8,True
9413209,730,4,30,3353,151225850,0,0,0,791.9,8,199032.48,11,0,7,10,True
9458843,1000,0,20,6033,151225850,0,0,0,792.07,3,198240.41,26,1,9,10,True
9773456,175,3,451,2120,151225850,0,0,0,791.86,7,197448.55,24,0,19,10,True
9835377,1113,1,451,3676,151225850,0,0,0,791.77,7,196656.78,0,2,22,10,True
1077052,482,1,10,9118,542768177,1,0,0,754.88,0,287360.88,5,5,19,1,True
1117953,166,4,25,2403,542768177,1,0,0,754.78,8,286606.1,24,4,10,1,True
1628582,639,4,30,4303,542768177,1,0,0,754.94,8,285851.16,24,2,16,3,False
1783508,1150,0,20,7856,542768177,1,0,0,755.21,3,285095.95,15,2,17,3,True
1931984,484,0,451,9873,542768177,1,0,0,755.18,7,284340.77,5,4,4,6,True
2070348,166,4,-1,1816,542768177,1,1,0,755.06,1,284340.77,24,6,16,6,False
2230991,1218,4,451,2042,542768177,1,0,0,755.26,7,283585.51,24,6,18,6,True
2426545,807,0,10,7975,542768177,1,0,0,754.96,0,284340.47,11,4,7,7,True
2465366,46,1,10,5079,542768177,1,0,0,755.03,6,285095.5,24,5,12,7,True
2656220,806,1,10,5312,542768177,1,0,0,754.77,6,285850.27,11,3,5,7,True
3072508,484,0,-1,5312,542768177,1,1,0,755.07,4,285850.27,5,6,9,8,True
3385687,639,4,451,5286,542768177,1,0,0,755.08,7,285095.19,24,5,3,8,True
3783520,889,0,20,3242,542768177,1,0,0,755.18,5,284340.01,27,2,6,9,False
3912332,1447,4,451,6534,542768177,1,0,0,754.88,7,283585.13,24,5,7,9,True
4063141,484,0,30,7514,542768177,1,0,0,755.22,8,282829.91,5,3,22,9,True
4273675,639,4,-1,5312,542768177,1,1,0,754.84,1,282829.91,24,5,22,10,True
4561529,484,0,-1,8651,542768177,1,2,0,754.95,4,282829.91,5,3,18,12,True
4646578,639,4,25,2814,542768177,1,0,0,754.81,8,282075.1,24,5,17,12,True
4680199,1218,4,25,1816,542768177,1,0,0,755.04,8,281320.06,24,5,4,1,True
4703202,1146,2,20,2704,542768177,1,0,0,755.14,3,280564.92,15,1,4,1,True
4862530,1447,4,30,3195,542768177,1,0,0,755.16,8,279809.76,24,3,0,2,True
5326978,1218,4,451,7856,542768177,1,0,0,754.87,7,279054.89,24,4,13,3,True
5338342,1447,4,451,8651,542768177,1,0,0,754.71,7,278300.18,24,4,4,5,True
5553410,484,0,451,2704,542768177,1,0,0,755.1,7,277545.08,5,1,15,5,True
5579883,399,2,20,9118,542768177,1,0,0,754.99,3,276790.09,10,3,16,5,True
5730284,639,4,25,9568,542768177,1,0,0,754.83,8,276035.26,24,4,23,7,True
5830994,166,4,451,2403,542768177,1,0,0,754.99,7,275280.27,24,1,14,8,True
5852671,365,0,20,5079,542768177,1,0,0,754.99,3,274525.28,25,4,15,8,True
5966650,952,0,10,8277,542768177,1,0,0,755.07,6,275280.35,13,4,23,8,True
6294460,166,4,451,5800,542768177,1,0,0,754.63,7,274525.72,24,6,18,9,True
6538008,1122,1,10,7856,542768177,1,0,0,755.08,0,275280.8,24,2,21,9,True
6608543,639,4,25,4932,542768177,1,0,0,755.17,8,274525.63,24,5,13,10,True
6665815,166,4,30,7856,542768177,1,0,0,755.17,8,273770.46,24,6,12,10,True
6882834,1218,4,451,7514,542768177,1,0,0,755.08,7,273015.38,24,1,3,11,True
6937836,1447,4,451,5079,542768177,1,0,0,755.01,7,272260.37,24,6,10,11,True
7191928,1218,4,30,5286,542768177,1,0,0,754.97,8,271505.4,24,0,0,12,True
7328426,1447,4,-1,7856,542768177,1,1,0,754.83,4,271505.4,24,1,3,12,True
7436793,1425,0,20,4932,542768177,1,0,0,754.73,5,270750.67,24,1,13,12,True
7444074,1218,4,451,4303,542768177,1,0,0,755.07,7,269995.6,24,6,17,12,False
7521890,857,1,10,4932,542768177,1,0,0,754.89,0,270750.49,24,2,12,12,True
7608866,1354,0,20,7251,542768177,1,0,0,755.06,5,269995.43,24,1,14,1,True
7767818,1218,4,25,7922,542768177,1,0,0,755.0,8,269240.43,24,4,1,2,True
8055102,484,0,-1,5312,542768177,1,1,0,754.92,1,269240.43,5,1,20,2,False
8427700,484,0,-1,4932,542768177,1,2,0,754.96,4,269240.43,5,1,4,3,False
8589263,484,0,30,6534,542768177,1,0,0,755.02,8,268485.41,5,6,19,3,False
9072640,1068,2,20,7251,542768177,1,0,0,755.14,5,267730.27,18,0,2,4,True
9166260,1218,4,-1,7856,542768177,1,1,0,755.02,4,267730.27,24,0,13,4,True
9180827,639,4,451,3195,542768177,1,0,0,755.08,7,266975.19,24,4,18,4,True
9411019,1218,4,30,5079,542768177,1,0,0,754.65,8,266220.54,24,3,23,6,True
9430747,484,0,25,6534,542768177,1,0,0,754.9,8,265465.64,5,5,14,6,True
9471267,1110,0,20,6158,542768177,1,0,0,755.03,5,264710.61,0,4,21,7,True
9488432,166,4,30,5251,542768177,1,0,0,755.04,8,263955.57,24,5,16,8,True
9651532,484,0,30,7922,542768177,1,0,0,754.93,8,263200.64,5,6,20,9,True
9674363,484,0,25,3195,542768177,1,0,0,755.18,8,262445.46,5,2,15,9,True
9734441,484,0,30,4932,542768177,1,0,0,755.05,8,261690.41,5,1,22,10,True
9741952,484,0,25,2704,542768177,1,0,0,755.06,8,260935.35,5,2,1,10,False
9831833,1218,4,-1,2042,542768177,1,1,0,754.98,1,260935.35,24,1,14,11,True
9986455,180,0,10,2364,542768177,1,0,0,755.15,6,261690.5,18,4,17,11,True
1022538,531,0,30,3575,866714158,1,0,0,967.83,8,575394.17,18,1,8,1,True
1141487,696,2,20,3278,866714158,1,0,0,968.3,5,574425.87,24,0,0,1,True
1371959,849,1,30,5754,866714158,1,0,0,967.91,8,573457.96,5,5,21,2,True
1385185,337,1,451,1788,866714158,1,0,0,968.14,7,572489.82,11,1,11,2,True
1473368,849,1,451,3256,866714158,1,0,0,968.16,7,571521.66,5,1,21,4,True
1498983,1235,1,-1,5522,866714158,1,1,0,968.24,4,571521.66,18,2,0,5,True
1600207,808,3,30,8380,866714158,1,0,0,968.08,8,570553.58,11,3,13,5,True
1797975,337,1,451,5264,866714158,1,0,0,968.14,7,569585.44,11,4,11,5,True
1909450,1227,0,-1,3497,866714158,1,1,0,968.07,1,569585.44,18,4,18,5,True
1947300,1231,2,20,5264,866714158,1,0,0,968.13,5,568617.31,18,5,2,6,True
2164537,1235,1,30,9469,866714158,1,0,0,968.01,8,567649.3,18,1,14,6,True
2743450,808,3,30,3728,866714158,1,0,0,967.84,8,566681.46,11,1,7,6,True
2970280,337,1,25,3728,866714158,1,0,0,967.72,8,565713.74,11,1,18,7,True
3130046,1227,0,25,6122,866714158,1,0,0,968.11,8,564745.63,18,1,22,7,True
3281123,337,1,451,5666,866714158,1,0,0,968.02,7,563777.61,11,2,10,7,True
3295850,648,3,25,5754,866714158,1,0,0,967.92,8,562809.69,24,6,7,7,True
3370032,1227,0,-1,3728,866714158,1,1,0,967.75,4,562809.69,18,6,22,8,True
3526556,808,3,25,5264,866714158,1,0,0,967.85,8,561841.84,11,3,20,8,True
3539763,123,0,10,3575,866714158,1,0,0,968.13,6,562809.97,18,3,15,10,True
3947469,1179,0,20,9730,866714158,1,0,0,968.24,5,561841.73,24,5,12,10,True
4079105,1119,0,10,3497,866714158,1,0,0,968.09,6,562809.82,24,4,7,11,True
4183081,211,0,10,3256,866714158,1,0,0,967.91,6,563777.73,9,2,10,11,True
4801254,1069,1,10,9730,866714158,1,0,0,967.94,6,564745.67,18,5,10,1,True
4947372,337,1,25,1504,866714158,1,0,0,967.71,8,563777.96,11,6,9,1,True
5032370,342,0,10,3256,866714158,1,0,0,967.9,0,564745.86,24,2,4,3,True
5145823,1485,0,20,6122,866714158,1,0,0,968.0,5,563777.86,24,0,7,4,True
5188740,648,3,-1,1504,866714158,1,1,0,967.94,1,563777.86,24,4,3,4,True
5210727,1227,0,-1,5522,866714158,1,2,0,968.0,4,563777.86,18,2,2,5,True
5291095,1245,1,10,5754,866714158,1,0,0,967.99,6,564745.85,18,1,9,6,True
5364102,649,0,20,9730,866714158,1,0,0,967.87,5,563777.98,24,4,20,6,True
5561873,716,0,10,9469,866714158,1,0,0,968.17,6,564746.15,18,3,6,6,True
5648731,81,0,10,6122,866714158,1,0,0,968.07,6,565714.22,1,4,21,7,True
5781460,531,0,451,9730,866714158,1,0,0,968.27,7,564745.95,18,4,6,8,True
5952366,648,3,30,3448,866714158,1,0,0,967.87,8,563778.08,24,1,11,8,True
6500764,1019,0,10,9145,866714158,1,0,0,967.98,6,564746.06,26,2,19,9,True
7358286,849,1,30,3256,866714158,1,0,0,967.95,8,563778.11,5,5,15,9,True
7681878,919,4,451,5264,866714158,1,0,0,968.12,7,562809.99,18,1,21,9,True
7696865,648,3,451,3497,866714158,1,0,0,968.03,7,561841.96,24,1,18,10,True
7707282,1227,0,451,3728,866714158,1,0,0,967.95,7,560874.01,18,2,16,11,True
7856146,1235,1,451,5343,866714158,1,0,0,967.87,7,559906.14,18,0,5,11,True
7916690,1270,1,10,4079,866714158,1,0,0,968.12,0,560874.26,23,5,1,12,True
7960149,648,3,451,5754,866714158,1,0,0,968.17,7,559906.09,24,3,10,1,True
8032025,337,1,25,3256,866714158,1,0,0,967.7,8,558938.39,11,0,16,1,True
8102457,1028,4,451,3055,866714158,1,0,0,968.05,7,557970.34,11,5,20,2,True
8218939,919,4,25,1504,866714158,1,0,0,967.95,8,557002.39,18,5,11,3,True
8253988,1227,0,-1,5264,866714158,1,1,0,967.86,4,557002.39,18,3,3,3,True
8348269,531,0,-1,4509,866714158,1,2,0,968.17,4,557002.39,18,3,1,4,True
8408870,219,0,10,1788,866714158,1,0,0,968.24,0,557970.63,9,3,7,5,True
8640510,1028,4,451,5666,866714158,1,0,0,967.77,7,557002.86,11,4,13,5,True
8967055,808,3,-1,5754,866714158,1,1,0,967.85,4,557002.86,11,0,23,6,True
9001095,337,1,451,3575,866714158,1,0,0,967.88,7,556034.98,11,2,7,6,True
9026129,1235,1,30,7113,866714158,1,0,0,968.08,8,555066.9,18,2,6,7,True
9153060,849,1,30,7113,866714158,1,0,0,967.96,8,554098.94,5,3,8,7,True
9193119,849,1,25,9870,866714158,1,0,0,967.91,8,553131.03,5,1,4,7,True
9292840,579,0,10,9730,866714158,1,0,0,967.97,0,554099.0,11,3,2,8,True
9422951,1028,4,30,3728,866714158,1,0,0,967.7,8,553131.3,11,2,2,10,True
9514936,808,3,451,6122,866714158,1,0,0,968.15,7,552163.15,11,2,8,10,False
9612557,942,0,20,4509,866714158,1,0,0,967.79,5,551195.36,24,4,19,10,True
9715734,550,0,20,8380,866714158,1,0,0,967.86,5,550227.5,17,4,1,11,True
1053434,1244,4,451,4437,120119680,1,0,0,436.8,7,596572.2,18,3,8,1,True
1084638,877,2,451,2394,120119680,1,0,0,436.99,7,596135.21,24,2,17,1,True
1204594,780,0,10,7743,120119680,1,0,0,437.03,0,596572.24,14,0,7,1,True
1230955,470,1,451,6963,120119680,1,0,0,436.98,7,596135.26,5,0,2,3,True
1407315,1356,2,20,8896,120119680,1,0,0,437.16,3,595698.1,24,5,20,4,True
1740553,644,0,20,7147,120119680,1,0,0,436.92,5,595261.18,24,4,7,4,True
1803983,877,2,25,7898,120119680,1,0,0,437.05,8,594824.13,24,0,18,5,True
1804560,1244,4,451,4437,120119680,1,0,0,437.05,7,594387.08,18,3,22,5,True
2234356,877,2,30,3854,120119680,1,0,0,437.19,8,593949.89,24,4,14,7,True
2238622,468,3,30,3550,120119680,1,0,0,437.0,8,593512.89,5,5,5,7,True
2385968,1244,4,30,6963,120119680,1,0,0,436.85,8,593076.04,18,6,14,7,True
2408900,468,3,30,2394,120119680,1,0,0,436.93,8,592639.11,5,6,21,7,True
2464710,470,1,25,6676,120119680,1,0,0,437.14,8,592201.97,5,1,12,8,True
2639095,931,0,20,8896,120119680,1,0,0,436.97,5,591765.0,24,5,23,9,True
2775888,1244,4,25,4437,120119680,1,0,0,437.08,8,591327.92,18,0,14,9,True
3173492,1244,4,30,7147,120119680,1,0,0,437.09,8,590890.83,18,1,2,10,True
3708704,1244,4,-1,3854,120119680,1,1,0,437.15,4,590890.83,18,2,19,10,True
3891946,877,2,25,9998,120119680,1,0,0,436.88,8,590453.95,24,0,7,10,True
4062910,485,1,10,7147,120119680,1,0,0,436.77,6,590890.72,5,2,2,11,True
4179730,470,1,30,9998,120119680,1,0,0,436.65,8,590454.07,5,5,6,11,True
4366573,468,3,451,3854,120119680,1,0,0,437.25,7,590016.82,5,5,17,11,True
4565371,1244,4,25,6963,120119680,1,0,0,437.16,8,589579.66,18,2,1,12,True
4915831,726,0,10,9207,120119680,1,0,0,437.2,0,590016.86,11,2,12,12,True
5057002,158,2,20,6676,120119680,1,0,0,437.15,3,589579.71,24,2,9,1,True
5368157,787,0,25,6963,120119680,1,0,0,437.09,8,589142.62,14,0,12,1,True
5437647,1244,4,451,4281,120119680,1,0,0,436.93,7,588705.69,18,1,14,1,True
5784740,468,3,25,9998,120119680,1,0,0,436.87,8,588268.82,5,2,21,1,True
5803223,1244,4,25,4281,120119680,1,0,0,436.88,8,587831.94,18,6,10,2,True
5808117,468,3,451,7743,120119680,1,0,0,436.98,7,587394.96,5,0,19,3,True
5838790,1244,4,451,3550,120119680,1,0,0,436.79,7,586958.17,18,3,12,3,True
5879153,800,0,10,7743,120119680,1,0,0,437.4,6,587395.57,11,2,15,3,True
5922647,470,1,451,6963,120119680,1,0,0,437.1,7,586958.47,5,4,3,3,True
6047819,812,0,20,8896,120119680,1,0,0,437.01,3,586521.46,18,4,22,3,True
6195129,550,0,20,3854,120119680,1,0,0,436.84,5,586084.62,17,0,6,5,True
6618951,584,0,10,8904,120119680,1,0,0,437.2,6,586521.82,11,0,23,6,True
6753226,1352,1,10,6263,120119680,1,0,0,436.84,0,586958.66,24,3,16,6,False
6950915,787,0,-1,7898,120119680,1,1,0,436.99,1,586958.66,14,0,11,7,True
7004451,1244,4,25,9207,120119680,1,0,0,436.78,8,586521.88,18,5,12,7,True
7065599,1244,4,451,9998,120119680,1,0,0,437.13,7,586084.75,18,1,7,8,True
7443571,787,0,-1,7898,120119680,1,1,0,436.96,4,586084.75,14,0,3,9,True
7575679,470,1,25,6963,120119680,1,0,0,437.15,8,585647.6,5,4,8,9,True
7625384,877,2,30,6963,120119680,1,0,0,437.12,8,585210.48,24,3,6,9,True
7639929,1244,4,451,7898,120119680,1,0,0,437.04,7,584773.44,18,6,2,10,True
7834091,1244,4,451,9998,120119680,1,0,0,437.08,7,584336.36,18,0,22,10,True
8138555,1244,4,25,3550,120119680,1,0,0,437.07,8,583899.29,18,4,23,11,True
8497881,877,2,-1,7743,120119680,1,1,0,437.21,4,583899.29,24,0,4,12,True
8607838,806,1,10,3854,120119680,1,0,0,436.98,6,584336.27,11,6,15,12,True
8867552,468,3,25,3854,120119680,1,0,0,437.14,8,583899.13,5,0,15,1,True
9066401,787,0,451,4437,120119680,1,0,0,437.08,7,583462.05,14,4,23,1,True
9088697,897,0,20,6263,120119680,1,0,0,437.17,5,583024.88,24,6,1,2,True
9142281,883,0,10,8896,120119680,1,0,0,437.12,6,583462.0,24,5,12,6,True
9175006,1244,4,451,4437,120119680,1,0,0,437.05,7,583024.95,18,6,7,6,True
9194953,468,3,451,6963,120119680,1,0,0,436.99,7,582587.96,5,2,1,6,True
9295912,787,0,-1,8904,120119680,1,1,0,437.06,4,582587.96,14,3,3,7,True
9360993,1244,4,25,7147,120119680,1,0,0,436.97,8,582150.99,18,4,17,7,True
9657155,1015,0,10,8904,120119680,1,0,0,437.06,6,582588.05,26,5,21,7,False
9773737,465,0,20,6963,120119680,1,0,0,436.87,5,582151.18,13,6,17,8,True
9779110,1072,0,10,3550,120119680,1,0,0,437.1,6,582588.28,18,3,8,10,True
9807280,645,0,20,9207,120119680,1,0,0,437.08,5,582151.2,24,5,19,10,True
1131326,639,4,25,3934,522451535,0,0,0,1001.96,8,370301.04,24,4,21,4,True
1288250,1485,0,20,3934,522451535,0,0,0,1002.38,3,369298.66,24,6,3,4,True
1296947,357,4,451,6671,522451535,0,0,0,1002.05,7,368296.61,24,1,23,4,True
1505268,774,2,451,6823,522451535,0,0,0,1002.26,7,367294.35,14,4,9,5,True
1513231,774,2,30,6905,522451535,0,0,0,1001.96,8,366292.39,14,6,15,5,True
1518232,774,2,451,6791,522451535,0,0,0,1002.33,7,365290.06,14,0,4,5,True
1539464,903,3,30,3788,522451535,0,0,0,1001.99,8,364288.07,2,6,4,7,True
1679483,427,2,451,2867,522451535,0,0,0,1002.06,7,363286.01,18,2,17,8,True
1689890,860,1,25,1098,522451535,0,0,0,1001.76,8,362284.25,24,0,1,8,True
1835921,910,0,10,6971,522451535,0,0,0,1002.22,6,363286.47,18,5,10,10,True
2042537,681,2,20,6791,522451535,0,0,0,1001.92,5,362284.55,24,0,14,10,True
2137511,168,0,20,6474,522451535,0,0,0,1001.89,5,361282.66,24,6,4,10,True
2180284,427,2,25,6823,522451535,0,0,0,1002.15,8,360280.51,18,3,23,11,True
2184772,427,2,-1,2867,522451535,0,1,0,1002.14,4,360280.51,18,0,9,11,True
2521019,448,0,10,3788,522451535,0,0,0,1002.05,0,361282.56,13,5,6,12,True
2586312,757,0,25,9984,522451535,0,0,0,1001.82,8,360280.74,24,3,4,1,True
2604002,675,2,20,2445,522451535,0,0,0,1002.1,5,359278.64,24,6,18,2,True
2773965,357,4,-1,2867,522451535,0,1,0,1002.05,4,359278.64,24,2,8,2,True
2884422,357,4,451,3749,522451535,0,0,0,1002.23,7,358276.41,24,5,15,3,True
3362850,1448,4,30,6671,522451535,0,0,0,1001.83,8,357274.58,11,2,5,4,True
3629774,1000,0,20,3934,522451535,0,0,0,1002.18,5,356272.4,26,4,5,4,True
3910364,860,1,-1,6107,522451535,0,1,0,1002.05,4,356272.4,24,4,11,4,False
4255141,774,2,30,2445,522451535,0,0,0,1002.03,8,355270.37,14,3,21,5,True
4291408,757,0,451,3934,522451535,0,0,0,1002.02,7,354268.35,24,6,11,5,True
4357036,774,2,451,2445,522451535,0,0,0,1002.05,7,353266.3,14,0,9,5,True
4598649,1406,0,10,6971,522451535,0,0,0,1001.88,0,354268.18,24,1,7,7,True
4658481,357,4,30,3788,522451535,0,0,0,1001.96,8,353266.22,24,6,6,7,True
4954461,774,2,30,6474,522451535,0,0,0,1002.13,8,352264.09,14,6,9,8,True
4978553,1247,0,20,2867,522451535,0,0,0,1001.82,3,351262.27,23,2,15,9,True
5214055,774,2,451,6971,522451535,0,0,0,1002.01,7,350260.26,14,0,22,9,False
5417999,903,3,451,6791,522451535,0,0,0,1002.34,7,349257.92,2,3,11,9,False
5720282,774,2,-1,6474,522451535,0,1,0,1001.97,1,349257.92,14,3,20,9,True
5774399,757,0,451,9984,522451535,0,0,0,1002.12,7,348255.8,24,3,13,9,True
5799803,1448,4,451,6791,522451535,0,0,0,1002.07,7,347253.73,11,5,8,10,True
5877810,333,1,30,2445,522451535,0,0,0,1002.01,8,346251.72,11,4,15,10,True
5972006,1238,0,20,6474,522451535,0,0,0,1002.42,3,345249.3,18,6,13,10,True
6218310,757,0,25,9984,522451535,0,0,0,1001.68,8,344247.62,24,3,1,11,True
6372859,1338,0,10,6905,522451535,0,0,0,1002.08,6,345249.7,18,5,20,12,True
6478441,333,1,-1,6971,522451535,0,1,0,1001.8,1,345249.7,11,1,21,12,True
7061390,757,0,451,6823,522451535,0,0,0,1001.91,7,344247.79,24,0,14,1,True
7150364,542,0,20,3749,522451535,0,0,0,1001.92,3,343245.87,17,2,12,1,True
7531005,1413,0,10,6474,522451535,0,0,0,1001.93,0,344247.8,24,5,22,3,True
7587202,1448,4,30,6474,522451535,0,0,0,1002.14,8,343245.66,11,3,5,4,True
7660942,774,2,451,6107,522451535,0,0,0,1002.04,7,342243.62,14,1,2,5,True
7773061,757,0,25,3788,522451535,0,0,0,1001.68,8,341241.94,24,3,7,5,True
7891025,774,2,451,6791,522451535,0,0,0,1002.1,7,340239.84,14,0,9,6,True
8208631,757,0,30,2445,522451535,0,0,0,1002.17,8,339237.67,24,5,1,6,True
8247570,639,4,451,1305,522451535,0,0,0,1002.19,7,338235.48,24,2,23,6,False
8383901,1134,1,10,6905,522451535,0,0,0,1002.13,6,339237.61,24,6,10,6,True
8656100,357,4,-1,2867,522451535,0,1,0,1002.06,4,339237.61,24,2,4,6,True
8863666,757,0,25,9099,522451535,0,0,0,1002.21,8,338235.4,24,0,15,7,True
9047466,774,2,-1,6504,522451535,0,1,0,1001.89,4,338235.4,14,6,11,9,True
9626547,427,2,30,9213,522451535,0,0,0,1002.02,8,337233.38,18,2,2,10,True
9675341,1448,4,451,2867,522451535,0,0,0,1001.8,7,336231.58,11,2,5,10,True
9774582,774,2,25,3788,522451535,0,0,0,1002.08,8,335229.5,14,5,6,10,True
9972998,639,4,25,9099,522451535,0,0,0,1002.11,8,334227.39,24,0,15,10,True
1240912,943,4,25,9267,152332313,0,0,0,189.2,8,958141.8,24,4,17,1,True
1241127,867,0,25,1489,152332313,0,0,0,189.28,8,957952.52,24,1,5,1,True
1563082,147,0,10,3319,152332313,0,0,0,188.84,6,958141.36,18,2,21,3,True
1583109,1364,0,20,3384,152332313,0,0,0,188.84,5,957952.52,16,2,19,3,True
1661363,641,0,10,5376,152332313,0,0,0,188.85,6,958141.37,24,2,14,3,True
2114264,1318,0,20,5376,152332313,0,0,0,188.96,3,957952.41,18,3,7,4,True
2241705,880,1,30,3319,152332313,0,0,0,188.98,8,957763.43,27,5,18,4,True
2393396,276,0,20,5376,152332313,0,0,0,189.09,3,957574.34,24,1,22,4,True
2502105,467,0,30,8969,152332313,0,0,0,188.92,8,957385.42,5,1,11,5,True
2559877,880,1,451,9267,152332313,0,0,0,188.87,7,957196.55,27,5,20,6,True
2673050,943,4,-1,8969,152332313,0,1,0,188.75,4,957196.55,24,5,9,6,True
2688856,44,4,-1,9784,152332313,0,2,0,188.9,4,957196.55,24,5,22,7,True
2805142,943,4,451,6678,152332313,0,0,0,188.96,7,957007.59,24,5,11,7,True
2877264,44,4,-1,5376,152332313,0,1,0,189.08,4,957007.59,24,1,12,9,True
2973497,219,0,20,3319,152332313,0,0,0,188.96,5,956818.63,9,5,0,9,True
3080341,867,0,25,3384,152332313,0,0,0,188.74,8,956629.89,24,5,17,9,True
3374899,867,0,-1,6678,152332313,0,1,0,189.04,4,956629.89,24,2,13,10,True
3477857,467,0,25,1015,152332313,0,0,0,189.09,8,956440.8,5,5,8,10,True
3563814,467,0,451,9784,152332313,0,0,0,189.05,7,956251.75,5,4,5,11,True
3687047,1132,0,10,6678,152332313,0,0,0,188.76,6,956440.51,24,4,13,11,True
4070892,72,4,30,3384,152332313,0,0,0,188.86,8,956251.65,20,2,23,12,True
4212558,1010,0,20,3384,152332313,0,0,0,188.99,5,956062.66,26,5,21,12,True
4324606,880,1,30,8258,152332313,0,0,0,189.13,8,955873.53,27,6,23,12,True
4340613,123,0,20,8969,152332313,0,0,0,188.81,5,955684.72,18,3,13,1,True
4646936,467,0,451,3384,152332313,0,0,0,189.05,7,955495.67,5,6,11,2,True
4659041,72,4,30,9190,152332313,0,0,0,189.01,8,955306.66,20,3,22,3,True
4797200,1035,0,10,1015,152332313,0,0,0,188.83,6,955495.49,11,5,17,4,True
4839962,867,0,30,5233,152332313,0,0,0,188.96,8,955306.53,24,5,13,4,True
5027787,362,0,10,6678,152332313,0,0,0,188.95,0,955495.48,24,6,11,4,True
5311601,1451,1,10,3384,152332313,0,0,0,189.08,6,955684.56,11,5,18,5,True
5457464,943,4,30,3384,152332313,0,0,0,189.08,8,955495.48,24,1,1,5,True
5541273,203,0,10,6678,152332313,0,0,0,189.11,6,955684.59,9,5,0,9,True
5768854,752,0,10,6341,152332313,0,0,0,188.94,6,955873.53,24,0,0,10,True
5850709,880,1,25,9267,152332313,0,0,0,189.03,8,955684.5,27,1,10,10,True
5885404,866,0,20,2505,152332313,0,0,0,188.86,3,955495.64,24,1,0,10,True
7385519,867,0,451,5233,152332313,0,0,0,188.88,7,955306.76,24,2,5,11,True
7598817,44,4,25,5996,152332313,0,0,0,188.89,8,955117.87,24,6,0,1,True
7731218,867,0,451,1015,152332313,0,0,0,188.72,7,954929.15,24,6,22,1,True
7790146,72,4,30,9315,152332313,0,0,0,188.98,8,954740.17,20,4,15,2,True
7874204,880,1,-1,7335,152332313,0,1,0,189.05,4,954740.17,27,4,13,2,True
8154534,943,4,30,2505,152332313,0,0,0,189.01,8,954551.16,24,6,1,2,True
8279926,1064,0,10,3319,152332313,0,0,0,189.16,6,954740.32,11,4,8,4,True
8383671,255,2,451,5376,152332313,0,0,0,189.02,7,954551.3,6,6,7,4,True
8609506,255,2,25,6341,152332313,0,0,0,188.84,8,954362.46,6,6,4,5,True
8889312,943,4,451,8258,152332313,0,0,0,188.96,7,954173.5,24,6,4,6,True
9129903,867,0,-1,6678,152332313,0,1,0,189.06,4,954173.5,24,5,11,8,True
9130348,880,1,-1,6341,152332313,0,2,0,188.81,4,954173.5,27,0,13,8,True
9150273,44,4,-1,9267,152332313,0,3,1,189.22,4,0.0,24,4,9,11,True
1076918,142,4,451,9219,990966140,0,0,0,628.07,7,386267.93,18,6,1,2,True
1256273,414,4,25,6207,990966140,0,0,0,628.02,8,385639.91,18,4,8,3,True
1274383,1448,4,30,3048,990966140,0,0,0,628.11,8,385011.8,11,5,19,3,True
1341475,1173,1,10,9422,990966140,0,0,0,627.97,6,385639.77,24,2,10,3,True
1482366,1169,0,10,3311,990966140,0,0,0,627.98,6,386267.75,24,4,0,4,True
1539475,142,4,30,2426,990966140,0,0,0,628.1,8,385639.65,18,4,6,5,True
1751192,142,4,25,6152,990966140,0,0,0,628.05,8,385011.6,18,6,9,5,True
1787182,822,4,25,3144,990966140,0,0,0,627.77,8,384383.83,18,4,12,6,True
1950614,1448,4,451,2552,990966140,0,0,0,627.83,7,383756.0,11,0,11,7,True
2003808,142,4,451,9219,990966140,0,0,0,628.22,7,383127.78,18,3,11,7,True
2376116,804,0,10,8973,990966140,0,0,0,627.98,0,383755.76,11,4,5,7,True
2537640,414,4,25,9422,990966140,0,0,0,628.21,8,383127.55,18,2,18,10,True
2616229,414,4,30,9403,990966140,0,0,0,628.14,8,382499.41,18,2,18,11,True
2839845,1110,0,10,8739,990966140,0,0,0,627.86,6,383127.27,0,6,18,12,True
3302034,882,0,20,3585,990966140,0,0,0,627.99,3,382499.28,27,0,22,12,True
3343373,937,0,20,9219,990966140,0,0,0,628.02,5,381871.26,24,0,21,1,True
3357008,630,0,30,2552,990966140,0,0,0,627.99,8,381243.27,11,2,18,1,True
3370044,630,0,-1,3311,990966140,0,1,0,627.94,4,381243.27,11,1,1,1,True
3553454,822,4,451,3311,990966140,0,0,0,627.83,7,380615.44,18,5,15,2,True
3594860,142,4,30,8739,990966140,0,0,0,628.08,8,379987.36,18,3,13,3,True
3628306,1448,4,451,5676,990966140,0,0,0,627.87,7,379359.49,11,2,10,3,True
3634738,649,0,10,4047,990966140,0,0,0,627.84,6,379987.33,24,4,4,3,True
3890804,822,4,451,2426,990966140,0,0,0,628.08,7,379359.25,18,4,15,3,True
4609458,831,1,10,3144,990966140,0,0,0,627.93,6,379987.18,5,6,7,4,True
4691500,1298,0,20,6819,990966140,0,0,0,628.26,5,379358.92,5,1,2,4,True
4741824,414,4,25,6152,990966140,0,0,0,628.27,8,378730.65,18,6,3,5,True
4752031,580,0,30,1385,990966140,0,0,0,628.1,8,378102.55,11,1,21,7,True
5218192,630,0,-1,3048,990966140,0,1,0,627.98,4,378102.55,11,6,21,7,True
5707635,580,0,451,1385,990966140,0,0,0,628.03,7,377474.52,11,2,5,7,True
5710416,721,4,451,8739,990966140,0,0,0,627.81,7,376846.71,11,6,6,7,True
5857111,142,4,30,4237,990966140,0,0,0,628.14,8,376218.57,18,6,20,7,True
5951894,822,4,451,6908,990966140,0,0,0,628.07,7,375590.5,18,6,13,8,True
6385292,142,4,30,4047,990966140,0,0,0,627.96,8,374962.54,18,3,9,8,True
6408249,630,0,30,8973,990966140,0,0,0,627.87,8,374334.67,11,2,0,11,True
6454675,414,4,30,3585,990966140,0,0,0,628.05,8,373706.62,18,5,4,11,True
6640481,580,0,25,7577,990966140,0,0,0,628.16,8,373078.46,11,0,19,11,True
7023417,1213,2,20,2426,990966140,0,0,0,628.18,5,372450.28,24,4,15,12,True
7216771,580,0,451,4047,990966140,0,0,0,628.19,7,371822.09,11,4,14,12,True
7343276,1448,4,25,8739,990966140,0,0,0,628.37,8,371193.72,11,6,13,2,True
7407791,1219,1,10,2426,990966140,0,0,0,627.85,6,371821.57,24,1,5,2,True
7432417,414,4,451,8739,990966140,0,0,0,628.12,7,371193.45,18,4,22,3,True
7523482,822,4,25,3585,990966140,0,0,0,628.15,8,370565.3,18,5,6,3,True
7942812,414,4,451,3144,990966140,0,0,0,627.75,7,369937.55,18,3,5,5,True
8035394,414,4,-1,3311,990966140,0,1,0,628.05,4,369937.55,18,1,23,5,True
8036420,822,4,30,5676,990966140,0,0,0,628.03,8,369309.52,18,2,22,5,True
8089428,822,4,451,3311,990966140,0,0,0,627.73,7,368681.79,18,6,18,6,True
8572417,484,0,20,4047,990966140,0,0,0,627.73,5,368054.06,5,4,5,7,True
8656762,414,4,451,5676,990966140,0,0,0,627.66,7,367426.4,18,2,22,8,True
8712938,630,0,30,7577,990966140,0,0,0,628.11,8,366798.29,11,1,14,10,True
9279212,1448,4,451,5976,990966140,0,0,0,628.0,7,366170.29,11,4,2,10,True
9342487,414,4,30,2426,990966140,0,0,0,628.23,8,365542.06,18,3,19,10,True
9354189,589,1,10,2426,990966140,0,0,0,627.99,6,366170.05,24,5,19,11,True
9408285,721,4,25,8739,990966140,0,0,0,628.13,8,365541.92,11,3,10,11,True
1276827,1087,4,451,5217,170042476,1,0,0,547.95,7,74500.05,18,4,20,1,True
1394122,1087,4,-1,8018,170042476,1,1,0,547.74,4,74500.05,18,2,15,2,True
1511524,202,4,25,4304,170042476,1,0,0,548.06,8,73951.99,9,3,20,3,True
1562047,114,0,10,2991,170042476,1,0,0,547.83,6,74499.82,3,5,0,3,True
1568072,1087,4,451,5480,170042476,1,0,0,548.26,7,73951.56,18,3,21,3,True
1622650,999,4,-1,9025,170042476,1,1,0,547.97,4,73951.56,26,2,0,4,True
1773161,1436,0,20,3409,170042476,1,0,0,548.03,5,73403.53,24,4,17,4,True
1853290,1363,0,10,5217,170042476,1,0,0,547.84,6,73951.37,16,4,21,5,True
2015162,681,2,20,5408,170042476,1,0,0,548.32,3,73403.05,24,4,7,7,True
2036286,999,4,451,3931,170042476,1,0,0,547.83,7,72855.22,26,0,3,8,True
2208106,1087,4,25,4596,170042476,1,0,0,547.88,8,72307.34,18,2,20,8,False
2265947,366,0,-1,1662,170042476,1,1,0,548.14,4,72307.34,25,2,17,9,True
2693429,202,4,451,5621,170042476,1,0,0,548.05,7,71759.29,9,4,21,9,True
2827573,1245,1,10,5217,170042476,1,0,0,547.96,6,72307.25,18,2,22,10,True
3028420,366,0,25,6203,170042476,1,0,0,548.07,8,71759.18,25,3,22,10,True
3093927,807,0,451,2857,170042476,1,0,0,547.99,7,71211.19,11,5,18,11,True
3405831,1087,4,-1,2549,170042476,1,1,0,547.82,1,71211.19,18,0,18,11,True
3509719,807,0,451,2857,170042476,1,0,0,548.05,7,70663.14,11,3,8,12,True
3575950,205,0,10,5408,170042476,1,0,0,548.1,6,71211.24,9,6,0,12,True
3726532,807,0,30,3931,170042476,1,0,0,548.07,8,70663.17,11,1,10,1,True
3965633,807,0,25,2857,170042476,1,0,0,548.02,8,70115.15,11,5,3,1,True
4061803,900,1,10,4596,170042476,1,0,0,547.95,6,70663.1,24,1,18,2,True
4244868,807,0,25,2857,170042476,1,0,0,547.92,8,70115.18,11,2,7,3,True
4268475,1090,0,10,4596,170042476,1,0,0,548.14,0,70663.32,18,6,8,3,True
4306354,807,0,30,4596,170042476,1,0,0,547.94,8,70115.38,11,6,9,5,True
4319535,999,4,-1,2991,170042476,1,1,0,548.07,4,70115.38,26,1,6,6,True
4494892,202,4,451,3409,170042476,1,0,0,547.96,7,69567.42,9,3,8,6,True
5227429,807,0,451,4835,170042476,1,0,0,547.7,7,69019.72,11,5,6,7,True
5259836,366,0,30,2549,170042476,1,0,0,547.98,8,68471.74,25,5,10,7,True
5494891,184,0,10,1054,170042476,1,0,0,547.8,6,69019.54,18,2,13,8,True
5531547,999,4,-1,5408,170042476,1,1,0,548.26,4,69019.54,26,4,14,8,True
5614163,1087,4,30,1054,170042476,1,0,0,547.96,8,68471.58,18,3,7,8,True
5726046,551,0,20,2857,170042476,1,0,0,548.06,5,67923.52,17,6,5,9,True
5805255,202,4,-1,2771,170042476,1,1,0,547.98,4,67923.52,9,4,22,9,True
5851020,498,0,-1,9025,170042476,1,2,0,547.84,4,67923.52,12,2,18,10,True
6172522,807,0,451,5896,170042476,1,0,0,548.04,7,67375.48,11,0,3,10,True
6469341,1087,4,451,1662,170042476,1,0,0,547.82,7,66827.66,18,5,13,10,True
6919490,366,0,451,6203,170042476,1,0,0,548.21,7,66279.45,25,2,15,11,True
7026916,1233,0,10,1662,170042476,1,0,0,548.02,6,66827.47,18,5,14,11,True
7032897,999,4,-1,2107,170042476,1,1,0,548.17,4,66827.47,26,0,15,11,True
7124463,999,4,451,6895,170042476,1,0,0,547.92,7,66279.55,26,1,17,11,True
7149037,1087,4,30,2343,170042476,1,0,0,547.95,8,65731.6,18,6,7,11,True
7325767,807,0,30,9249,170042476,1,0,0,548.15,8,65183.45,11,2,20,1,True
7443972,366,0,451,1662,170042476,1,0,0,547.96,7,64635.49,25,3,16,1,True
7463873,1150,0,10,2857,170042476,1,0,0,547.8,6,65183.29,15,0,1,2,True
7732907,202,4,25,3931,170042476,1,0,0,547.98,8,64635.31,9,2,14,4,True
7854433,369,1,10,5621,170042476,1,0,0,547.81,0,65183.12,25,3,18,4,True
7946907,346,0,10,4774,170042476,1,0,0,547.99,6,65731.11,24,0,23,4,True
7997712,202,4,451,4304,170042476,1,0,0,547.77,7,65183.34,9,4,9,4,True
8038292,999,4,30,3931,170042476,1,0,0,548.04,8,64635.3,26,5,2,5,True
8056094,807,0,451,5621,170042476,1,0,0,547.85,7,64087.45,11,6,0,5,True
8424281,807,0,-1,8018,170042476,1,1,0,547.91,4,64087.45,11,2,16,6,True
8760130,807,0,30,5480,170042476,1,0,0,547.91,8,63539.54,11,5,23,6,False
8845717,202,4,-1,5217,170042476,1,1,0,547.94,1,63539.54,9,3,11,7,True
8904154,807,0,30,4596,170042476,1,0,0,548.27,8,62991.27,11,5,9,7,True
9433887,297,0,20,5621,170042476,1,0,0,547.87,5,62443.4,4,4,10,8,True
9590416,999,4,451,8018,170042476,1,0,0,547.91,7,61895.49,26,3,13,11,True
1076407,1087,4,30,9888,736588033,1,0,0,161.91,8,956654.09,18,3,4,1,True
1242673,208,0,20,9412,736588033,1,0,0,162.23,3,956491.86,9,0,22,1,True
1309697,1087,4,25,7392,736588033,1,0,0,161.97,8,956329.89,18,2,9,1,True
1426762,1087,4,451,7392,736588033,1,0,0,162.09,7,956167.8,18,6,16,2,True
1832520,1482,3,-1,7392,736588033,1,1,0,162.27,4,956167.8,24,1,10,2,True
1989545,378,0,20,2596,736588033,1,0,0,161.67,3,956006.13,25,1,14,2,True
2798556,1155,0,10,5501,736588033,1,0,0,162.14,6,956168.27,15,4,18,3,True
2995567,589,1,10,5501,736588033,1,0,0,161.74,0,956330.01,24,2,0,6,True
3389617,27,0,10,4983,736588033,1,0,0,161.84,6,956491.85,11,5,6,6,True
3395481,579,0,10,6716,736588033,1,0,0,162.16,0,956654.01,11,6,19,7,True
3612051,897,0,-1,4983,736588033,1,1,0,161.98,4,956654.01,24,2,14,7,True
3642893,1208,4,25,5501,736588033,1,0,0,161.96,8,956492.05,24,2,17,8,True
3662945,485,1,451,6716,736588033,1,0,0,161.91,7,956330.14,5,3,14,9,True
3704187,1208,4,30,2568,736588033,1,0,0,161.84,8,956168.3,24,3,9,10,True
3988782,1482,3,25,2312,736588033,1,0,0,161.91,8,956006.39,24,2,11,11,False
4084683,208,0,10,3505,736588033,1,0,0,162.18,6,956168.57,9,0,18,12,True
4170460,1246,0,20,5501,736588033,1,0,0,162.01,3,956006.56,23,0,1,12,True
4342663,1087,4,25,2568,736588033,1,0,0,162.11,8,955844.45,18,2,23,12,True
4567593,485,1,25,8176,736588033,1,0,0,161.93,8,955682.52,5,3,2,12,True
4615012,1283,2,20,8581,736588033,1,0,0,162.02,3,955520.5,24,1,2,1,True
4681428,897,0,451,9412,736588033,1,0,0,162.08,7,955358.42,24,3,20,1,True
4774605,485,1,451,2312,736588033,1,0,0,162.18,7,955196.24,5,1,23,2,True
4825669,895,0,20,5501,736588033,1,0,0,162.37,3,955033.87,24,2,10,3,True
5311725,137,2,20,2596,736588033,1,0,0,162.13,3,954871.74,18,2,19,5,True
5723027,628,0,20,9412,736588033,1,0,0,162.23,5,954709.51,11,3,7,7,True
5746376,727,0,-1,4789,736588033,1,1,0,162.29,1,954709.51,11,2,10,7,True
6138999,1482,3,451,9412,736588033,1,0,0,162.25,7,954547.26,24,6,21,8,True
6362772,128,0,30,4789,736588033,1,0,0,162.18,8,954385.08,18,4,0,9,True
6419782,1208,4,451,9412,736588033,1,0,0,162.27,7,954222.81,24,6,16,9,True
6652404,897,0,451,2568,736588033,1,0,0,162.08,7,954060.73,24,5,16,1,True
6777163,485,1,451,8581,736588033,1,0,0,162.16,7,953898.57,5,5,4,1,True
6910449,727,0,451,2312,736588033,1,0,0,162.04,7,953736.53,11,5,8,2,True
7118688,228,0,20,7392,736588033,1,0,0,161.89,3,953574.64,26,6,3,3,True
7205307,1482,3,451,8176,736588033,1,0,0,162.19,7,953412.45,24,0,11,3,True
7357076,727,0,30,9888,736588033,1,0,0,162.04,8,953250.41,11,5,9,4,True
7368813,1482,3,451,2663,736588033,1,0,0,162.03,7,953088.38,24,5,0,4,True
7481958,297,0,20,3505,736588033,1,0,0,162.0,3,952926.38,4,0,6,4,True
7721163,485,1,-1,2596,736588033,1,1,0,161.87,1,952926.38,5,5,14,4,True
7797395,1411,0,20,2568,736588033,1,0,0,162.11,3,952764.27,24,5,22,4,True
8135988,485,1,30,7392,736588033,1,0,0,161.97,8,952602.3,5,2,0,6,True
8163209,736,1,10,4789,736588033,1,0,0,162.02,6,952764.32,11,2,12,6,True
8369167,485,1,-1,2568,736588033,1,1,0,161.93,1,952764.32,5,5,7,7,True
8480805,1087,4,30,6261,736588033,1,0,0,162.12,8,952602.2,18,4,9,9,True
8527710,1087,4,25,7392,736588033,1,0,0,162.44,8,952439.76,18,3,1,9,True
8631528,485,1,25,2663,736588033,1,0,0,161.92,8,952277.84,5,4,13,10,True
9492321,560,2,20,6261,736588033,1,0,0,162.26,5,952115.58,17,4,8,11,True
9675918,897,0,25,4983,736588033,1,0,0,162.14,8,951953.44,24,2,0,11,True
9772611,712,0,10,5501,736588033,1,0,0,161.88,6,952115.32,18,4,2,11,True
9808128,727,0,451,5501,736588033,1,0,0,161.78,7,951953.54,11,4,5,11,True
9908977,485,1,451,6261,736588033,1,0,0,161.74,7,951791.8,5,2,13,11,True
9950046,1208,4,30,4983,736588033,1,0,0,161.89,8,951629.91,24,5,21,11,True
1147128,614,4,25,9030,702911350,1,0,0,376.07,8,115290.93,11,1,1,2,True
1158903,605,0,20,7342,702911350,1,0,0,375.94,5,114914.99,24,5,15,4,True
1240358,14,2,20,4627,702911350,1,0,0,375.76,5,114539.23,24,3,4,5,True
1283161,247,4,30,4627,702911350,1,0,0,376.02,8,114163.21,6,6,3,6,True
1309715,614,4,451,4048,702911350,1,0,0,376.0,7,113787.21,11,6,8,7,True
1496769,417,3,-1,9030,702911350,1,1,0,376.34,1,113787.21,18,6,2,8,True
1568771,247,4,30,7257,702911350,1,0,0,375.91,8,113411.3,6,3,4,9,True
2116165,1231,2,-1,9913,702911350,1,1,0,375.83,4,113411.3,18,5,23,9,True
2214096,417,3,-1,6462,702911350,1,2,0,376.09,4,113411.3,18,0,4,9,True
2364954,325,0,10,9913,702911350,1,0,0,375.98,6,113787.28,11,1,8,10,True
2614333,811,0,451,9423,702911350,1,0,0,376.02,7,113411.26,18,5,7,10,True
2634272,819,2,-1,9795,702911350,1,1,0,375.98,4,113411.26,18,1,19,11,True
2832204,247,4,451,9795,702911350,1,0,0,376.2,7,113035.06,6,0,17,11,True
2978284,1401,1,10,9000,702911350,1,0,0,375.98,6,113411.04,24,5,20,12,False
3042577,297,0,20,7120,702911350,1,0,0,375.98,3,113035.06,4,6,23,12,False
3226665,247,4,451,9795,702911350,1,0,0,375.9,7,112659.16,6,3,6,12,True
3403758,667,4,451,8874,702911350,1,0,0,375.95,7,112283.21,18,0,1,2,True
3453395,417,3,-1,8112,702911350,1,1,0,376.12,4,112283.21,18,0,10,2,True
3471599,1231,2,30,4449,702911350,1,0,0,376.0,8,111907.21,18,5,1,2,True
4198424,614,4,-1,1296,702911350,1,1,0,376.05,4,111907.21,11,2,11,3,True
4284678,820,1,10,8112,702911350,1,0,0,375.91,0,112283.12,18,1,9,3,True
4314618,1231,2,25,1296,702911350,1,0,0,375.94,8,111907.18,18,6,16,4,True
4506163,811,0,25,9913,702911350,1,0,0,375.76,8,111531.42,18,2,14,5,True
4531878,819,2,451,1296,702911350,1,0,0,376.0,7,111155.42,18,4,12,5,True
4917830,1231,2,30,2677,702911350,1,0,0,375.85,8,110779.57,18,2,22,6,True
5198757,417,3,25,9207,702911350,1,0,0,376.0,8,110403.57,18,2,15,7,True
5203491,929,0,20,4449,702911350,1,0,0,376.12,3,110027.45,18,0,7,8,True
5492691,811,0,-1,7058,702911350,1,1,0,375.84,4,110027.45,18,3,21,10,True
5726828,811,0,10,7734,702911350,1,0,0,375.9,6,110403.35,18,1,11,10,True
5770455,1101,2,20,4048,702911350,1,0,0,376.05,5,110027.3,0,3,4,11,True
5914457,1231,2,30,7761,702911350,1,0,0,375.92,8,109651.38,18,6,17,11,True
5993858,667,4,451,4449,702911350,1,0,0,375.9,7,109275.48,18,0,23,1,True
6007408,811,0,451,9913,702911350,1,0,0,375.77,7,108899.71,18,5,8,1,True
6077153,819,2,30,7058,702911350,1,0,0,376.1,8,108523.61,18,1,17,2,True
6151318,819,2,25,4053,702911350,1,0,0,375.91,8,108147.7,18,6,4,2,True
6490095,1019,0,20,7761,702911350,1,0,0,375.98,3,107771.72,26,3,11,2,True
6744667,185,1,10,8112,702911350,1,0,0,376.16,6,108147.88,18,6,8,2,True
7205814,262,2,20,9795,702911350,1,0,0,375.99,5,107771.89,6,5,4,4,True
7222765,614,4,451,9207,702911350,1,0,0,375.94,7,107395.95,11,5,11,4,True
7503673,584,0,20,7257,702911350,1,0,0,376.09,3,107019.86,11,3,3,6,True
7592771,735,1,10,9795,702911350,1,0,0,376.19,6,107396.05,11,4,6,6,True
7610986,417,3,30,4627,702911350,1,0,0,376.17,8,107019.88,18,3,5,7,True
7847912,819,2,-1,9423,702911350,1,1,0,376.1,1,107019.88,18,4,23,7,True
8140101,811,0,25,7734,702911350,1,0,0,375.99,8,106643.89,18,5,11,7,True
8156731,205,0,10,8874,702911350,1,0,0,375.77,0,107019.66,9,2,1,8,True
8373883,1339,2,20,4053,702911350,1,0,0,375.87,5,106643.79,18,5,4,9,True
9023285,1231,2,25,7342,702911350,1,0,0,375.87,8,106267.92,18,2,17,9,True
9646937,811,0,30,4053,702911350,1,0,0,376.1,8,105891.82,18,4,11,9,True
9828680,417,3,-1,1296,702911350,1,1,0,375.88,4,105891.82,18,4,6,10,True
9915673,819,2,451,7120,702911350,1,0,0,376.25,7,105515.57,18,1,23,11,True
1410416,218,0,30,9987,795904222,1,0,0,905.17,8,324886.83,9,0,20,1,True
1411194,1439,4,451,9778,795904222,1,0,0,904.73,7,323982.1,24,3,4,1,True
1577430,283,4,451,2280,795904222,1,0,0,904.74,7,323077.36,24,5,14,2,True
1842485,309,0,10,7051,795904222,1,0,0,904.77,0,323982.13,4,1,1,3,True
2377811,391,3,451,6584,795904222,1,0,0,904.92,7,323077.21,10,6,18,4,True
2948882,610,0,20,7876,795904222,1,0,0,904.86,5,322172.35,11,5,20,5,True
3053948,218,0,451,2950,795904222,1,0,0,905.0,7,321267.35,9,0,12,5,True
3200130,283,4,451,2173,795904222,1,0,0,904.93,7,320362.42,24,0,4,6,True
3290238,269,0,20,6474,795904222,1,0,0,905.07,5,319457.35,24,3,22,6,True
3309037,1488,0,-1,2677,795904222,1,1,0,904.95,4,319457.35,24,1,13,8,True
3329621,145,0,10,1432,795904222,1,0,0,905.18,0,320362.53,18,0,23,10,True
3502036,436,4,451,8490,795904222,1,0,0,905.11,7,319457.42,24,1,14,10,True
3575816,1212,0,10,3269,795904222,1,0,0,904.95,6,320362.37,24,3,0,11,True
3732811,283,4,451,7652,795904222,1,0,0,905.1,7,319457.27,24,4,22,11,True
3823012,1439,4,451,9191,795904222,1,0,0,905.11,7,318552.16,24,2,12,11,True
3927509,1439,4,30,7742,795904222,1,0,0,904.97,8,317647.19,24,2,23,12,True
4063327,218,0,25,8503,795904222,1,0,0,905.02,8,316742.17,9,1,13,12,True
4093989,1439,4,451,1432,795904222,1,0,0,904.98,7,315837.19,24,2,15,1,True
4198643,1488,0,-1,9987,795904222,1,1,0,904.71,4,315837.19,24,1,5,1,True
4333798,283,4,451,6474,795904222,1,0,0,905.06,7,314932.13,24,3,22,2,True
4345749,677,0,20,8588,795904222,1,0,0,904.94,5,314027.19,24,5,6,4,True
4576040,1488,0,451,6474,795904222,1,0,0,904.87,7,313122.32,24,6,9,4,False
4579436,1439,4,25,9778,795904222,1,0,0,904.87,8,312217.45,24,4,4,4,True
4679776,1439,4,25,3269,795904222,1,0,0,905.11,8,311312.34,24,6,20,6,True
4707879,1488,0,30,5039,795904222,1,0,0,905.0,8,310407.34,24,2,2,6,True
5127341,1488,0,451,2067,795904222,1,0,0,904.99,7,309502.35,24,5,20,7,True
5139831,391,3,30,9778,795904222,1,0,0,905.12,8,308597.23,10,0,14,8,True
5141635,1439,4,451,2677,795904222,1,0,0,904.81,7,307692.42,24,1,13,9,True
5371830,1488,0,25,7652,795904222,1,0,0,904.9,8,306787.52,24,6,13,10,True
5494888,391,3,30,1679,795904222,1,0,0,905.02,8,305882.5,10,2,10,10,True
5591399,1488,0,25,6584,795904222,1,0,0,905.04,8,304977.46,24,0,12,10,True
5652686,1461,0,10,6584,795904222,1,0,0,904.91,6,305882.37,11,0,13,11,True
5706735,283,4,-1,9191,795904222,1,1,0,905.01,1,305882.37,24,3,10,11,True
6162863,391,3,25,7876,795904222,1,0,0,905.05,8,304977.32,10,0,21,11,True
6365760,1488,0,451,9778,795904222,1,0,0,905.0,7,304072.32,24,6,22,12,True
6533700,1307,0,10,3657,795904222,1,0,0,905.08,0,304977.4,5,6,14,12,True
6627751,679,0,10,8503,795904222,1,0,0,904.82,6,305882.22,24,4,10,2,True
7071334,218,0,451,2067,795904222,1,0,0,905.01,7,304977.21,9,5,10,3,True
7266681,1488,0,451,5039,795904222,1,0,0,905.11,7,304072.1,24,6,12,3,True
7289186,1439,4,-1,8490,795904222,1,1,0,905.0,4,304072.1,24,1,9,3,True
7549642,471,0,20,1189,795904222,1,0,0,905.19,5,303166.91,5,5,23,3,True
7587753,679,0,20,3518,795904222,1,0,0,905.07,5,302261.84,24,6,10,3,True
7615368,1052,0,10,8503,795904222,1,0,0,905.0,6,303166.84,11,5,17,4,True
7751974,577,0,20,9757,795904222,1,0,0,905.07,5,302261.77,11,6,17,4,True
7946440,283,4,25,3269,795904222,1,0,0,905.08,8,301356.69,24,1,4,4,True
8179654,68,0,10,3969,795904222,1,0,0,904.92,0,302261.61,20,1,1,5,True
8237861,436,4,451,9778,795904222,1,0,0,905.03,7,301356.58,24,2,11,5,True
8342837,1439,4,25,6584,795904222,1,0,0,904.98,8,300451.6,24,0,8,5,True
8470966,436,4,451,1806,795904222,1,0,0,905.03,7,299546.57,24,2,15,7,True
8775909,436,4,451,5564,795904222,1,0,0,905.19,7,298641.38,24,0,0,8,True
8882889,283,4,25,7652,795904222,1,0,0,904.81,8,297736.57,24,6,13,8,True
8973267,1439,4,451,8503,795904222,1,0,0,904.83,7,296831.74,24,4,13,9,True
9496297,1439,4,30,1806,795904222,1,0,0,905.1,8,295926.64,24,1,4,9,True
9635319,1439,4,30,2677,795904222,1,0,0,904.91,8,295021.73,24,4,14,9,True
9802312,1439,4,451,1230,795904222,1,0,0,904.94,7,294116.79,24,0,13,9,True
9917700,218,0,451,3518,795904222,1,0,0,905.21,7,293211.58,9,3,7,10,False
1009371,585,2,25,3505,439821858,0,0,0,927.32,8,707727.68,11,3,17,1,True
1098490,585,2,25,8049,439821858,0,0,0,926.96,8,706800.72,11,4,16,1,True
1158506,300,0,30,4132,439821858,0,0,0,926.87,8,705873.85,4,6,2,1,True
1184520,367,1,10,6725,439821858,0,0,0,927.28,6,706801.13,25,2,3,2,True
1319489,276,0,20,8049,439821858,0,0,0,927.13,5,705874.0,24,4,6,2,True
1408786,57,3,451,3960,439821858,0,0,0,926.85,7,704947.15,20,5,5,4,True
1468363,341,0,20,9124,439821858,0,0,0,927.37,5,704019.78,24,6,15,5,True
1968348,57,3,-1,6725,439821858,0,1,0,927.13,4,704019.78,20,0,17,6,True
2152284,1338,0,10,8832,439821858,0,0,0,927.12,0,704946.9,18,3,6,6,True
2302777,585,2,30,4394,439821858,0,0,0,927.03,8,704019.87,11,1,17,7,True
2350594,79,4,451,3505,439821858,0,0,0,926.91,7,703092.96,1,6,10,7,True
2514779,833,4,451,9124,439821858,0,0,0,927.49,7,702165.47,5,2,6,8,True
2608040,312,0,30,7437,439821858,0,0,0,926.93,8,701238.54,4,6,17,8,True
2669622,833,4,451,6725,439821858,0,0,0,927.26,7,700311.28,5,1,23,9,True
2777932,79,4,451,9879,439821858,0,0,0,926.96,7,699384.32,1,3,0,9,True
2817523,79,4,30,5127,439821858,0,0,0,927.13,8,698457.19,1,3,2,9,True
2915631,844,1,10,8772,439821858,0,0,0,926.81,6,699384.0,5,2,5,10,True
2936253,312,0,30,4394,439821858,0,0,0,927.12,8,698456.88,4,5,2,11,True
3019413,312,0,-1,9599,439821858,0,1,0,927.02,4,698456.88,4,1,9,11,False
3152698,312,0,30,9124,439821858,0,0,0,926.8,8,697530.08,4,2,2,11,True
4034361,585,2,-1,4132,439821858,0,1,0,926.79,1,697530.08,11,4,10,11,False
4233465,300,0,451,4132,439821858,0,0,0,926.93,7,696603.15,4,3,0,12,True
4728486,585,2,30,9124,439821858,0,0,0,927.06,8,695676.09,11,1,17,1,True
4762155,312,0,451,6725,439821858,0,0,0,927.17,7,694748.92,4,5,19,1,True
4907755,833,4,30,5722,439821858,0,0,0,926.94,8,693821.98,5,0,8,2,True
5009125,748,1,10,3505,439821858,0,0,0,927.19,6,694749.17,24,2,6,2,True
5122528,865,0,10,9124,439821858,0,0,0,927.04,6,695676.21,24,6,13,3,True
5185908,689,0,20,5127,439821858,0,0,0,927.16,5,694749.05,24,2,9,3,True
5355661,585,2,451,8832,439821858,0,0,0,926.88,7,693822.17,11,0,8,3,True
5436848,79,4,25,7803,439821858,0,0,0,927.03,8,692895.14,1,5,21,4,True
5478481,57,3,30,4394,439821858,0,0,0,926.91,8,691968.23,20,5,19,5,True
5576271,297,0,20,1663,439821858,0,0,0,926.94,5,691041.29,4,2,3,6,True
5635285,998,0,20,4394,439821858,0,0,0,926.71,5,690114.58,26,1,4,6,True
5724097,312,0,451,5127,439821858,0,0,0,927.15,7,689187.43,4,4,2,7,True
5950883,585,2,30,4394,439821858,0,0,0,926.92,8,688260.51,11,5,7,9,True
6002542,1010,0,20,3960,439821858,0,0,0,927.11,3,687333.4,26,4,8,9,True
6854854,300,0,-1,2104,439821858,0,1,0,926.95,4,687333.4,4,1,14,9,True
6873164,300,0,451,7437,439821858,0,0,0,926.8,7,686406.6,4,4,20,12,True
6877976,858,1,10,3960,439821858,0,0,0,927.05,6,687333.65,24,5,23,12,True
6927890,300,0,25,2313,439821858,0,0,0,926.77,8,686406.88,4,3,16,12,True
6932254,585,2,-1,3960,439821858,0,1,0,926.8,1,686406.88,11,1,7,1,True
6978165,312,0,-1,3505,439821858,0,2,0,926.98,4,686406.88,4,5,22,1,True
7036703,312,0,451,4394,439821858,0,0,0,926.79,7,685480.09,4,1,13,1,True
7062126,57,3,451,7803,439821858,0,0,0,927.11,7,684552.98,20,3,6,2,True
7331938,300,0,451,7142,439821858,0,0,0,926.95,7,683626.03,4,5,8,2,True
7469844,300,0,-1,8772,439821858,0,1,0,927.01,4,683626.03,4,4,5,2,True
7527992,312,0,-1,4132,439821858,0,2,0,926.87,4,683626.03,4,6,23,4,True
8496310,833,4,451,4132,439821858,0,0,0,926.91,7,682699.12,5,3,13,6,True
8546690,79,4,25,4394,439821858,0,0,0,927.01,8,681772.11,1,0,8,7,True
8690350,57,3,30,8832,439821858,0,0,0,927.01,8,680845.1,20,4,12,7,True
9008235,910,0,20,5127,439821858,0,0,0,927.01,3,679918.09,18,3,2,7,True
9044428,312,0,25,9124,439821858,0,0,0,927.06,8,678991.03,4,6,20,8,True
9129249,57,3,25,9724,439821858,0,0,0,926.88,8,678064.15,20,5,23,8,True
9210858,312,0,25,3505,439821858,0,0,0,927.0,8,677137.15,4,4,1,8,True
9216131,820,1,10,7256,439821858,0,0,0,927.14,6,678064.29,18,1,16,9,True
9618503,199,0,20,7973,439821858,0,0,0,927.03,5,677137.26,18,0,13,9,True
9841786,467,0,10,6725,439821858,0,0,0,926.87,6,678064.13,5,0,5,10,True
9949118,585,2,451,7000,439821858,0,0,0,927.04,7,677137.09,11,6,19,11,True
1144799,332,4,451,7302,816990241,1,0,0,297.02,7,213953.98,11,6,19,1,True
1196742,996,0,30,5580,816990241,1,0,0,296.81,8,213657.17,26,1,4,1,False
1372892,332,4,451,5176,816990241,1,0,0,296.92,7,213360.25,11,0,18,3,False
1606302,770,4,451,7014,816990241,1,0,0,297.26,7,213062.99,14,3,8,4,True
1706801,427,2,451,3153,816990241,1,0,0,297.25,7,212765.74,18,2,12,4,True
1904353,427,2,25,6209,816990241,1,0,0,297.04,8,212468.7,18,6,14,4,True
1912222,770,4,451,5176,816990241,1,0,0,297.18,7,212171.52,14,1,13,5,True
2027035,752,0,10,1923,816990241,1,0,0,297.05,6,212468.57,24,2,10,6,True
2218226,1467,0,10,4411,816990241,1,0,0,297.16,6,212765.73,11,2,3,8,True
2233011,996,0,451,7514,816990241,1,0,0,297.1,7,212468.63,26,1,2,9,True
2365511,332,4,-1,5638,816990241,1,1,0,296.97,4,212468.63,11,1,14,10,True
2432392,1034,1,25,4411,816990241,1,0,0,297.04,8,212171.59,11,2,3,10,True
2690318,1483,0,10,7916,816990241,1,0,0,297.03,6,212468.62,24,4,8,10,True
2818197,996,0,451,7014,816990241,1,0,0,296.99,7,212171.63,26,5,17,11,True
3027431,95,2,25,4411,816990241,1,0,0,297.15,8,211874.48,1,1,1,11,False
3031365,1034,1,451,7483,816990241,1,0,0,297.13,7,211577.35,11,2,22,12,True
3153529,770,4,451,3492,816990241,1,0,0,296.93,7,211280.42,14,3,2,1,True
3215696,427,2,25,9649,816990241,1,0,0,296.79,8,210983.63,18,0,3,2,True
3405089,996,0,30,7302,816990241,1,0,0,297.21,8,210686.42,26,1,19,3,True
3547526,332,4,25,3690,816990241,1,0,0,297.04,8,210389.38,11,5,2,4,False
3654044,1152,0,20,7916,816990241,1,0,0,297.26,3,210092.12,15,4,11,5,True
3778137,1092,1,10,7263,816990241,1,0,0,297.02,6,210389.14,18,1,14,5,True
3925658,770,4,451,7302,816990241,1,0,0,297.16,7,210091.98,14,5,14,5,True
4239057,427,2,-1,2828,816990241,1,1,0,297.19,1,210091.98,18,1,12,6,True
5056689,1476,0,20,5741,816990241,1,0,0,296.81,5,209795.17,24,2,10,6,True
5242905,1262,0,20,7437,816990241,1,0,0,296.88,5,209498.29,23,3,8,7,True
5304629,645,0,20,6895,816990241,1,0,0,296.96,5,209201.33,24,5,17,9,True
5307759,1034,1,30,7916,816990241,1,0,0,297.18,8,208904.15,11,2,10,9,True
5557343,1217,0,10,5045,816990241,1,0,0,296.9,6,209201.05,24,0,20,10,True
5632235,47,1,10,7514,816990241,1,0,0,296.96,6,209498.01,24,4,1,11,True
5730165,770,4,30,5176,816990241,1,0,0,297.04,8,209200.97,14,6,1,11,True
6212543,427,2,-1,7302,816990241,1,1,0,297.03,1,209200.97,18,1,22,12,True
6319732,95,2,-1,4411,816990241,1,2,0,296.93,4,209200.97,1,0,0,1,True
6334810,1034,1,30,9458,816990241,1,0,0,296.77,8,208904.2,11,0,8,1,True
6412022,95,2,30,7916,816990241,1,0,0,296.96,8,208607.24,1,2,23,2,True
6467735,95,2,-1,7014,816990241,1,1,0,296.93,4,208607.24,1,4,14,3,True
6997343,770,4,30,9649,816990241,1,0,0,296.8,8,208310.44,14,3,21,3,True
7479234,312,0,10,7696,816990241,1,0,0,297.27,6,208607.71,4,1,20,4,True
7493730,332,4,-1,7302,816990241,1,1,0,297.17,4,208607.71,11,6,10,4,True
7755842,332,4,451,6209,816990241,1,0,0,297.1,7,208310.61,11,4,10,4,True
7837869,770,4,25,7014,816990241,1,0,0,297.15,8,208013.46,14,4,3,5,True
7978686,996,0,451,5580,816990241,1,0,0,297.11,7,207716.35,26,4,23,6,True
8084714,1034,1,-1,7916,816990241,1,1,0,296.65,1,207716.35,11,0,14,6,True
8113621,770,4,25,6209,816990241,1,0,0,297.09,8,207419.26,14,5,21,6,True
8497087,524,1,10,9458,816990241,1,0,0,297.16,0,207716.42,18,2,14,7,True
8619996,427,2,-1,1609,816990241,1,1,0,296.92,4,207716.42,18,0,8,7,True
8742187,427,2,451,3492,816990241,1,0,0,297.11,7,207419.31,18,4,22,9,True
9138155,1272,0,10,6209,816990241,1,0,0,297.08,6,207716.39,24,3,17,10,True
9176174,952,0,20,6895,816990241,1,0,0,296.86,5,207419.53,13,4,20,11,True
9690610,427,2,-1,4411,816990241,1,1,0,297.03,4,207419.53,18,5,16,11,True
1056600,1356,2,-1,1190,524315718,1,1,0,521.02,4,696171.0,24,3,19,2,True
1118616,21,0,451,2859,524315718,1,0,0,520.84,7,695650.16,11,3,9,2,True
1129180,21,0,-1,4580,524315718,1,1,0,520.99,4,695650.16,11,3,10,3,True
1471318,1215,3,30,5343,524315718,1,0,0,520.95,8,695129.21,24,2,0,3,True
1539730,1215,3,25,4915,524315718,1,0,0,521.28,8,694607.93,24,0,22,3,True
1620975,850,1,10,7363,524315718,1,0,0,520.93,0,695128.86,5,5,6,3,False
1649923,759,0,10,9835,524315718,1,0,0,521.1,0,695649.96,24,0,9,3,True
1651087,1382,0,10,4019,524315718,1,0,0,520.64,6,696170.6,16,2,18,5,False
1859952,1105,2,20,2852,524315718,1,0,0,521.14,3,695649.46,0,1,4,6,True
2112019,1356,2,25,6310,524315718,1,0,0,521.12,8,695128.34,24,0,0,6,True
2205892,956,1,10,6777,524315718,1,0,0,520.98,0,695649.32,13,2,22,6,True
2642343,681,2,30,2859,524315718,1,0,0,520.8,8,695128.52,24,4,16,7,True
2775390,27,0,-1,7025,524315718,1,1,0,520.96,4,695128.52,11,0,4,7,True
2849852,21,0,25,2859,524315718,1,0,0,521.2,8,694607.32,11,1,5,7,True
3081370,1116,0,30,2929,524315718,1,0,0,520.9,8,694086.42,24,4,17,7,True
3167396,1356,2,25,4915,524315718,1,0,0,521.13,8,693565.29,24,5,3,7,True
3185435,1356,2,451,6777,524315718,1,0,0,521.02,7,693044.27,24,6,7,7,True
3526829,254,0,10,6411,524315718,1,0,0,520.86,6,693565.13,6,6,22,7,True
3645809,1356,2,25,8664,524315718,1,0,0,521.09,8,693044.04,24,0,3,8,True
3755584,21,0,25,7025,524315718,1,0,0,521.15,8,692522.89,11,1,6,8,True
3787868,1090,0,10,4019,524315718,1,0,0,520.89,6,693043.78,18,0,23,8,True
4241592,1116,0,30,2859,524315718,1,0,0,521.07,8,692522.71,24,6,11,8,False
4257423,1116,0,30,2852,524315718,1,0,0,521.14,8,692001.57,24,6,12,8,True
4301804,681,2,30,9835,524315718,1,0,0,520.94,8,691480.63,24,2,0,10,True
4460922,1356,2,30,6777,524315718,1,0,0,520.94,8,690959.69,24,4,5,10,True
5271593,713,0,20,6411,524315718,1,0,0,520.68,3,690439.01,18,4,22,10,True
5563549,1303,0,10,4019,524315718,1,0,0,521.16,0,690960.17,5,1,6,12,True
5839576,27,0,451,2852,524315718,1,0,0,520.98,7,690439.19,11,6,6,12,True
5927261,522,0,10,2859,524315718,1,0,0,520.94,0,690960.13,18,3,15,12,True
5972191,1116,0,25,9502,524315718,1,0,0,521.14,8,690438.99,24,4,13,12,True
6218467,1356,2,30,5567,524315718,1,0,0,521.31,8,689917.68,24,3,3,1,True
6292421,364,4,30,5343,524315718,1,0,0,521.09,8,689396.59,25,5,19,3,True
6975549,1215,3,451,8225,524315718,1,0,0,521.12,7,688875.47,24,3,2,4,True
6984331,429,0,20,9835,524315718,1,0,0,521.03,5,688354.44,24,6,9,6,True
7002379,687,0,20,4580,524315718,1,0,0,521.12,3,687833.32,24,5,19,7,True
7172236,27,0,-1,4269,524315718,1,1,0,521.21,4,687833.32,11,3,5,7,True
7366972,364,4,30,5567,524315718,1,0,0,521.16,8,687312.16,25,3,0,8,True
7417640,1116,0,-1,4580,524315718,1,1,0,521.04,4,687312.16,24,3,15,9,True
7542865,1215,3,451,5343,524315718,1,0,0,521.12,7,686791.04,24,6,4,9,True
7620194,1215,3,30,5457,524315718,1,0,0,521.3,8,686269.74,24,3,8,9,True
7762174,1425,0,20,6310,524315718,1,0,0,521.0,5,685748.74,24,1,3,10,True
7919828,21,0,30,5343,524315718,1,0,0,521.01,8,685227.73,11,3,15,12,True
8261180,1356,2,25,7363,524315718,1,0,0,520.95,8,684706.78,24,2,12,1,True
8404107,1035,0,20,7363,524315718,1,0,0,520.85,5,684185.93,11,3,21,2,True
8742114,630,0,20,5457,524315718,1,0,0,521.15,5,683664.78,11,6,19,4,True
9123642,681,2,25,6295,524315718,1,0,0,521.19,8,683143.59,24,5,9,5,True
9134350,681,2,30,2185,524315718,1,0,0,520.95,8,682622.64,24,0,16,5,True
9251775,1215,3,30,8664,524315718,1,0,0,520.79,8,682101.85,24,3,19,7,True
9485196,1189,2,20,7363,524315718,1,0,0,521.25,5,681580.6,24,0,20,8,True
9543888,1215,3,25,8225,524315718,1,0,0,520.71,8,681059.89,24,4,22,8,True
9694224,1127,0,10,8664,524315718,1,0,0,521.12,0,681581.01,24,3,18,9,True
9751521,1215,3,25,9943,524315718,1,0,0,520.75,8,681060.26,24,0,7,10,True
1247278,1350,4,-1,7163,910018828,0,1,0,504.05,1,988378.0,24,4,18,1,True
1518878,953,4,30,1481,910018828,0,0,0,503.88,8,987874.12,13,1,8,1,True
1641228,143,4,25,7193,910018828,0,0,0,503.88,8,987370.24,18,2,11,1,True
1841420,980,1,10,1504,910018828,0,0,0,503.96,6,987874.2,22,3,11,2,True
1983794,842,2,20,1889,910018828,0,0,0,503.95,5,987370.25,5,3,23,3,True
2103053,1350,4,-1,3834,910018828,0,1,0,503.94,1,987370.25,24,5,8,5,True
2141035,404,1,25,7165,910018828,0,0,0,504.14,8,986866.11,10,5,21,6,True
2164474,143,4,-1,4549,910018828,0,1,0,503.86,4,986866.11,18,6,16,8,True
2202538,143,4,451,7193,910018828,0,0,0,503.83,7,986362.28,18,3,9,8,True
2251193,727,0,20,3996,910018828,0,0,0,503.91,5,985858.37,11,3,20,8,True
2525521,367,1,10,9608,910018828,0,0,0,504.13,0,986362.5,25,6,4,12,True
3120988,953,4,30,4511,910018828,0,0,0,504.21,8,985858.29,13,3,15,12,True
3164777,953,4,451,7193,910018828,0,0,0,504.03,7,985354.26,13,6,15,1,True
3325617,404,1,25,4549,910018828,0,0,0,504.28,8,984849.98,10,1,4,1,True
3385649,168,0,451,1289,910018828,0,0,0,503.99,7,984345.99,24,5,9,2,True
3796219,953,4,-1,6270,910018828,0,1,0,503.9,1,984345.99,13,3,0,2,True
3835615,1380,0,10,4549,910018828,0,0,0,503.93,6,984849.92,16,3,11,3,True
4050446,1350,4,451,7165,910018828,0,0,0,504.3,7,984345.62,24,6,18,4,True
4076767,1350,4,30,4174,910018828,0,0,0,504.05,8,983841.57,24,1,20,4,True
4214719,1350,4,451,7906,910018828,0,0,0,504.09,7,983337.48,24,2,0,4,True
4480427,143,4,25,7193,910018828,0,0,0,503.99,8,982833.49,18,2,22,5,True
4523695,953,4,25,2716,910018828,0,0,0,503.77,8,982329.72,13,4,14,6,True
4661803,168,0,-1,7165,910018828,0,1,0,503.91,4,982329.72,24,4,7,7,True
4711128,404,1,-1,1504,910018828,0,2,0,503.88,4,982329.72,10,1,14,8,True
4768135,953,4,25,3210,910018828,0,0,0,503.9,8,981825.82,13,1,6,9,True
4834464,404,1,451,3210,910018828,0,0,0,504.04,7,981321.78,10,0,18,9,True
5060119,953,4,25,1358,910018828,0,0,0,503.63,8,980818.15,13,5,1,9,True
5115211,143,4,-1,7163,910018828,0,1,0,503.98,1,980818.15,18,4,14,10,True
5144610,800,0,20,8401,910018828,0,0,0,504.02,3,980314.13,11,1,21,11,True
5504861,282,2,20,8227,910018828,0,0,0,503.93,3,979810.2,24,6,17,11,True
5758069,953,4,25,2716,910018828,0,0,0,503.75,8,979306.45,13,1,12,12,True
5814373,953,4,451,7906,910018828,0,0,0,503.9,7,978802.55,13,4,7,1,True
6107850,168,0,451,9002,910018828,0,0,0,504.03,7,978298.52,24,4,16,2,True
6232430,404,1,25,9010,910018828,0,0,0,503.67,8,977794.85,10,1,5,2,False
6563062,198,0,10,7906,910018828,0,0,0,504.09,6,978298.94,18,2,8,2,True
6828984,316,2,20,1289,910018828,0,0,0,504.11,3,977794.83,4,2,22,3,True
7063815,168,0,451,3996,910018828,0,0,0,504.14,7,977290.69,24,6,5,4,True
7133500,1350,4,451,1504,910018828,0,0,0,503.86,7,976786.83,24,5,13,6,True
7137569,953,4,30,6270,910018828,0,0,0,503.82,8,976283.01,13,1,18,6,True
7156948,404,1,30,3210,910018828,0,0,0,503.87,8,975779.14,10,5,14,7,True
8020307,168,0,-1,3834,910018828,0,1,0,504.03,1,975779.14,24,1,10,7,True
8051992,143,4,25,4174,910018828,0,0,0,504.11,8,975275.03,18,6,0,7,True
8193353,816,0,20,9010,910018828,0,0,0,504.16,3,974770.87,18,1,15,7,True
8451283,1350,4,30,5469,910018828,0,0,0,503.94,8,974266.93,24,5,14,7,True
8565946,404,1,-1,9010,910018828,0,1,0,504.1,4,974266.93,10,3,9,8,True
9002429,1273,0,20,1289,910018828,0,0,0,503.87,5,973763.06,24,0,10,8,True
9057273,953,4,451,1504,910018828,0,0,0,503.85,7,973259.21,13,1,3,8,True
9305944,428,0,20,4549,910018828,0,0,0,504.02,5,972755.19,18,6,3,9,True
9619472,168,0,25,4549,910018828,0,0,0,503.96,8,972251.23,24,0,13,9,True
9785791,168,0,25,4549,910018828,0,0,0,504.14,8,971747.09,24,4,4,10,True
9845225,1350,4,30,1289,910018828,0,0,0,503.8,8,971243.29,24,5,19,10,True
1213957,1319,1,10,2259,311824637,1,0,0,103.02,0,600825.02,18,4,18,3,True
1251256,780,0,20,8651,311824637,1,0,0,103.09,5,600721.93,14,6,17,4,True
1275685,434,3,-1,4198,311824637,1,1,0,102.78,4,600721.93,24,1,8,4,True
1641927,1311,2,25,2098,311824637,1,0,0,102.97,8,600618.96,5,6,19,5,True
1716597,434,3,451,4198,311824637,1,0,0,102.97,7,600515.99,24,4,10,6,True
1925032,1278,0,10,8651,311824637,1,0,0,103.05,6,600619.04,24,2,3,6,True
2006435,1311,2,-1,2259,311824637,1,1,0,103.14,4,600619.04,5,1,2,7,True
2078549,140,3,25,6255,311824637,1,0,0,102.99,8,600516.05,18,1,21,7,True
2342365,1109,4,-1,1433,311824637,1,1,0,102.79,4,600516.05,0,4,10,8,True
2610626,140,3,451,7588,311824637,1,0,0,103.13,7,600412.92,18,0,7,8,True
2631590,58,2,20,7103,311824637,1,0,0,103.18,5,600309.74,20,5,2,8,True
3114706,1322,2,20,4085,311824637,1,0,0,102.93,5,600206.81,18,3,0,8,True
3312125,848,2,-1,8954,311824637,1,1,0,102.63,4,600206.81,5,6,13,9,True
3342153,1109,4,451,4085,311824637,1,0,0,103.26,7,600103.55,0,1,14,9,True
3414281,848,2,25,7103,311824637,1,0,0,103.34,8,600000.21,5,2,21,10,True
3649965,1109,4,451,7875,311824637,1,0,0,103.14,7,599897.07,0,3,0,12,True
3715529,1311,2,451,3747,311824637,1,0,0,103.1,7,599793.97,5,6,3,12,True
3865682,434,3,451,1433,311824637,1,0,0,102.91,7,599691.06,24,3,10,12,True
3910847,848,2,451,7588,311824637,1,0,0,103.03,7,599588.03,5,0,1,2,True
4113510,1109,4,25,7875,311824637,1,0,0,103.12,8,599484.91,0,3,20,2,True
4437073,1000,0,10,4198,311824637,1,0,0,102.64,6,599587.55,26,6,20,3,True
4553829,140,3,30,7588,311824637,1,0,0,102.85,8,599484.7,18,2,2,4,True
4886880,144,1,10,1433,311824637,1,0,0,103.19,0,599587.89,18,0,8,5,True
4999421,434,3,25,2098,311824637,1,0,0,102.92,8,599484.97,24,1,6,5,True
5208743,140,3,451,3775,311824637,1,0,0,102.8,7,599382.17,18,3,12,5,True
5248472,1311,2,451,8954,311824637,1,0,0,102.99,7,599279.18,5,3,13,6,True
5477146,482,1,10,8651,311824637,1,0,0,103.15,0,599382.33,5,1,19,6,True
5592281,434,3,451,9560,311824637,1,0,0,102.97,7,599279.36,24,5,14,7,False
5618963,1109,4,30,4316,311824637,1,0,0,103.04,8,599176.32,0,0,15,7,True
5742064,267,0,10,2470,311824637,1,0,0,102.9,6,599279.22,6,1,22,7,True
6065007,140,3,30,7588,311824637,1,0,0,102.95,8,599176.27,18,2,22,8,False
6159010,942,0,10,8030,311824637,1,0,0,102.72,6,599278.99,24,2,11,8,True
6202631,253,2,20,7588,311824637,1,0,0,103.03,5,599175.96,6,5,17,9,True
6557027,1311,2,451,2259,311824637,1,0,0,103.12,7,599072.84,5,3,0,9,True
6734407,848,2,-1,7103,311824637,1,1,0,103.18,4,599072.84,5,2,14,10,True
7338026,117,1,10,8651,311824637,1,0,0,103.0,0,599175.84,18,5,18,10,True
7446680,140,3,25,6255,311824637,1,0,0,103.04,8,599072.8,18,5,22,10,True
7625606,848,2,25,7103,311824637,1,0,0,103.0,8,598969.8,5,6,3,10,True
7681759,1311,2,30,4316,311824637,1,0,0,103.01,8,598866.79,5,2,17,11,True
8416367,434,3,451,6255,311824637,1,0,0,102.95,7,598763.84,24,4,13,1,True
8492284,848,2,25,2470,311824637,1,0,0,103.23,8,598660.61,5,5,13,2,True
8539800,1109,4,30,7875,311824637,1,0,0,103.0,8,598557.61,0,3,0,2,True
8585278,140,3,451,3747,311824637,1,0,0,102.73,7,598454.88,18,0,6,3,True
8673973,1311,2,451,4316,311824637,1,0,0,103.06,7,598351.82,5,1,15,4,True
8771759,195,1,10,2259,311824637,1,0,0,103.02,6,598454.84,18,5,0,6,True
8890424,140,3,451,9560,311824637,1,0,0,103.2,7,598351.64,18,5,19,6,True
9144741,1109,4,451,8651,311824637,1,0,0,103.02,7,598248.62,0,5,11,6,True
9475599,434,3,30,3775,311824637,1,0,0,103.12,8,598145.5,24,3,13,7,True
9514398,848,2,-1,2259,311824637,1,1,0,103.29,1,598145.5,5,0,19,7,True
9596906,952,0,20,1170,311824637,1,0,0,103.06,5,598042.44,13,6,6,8,True
9604702,695,2,20,8651,311824637,1,0,0,103.28,5,597939.16,24,1,7,8,True
9749470,140,3,25,1170,311824637,1,0,0,103.05,8,597836.11,18,4,11,8,True
9760413,1109,4,30,7103,311824637,1,0,0,103.04,8,597733.07,0,3,20,10,True
9981190,1262,0,20,1433,311824637,1,0,0,102.94,3,597630.13,23,1,12,10,True
1042335,1379,3,451,5552,337325989,0,0,0,381.06,7,618797.94,16,2,7,1,True
1080528,689,0,20,7567,337325989,0,0,0,380.98,3,618416.96,24,6,20,3,True
1113345,777,3,30,5123,337325989,0,0,0,381.08,8,618035.88,14,2,19,3,True
1153266,239,1,10,8859,337325989,0,0,0,381.0,6,618416.88,26,2,0,3,True
1254314,777,3,451,8859,337325989,0,0,0,380.8,7,618036.08,14,3,9,3,True
1282129,341,0,10,5214,337325989,0,0,0,380.89,6,618416.97,24,1,18,3,True
1459751,86,4,451,9485,337325989,0,0,0,380.9,7,618036.07,1,5,5,4,True
1505373,1379,3,30,9485,337325989,0,0,0,380.93,8,617655.14,16,1,1,4,True
1870954,86,4,25,7179,337325989,0,0,0,380.96,8,617274.18,1,6,4,4,True
1975578,1354,0,10,8790,337325989,0,0,0,381.01,6,617655.19,24,2,23,5,True
2061822,86,4,-1,9294,337325989,0,1,0,381.29,4,617655.19,1,3,1,6,True
2276016,1098,4,25,5825,337325989,0,0,0,380.7,8,617274.49,0,0,2,8,True
2304111,35,2,20,8431,337325989,0,0,0,381.02,5,616893.47,11,6,8,9,True
2632253,135,2,451,5552,337325989,0,0,0,380.75,7,616512.72,18,4,9,10,True
3279057,850,1,451,6000,337325989,0,0,0,380.79,7,616131.93,5,2,18,11,True
3518465,1098,4,451,9949,337325989,0,0,0,381.27,7,615750.66,0,3,5,11,True
3983984,607,2,20,7567,337325989,0,0,0,380.86,3,615369.8,24,4,21,12,True
4399467,365,0,10,8032,337325989,0,0,0,380.9,6,615750.7,25,2,22,1,True
4534878,634,1,10,7884,337325989,0,0,0,381.03,0,616131.73,24,4,0,1,True
4763117,1379,3,25,8646,337325989,0,0,0,380.96,8,615750.77,16,1,17,1,True
5001560,234,0,20,9294,337325989,0,0,0,380.79,5,615369.98,26,0,0,1,True
5202907,850,1,30,9485,337325989,0,0,0,380.82,8,614989.16,5,0,23,4,False
5582058,850,1,451,5927,337325989,0,0,0,380.91,7,614608.25,5,5,3,4,True
5643281,850,1,451,5123,337325989,0,0,0,380.84,7,614227.41,5,0,18,5,True
5750085,1379,3,-1,8144,337325989,0,1,0,381.08,4,614227.41,16,3,19,6,True
5860053,135,2,451,9294,337325989,0,0,0,380.79,7,613846.62,18,2,7,6,True
5877646,1273,0,10,5123,337325989,0,0,0,381.15,6,614227.77,24,5,6,7,True
5964108,372,0,20,2811,337325989,0,0,0,381.1,3,613846.67,25,0,7,7,True
6030600,818,1,10,7179,337325989,0,0,0,380.98,6,614227.65,18,3,21,8,True
6542062,850,1,451,4865,337325989,0,0,0,380.61,7,613847.04,5,0,11,9,True
6593249,1379,3,25,8032,337325989,0,0,0,381.09,8,613465.95,16,0,0,9,True
6635832,850,1,451,7047,337325989,0,0,0,381.25,7,613084.7,5,6,12,10,True
6727156,777,3,30,5123,337325989,0,0,0,380.97,8,612703.73,14,3,7,11,False
7116774,1098,4,25,1177,337325989,0,0,0,381.26,8,612322.47,0,6,22,11,True
7135467,1098,4,451,5214,337325989,0,0,0,380.94,7,611941.53,0,1,13,11,False
7224477,1098,4,30,7567,337325989,0,0,0,381.04,8,611560.49,0,0,18,12,True
7231912,1379,3,-1,9949,337325989,0,1,0,381.05,4,611560.49,16,4,0,12,True
7325851,135,2,451,5927,337325989,0,0,0,381.04,7,611179.45,18,1,7,1,True
7657716,591,0,10,9949,337325989,0,0,0,381.06,6,611560.51,24,0,19,2,True
7912848,135,2,-1,5552,337325989,0,1,0,381.13,4,611560.51,18,6,23,3,True
7925579,716,0,20,9294,337325989,0,0,0,381.08,5,611179.43,18,2,11,3,True
7935774,1098,4,451,6000,337325989,0,0,0,381.16,7,610798.27,0,5,3,3,True
8406638,850,1,30,8431,337325989,0,0,0,380.99,8,610417.28,5,6,12,4,True
8544889,850,1,451,8032,337325989,0,0,0,380.73,7,610036.55,5,4,1,6,True
8803551,1379,3,25,6472,337325989,0,0,0,381.24,8,609655.31,16,2,15,6,True
8957730,135,2,25,2811,337325989,0,0,0,381.43,8,609273.88,18,5,12,6,True
9040910,649,0,20,7047,337325989,0,0,0,381.09,5,608892.79,24,0,6,6,True
9137856,1379,3,-1,5123,337325989,0,1,0,381.09,1,608892.79,16,3,3,6,True
9249444,135,2,25,5123,337325989,0,0,0,380.95,8,608511.84,18,4,20,7,True
9277886,135,2,30,6170,337325989,0,0,0,381.03,8,608130.81,18,2,1,7,True
9472372,850,1,30,8032,337325989,0,0,0,380.91,8,607749.9,5,3,6,7,True
9643351,777,3,30,8790,337325989,0,0,0,381.1,8,607368.8,14,3,12,9,True
9867953,777,3,25,8646,337325989,0,0,0,381.12,8,606987.68,14,3,15,9,True
9938927,1245,1,10,7567,337325989,0,0,0,380.78,0,607368.46,18,2,4,10,True
1065164,116,0,20,5973,632930809,1,0,0,541.99,5,931482.01,3,5,20,1,True
1205135,1382,0,10,8304,632930809,1,0,0,542.1,6,932024.11,16,2,13,2,True
1371865,814,4,30,1413,632930809,1,0,0,541.95,8,931482.16,18,3,9,2,True
1461016,48,4,25,7411,632930809,1,0,0,541.79,8,930940.37,24,5,17,2,True
1954897,1461,0,-1,7635,632930809,1,1,0,542.01,4,930940.37,11,0,11,3,True
2119539,445,0,10,8304,632930809,1,0,0,541.8,6,931482.17,13,0,13,4,True
2421717,1461,0,-1,7647,632930809,1,1,0,542.22,1,931482.17,11,5,3,4,True
2594815,1122,1,10,8304,632930809,1,0,0,541.87,6,932024.04,24,4,21,5,True
2634675,1321,0,20,5314,632930809,1,0,0,541.88,5,931482.16,18,3,3,6,True
2818004,522,0,20,6033,632930809,1,0,0,541.75,5,930940.41,18,5,5,7,True
2862000,1232,1,30,4423,632930809,1,0,0,542.2,8,930398.21,18,1,0,7,True
3001739,252,4,25,3202,632930809,1,0,0,542.14,8,929856.07,6,4,21,8,True
3014638,1461,0,30,8422,632930809,1,0,0,541.96,8,929314.11,11,5,10,9,True
3090996,252,4,25,3202,632930809,1,0,0,541.89,8,928772.22,6,6,9,9,True
3161244,361,4,25,7635,632930809,1,0,0,542.0,8,928230.22,24,5,1,10,True
3202612,465,0,20,8304,632930809,1,0,0,541.87,3,927688.35,13,6,17,11,True
3428624,1435,2,20,1413,632930809,1,0,0,542.26,5,927146.09,24,5,21,12,True
3471514,814,4,30,3202,632930809,1,0,0,542.19,8,926603.9,18,5,1,12,True
3722273,361,4,25,8654,632930809,1,0,0,541.92,8,926061.98,24,3,13,2,True
4000268,361,4,451,1876,632930809,1,0,0,542.17,7,925519.81,24,1,21,2,True
4029072,360,0,10,7411,632930809,1,0,0,542.13,6,926061.94,24,5,2,2,True
4070270,252,4,451,4423,632930809,1,0,0,541.76,7,925520.18,6,0,23,2,True
4115990,1232,1,25,7635,632930809,1,0,0,542.21,8,924977.97,18,4,23,3,True
4523969,1069,1,10,7411,632930809,1,0,0,542.01,0,925519.98,18,5,0,5,True
4715508,814,4,451,4353,632930809,1,0,0,541.96,7,924978.02,18,5,12,5,True
4783981,48,4,30,8304,632930809,1,0,0,542.19,8,924435.83,24,0,0,5,True
4953447,739,1,10,5973,632930809,1,0,0,541.73,0,924977.56,24,0,18,6,True
5156266,628,0,20,3202,632930809,1,0,0,542.01,5,924435.55,11,5,22,7,True
5361785,1461,0,30,9634,632930809,1,0,0,542.2,8,923893.35,11,3,2,8,True
5628544,302,1,10,8304,632930809,1,0,0,541.83,0,924435.18,4,2,2,9,True
5813512,52,4,451,7635,632930809,1,0,0,542.23,7,923892.95,20,5,6,10,True
6148655,790,0,20,1876,632930809,1,0,0,542.01,3,923350.94,11,4,14,10,True
6159221,48,4,451,8422,632930809,1,0,0,541.9,7,922809.04,24,2,12,10,True
6288556,52,4,25,7386,632930809,1,0,0,541.99,8,922267.05,20,3,22,10,True
6540577,1232,1,25,7411,632930809,1,0,0,542.05,8,921725.0,18,1,0,11,True
6967187,1232,1,451,4353,632930809,1,0,0,542.13,7,921182.87,18,3,3,1,True
7137006,814,4,30,9634,632930809,1,0,0,541.92,8,920640.95,18,0,15,1,True
7213945,252,4,25,9225,632930809,1,0,0,541.83,8,920099.12,6,1,0,1,True
7219822,1232,1,451,5802,632930809,1,0,0,542.3,7,919556.82,18,2,22,1,True
7256640,814,4,451,7647,632930809,1,0,0,541.91,7,919014.91,18,2,7,3,True
7297340,361,4,451,6033,632930809,1,0,0,541.96,7,918472.95,24,2,3,3,True
7372599,52,4,451,6033,632930809,1,0,0,541.85,7,917931.1,20,2,11,3,True
7537253,814,4,-1,8226,632930809,1,1,0,541.86,1,917931.1,18,3,10,4,True
7599935,1461,0,25,5314,632930809,1,0,0,542.19,8,917388.91,11,1,19,5,True
7827223,1461,0,451,7647,632930809,1,0,0,541.82,7,916847.09,11,4,14,5,True
7915823,252,4,451,9225,632930809,1,0,0,541.89,7,916305.2,6,0,2,7,True
7977332,814,4,-1,9634,632930809,1,1,0,542.0,4,916305.2,18,3,0,8,True
8074561,1232,1,30,5314,632930809,1,0,0,542.13,8,915763.07,18,3,4,8,True
8308854,1409,1,10,3474,632930809,1,0,0,542.01,6,916305.08,24,3,14,8,True
8585600,716,0,20,8654,632930809,1,0,0,542.2,5,915762.88,18,6,1,9,True
8892105,361,4,-1,9225,632930809,1,1,0,542.28,1,915762.88,24,5,7,9,True
8959908,255,2,20,7411,632930809,1,0,0,542.14,3,915220.74,6,5,9,9,False
8979043,325,0,20,2105,632930809,1,0,0,542.03,5,914678.71,11,2,15,10,True
9192035,1297,0,20,3474,632930809,1,0,0,541.91,5,914136.8,5,4,20,10,True
9311039,1128,2,20,3474,632930809,1,0,0,541.93,5,913594.87,24,5,6,10,True
9380570,334,0,10,7635,632930809,1,0,0,541.97,6,914136.84,11,4,11,10,True
9707971,52,4,451,4423,632930809,1,0,0,541.96,7,913594.88,20,0,5,11,True
1281935,180,0,20,8394,449274487,0,0,0,729.19,3,770195.81,18,0,6,1,True
1527118,47,1,451,6447,449274487,0,0,0,729.18,7,769466.63,24,6,0,1,True
1528295,551,0,20,3509,449274487,0,0,0,729.15,5,768737.48,17,6,7,2,True
1667318,485,1,25,1478,449274487,0,0,0,728.91,8,768008.57,5,6,2,3,False
1695038,739,1,30,4049,449274487,0,0,0,729.05,8,767279.52,24,2,23,4,True
1703120,60,4,25,3561,449274487,0,0,0,728.72,8,766550.8,20,1,7,5,True
2076680,1349,3,-1,2331,449274487,0,1,0,728.87,1,766550.8,24,5,19,6,True
2428588,60,4,-1,8394,449274487,0,2,0,729.32,4,766550.8,20,6,4,6,False
2441168,485,1,451,4049,449274487,0,0,0,728.9,7,765821.9,5,5,3,6,True
2533140,1349,3,451,8394,449274487,0,0,0,729.22,7,765092.68,24,0,13,7,True
2755450,1010,0,10,9727,449274487,0,0,0,728.85,0,765821.53,26,3,13,9,True
2769579,297,0,10,4645,449274487,0,0,0,728.9,6,766550.43,4,4,0,9,True
2847291,47,1,25,8394,449274487,0,0,0,728.97,8,765821.46,24,0,21,10,True
2883934,128,0,20,7531,449274487,0,0,0,729.0,5,765092.46,18,5,17,10,True
2981784,739,1,451,7531,449274487,0,0,0,729.0,7,764363.46,24,0,12,11,True
3214313,1137,1,10,8580,449274487,0,0,0,729.09,6,765092.55,24,0,14,12,True
3680910,1467,0,20,5917,449274487,0,0,0,728.94,5,764363.61,11,2,5,12,True
3851385,1477,2,451,8413,449274487,0,0,0,728.99,7,763634.62,24,3,14,12,True
4166762,913,0,20,8394,449274487,0,0,0,728.68,3,762905.94,18,0,12,3,True
4171046,1349,3,25,8394,449274487,0,0,0,729.17,8,762176.77,24,6,20,4,True
4208211,1477,2,25,8394,449274487,0,0,0,729.13,8,761447.64,24,1,11,4,True
4268194,346,0,20,3509,449274487,0,0,0,729.13,3,760718.51,24,4,1,5,True
4509793,1349,3,451,6472,449274487,0,0,0,729.04,7,759989.47,24,6,8,6,False
4769937,366,0,20,2331,449274487,0,0,0,729.18,5,759260.29,25,3,9,6,True
4938493,794,2,20,3561,449274487,0,0,0,729.11,5,758531.18,11,0,19,7,True
5016278,739,1,-1,6472,449274487,0,1,0,728.84,4,758531.18,24,4,13,7,False
5177533,47,1,30,3853,449274487,0,0,0,729.0,8,757802.18,24,6,21,8,True
5310965,47,1,-1,4213,449274487,0,1,0,729.1,4,757802.18,24,4,21,9,True
5322226,1351,4,451,8394,449274487,0,0,0,728.94,7,757073.24,24,1,12,11,True
5401561,1477,2,451,8413,449274487,0,0,0,729.28,7,756343.96,24,2,22,11,True
5469426,652,0,20,6447,449274487,0,0,0,728.82,5,755615.14,24,5,2,12,True
6199620,1349,3,451,9875,449274487,0,0,0,728.89,7,754886.25,24,1,19,1,True
6232755,1349,3,30,3853,449274487,0,0,0,729.15,8,754157.1,24,1,12,1,True
6422538,1477,2,30,6447,449274487,0,0,0,729.28,8,753427.82,24,5,5,2,True
6485640,1351,4,-1,3509,449274487,0,1,0,729.15,4,753427.82,24,1,14,2,True
6777210,47,1,451,2351,449274487,0,0,0,728.95,7,752698.87,24,0,16,2,True
6875344,1349,3,451,3561,449274487,0,0,0,729.04,7,751969.83,24,4,12,3,True
6947920,47,1,25,4049,449274487,0,0,0,729.15,8,751240.68,24,4,20,3,True
7053738,1477,2,30,4645,449274487,0,0,0,728.96,8,750511.72,24,0,13,4,True
7092949,1351,4,-1,4049,449274487,0,1,0,729.01,1,750511.72,24,6,7,4,True
7177750,60,4,451,3853,449274487,0,0,0,729.1,7,749782.62,20,2,3,5,False
7358281,485,1,451,4049,449274487,0,0,0,729.08,7,749053.54,5,1,9,6,True
7427410,1035,0,10,7531,449274487,0,0,0,728.86,0,749782.4,11,0,12,8,True
7772458,1217,0,10,6169,449274487,0,0,0,729.07,6,750511.47,24,1,16,8,True
7839267,1351,4,451,6347,449274487,0,0,0,728.76,7,749782.71,24,2,7,8,True
8680065,60,4,-1,1847,449274487,0,1,0,729.15,4,749782.71,20,0,12,8,True
8718447,485,1,25,5917,449274487,0,0,0,728.76,8,749053.95,5,1,13,8,True
8834713,739,1,30,4213,449274487,0,0,0,729.03,8,748324.92,24,2,8,9,True
8879064,1036,1,10,2331,449274487,0,0,0,729.05,6,749053.97,11,6,12,9,True
9070937,60,4,-1,8413,449274487,0,1,0,729.16,1,749053.97,20,5,9,10,True
9119150,1477,2,451,7531,449274487,0,0,0,729.12,7,748324.85,24,5,16,10,True
9319561,979,0,20,3561,449274487,0,0,0,728.91,5,747595.94,22,6,13,10,True
9888429,485,1,25,8394,449274487,0,0,0,728.97,8,746866.97,5,2,1,11,True
9962723,1477,2,451,3509,449274487,0,0,0,729.13,7,746137.84,24,0,20,11,True
1245174,1189,2,451,3314,779540433,0,0,0,956.18,7,74061.82,24,6,0,2,True
1259658,738,2,20,6544,779540433,0,0,0,956.02,5,73105.8,11,0,1,2,True
1280844,123,0,25,1717,779540433,0,0,0,955.94,8,72149.86,18,6,23,3,True
1517006,1208,4,30,7181,779540433,0,0,0,955.87,8,71193.99,24,6,4,3,True
2072575,123,0,-1,6251,779540433,0,1,0,955.84,4,71193.99,18,1,6,5,True
2328189,728,1,25,6590,779540433,0,0,0,956.12,8,70237.87,11,6,22,6,True
2350593,735,1,10,8258,779540433,0,0,0,956.18,6,71194.05,11,5,17,7,True
2385987,1319,1,25,8034,779540433,0,0,0,956.01,8,70238.04,18,1,13,7,False
2498312,1208,4,451,6850,779540433,0,0,0,956.04,7,69282.0,24,6,19,10,True
2740475,353,1,10,5701,779540433,0,0,0,955.92,6,70237.92,24,1,12,11,True
2800695,565,4,30,3778,779540433,0,0,0,955.92,8,69282.0,11,0,9,12,True
2981497,728,1,25,9306,779540433,0,0,0,956.09,8,68325.91,11,6,20,4,True
3178929,1319,1,-1,3314,779540433,0,1,0,956.17,4,68325.91,18,0,9,5,True
3220312,429,0,10,8258,779540433,0,0,0,955.93,0,69281.84,24,4,4,6,True
3524812,27,0,20,8672,779540433,0,0,0,955.97,3,68325.87,11,3,18,6,True
3723013,325,0,10,6353,779540433,0,0,0,955.96,6,69281.83,11,0,18,6,True
4278732,1399,0,25,7181,779540433,0,0,0,956.04,8,68325.79,24,2,20,6,True
4454233,1189,2,-1,1706,779540433,0,1,0,955.89,4,68325.79,24,5,7,7,True
4481645,679,0,451,6251,779540433,0,0,0,955.83,7,67369.96,24,4,21,8,True
4624659,679,0,451,4298,779540433,0,0,0,955.93,7,66414.03,24,1,10,8,True
4881577,965,4,-1,6251,779540433,0,1,0,956.18,1,66414.03,13,4,23,8,False
4967473,679,0,451,2520,779540433,0,0,0,956.15,7,65457.88,24,0,9,8,True
5196909,1189,2,451,2988,779540433,0,0,0,956.24,7,64501.64,24,1,19,8,False
5456180,1208,4,451,9463,779540433,0,0,0,955.96,7,63545.68,24,3,10,8,True
5763858,679,0,25,5701,779540433,0,0,0,956.03,8,62589.65,24,3,14,8,True
5862169,728,1,-1,6353,779540433,0,1,0,955.96,4,62589.65,11,4,3,9,True
6001586,1189,2,30,4002,779540433,0,0,0,956.01,8,61633.64,24,5,18,9,True
6006924,728,1,25,6251,779540433,0,0,0,956.12,8,60677.52,11,4,21,9,True
6078597,965,4,25,8993,779540433,0,0,0,956.11,8,59721.41,13,6,19,10,False
6120305,1399,0,30,8672,779540433,0,0,0,955.75,8,58765.66,24,6,5,10,True
6357197,1399,0,25,9463,779540433,0,0,0,956.08,8,57809.58,24,1,13,10,True
6391163,679,0,-1,8034,779540433,0,1,0,956.12,4,57809.58,24,4,22,11,True
6476427,965,4,25,9306,779540433,0,0,0,955.84,8,56853.74,13,6,4,11,True
6498582,123,0,-1,4298,779540433,0,1,0,956.07,1,56853.74,18,4,14,12,True
6616176,1208,4,30,1706,779540433,0,0,0,956.03,8,55897.71,24,0,12,12,True
6800244,123,0,451,6544,779540433,0,0,0,955.97,7,54941.74,18,4,17,1,True
7087442,334,0,10,8672,779540433,0,0,0,955.78,0,55897.52,11,3,17,2,True
7337601,1189,2,-1,3314,779540433,0,1,0,955.89,4,55897.52,24,5,12,2,True
7506399,551,0,20,9463,779540433,0,0,0,955.99,3,54941.53,17,4,6,2,True
7595637,1189,2,-1,8258,779540433,0,1,0,956.02,4,54941.53,24,4,8,3,True
7860337,1319,1,451,6251,779540433,0,0,0,955.98,7,53985.55,18,1,10,3,True
8153884,1399,0,30,7181,779540433,0,0,0,955.88,8,53029.67,24,4,19,3,True
8334833,979,0,20,8993,779540433,0,0,0,955.8,5,52073.87,22,5,19,3,True
8347913,1164,0,20,5701,779540433,0,0,0,956.15,3,51117.72,24,5,10,4,False
8367314,1206,0,20,6590,779540433,0,0,0,956.15,5,50161.57,24,3,1,5,True
8434403,123,0,451,8283,779540433,0,0,0,956.18,7,49205.39,18,0,12,6,True
8547532,1189,2,451,3339,779540433,0,0,0,956.12,7,48249.27,24,1,2,7,True
8625044,1208,4,25,2988,779540433,0,0,0,955.87,8,47293.4,24,6,2,8,True
8813496,965,4,30,6251,779540433,0,0,0,956.07,8,46337.33,13,3,1,8,True
8866701,1319,1,451,6850,779540433,0,0,0,956.1,7,45381.23,18,3,9,8,True
8943502,965,4,25,1706,779540433,0,0,0,955.68,8,44425.55,13,4,16,9,True
9331647,679,0,25,9463,779540433,0,0,0,955.89,8,43469.66,24,4,10,9,True
9735496,565,4,25,6544,779540433,0,0,0,955.85,8,42513.81,11,2,13,10,True
9909692,1189,2,451,9306,779540433,0,0,0,955.85,7,41557.96,24,3,23,11,True
1070060,1410,1,30,4765,824297491,0,0,0,1128.16,8,377915.84,24,1,9,1,True
1200012,628,0,451,6938,824297491,0,0,0,1127.92,7,376787.92,11,2,3,3,True
1205208,869,2,25,1553,824297491,0,0,0,1128.13,8,375659.79,24,4,22,3,True
1237366,342,0,20,1611,824297491,0,0,0,1127.78,3,374532.01,24,2,19,4,True
1352828,637,4,451,8309,824297491,0,0,0,1128.08,7,373403.93,24,3,16,4,True
1506049,1376,3,451,5330,824297491,0,0,0,1128.05,7,372275.88,16,0,1,5,True
1699440,641,0,451,3737,824297491,0,0,0,1128.18,7,371147.7,24,5,6,5,True
1726554,628,0,451,9177,824297491,0,0,0,1128.27,7,370019.43,11,4,21,5,True
2020364,628,0,451,2845,824297491,0,0,0,1127.88,7,368891.55,11,0,12,5,True
2085290,637,4,451,5330,824297491,0,0,0,1128.15,7,367763.4,24,6,15,5,True
2167590,628,0,451,5098,824297491,0,0,0,1128.07,7,366635.33,11,6,13,6,True
2213107,1410,1,-1,1935,824297491,0,1,0,1127.84,4,366635.33,24,3,13,7,True
2228571,637,4,451,4765,824297491,0,0,0,1128.17,7,365507.16,24,2,2,8,True
2478913,662,1,10,5330,824297491,0,0,0,1128.05,6,366635.21,18,2,21,8,True
2698202,398,0,10,2730,824297491,0,0,0,1128.52,0,367763.73,10,5,6,8,True
2807097,869,2,451,2845,824297491,0,0,0,1127.96,7,366635.77,24,1,17,8,True
2840101,1155,0,20,9329,824297491,0,0,0,1128.15,3,365507.62,15,5,11,9,True
2952761,628,0,451,9003,824297491,0,0,0,1127.99,7,364379.63,11,1,17,9,True
3411625,895,0,20,8401,824297491,0,0,0,1127.89,5,363251.74,24,0,23,12,True
3719734,580,0,20,8401,824297491,0,0,0,1127.86,5,362123.88,11,2,15,12,True
3842002,637,4,451,8401,824297491,0,0,0,1128.42,7,360995.46,24,0,16,1,True
4054028,869,2,25,1553,824297491,0,0,0,1128.02,8,359867.44,24,5,6,1,False
4328997,641,0,30,1611,824297491,0,0,0,1127.93,8,358739.51,24,6,19,1,False
4746239,628,0,451,1935,824297491,0,0,0,1128.09,7,357611.42,11,3,22,3,True
4836945,557,1,451,1611,824297491,0,0,0,1128.17,7,356483.25,17,2,0,4,True
4937327,219,0,10,2845,824297491,0,0,0,1127.85,0,357611.1,9,2,22,4,True
5196033,557,1,25,8401,824297491,0,0,0,1128.12,8,356482.98,17,6,6,4,True
5364293,496,1,10,9177,824297491,0,0,0,1127.81,6,357610.79,12,0,1,5,True
5392363,637,4,30,9003,824297491,0,0,0,1127.97,8,356482.82,24,3,22,5,True
5480632,1410,1,25,1553,824297491,0,0,0,1127.81,8,355355.01,24,0,21,8,True
5948569,628,0,-1,2845,824297491,0,1,0,1127.97,4,355355.01,11,3,8,8,True
6324044,869,2,25,2730,824297491,0,0,0,1127.94,8,354227.07,24,3,17,10,True
6358589,637,4,451,8401,824297491,0,0,0,1127.49,7,353099.58,24,1,19,10,True
6749594,557,1,25,4765,824297491,0,0,0,1128.06,8,351971.52,17,3,13,11,True
6844148,637,4,25,1935,824297491,0,0,0,1127.83,8,350843.69,24,0,19,12,True
6909820,199,0,10,8401,824297491,0,0,0,1127.79,6,351971.48,18,1,16,12,True
7169255,1376,3,451,9003,824297491,0,0,0,1128.21,7,350843.27,16,1,8,12,True
7316197,145,0,20,9003,824297491,0,0,0,1127.87,5,349715.4,18,2,14,1,True
7870320,662,1,10,2730,824297491,0,0,0,1127.93,6,350843.33,18,2,7,1,True
8020840,869,2,-1,6938,824297491,0,1,0,1128.01,1,350843.33,24,0,1,3,True
8111010,1410,1,25,5098,824297491,0,0,0,1127.83,8,349715.5,24,1,9,3,True
8374950,557,1,25,1553,824297491,0,0,0,1128.09,8,348587.41,17,0,2,4,False
8523317,1410,1,451,9003,824297491,0,0,0,1128.08,7,347459.33,24,6,2,5,False
8598971,637,4,451,9003,824297491,0,0,0,1127.99,7,346331.34,24,3,6,7,True
8784133,628,0,451,8401,824297491,0,0,0,1127.79,7,345203.55,11,6,22,8,True
8842476,641,0,30,5098,824297491,0,0,0,1127.83,8,344075.72,24,6,3,9,True
8991410,249,0,20,1553,824297491,0,0,0,1128.09,3,342947.63,6,5,17,10,True
9059290,628,0,-1,4765,824297491,0,1,0,1128.04,1,342947.63,11,0,17,10,True
9673550,670,0,10,9003,824297491,0,0,0,1128.18,0,344075.81,18,4,1,11,True
9743314,887,2,20,2730,824297491,0,0,0,1127.94,3,342947.87,27,6,16,11,True
9793951,1410,1,-1,3737,824297491,0,1,0,1127.77,1,342947.87,24,4,17,11,True
1571261,318,0,451,7895,175275301,1,0,0,682.11,7,854056.89,11,4,0,2,False
1999823,1159,0,10,4719,175275301,1,0,0,682.12,0,854739.01,15,5,13,2,True
2165845,1463,2,25,6131,175275301,1,0,0,681.99,8,854057.02,11,4,14,3,True
2226858,249,0,-1,5011,175275301,1,1,0,682.18,1,854057.02,6,0,15,3,True
2577761,318,0,451,6666,175275301,1,0,0,682.04,7,853374.98,11,0,8,4,True
2608670,1460,2,30,4719,175275301,1,0,0,681.93,8,852693.05,11,1,11,4,True
2739127,1399,0,20,4218,175275301,1,0,0,681.96,5,852011.09,24,4,9,5,True
2836007,421,3,451,6258,175275301,1,0,0,681.98,7,851329.11,18,3,14,5,True
2871166,421,3,25,8808,175275301,1,0,0,681.94,8,850647.17,18,6,17,6,True
2940186,249,0,451,8283,175275301,1,0,0,682.09,7,849965.08,6,6,1,12,True
2993319,1460,2,30,5224,175275301,1,0,0,681.96,8,849283.12,11,0,3,1,True
3402307,1463,2,-1,4719,175275301,1,1,0,682.22,4,849283.12,11,3,13,1,True
3523251,594,0,10,2172,175275301,1,0,0,681.94,6,849965.06,24,1,20,1,True
3599022,318,0,30,3846,175275301,1,0,0,682.01,8,849283.05,11,3,12,1,True
3731819,318,0,30,6131,175275301,1,0,0,682.21,8,848600.84,11,4,7,1,True
3871998,1463,2,451,5224,175275301,1,0,0,682.06,7,847918.78,11,2,18,2,True
3983565,1460,2,25,3846,175275301,1,0,0,681.91,8,847236.87,11,5,21,2,True
4041445,41,2,20,3846,175275301,1,0,0,681.92,3,846554.95,11,2,7,3,True
4475674,1460,2,25,1295,175275301,1,0,0,681.95,8,845873.0,11,1,0,3,True
4607337,421,3,30,5180,175275301,1,0,0,682.25,8,845190.75,18,3,6,4,True
4802860,1336,2,20,5571,175275301,1,0,0,681.97,5,844508.78,18,0,20,4,True
4814276,583,2,20,6258,175275301,1,0,0,682.16,5,843826.62,11,1,4,4,True
4944276,318,0,451,6131,175275301,1,0,0,681.61,7,843145.01,11,0,3,5,True
5556203,318,0,451,3846,175275301,1,0,0,681.88,7,842463.13,11,2,11,5,True
5645886,318,0,-1,5180,175275301,1,1,0,681.84,1,842463.13,11,5,11,7,True
6007533,249,0,451,8891,175275301,1,0,0,682.07,7,841781.06,6,0,14,7,True
6303920,1463,2,-1,3846,175275301,1,1,0,681.82,4,841781.06,11,1,7,8,False
6355399,1471,0,10,8891,175275301,1,0,0,682.14,6,842463.2,24,4,5,8,True
6426231,1463,2,30,5180,175275301,1,0,0,682.06,8,841781.14,11,1,23,9,True
6658122,249,0,30,8808,175275301,1,0,0,682.12,8,841099.02,6,2,18,11,True
6794196,249,0,25,5011,175275301,1,0,0,681.95,8,840417.07,6,4,8,12,True
7145008,993,0,20,6131,175275301,1,0,0,681.88,5,839735.19,22,4,19,1,True
7326369,59,0,10,8808,175275301,1,0,0,681.99,6,840417.18,20,0,3,2,True
7398175,1116,0,20,4218,175275301,1,0,0,682.17,5,839735.01,24,3,6,2,True
7625484,1111,0,20,4719,175275301,1,0,0,681.9,5,839053.11,0,4,0,2,True
7634986,318,0,-1,5011,175275301,1,1,0,682.04,4,839053.11,11,5,14,2,True
7696206,1460,2,451,5011,175275301,1,0,0,681.98,7,838371.13,11,0,8,2,True
7696696,211,0,20,2172,175275301,1,0,0,681.85,5,837689.28,9,5,19,3,True
7964343,249,0,25,5571,175275301,1,0,0,682.08,8,837007.2,6,5,0,3,True
8022810,249,0,25,1894,175275301,1,0,0,682.01,8,836325.19,6,4,16,3,True
8031316,318,0,-1,4620,175275301,1,1,0,682.0,4,836325.19,11,1,7,4,True
8041988,318,0,-1,7895,175275301,1,2,0,681.98,4,836325.19,11,2,9,4,True
8082972,457,0,20,4719,175275301,1,0,0,681.99,5,835643.2,13,2,9,5,True
8619805,1460,2,25,8283,175275301,1,0,0,681.79,8,834961.41,11,5,15,5,True
8858097,318,0,451,4218,175275301,1,0,0,682.46,7,834278.95,11,0,20,5,True
8939138,1460,2,451,1894,175275301,1,0,0,682.01,7,833596.94,11,4,20,5,True
8941043,421,3,-1,5130,175275301,1,1,0,682.0,1,833596.94,18,3,10,7,True
8956477,1036,1,10,6131,175275301,1,0,0,682.12,6,834279.06,11,2,4,7,True
9176528,318,0,451,6258,175275301,1,0,0,681.88,7,833597.18,11,3,9,7,True
9281947,1460,2,25,5180,175275301,1,0,0,681.87,8,832915.31,11,4,11,9,True
9921071,318,0,451,6131,175275301,1,0,0,682.1,7,832233.21,11,6,0,11,True
1114859,1409,1,451,7747,348574133,1,0,0,895.74,7,381221.26,24,5,9,1,True
1474647,1429,0,451,1300,348574133,1,0,0,895.88,7,380325.38,24,2,4,1,True
1704730,605,0,-1,9906,348574133,1,1,0,896.01,1,380325.38,24,3,8,1,False
1967022,223,2,451,1300,348574133,1,0,0,896.05,7,379429.33,26,2,6,1,True
2011294,1429,0,30,9854,348574133,1,0,0,895.96,8,378533.37,24,1,23,2,True
2061885,1409,1,-1,3054,348574133,1,1,0,895.93,4,378533.37,24,2,18,2,True
2133822,223,2,451,6403,348574133,1,0,0,896.0,7,377637.37,26,0,19,3,True
2161472,605,0,-1,7579,348574133,1,1,0,895.88,4,377637.37,24,3,13,4,True
2252918,1471,0,20,3054,348574133,1,0,0,896.02,5,376741.35,24,4,2,5,True
2338329,1429,0,-1,9854,348574133,1,1,0,895.88,4,376741.35,24,4,5,5,True
2529281,518,2,20,7579,348574133,1,0,0,896.03,5,375845.32,18,4,3,7,True
2541889,605,0,451,8299,348574133,1,0,0,895.97,7,374949.35,24,3,19,8,True
2870987,1270,1,451,8299,348574133,1,0,0,896.32,7,374053.03,23,5,1,11,True
3294252,325,0,20,1138,348574133,1,0,0,895.77,3,373157.26,11,6,5,12,True
3327999,129,0,10,5978,348574133,1,0,0,896.29,0,374053.55,18,1,8,12,True
3328259,333,1,451,6809,348574133,1,0,0,896.03,7,373157.52,11,1,8,12,True
3394879,1039,1,451,3054,348574133,1,0,0,895.85,7,372261.67,11,0,10,12,True
3453935,331,4,451,5978,348574133,1,0,0,896.02,7,371365.65,11,3,10,2,True
3497610,223,2,30,5333,348574133,1,0,0,895.82,8,370469.83,26,6,22,2,True
3503484,1409,1,30,3054,348574133,1,0,0,896.06,8,369573.77,24,4,12,3,True
3632025,223,2,30,7747,348574133,1,0,0,895.64,8,368678.13,26,5,17,3,True
3855843,573,0,10,9906,348574133,1,0,0,896.19,0,369574.32,11,3,8,5,True
4028701,331,4,451,1138,348574133,1,0,0,896.03,7,368678.29,11,0,9,5,True
4220979,1409,1,451,6403,348574133,1,0,0,896.01,7,367782.28,24,2,15,7,True
4224344,223,2,451,9854,348574133,1,0,0,895.97,7,366886.31,26,3,12,7,True
4367195,1039,1,30,6809,348574133,1,0,0,896.2,8,365990.11,11,6,17,7,True
4396826,160,0,20,9854,348574133,1,0,0,896.31,5,365093.8,24,5,13,8,False
4572861,1429,0,451,8299,348574133,1,0,0,896.28,7,364197.52,24,2,10,8,True
6240178,747,1,10,7501,348574133,1,0,0,895.81,6,365093.33,24,6,10,10,True
6290992,1270,1,-1,7747,348574133,1,1,0,895.89,4,365093.33,23,5,4,10,True
6358105,616,1,10,3054,348574133,1,0,0,896.1,0,365989.43,11,4,6,11,True
6514597,591,0,20,1300,348574133,1,0,0,895.91,5,365093.52,24,4,16,11,False
6554006,567,1,10,1138,348574133,1,0,0,895.95,0,365989.47,11,4,13,12,True
6728140,1409,1,-1,6809,348574133,1,1,0,895.87,1,365989.47,24,6,3,12,True
6833486,166,4,30,5711,348574133,1,0,0,896.02,8,365093.45,24,0,0,12,True
7067665,166,4,451,1138,348574133,1,0,0,895.92,7,364197.53,24,3,6,12,True
7133489,166,4,25,9906,348574133,1,0,0,895.97,8,363301.56,24,4,16,1,True
7443347,1409,1,-1,8299,348574133,1,1,0,896.04,4,363301.56,24,0,8,1,True
7551498,223,2,30,6403,348574133,1,0,0,896.03,8,362405.53,26,0,8,2,True
7572335,333,1,-1,7579,348574133,1,1,0,895.98,1,362405.53,11,0,0,3,True
7645814,166,4,451,7747,348574133,1,0,0,895.97,7,361509.56,24,2,1,3,True
7793050,940,1,10,7501,348574133,1,0,0,895.93,0,362405.49,24,6,13,3,True
7830648,331,4,451,3054,348574133,1,0,0,895.9,7,361509.59,11,0,12,4,True
8017158,166,4,451,7747,348574133,1,0,0,895.8,7,360613.79,24,1,1,4,True
8197444,333,1,30,7579,348574133,1,0,0,896.13,8,359717.66,11,1,22,4,False
8465749,783,0,10,9906,348574133,1,0,0,895.84,6,360613.5,14,0,9,4,True
8733667,1429,0,451,5333,348574133,1,0,0,896.03,7,359717.47,24,5,23,5,False
8952176,166,4,451,8299,348574133,1,0,0,895.92,7,358821.55,24,4,18,5,True
9269537,1039,1,451,6403,348574133,1,0,0,895.89,7,357925.66,11,0,21,9,False
9495404,223,2,30,1300,348574133,1,0,0,896.22,8,357029.44,26,1,5,10,True
9563054,1169,0,20,6403,348574133,1,0,0,896.15,5,356133.29,24,4,6,10,True
9776441,365,0,20,6809,348574133,1,0,0,896.25,5,355237.04,25,2,16,11,True
9964278,850,1,10,5978,348574133,1,0,0,896.01,6,356133.05,5,1,4,11,True
1093710,718,4,30,1579,299343792,0,0,0,136.85,8,679323.15,18,1,22,1,True
1149919,718,4,451,8405,299343792,0,0,0,137.0,7,679186.15,18,0,19,1,True
1204033,485,1,10,4393,299343792,0,0,0,136.87,0,679323.02,5,0,6,2,True
1414649,718,4,25,8405,299343792,0,0,0,137.2,8,679185.82,18,0,12,2,True
1506702,328,0,25,8907,299343792,0,0,0,136.9,8,679048.92,11,2,10,3,True
1548333,963,4,30,5892,299343792,0,0,0,136.99,8,678911.93,13,6,20,3,True
1856482,735,1,10,4857,299343792,0,0,0,137.09,0,679049.02,11,4,22,4,True
1998872,328,0,451,1821,299343792,0,0,0,136.99,7,678912.03,11,6,0,4,False
2139318,648,3,30,8982,299343792,0,0,0,137.12,8,678774.91,24,0,16,4,True
2318625,448,0,30,8982,299343792,0,0,0,136.93,8,678637.98,13,3,23,4,False
2396610,869,2,451,5892,299343792,0,0,0,136.96,7,678501.02,24,0,2,5,True
2538739,869,2,-1,8937,299343792,0,1,0,137.11,1,678501.02,24,0,18,6,True
2737467,448,0,30,8937,299343792,0,0,0,136.6,8,678364.42,13,2,1,7,True
2775407,1486,2,20,1821,299343792,0,0,0,136.77,5,678227.65,24,5,10,9,True
3029843,718,4,25,4393,299343792,0,0,0,137.1,8,678090.55,18,6,16,9,True
3110373,963,4,25,9129,299343792,0,0,0,136.94,8,677953.61,13,5,0,10,True
3219805,718,4,30,4643,299343792,0,0,0,136.9,8,677816.71,18,1,6,10,True
3605196,869,2,25,8937,299343792,0,0,0,137.16,8,677679.55,24,2,2,12,True
3674758,963,4,451,1821,299343792,0,0,0,137.31,7,677542.24,13,3,7,1,True
3984180,869,2,25,4643,299343792,0,0,0,136.91,8,677405.33,24,5,9,2,True
3989289,854,0,10,4857,299343792,0,0,0,137.27,6,677542.6,24,3,4,2,True
4010162,1443,4,451,8907,299343792,0,0,0,136.83,7,677405.77,24,3,9,3,True
4031244,673,0,10,8405,299343792,0,0,0,137.07,6,677542.84,18,5,1,3,True
4128292,628,0,20,1579,299343792,0,0,0,137.26,3,677405.58,11,1,21,3,True
4146049,851,1,10,4393,299343792,0,0,0,137.06,0,677542.64,5,4,17,5,True
4458272,1076,1,10,4857,299343792,0,0,0,136.85,0,677679.49,18,0,22,6,True
4502388,116,0,20,1579,299343792,0,0,0,136.9,5,677542.59,3,0,5,7,True
4935008,328,0,451,5807,299343792,0,0,0,136.96,7,677405.63,11,1,19,8,True
5213344,156,4,451,1579,299343792,0,0,0,136.96,7,677268.67,18,3,15,8,True
5497732,523,2,20,8907,299343792,0,0,0,137.31,5,677131.36,18,1,7,8,True
5614205,1443,4,451,1720,299343792,0,0,0,136.85,7,676994.51,24,2,11,8,True
5945253,328,0,-1,8982,299343792,0,1,0,137.02,4,676994.51,11,0,7,9,True
6028666,1443,4,451,1579,299343792,0,0,0,136.98,7,676857.53,24,5,3,9,True
6053071,1189,2,20,1579,299343792,0,0,0,136.8,3,676720.73,24,5,0,9,True
6063174,1443,4,30,4643,299343792,0,0,0,137.09,8,676583.64,24,3,1,11,True
6256110,156,4,30,5736,299343792,0,0,0,137.12,8,676446.52,18,3,21,11,True
6279083,448,0,451,8166,299343792,0,0,0,136.6,7,676309.92,13,6,19,12,True
6419511,603,0,10,1720,299343792,0,0,0,137.6,6,676447.52,24,4,16,1,True
6469071,448,0,-1,1579,299343792,0,1,0,137.07,4,676447.52,13,4,19,1,True
6596543,1443,4,25,3722,299343792,0,0,0,137.0,8,676310.52,24,1,11,1,True
6713638,869,2,25,1579,299343792,0,0,0,136.54,8,676173.98,24,5,5,2,True
6743577,156,4,451,4393,299343792,0,0,0,137.24,7,676036.74,18,0,22,2,True
6891367,869,2,451,1821,299343792,0,0,0,136.89,7,675899.85,24,0,4,2,True
7127644,1063,0,20,9129,299343792,0,0,0,136.89,5,675762.96,11,4,3,4,True
7292333,963,4,30,1934,299343792,0,0,0,136.83,8,675626.13,13,0,4,4,False
7570306,1443,4,451,1720,299343792,0,0,0,137.34,7,675488.79,24,1,1,4,True
7709424,72,4,30,4643,299343792,0,0,0,136.92,8,675351.87,20,0,4,5,True
7727543,145,0,20,9129,299343792,0,0,0,137.13,3,675214.74,18,0,22,5,True
7809610,328,0,-1,4643,299343792,0,1,0,136.97,4,675214.74,11,3,13,5,True
8045704,1443,4,451,1821,299343792,0,0,0,136.83,7,675077.91,24,3,16,5,True
8055896,963,4,25,8907,299343792,0,0,0,137.09,8,674940.82,13,6,12,5,True
8171204,718,4,451,4857,299343792,0,0,0,136.9,7,674803.92,18,3,19,6,True
8392239,328,0,30,8937,299343792,0,0,0,136.91,8,674667.01,11,5,8,7,True
8593766,1134,1,10,3722,299343792,0,0,0,137.17,6,674804.18,24,4,12,8,True
8688609,156,4,451,5892,299343792,0,0,0,136.99,7,674667.19,18,1,11,9,True
9336223,328,0,-1,8937,299343792,0,1,0,136.88,1,674667.19,11,0,0,9,True
9514967,448,0,451,8907,299343792,0,0,0,137.03,7,674530.16,13,4,10,10,True
9892731,208,0,10,8982,299343792,0,0,0,136.78,6,674666.94,9,3,7,11,True
1065707,1461,0,20,3843,898367812,1,0,0,844.16,3,635399.84,11,6,20,1,True
1219127,192,2,451,7733,898367812,1,0,0,843.9,7,634555.94,18,3,5,2,True
1371992,389,3,451,5604,898367812,1,0,0,843.71,7,633712.23,10,3,14,3,True
1398842,393,1,451,2339,898367812,1,0,0,843.85,7,632868.38,10,4,8,4,True
1712551,393,1,451,4611,898367812,1,0,0,843.97,7,632024.41,10,1,3,5,True
1727529,1445,2,25,5019,898367812,1,0,0,843.83,8,631180.58,24,0,4,5,True
1869617,393,1,-1,2334,898367812,1,1,0,843.88,4,631180.58,10,3,19,5,True
1981354,362,0,20,1485,898367812,1,0,0,844.14,3,630336.44,24,1,8,6,True
2082632,712,0,10,9579,898367812,1,0,0,843.57,6,631180.01,18,1,23,6,True
2172142,234,0,20,7191,898367812,1,0,0,843.86,5,630336.15,26,0,18,7,True
2861373,393,1,30,7353,898367812,1,0,0,843.71,8,629492.44,10,6,7,8,True
3083239,1445,2,30,4611,898367812,1,0,0,843.94,8,628648.5,24,1,16,9,True
3393986,21,0,10,1811,898367812,1,0,0,844.0,6,629492.5,11,2,15,10,True
3638131,782,4,25,3025,898367812,1,0,0,843.96,8,628648.54,14,3,8,10,True
3715381,920,4,451,7784,898367812,1,0,0,844.04,7,627804.5,18,1,0,11,True
3802731,1434,0,20,5828,898367812,1,0,0,844.05,5,626960.45,24,2,9,12,True
3833855,920,4,25,4611,898367812,1,0,0,843.76,8,626116.69,18,1,22,1,True
3961738,782,4,30,1485,898367812,1,0,0,844.08,8,625272.61,14,2,22,2,True
4007658,389,3,-1,2339,898367812,1,1,0,844.04,1,625272.61,10,0,9,3,True
4045955,393,1,25,4774,898367812,1,0,0,843.91,8,624428.7,10,2,2,3,True
4185217,192,2,-1,5019,898367812,1,1,0,843.67,4,624428.7,18,5,7,3,True
4359447,192,2,25,8781,898367812,1,0,0,844.0,8,623584.7,18,6,13,4,True
4863300,920,4,451,4611,898367812,1,0,0,843.8,7,622740.9,18,5,0,4,True
4863841,1391,2,20,6172,898367812,1,0,0,844.04,3,621896.86,24,3,5,4,True
4918362,389,3,451,3025,898367812,1,0,0,843.77,7,621053.09,10,2,11,5,True
5059699,238,0,10,3353,898367812,1,0,0,843.95,0,621897.04,26,2,23,7,True
5147632,389,3,25,2334,898367812,1,0,0,843.91,8,621053.13,10,5,11,7,True
5242989,218,0,20,1970,898367812,1,0,0,843.83,5,620209.3,9,5,9,7,True
5626077,920,4,451,3968,898367812,1,0,0,844.19,7,619365.11,18,5,3,9,True
5679809,920,4,30,3968,898367812,1,0,0,844.0,8,618521.11,18,5,18,9,True
5921727,192,2,451,6172,898367812,1,0,0,844.13,7,617676.98,18,0,14,9,True
6083687,1445,2,20,1458,898367812,1,0,0,843.93,5,616833.05,24,5,22,9,True
6192094,192,2,25,7353,898367812,1,0,0,844.25,8,615988.8,18,6,19,10,True
6287686,802,2,20,3968,898367812,1,0,0,843.81,3,615144.99,11,2,0,10,True
6290789,780,0,20,8781,898367812,1,0,0,843.93,3,614301.06,14,6,18,10,True
6346049,192,2,25,6172,898367812,1,0,0,843.91,8,613457.15,18,0,0,10,True
6685933,782,4,30,1485,898367812,1,0,0,844.15,8,612613.0,14,2,20,12,True
7018647,1476,0,20,5828,898367812,1,0,0,843.99,5,611769.01,24,5,22,1,True
7167427,1445,2,-1,3356,898367812,1,1,0,844.24,4,611769.01,24,1,2,1,True
7190329,1445,2,25,3025,898367812,1,0,0,843.92,8,610925.09,24,2,3,1,True
7203342,389,3,451,7733,898367812,1,0,0,843.89,7,610081.2,10,1,18,2,True
7361874,782,4,-1,3353,898367812,1,1,0,844.15,4,610081.2,14,1,1,3,True
7736545,1413,0,10,8781,898367812,1,0,0,844.1,0,610925.3,24,0,19,3,True
7747521,1445,2,30,2334,898367812,1,0,0,844.04,8,610081.26,24,4,5,4,True
7932031,859,2,20,5007,898367812,1,0,0,844.14,5,609237.12,24,5,21,4,True
7995732,557,1,10,5007,898367812,1,0,0,843.96,6,610081.08,17,1,3,4,True
8219973,782,4,25,1167,898367812,1,0,0,844.11,8,609236.97,14,0,16,5,True
8431279,389,3,451,1485,898367812,1,0,0,844.04,7,608392.93,10,3,20,5,True
8467849,920,4,25,7353,898367812,1,0,0,844.1,8,607548.83,18,5,5,7,True
8678342,1445,2,-1,6172,898367812,1,1,0,843.72,4,607548.83,24,2,1,7,True
8815890,389,3,451,1970,898367812,1,0,0,843.96,7,606704.87,10,5,2,7,True
9106874,1445,2,30,1970,898367812,1,0,0,843.81,8,605861.06,24,6,8,9,True
9153974,393,1,30,5604,898367812,1,0,0,844.09,8,605016.97,10,4,13,10,True
9672726,782,4,-1,2637,898367812,1,1,0,843.89,4,605016.97,14,2,13,10,True
9799411,389,3,451,4774,898367812,1,0,0,843.86,7,604173.11,10,2,10,11,True
1333508,1061,2,-1,4220,956535833,0,1,0,758.96,1,516042.0,11,0,10,2,True
1399700,304,0,451,3353,956535833,0,0,0,758.99,7,515283.01,4,2,22,3,True
1460954,1492,4,-1,2486,956535833,0,1,0,758.93,4,515283.01,24,6,10,4,True
1507417,1061,2,25,4220,956535833,0,0,0,759.23,8,514523.78,11,1,9,5,True
1509958,276,0,451,4220,956535833,0,0,0,759.2,7,513764.58,24,6,15,5,True
1530320,1210,0,451,4593,956535833,0,0,0,758.99,7,513005.59,24,2,11,6,True
1535683,304,0,30,2410,956535833,0,0,0,759.15,8,512246.44,4,4,5,6,True
1666942,1061,2,451,8517,956535833,0,0,0,758.76,7,511487.68,11,4,5,10,True
1689202,63,3,-1,8517,956535833,0,1,0,759.14,1,511487.68,20,6,20,10,True
2171676,1210,0,451,1901,956535833,0,0,0,759.1,7,510728.58,24,1,16,10,True
2329246,276,0,451,3783,956535833,0,0,0,759.12,7,509969.46,24,3,11,10,True
2420220,1061,2,451,4220,956535833,0,0,0,758.86,7,509210.6,11,6,11,11,True
2732892,663,4,30,7621,956535833,0,0,0,758.92,8,508451.68,18,0,6,11,True
2780329,63,3,451,8517,956535833,0,0,0,759.0,7,507692.68,20,3,4,12,True
2864128,1210,0,25,3353,956535833,0,0,0,759.29,8,506933.39,24,4,8,12,True
2931109,47,1,10,8789,956535833,0,0,0,758.89,6,507692.28,24,0,13,12,True
3022699,907,0,20,1901,956535833,0,0,0,759.0,3,506933.28,2,4,5,1,True
3029461,276,0,30,1654,956535833,0,0,0,759.31,8,506173.97,24,5,19,3,True
3232184,1090,0,10,1654,956535833,0,0,0,759.06,6,506933.03,18,0,11,4,True
3947305,1492,4,30,8789,956535833,0,0,0,759.05,8,506173.98,24,1,13,4,True
4075214,1210,0,451,8517,956535833,0,0,0,759.14,7,505414.84,24,1,15,4,True
4237087,63,3,30,3353,956535833,0,0,0,759.32,8,504655.52,20,4,1,4,True
4292686,1210,0,451,8789,956535833,0,0,0,758.88,7,503896.64,24,0,11,5,True
4311143,1210,0,-1,4220,956535833,0,1,0,759.0,4,503896.64,24,3,18,6,True
4326185,304,0,30,2410,956535833,0,0,0,758.81,8,503137.83,4,3,2,6,True
4461262,663,4,25,7621,956535833,0,0,0,759.1,8,502378.73,18,5,5,7,True
4851282,1210,0,451,4622,956535833,0,0,0,759.18,7,501619.55,24,5,19,7,True
5012449,1060,1,10,7621,956535833,0,0,0,759.13,0,502378.68,11,2,19,7,True
5107055,1061,2,-1,7893,956535833,0,1,0,759.17,4,502378.68,11,2,17,9,True
5203182,260,0,10,2410,956535833,0,0,0,759.0,6,503137.68,6,2,14,11,True
5226554,276,0,25,7621,956535833,0,0,0,759.04,8,502378.64,24,4,1,1,True
5353417,276,0,-1,4593,956535833,0,1,0,759.31,4,502378.64,24,4,5,1,True
5412682,1492,4,30,8517,956535833,0,0,0,758.96,8,501619.68,24,5,23,1,True
5581341,1061,2,451,3783,956535833,0,0,0,759.13,7,500860.55,11,1,3,2,True
5629973,63,3,-1,7621,956535833,0,1,0,759.1,1,500860.55,20,6,22,3,True
5745107,1483,0,10,4220,956535833,0,0,0,759.28,6,501619.83,24,6,2,4,True
6136759,63,3,451,1654,956535833,0,0,0,758.94,7,500860.89,20,1,2,4,True
6789398,1061,2,-1,3783,956535833,0,1,0,759.01,4,500860.89,11,2,2,4,True
6829878,1486,2,20,4220,956535833,0,0,0,758.81,3,500102.08,24,4,15,4,True
6863457,739,1,10,8517,956535833,0,0,0,758.68,6,500860.76,24,6,5,6,True
6873223,1112,1,10,8200,956535833,0,0,0,758.89,6,501619.65,0,2,1,7,True
7068396,1061,2,-1,4220,956535833,0,1,0,759.16,4,501619.65,11,2,17,7,True
7235186,304,0,451,1654,956535833,0,0,0,758.96,7,500860.69,4,2,21,8,True
7357416,63,3,25,4622,956535833,0,0,0,759.03,8,500101.66,20,3,3,9,True
7497960,276,0,451,3783,956535833,0,0,0,758.83,7,499342.83,24,6,12,9,True
7669887,1210,0,451,1654,956535833,0,0,0,759.14,7,498583.69,24,3,5,9,True
7803687,716,0,10,3783,956535833,0,0,0,759.08,6,499342.77,18,6,12,10,True
8453791,783,0,20,4220,956535833,0,0,0,759.35,5,498583.42,14,0,16,10,True
8689693,304,0,-1,7186,956535833,0,1,0,758.71,4,498583.42,4,6,21,10,True
9159445,63,3,451,3353,956535833,0,0,0,759.3,7,497824.12,20,0,7,10,True
9215257,1471,0,10,7186,956535833,0,0,0,759.09,6,498583.21,24,0,8,10,True
9500683,1260,0,20,3353,956535833,0,0,0,759.04,5,497824.17,23,2,19,10,True
9826671,276,0,451,3353,956535833,0,0,0,759.25,7,497064.92,24,1,23,11,True
1007647,1467,0,30,4126,542584564,1,0,0,127.1,8,520818.9,11,0,4,1,True
1064770,1315,0,20,7751,542584564,1,0,0,127.01,5,520691.89,5,5,23,2,True
1180265,819,2,30,8441,542584564,1,0,0,127.13,8,520564.76,18,0,5,2,True
1376607,1467,0,-1,7942,542584564,1,1,0,127.04,4,520564.76,11,4,7,4,True
1557449,525,0,30,9050,542584564,1,0,0,126.84,8,520437.92,18,5,14,6,True
1811957,834,0,25,2479,542584564,1,0,0,126.99,8,520310.93,5,0,9,7,True
1948361,834,0,25,2004,542584564,1,0,0,126.92,8,520184.01,5,6,19,8,True
1970677,525,0,-1,5534,542584564,1,1,0,126.85,1,520184.01,18,3,17,9,True
2602613,1342,3,451,8642,542584564,1,0,0,127.07,7,520056.94,24,2,21,10,True
2730673,53,0,10,9080,542584564,1,0,0,127.04,6,520183.98,20,6,0,10,True
2871947,1467,0,-1,3965,542584564,1,1,0,126.79,4,520183.98,11,1,9,10,True
2925827,950,0,451,8642,542584564,1,0,0,126.83,7,520057.15,24,6,6,10,True
3146823,819,2,30,3965,542584564,1,0,0,127.02,8,519930.13,18,3,16,11,True
3197571,1342,3,451,8642,542584564,1,0,0,127.22,7,519802.91,24,2,3,12,True
3477059,950,0,25,7942,542584564,1,0,0,126.91,8,519676.0,24,3,14,12,True
3845552,525,0,25,7942,542584564,1,0,0,126.85,8,519549.15,18,2,7,2,True
3926203,511,1,10,1668,542584564,1,0,0,126.96,6,519676.11,12,4,5,2,True
3968047,819,2,-1,1335,542584564,1,1,0,127.06,4,519676.11,18,5,17,3,True
4117945,942,0,20,4095,542584564,1,0,0,127.15,5,519548.96,24,3,9,4,True
4119599,131,4,-1,7751,542584564,1,1,0,127.13,1,519548.96,18,4,7,4,True
4637411,1132,0,10,5442,542584564,1,0,0,127.03,6,519675.99,24,0,3,5,True
4693951,1342,3,25,8607,542584564,1,0,0,127.13,8,519548.86,24,0,11,5,True
4971925,1467,0,451,9050,542584564,1,0,0,126.91,7,519421.95,11,6,21,6,True
5080174,834,0,25,2004,542584564,1,0,0,127.0,8,519294.95,5,4,4,6,False
5233111,950,0,451,2479,542584564,1,0,0,126.93,7,519168.02,24,5,21,7,True
6338001,811,0,20,5534,542584564,1,0,0,127.21,5,519040.81,18,3,1,8,True
6546312,950,0,-1,2479,542584564,1,1,0,127.01,4,519040.81,24,0,10,9,False
6551861,1342,3,451,2479,542584564,1,0,0,127.08,7,518913.73,24,6,0,10,True
6786961,131,4,25,3562,542584564,1,0,0,127.04,8,518786.69,18,2,10,11,True
6838916,866,0,20,7751,542584564,1,0,0,126.72,3,518659.97,24,3,17,11,True
7079401,525,0,30,8642,542584564,1,0,0,127.13,8,518532.84,18,4,6,1,True
7119982,759,0,10,8607,542584564,1,0,0,126.96,6,518659.8,24,3,12,2,True
7153926,131,4,451,1668,542584564,1,0,0,126.84,7,518532.96,18,1,11,2,True
7284617,950,0,20,8607,542584564,1,0,0,127.23,3,518405.73,24,5,20,3,True
7467447,689,0,10,4095,542584564,1,0,0,126.95,6,518532.68,24,3,3,4,True
7472987,131,4,451,8441,542584564,1,0,0,126.82,7,518405.86,18,2,14,5,True
7511231,785,0,10,5442,542584564,1,0,0,126.88,6,518532.74,14,0,13,6,True
7520545,131,4,30,3131,542584564,1,0,0,126.98,8,518405.76,18,1,15,6,True
7633579,131,4,30,3562,542584564,1,0,0,127.28,8,518278.48,18,2,3,7,True
7690196,834,0,451,1668,542584564,1,0,0,126.93,7,518151.55,5,0,17,7,True
7965874,950,0,451,4126,542584564,1,0,0,127.06,7,518024.49,24,4,3,8,True
8059222,131,4,451,5442,542584564,1,0,0,126.98,7,517897.51,18,1,2,8,False
8410479,97,0,20,8601,542584564,1,0,0,127.02,5,517770.49,3,0,7,9,False
8513338,950,0,25,9050,542584564,1,0,0,127.28,8,517643.21,24,5,15,9,True
8718651,320,1,10,5442,542584564,1,0,0,126.85,6,517770.06,11,4,9,10,True
8756238,131,4,30,5442,542584564,1,0,0,127.27,8,517642.79,18,1,14,10,False
8822224,1363,0,10,2479,542584564,1,0,0,126.91,6,517769.7,16,2,0,10,True
9010000,1282,2,20,9050,542584564,1,0,0,126.98,5,517642.72,24,0,10,10,True
9129635,533,2,20,3965,542584564,1,0,0,127.09,3,517515.63,18,6,3,10,True
9210299,1467,0,25,1826,542584564,1,0,0,126.73,8,517388.9,11,0,5,10,True
1051366,564,0,10,7456,489186876,1,0,0,1032.75,0,508472.75,17,5,17,1,True
1066661,1282,2,451,6756,489186876,1,0,0,1032.92,7,507439.83,24,0,12,1,True
1256761,887,2,30,4628,489186876,1,0,0,1032.75,8,506407.08,27,2,2,2,True
1720176,1485,0,10,4628,489186876,1,0,0,1032.79,6,507439.87,24,6,20,3,True
1778569,887,2,25,1302,489186876,1,0,0,1033.01,8,506406.86,27,5,5,4,True
1834771,1244,4,25,6658,489186876,1,0,0,1032.87,8,505373.99,18,1,22,4,True
2284813,472,4,25,1329,489186876,1,0,0,1033.09,8,504340.9,5,2,7,4,True
2415887,1345,2,451,6658,489186876,1,0,0,1033.07,7,503307.83,24,1,22,5,True
2451646,1345,2,25,6756,489186876,1,0,0,1032.87,8,502274.96,24,3,16,6,True
2675228,1282,2,25,9911,489186876,1,0,0,1032.68,8,501242.28,24,2,17,6,True
2904647,745,4,25,9033,489186876,1,0,0,1033.06,8,500209.22,24,3,9,7,True
2965549,774,2,20,7084,489186876,1,0,0,1032.88,5,499176.34,14,0,5,7,True
3204005,1282,2,25,6658,489186876,1,0,0,1032.96,8,498143.38,24,3,17,9,True
3387517,1282,2,-1,1329,489186876,1,1,0,1032.92,4,498143.38,24,4,18,9,True
3391816,714,2,20,7456,489186876,1,0,0,1033.09,5,497110.29,18,3,4,9,True
3519798,159,2,20,1329,489186876,1,0,0,1032.76,5,496077.53,24,1,15,10,True
3711405,1385,4,25,9033,489186876,1,0,0,1033.02,8,495044.51,24,5,22,12,True
3872010,472,4,30,3472,489186876,1,0,0,1033.31,8,494011.2,5,1,14,12,True
4014252,745,4,30,7750,489186876,1,0,0,1033.06,8,492978.14,24,5,4,1,True
4015053,564,0,20,7084,489186876,1,0,0,1033.03,3,491945.11,17,6,16,1,True
4042909,887,2,25,1329,489186876,1,0,0,1032.77,8,490912.34,27,6,14,1,True
4175978,605,0,20,7750,489186876,1,0,0,1032.87,5,489879.47,24,0,6,1,True
4403726,761,2,20,2109,489186876,1,0,0,1033.0,5,488846.47,24,1,15,1,True
4647353,807,0,20,9911,489186876,1,0,0,1032.97,5,487813.5,11,6,20,3,True
5057955,1385,4,451,2092,489186876,1,0,0,1033.03,7,486780.47,24,0,6,4,True
5260575,745,4,30,3472,489186876,1,0,0,1032.96,8,485747.51,24,4,9,6,True
5351786,745,4,25,1329,489186876,1,0,0,1032.96,8,484714.55,24,0,4,6,True
5481128,887,2,451,1302,489186876,1,0,0,1033.33,7,483681.22,27,2,1,6,True
5582218,820,1,10,7750,489186876,1,0,0,1033.24,0,484714.46,18,4,22,8,True
5917533,1244,4,451,2109,489186876,1,0,0,1033.13,7,483681.33,18,5,19,8,True
5924758,869,2,20,7456,489186876,1,0,0,1032.77,5,482648.56,24,5,2,8,True
6310109,472,4,451,7084,489186876,1,0,0,1032.97,7,481615.59,5,5,2,9,True
6475956,1244,4,451,7084,489186876,1,0,0,1033.21,7,480582.38,18,1,15,9,True
6484931,1244,4,-1,7456,489186876,1,1,0,1032.82,4,480582.38,18,4,10,9,True
6581729,713,0,20,2092,489186876,1,0,0,1032.93,5,479549.45,18,3,10,10,True
6797957,1345,2,30,6658,489186876,1,0,0,1032.77,8,478516.68,24,4,14,10,True
6819941,1385,4,-1,7456,489186876,1,1,0,1033.2,1,478516.68,24,5,5,11,False
6951723,472,4,-1,7750,489186876,1,2,0,1033.21,4,478516.68,5,0,3,11,True
7403556,745,4,25,6756,489186876,1,0,0,1032.77,8,477483.91,24,3,14,11,True
7832425,712,0,10,2109,489186876,1,0,0,1032.8,6,478516.71,18,0,7,12,True
7860209,1244,4,30,3472,489186876,1,0,0,1033.01,8,477483.7,18,3,2,1,True
7888560,811,0,10,7084,489186876,1,0,0,1032.78,6,478516.48,18,5,19,1,True
8014301,1345,2,-1,9033,489186876,1,1,0,1033.2,4,478516.48,24,6,20,2,True
8292792,1345,2,30,8214,489186876,1,0,0,1033.14,8,477483.34,24,1,20,3,True
8524606,887,2,451,8214,489186876,1,0,0,1033.01,7,476450.33,27,5,5,3,True
8601512,64,0,10,2092,489186876,1,0,0,1032.88,6,477483.21,20,4,17,4,False
8735785,1385,4,451,2109,489186876,1,0,0,1033.03,7,476450.18,24,3,9,4,True
8807278,472,4,-1,7750,489186876,1,1,0,1032.88,1,476450.18,5,3,12,5,True
8977271,20,0,10,2109,489186876,1,0,0,1033.25,6,477483.43,24,0,21,5,True
9002660,816,0,10,1302,489186876,1,0,0,1032.96,6,478516.39,18,6,13,8,True
9117374,850,1,10,9033,489186876,1,0,0,1032.96,6,479549.35,5,1,16,9,True
9142747,1282,2,30,2092,489186876,1,0,0,1032.9,8,478516.45,24,1,0,10,True
9311831,1244,4,451,1302,489186876,1,0,0,1032.82,7,477483.63,18,3,15,11,True
1098814,865,0,20,2296,796480505,1,0,0,1195.89,3,177632.11,24,3,23,1,True
1503574,343,1,25,5611,796480505,1,0,0,1196.01,8,176436.1,24,5,1,1,True
1597187,1246,0,20,2781,796480505,1,0,0,1196.0,3,175240.1,23,3,23,2,True
1605231,662,1,25,2791,796480505,1,0,0,1195.88,8,174044.22,18,6,5,3,True
1715817,580,0,451,7870,796480505,1,0,0,1196.14,7,172848.08,11,6,2,4,True
1769154,580,0,25,4491,796480505,1,0,0,1195.88,8,171652.2,11,4,17,4,True
1898474,580,0,451,2296,796480505,1,0,0,1196.1,7,170456.1,11,4,16,5,True
2126513,1421,0,10,5457,796480505,1,0,0,1196.02,6,171652.12,24,6,8,6,True
2405150,1460,2,30,7808,796480505,1,0,0,1195.98,8,170456.14,11,0,19,7,True
2506872,748,1,25,2407,796480505,1,0,0,1196.01,8,169260.13,24,5,0,7,True
2521716,748,1,25,2791,796480505,1,0,0,1195.8,8,168064.33,24,6,16,9,True
2814543,445,0,20,8064,796480505,1,0,0,1196.31,5,166868.02,13,5,22,11,True
2893870,1460,2,25,2791,796480505,1,0,0,1196.13,8,165671.89,11,4,0,11,True
3247778,1460,2,25,6619,796480505,1,0,0,1196.13,8,164475.76,11,3,11,11,True
3320067,365,0,10,4524,796480505,1,0,0,1195.83,0,165671.59,25,1,4,12,True
3571184,799,2,25,7808,796480505,1,0,0,1196.17,8,164475.42,11,2,17,12,True
3635792,1460,2,451,8064,796480505,1,0,0,1196.17,7,163279.25,11,3,19,3,True
3699133,580,0,30,9079,796480505,1,0,0,1195.89,8,162083.36,11,6,5,3,True
3934355,748,1,451,6232,796480505,1,0,0,1196.12,7,160887.24,24,1,20,4,True
4431237,748,1,30,2407,796480505,1,0,0,1196.11,8,159691.13,24,3,6,4,True
4687475,748,1,30,2407,796480505,1,0,0,1195.85,8,158495.28,24,4,1,4,True
4820834,343,1,30,7870,796480505,1,0,0,1196.03,8,157299.25,24,4,0,5,True
4896774,799,2,451,3270,796480505,1,0,0,1195.84,7,156103.41,11,5,3,5,True
4934060,1296,4,25,9079,796480505,1,0,0,1195.98,8,154907.43,5,1,8,5,True
5394415,580,0,30,7870,796480505,1,0,0,1195.95,8,153711.48,11,2,2,6,True
5910597,818,1,10,8515,796480505,1,0,0,1195.88,6,154907.36,18,0,4,7,True
6257737,945,1,10,2296,796480505,1,0,0,1195.96,6,156103.32,24,0,16,7,True
6436849,343,1,25,6467,796480505,1,0,0,1195.86,8,154907.46,24,0,11,8,True
6751307,748,1,25,3279,796480505,1,0,0,1195.82,8,153711.64,24,5,17,8,True
6953291,1012,0,10,6467,796480505,1,0,0,1196.01,6,154907.65,26,6,11,8,True
6994553,580,0,451,7808,796480505,1,0,0,1195.9,7,153711.75,11,0,8,9,True
7271286,1460,2,451,3103,796480505,1,0,0,1195.98,7,152515.77,11,4,23,9,True
7369266,816,0,10,2781,796480505,1,0,0,1196.06,6,153711.83,18,3,20,9,True
7474242,23,0,10,2296,796480505,1,0,0,1196.05,0,154907.88,11,5,1,9,True
7571575,1488,0,20,2407,796480505,1,0,0,1196.11,5,153711.77,24,1,8,10,True
7945200,343,1,-1,3279,796480505,1,1,0,1195.86,4,153711.77,24,2,14,10,True
8206165,580,0,-1,6139,796480505,1,2,0,1195.71,4,153711.77,11,3,1,11,True
8286493,662,1,30,8870,796480505,1,0,0,1196.2,8,152515.57,18,0,10,11,True
8290594,168,0,10,7870,796480505,1,0,0,1195.88,6,153711.45,24,2,7,12,True
8315737,1296,4,30,5457,796480505,1,0,0,1196.17,8,152515.28,5,1,9,12,True
8640717,1460,2,451,4997,796480505,1,0,0,1196.1,7,151319.18,11,3,1,2,True
8696488,799,2,-1,6467,796480505,1,1,0,1196.03,1,151319.18,11,2,23,2,True
8724603,783,0,20,3279,796480505,1,0,0,1195.87,5,150123.31,14,2,2,3,True
8768352,1460,2,451,8238,796480505,1,0,0,1196.12,7,148927.19,11,0,12,3,True
8776707,1460,2,451,8064,796480505,1,0,0,1195.79,7,147731.4,11,5,15,3,True
8896926,799,2,-1,4997,796480505,1,1,0,1196.22,4,147731.4,11,3,7,5,True
9026976,580,0,451,2296,796480505,1,0,0,1196.03,7,146535.37,11,3,1,8,True
9123677,1296,4,25,3103,796480505,1,0,0,1195.96,8,145339.41,5,5,16,8,True
9157105,580,0,-1,2781,796480505,1,1,0,1196.17,4,145339.41,11,4,14,8,True
9264814,1460,2,451,4997,796480505,1,0,0,1195.81,7,144143.6,11,6,13,9,True
9424545,799,2,30,2407,796480505,1,0,0,1195.88,8,142947.72,11,3,3,11,True
9452676,748,1,25,3279,796480505,1,0,0,1195.8,8,141751.92,24,0,21,11,True
1033024,947,2,30,6110,809486661,1,0,0,142.12,8,879223.88,24,5,11,1,True
1161615,498,0,30,1919,809486661,1,0,0,141.98,8,879081.9,12,5,2,4,True
1259179,498,0,30,6629,809486661,1,0,0,142.11,8,878939.79,12,3,23,4,True
1290860,628,0,451,9269,809486661,1,0,0,142.1,7,878797.69,11,5,3,5,True
1364709,947,2,451,6629,809486661,1,0,0,142.0,7,878655.69,24,6,5,6,True
1599765,947,2,25,5966,809486661,1,0,0,142.03,8,878513.66,24,2,18,6,True
1836539,87,3,30,2262,809486661,1,0,0,141.93,8,878371.73,1,3,2,7,True
1859000,820,1,451,2262,809486661,1,0,0,141.96,7,878229.77,18,3,11,7,True
2042187,29,0,10,4716,809486661,1,0,0,142.11,6,878371.88,11,0,1,7,True
2095179,182,1,10,6773,809486661,1,0,0,141.96,0,878513.84,18,2,6,7,True
2186928,798,4,25,4684,809486661,1,0,0,142.01,8,878371.83,11,1,6,8,True
2373884,498,0,451,3031,809486661,1,0,0,141.76,7,878230.07,12,4,4,9,True
2380325,144,1,10,7543,809486661,1,0,0,141.98,6,878372.05,18,6,1,9,True
2471187,1233,0,10,2961,809486661,1,0,0,142.03,6,878514.08,18,0,7,9,True
2494008,87,3,451,2179,809486661,1,0,0,142.2,7,878371.88,1,2,4,11,True
2707158,643,4,30,7043,809486661,1,0,0,141.86,8,878230.02,24,2,22,11,True
2939678,947,2,451,6385,809486661,1,0,0,141.98,7,878088.04,24,4,10,11,True
2998355,947,2,-1,3013,809486661,1,1,0,142.28,1,878088.04,24,2,8,12,True
3283645,87,3,25,9269,809486661,1,0,0,142.1,8,877945.94,1,4,16,12,True
3410302,798,4,451,6877,809486661,1,0,0,142.01,7,877803.93,11,6,16,1,True
3446019,798,4,451,7043,809486661,1,0,0,142.15,7,877661.78,11,5,13,2,True
3660015,889,0,20,4684,809486661,1,0,0,141.99,5,877519.79,27,5,21,3,True
3708577,907,0,10,5280,809486661,1,0,0,141.9,0,877661.69,2,0,1,3,True
3738468,643,4,451,6385,809486661,1,0,0,142.22,7,877519.47,24,4,22,3,True
3837868,643,4,451,5056,809486661,1,0,0,142.15,7,877377.32,24,0,17,4,True
4122972,87,3,30,4716,809486661,1,0,0,141.74,8,877235.58,1,3,7,4,True
4184143,798,4,-1,9802,809486661,1,1,0,142.18,4,877235.58,11,3,5,4,True
4475596,798,4,25,6773,809486661,1,0,0,142.28,8,877093.3,11,0,22,5,True
4544394,372,0,20,6629,809486661,1,0,0,142.16,5,876951.14,25,4,9,6,True
4929926,208,0,20,7499,809486661,1,0,0,142.13,5,876809.01,9,2,17,6,True
4995794,415,4,25,6877,809486661,1,0,0,142.01,8,876667.0,18,5,9,8,True
5240589,1411,0,10,6773,809486661,1,0,0,142.18,6,876809.18,24,0,17,8,True
5326168,664,2,20,5966,809486661,1,0,0,142.26,5,876666.92,18,4,13,9,True
5803599,415,4,25,7257,809486661,1,0,0,141.96,8,876524.96,18,5,16,9,True
6113217,467,0,20,1994,809486661,1,0,0,141.89,5,876383.07,5,1,11,9,True
6206356,643,4,451,4296,809486661,1,0,0,141.68,7,876241.39,24,3,16,11,True
6383512,798,4,25,4296,809486661,1,0,0,142.15,8,876099.24,11,5,0,11,True
6539605,415,4,30,9269,809486661,1,0,0,141.84,8,875957.4,18,1,14,12,True
6721034,798,4,451,4684,809486661,1,0,0,141.84,7,875815.56,11,1,6,1,True
6926154,628,0,-1,7548,809486661,1,1,0,141.75,4,875815.56,11,0,23,1,True
7612675,1029,0,20,8008,809486661,1,0,0,142.15,5,875673.41,11,1,7,1,True
8041646,303,0,10,2583,809486661,1,0,0,141.94,6,875815.35,4,1,6,2,True
8075431,798,4,30,8570,809486661,1,0,0,142.01,8,875673.34,11,4,5,4,True
8164555,628,0,25,8008,809486661,1,0,0,141.9,8,875531.44,11,2,20,5,True
8433578,87,3,-1,9802,809486661,1,1,0,142.17,4,875531.44,1,3,16,5,True
8841287,87,3,451,7043,809486661,1,0,0,141.93,7,875389.51,1,0,8,5,True
8936671,498,0,451,4684,809486661,1,0,0,141.82,7,875247.69,12,2,4,6,True
9226451,798,4,451,8570,809486661,1,0,0,142.0,7,875105.69,11,0,9,6,True
9364195,87,3,451,2179,809486661,1,0,0,141.69,7,874964.0,1,4,2,6,True
9392107,798,4,30,5280,809486661,1,0,0,141.89,8,874822.11,11,4,13,6,True
9671510,297,0,20,7499,809486661,1,0,0,142.12,3,874679.99,4,2,21,9,True
9933467,318,0,10,2961,809486661,1,0,0,142.03,6,874822.02,11,4,11,9,True
1006743,379,4,30,5025,458865581,0,0,0,459.93,8,803286.07,25,2,12,2,True
1251552,485,1,451,5720,458865581,0,0,0,460.32,7,802825.75,5,5,13,2,True
1338579,35,2,-1,3108,458865581,0,1,0,460.29,4,802825.75,11,4,0,2,True
1373104,337,1,10,5025,458865581,0,0,0,460.01,6,803285.76,11,3,14,3,True
1407513,294,3,-1,1592,458865581,0,1,0,460.08,4,803285.76,4,1,3,3,True
1420511,972,3,25,3265,458865581,0,0,0,459.68,8,802826.08,13,1,12,4,True
1486289,399,2,20,6588,458865581,0,0,0,459.98,5,802366.1,10,6,20,4,True
1504571,972,3,25,1592,458865581,0,0,0,459.9,8,801906.2,13,3,10,5,True
1542163,972,3,25,1592,458865581,0,0,0,460.21,8,801445.99,13,0,3,5,True
1891384,485,1,30,3265,458865581,0,0,0,460.06,8,800985.93,5,2,4,5,True
2005720,687,0,20,2863,458865581,0,0,0,459.79,5,800526.14,24,2,3,5,True
2039769,35,2,451,2590,458865581,0,0,0,460.08,7,800066.06,11,6,14,6,True
2054821,1256,2,25,7858,458865581,0,0,0,460.14,8,799605.92,23,5,5,6,True
2306920,294,3,451,3364,458865581,0,0,0,460.07,7,799145.85,4,6,17,6,True
2494887,379,4,451,5720,458865581,0,0,0,459.91,7,798685.94,25,1,0,7,True
2811009,485,1,25,4478,458865581,0,0,0,459.99,8,798225.95,5,2,2,7,True
2879499,1256,2,451,2863,458865581,0,0,0,459.76,7,797766.19,23,6,18,8,True
3121360,309,0,20,3265,458865581,0,0,0,459.93,5,797306.26,4,3,22,8,True
3351509,1095,4,30,3265,458865581,0,0,0,460.1,8,796846.16,0,6,3,10,True
3522925,972,3,-1,5025,458865581,0,1,0,459.93,4,796846.16,13,1,2,10,True
3968844,485,1,30,6588,458865581,0,0,0,459.95,8,796386.21,5,5,15,10,True
4067585,294,3,25,5025,458865581,0,0,0,460.1,8,795926.11,4,4,8,10,True
4307465,1095,4,451,5025,458865581,0,0,0,459.87,7,795466.24,0,2,13,11,True
4556966,1256,2,30,2863,458865581,0,0,0,460.04,8,795006.2,23,0,20,11,True
4729561,35,2,25,3265,458865581,0,0,0,460.14,8,794546.06,11,2,3,12,True
4933324,1095,4,25,5025,458865581,0,0,0,459.9,8,794086.16,0,1,20,12,True
4962675,972,3,-1,3265,458865581,0,1,0,460.09,4,794086.16,13,4,22,1,True
5256246,35,2,25,3108,458865581,0,0,0,459.98,8,793626.18,11,6,17,2,True
5339992,294,3,30,3265,458865581,0,0,0,460.14,8,793166.04,4,6,20,2,True
5541442,670,0,10,9441,458865581,0,0,0,459.89,0,793625.93,18,2,19,4,True
6047398,1007,2,20,9441,458865581,0,0,0,460.07,3,793165.86,26,0,6,4,True
6154527,35,2,25,5720,458865581,0,0,0,460.08,8,792705.78,11,0,4,4,True
6224459,1425,0,10,4478,458865581,0,0,0,459.92,6,793165.7,24,2,8,4,True
6460755,485,1,-1,7858,458865581,0,1,0,459.9,1,793165.7,5,6,18,6,True
6594829,1095,4,25,5079,458865581,0,0,0,459.92,8,792705.78,0,2,5,8,True
6745489,35,2,30,2590,458865581,0,0,0,460.16,8,792245.62,11,5,14,8,True
6794095,1116,0,10,3108,458865581,0,0,0,460.15,6,792705.77,24,4,15,9,True
6823258,485,1,-1,7655,458865581,0,1,0,459.76,4,792705.77,5,0,1,10,True
6902259,379,4,25,5025,458865581,0,0,0,459.88,8,792245.89,25,3,20,11,True
7069130,735,1,10,9734,458865581,0,0,0,459.87,0,792705.76,11,2,4,12,True
7181608,485,1,25,2590,458865581,0,0,0,459.78,8,792245.98,5,6,14,1,True
7528742,726,0,20,3364,458865581,0,0,0,459.68,5,791786.3,11,6,4,2,True
7811598,294,3,30,2590,458865581,0,0,0,460.08,8,791326.22,4,1,18,2,True
7895109,485,1,30,3265,458865581,0,0,0,460.18,8,790866.04,5,4,10,3,True
7960424,972,3,451,7858,458865581,0,0,0,459.83,7,790406.21,13,6,4,5,True
7997804,294,3,-1,1592,458865581,0,1,0,460.12,1,790406.21,4,0,11,6,True
8011088,198,0,10,5720,458865581,0,0,0,459.75,6,790865.96,18,1,3,6,True
8227411,1467,0,10,3364,458865581,0,0,0,460.2,0,791326.16,11,4,9,6,True
8275475,1095,4,-1,5079,458865581,0,1,0,459.94,4,791326.16,0,4,0,6,True
8572962,524,1,10,7858,458865581,0,0,0,460.05,6,791786.21,18,6,14,7,True
8940309,848,2,20,9276,458865581,0,0,0,459.85,5,791326.36,5,3,5,7,True
9348917,577,0,10,5720,458865581,0,0,0,460.31,6,791786.67,11,5,19,7,True
9359443,550,0,20,3364,458865581,0,0,0,459.99,3,791326.68,17,2,10,8,False
9637426,485,1,451,1592,458865581,0,0,0,460.14,7,790866.54,5,2,3,9,True
9642867,193,1,10,1592,458865581,0,0,0,460.13,6,791326.67,18,5,16,9,True
1406149,260,0,451,6998,276209607,0,0,0,319.78,7,150419.22,6,2,13,2,True
1519286,504,4,451,4781,276209607,0,0,0,320.02,7,150099.2,12,4,13,2,False
1966383,454,1,10,9673,276209607,0,0,0,320.05,6,150419.25,13,2,9,3,True
2170878,398,0,20,9352,276209607,0,0,0,320.29,5,150098.96,10,1,0,5,True
2435200,1208,4,30,4528,276209607,0,0,0,319.88,8,149779.08,24,6,13,5,True
2692394,504,4,451,5672,276209607,0,0,0,320.26,7,149458.82,12,0,9,5,True
2854650,504,4,25,1891,276209607,0,0,0,319.83,8,149138.99,12,0,17,6,True
2985167,1289,1,10,1891,276209607,0,0,0,320.26,6,149459.25,24,5,17,7,True
3522447,504,4,451,5672,276209607,0,0,0,319.84,7,149139.41,12,6,16,7,True
3644172,504,4,451,4411,276209607,0,0,0,319.94,7,148819.47,12,6,6,8,True
3766433,723,1,-1,2298,276209607,0,1,0,319.89,4,148819.47,11,1,11,8,True
3880467,409,4,451,6017,276209607,0,0,0,319.94,7,148499.53,10,1,12,9,True
4044134,1208,4,451,4048,276209607,0,0,0,320.1,7,148179.43,24,6,19,10,True
4899256,1347,4,25,5009,276209607,0,0,0,319.87,8,147859.56,24,0,19,11,True
5074308,1044,0,10,3043,276209607,0,0,0,319.6,0,148179.16,11,2,8,11,True
5225803,260,0,451,5442,276209607,0,0,0,319.97,7,147859.19,6,5,23,12,True
5400526,346,0,20,1088,276209607,0,0,0,320.04,5,147539.15,24,2,12,12,True
5580763,260,0,30,3043,276209607,0,0,0,320.02,8,147219.13,6,1,18,1,True
5794514,504,4,451,1891,276209607,0,0,0,320.02,7,146899.11,12,6,22,2,True
5987194,98,0,10,5387,276209607,0,0,0,319.83,0,147218.94,3,1,14,3,True
6179606,409,4,25,4781,276209607,0,0,0,320.05,8,146898.89,10,3,19,4,True
6199530,723,1,-1,5888,276209607,0,1,0,320.03,4,146898.89,11,0,17,4,True
6226848,504,4,451,1891,276209607,0,0,0,320.27,7,146578.62,12,5,23,4,True
6422698,409,4,25,9470,276209607,0,0,0,320.03,8,146258.59,10,2,23,5,True
6534433,591,0,20,8866,276209607,0,0,0,320.04,5,145938.55,24,3,20,5,True
6657971,865,0,10,5974,276209607,0,0,0,319.96,6,146258.51,24,2,21,5,True
6717932,909,2,451,5523,276209607,0,0,0,320.12,7,145938.39,18,5,23,6,True
6881131,409,4,30,7391,276209607,0,0,0,320.17,8,145618.22,10,0,1,7,True
6958780,504,4,25,6017,276209607,0,0,0,320.04,8,145298.18,12,3,2,7,True
7231327,909,2,30,5817,276209607,0,0,0,320.05,8,144978.13,18,2,17,8,True
7298069,1421,0,10,9470,276209607,0,0,0,319.89,6,145298.02,24,5,18,9,True
7359422,504,4,451,4048,276209607,0,0,0,319.89,7,144978.13,12,0,7,9,True
7366762,300,0,10,4528,276209607,0,0,0,319.87,6,145298.0,4,4,13,9,True
7492568,409,4,451,5442,276209607,0,0,0,319.84,7,144978.16,10,3,17,10,True
7831792,260,0,25,1088,276209607,0,0,0,319.95,8,144658.21,6,2,2,12,True
7918266,409,4,25,4411,276209607,0,0,0,320.06,8,144338.15,10,1,8,2,True
7950367,114,0,10,4781,276209607,0,0,0,320.29,6,144658.44,3,0,15,3,True
7987916,1467,0,20,6998,276209607,0,0,0,319.87,3,144338.57,11,1,23,3,True
8114091,260,0,-1,5387,276209607,0,1,0,319.9,4,144338.57,6,3,3,3,True
8290578,409,4,451,5888,276209607,0,0,0,319.97,7,144018.6,10,6,14,3,True
8354353,1347,4,451,5442,276209607,0,0,0,320.03,7,143698.57,24,6,21,4,True
8385957,947,2,20,9470,276209607,0,0,0,319.72,5,143378.85,24,4,15,5,True
8678169,564,0,10,7391,276209607,0,0,0,320.13,6,143698.98,17,3,22,7,True
8937465,1208,4,30,9352,276209607,0,0,0,319.95,8,143379.03,24,6,12,7,True
8970599,1208,4,-1,3591,276209607,0,1,0,320.04,4,143379.03,24,5,23,8,True
9000824,260,0,30,5817,276209607,0,0,0,319.76,8,143059.27,6,4,4,9,True
9071962,1208,4,30,4089,276209607,0,0,0,320.08,8,142739.19,24,1,12,9,False
9081822,260,0,30,5974,276209607,0,0,0,319.98,8,142419.21,6,5,10,9,True
9330046,1208,4,-1,8524,276209607,0,1,0,319.91,1,142419.21,24,1,12,10,True
9361463,504,4,-1,8524,276209607,0,2,0,320.11,4,142419.21,12,6,16,10,True
9372595,909,2,-1,4089,276209607,0,3,1,319.82,1,0.0,18,5,2,11,True
1079797,632,4,-1,7380,402035928,0,1,0,234.04,1,920848.0,11,5,2,1,True
1211346,865,0,10,7155,402035928,0,0,0,233.87,6,921081.87,24,0,20,2,True
1484583,1092,1,-1,7218,402035928,0,1,0,234.07,4,921081.87,18,5,10,3,True
1490429,410,4,30,4511,402035928,0,0,0,233.83,8,920848.04,18,1,12,4,True
1676584,410,4,30,4365,402035928,0,0,0,234.13,8,920613.91,18,3,6,4,True
1726306,269,0,10,3628,402035928,0,0,0,233.98,6,920847.89,24,0,1,4,True
1730881,1272,0,20,2353,402035928,0,0,0,234.1,3,920613.79,24,1,11,5,True
1739535,441,4,30,5891,402035928,0,0,0,234.09,8,920379.7,24,2,2,6,True
1809725,632,4,30,1731,402035928,0,0,0,233.99,8,920145.71,11,3,4,6,True
1901884,632,4,30,8826,402035928,0,0,0,233.77,8,919911.94,11,5,1,6,True
2380457,328,0,10,3123,402035928,0,0,0,233.79,6,920145.73,11,5,5,6,True
2463599,780,0,30,6580,402035928,0,0,0,234.03,8,919911.7,14,6,18,7,True
2681117,398,0,20,1731,402035928,0,0,0,233.99,5,919677.71,10,0,6,7,True
2918109,155,1,10,4511,402035928,0,0,0,233.69,0,919911.4,18,5,2,7,True
3187183,410,4,30,6580,402035928,0,0,0,234.07,8,919677.33,18,6,17,7,True
3593103,780,0,25,2353,402035928,0,0,0,233.93,8,919443.4,14,1,10,7,True
3657436,1401,1,10,5891,402035928,0,0,0,234.19,6,919677.59,24,0,17,8,True
4886314,1488,0,20,3086,402035928,0,0,0,234.1,5,919443.49,24,2,20,8,True
4889453,410,4,30,8790,402035928,0,0,0,233.93,8,919209.56,18,2,16,9,True
5277745,965,4,-1,5225,402035928,0,1,0,234.06,4,919209.56,13,0,3,10,True
5282317,632,4,451,8934,402035928,0,0,0,234.06,7,918975.5,11,5,23,10,True
5448039,1092,1,-1,1068,402035928,0,1,0,233.96,1,918975.5,18,6,18,12,True
5452777,807,0,20,3528,402035928,0,0,0,233.86,3,918741.64,11,2,2,12,True
5652716,1072,0,-1,6342,402035928,0,1,0,233.93,1,918741.64,18,0,4,2,True
5793817,304,0,10,4689,402035928,0,0,0,234.14,6,918975.78,4,5,11,3,True
6005172,441,4,25,3922,402035928,0,0,0,234.04,8,918741.74,24,2,10,3,True
6139333,558,0,20,4689,402035928,0,0,0,234.23,5,918507.51,17,5,19,4,True
6275200,965,4,451,5225,402035928,0,0,0,234.06,7,918273.45,13,0,3,4,True
6536234,410,4,-1,7155,402035928,0,1,0,234.01,1,918273.45,18,2,23,5,True
6591935,1092,1,30,5891,402035928,0,0,0,234.0,8,918039.45,18,5,15,5,True
6749842,378,0,10,2178,402035928,0,0,0,233.77,6,918273.22,25,6,17,6,True
6835629,1449,0,20,3922,402035928,0,0,0,233.79,5,918039.43,11,4,13,10,True
7107280,441,4,451,1068,402035928,0,0,0,234.16,7,917805.27,24,5,4,11,True
7336449,780,0,451,3628,402035928,0,0,0,233.93,7,917571.34,14,6,14,11,True
7440414,757,0,20,5225,402035928,0,0,0,234.09,5,917337.25,24,1,12,11,True
7562174,780,0,451,5437,402035928,0,0,0,233.92,7,917103.33,14,2,4,12,True
7578145,137,2,20,3628,402035928,0,0,0,234.17,5,916869.16,18,4,19,1,True
7666718,1212,0,10,6342,402035928,0,0,0,233.96,6,917103.12,24,2,3,1,True
7921265,1250,1,10,4365,402035928,0,0,0,233.98,0,917337.1,23,2,14,1,True
8030728,844,1,10,7155,402035928,0,0,0,233.95,0,917571.05,5,2,0,1,True
8106804,632,4,-1,4365,402035928,0,1,0,234.26,4,917571.05,11,2,16,1,True
8454215,965,4,451,7380,402035928,0,0,0,234.33,7,917336.72,13,6,19,2,True
8605723,1072,0,451,8934,402035928,0,0,0,234.12,7,917102.6,18,0,8,2,True
8662665,632,4,25,3086,402035928,0,0,0,234.26,8,916868.34,11,0,8,3,True
8693837,441,4,30,3628,402035928,0,0,0,234.06,8,916634.28,24,0,2,4,True
8710148,965,4,25,2353,402035928,0,0,0,233.92,8,916400.36,13,2,9,5,True
8912737,1072,0,30,1821,402035928,0,0,0,234.08,8,916166.28,18,5,13,5,True
8938355,780,0,-1,2353,402035928,0,1,0,233.94,4,916166.28,14,1,10,6,True
9172217,218,0,20,1821,402035928,0,0,0,234.1,5,915932.18,9,3,12,8,False
9384517,1454,1,10,8790,402035928,0,0,0,233.98,6,916166.16,11,0,23,9,True
9497750,21,0,20,1812,402035928,0,0,0,233.91,5,915932.25,11,0,21,9,True
9507736,1072,0,30,8790,402035928,0,0,0,234.07,8,915698.18,18,1,14,10,True
9562488,726,0,20,2353,402035928,0,0,0,234.23,3,915463.95,11,0,23,10,True
9611211,410,4,30,3628,402035928,0,0,0,233.98,8,915229.97,18,0,13,11,True
9637220,632,4,-1,7435,402035928,0,1,0,234.1,4,915229.97,11,2,4,11,True
9747652,1065,0,10,1812,402035928,0,0,0,234.0,6,915463.97,11,6,10,11,True
9918866,441,4,-1,8826,402035928,0,1,0,234.01,4,915463.97,24,1,7,11,True
1165114,871,0,-1,1571,881872889,0,1,0,424.07,4,631745.0,24,1,12,4,True
1207438,392,4,30,6830,881872889,0,0,0,424.24,8,631320.76,10,5,19,4,True
1237809,1116,0,451,1571,881872889,0,0,0,424.12,7,630896.64,24,0,5,5,True
1245606,1110,0,-1,5468,881872889,0,1,0,424.17,4,630896.64,0,0,12,5,True
1335146,1110,0,-1,3550,881872889,0,2,0,424.16,1,630896.64,0,2,9,5,True
1382818,871,0,30,1571,881872889,0,0,0,423.92,8,630472.72,24,4,1,6,True
1386269,812,0,10,9192,881872889,0,0,0,423.92,6,630896.64,18,3,8,6,True
1460182,1110,0,30,8626,881872889,0,0,0,424.12,8,630472.52,0,1,7,6,True
1510474,787,0,25,5706,881872889,0,0,0,424.02,8,630048.5,14,2,7,8,True
1549887,871,0,451,7397,881872889,0,0,0,423.91,7,629624.59,24,4,6,8,True
1866386,1110,0,30,9788,881872889,0,0,0,423.9,8,629200.69,0,0,4,9,True
1876401,787,0,451,5468,881872889,0,0,0,423.99,7,628776.7,14,2,23,9,True
1943886,392,4,-1,5356,881872889,0,1,0,423.97,4,628776.7,10,3,11,10,True
2014413,1152,0,20,5356,881872889,0,0,0,423.96,5,628352.74,15,2,21,10,True
2237810,392,4,451,2127,881872889,0,0,0,424.16,7,627928.58,10,1,14,11,True
2377264,392,4,30,4518,881872889,0,0,0,424.13,8,627504.45,10,3,1,11,True
2482539,871,0,30,8182,881872889,0,0,0,423.79,8,627080.66,24,0,22,11,True
2554696,1110,0,30,8182,881872889,0,0,0,423.72,8,626656.94,0,6,9,12,True
2707597,787,0,30,8182,881872889,0,0,0,424.12,8,626232.82,14,4,10,1,True
2909147,1116,0,-1,9046,881872889,0,1,0,423.93,4,626232.82,24,0,17,1,True
2956234,787,0,30,3550,881872889,0,0,0,424.16,8,625808.66,14,5,7,2,True
3290835,1179,0,20,6599,881872889,0,0,0,424.03,5,625384.63,24,6,11,2,True
3394580,1110,0,-1,7580,881872889,0,1,0,424.2,4,625384.63,0,2,20,2,True
3555325,1110,0,25,8990,881872889,0,0,0,424.24,8,624960.39,0,1,3,3,True
4279543,787,0,-1,5468,881872889,0,1,0,423.96,4,624960.39,14,5,9,3,True
4497491,1116,0,30,5706,881872889,0,0,0,424.0,8,624536.39,24,3,17,5,True
4621459,392,4,451,8626,881872889,0,0,0,424.14,7,624112.25,10,0,5,5,True
4886935,1110,0,-1,7397,881872889,0,1,0,424.0,4,624112.25,0,2,15,5,True
4958307,787,0,-1,8182,881872889,0,2,0,423.99,4,624112.25,14,3,11,6,True
5050597,1110,0,451,4518,881872889,0,0,0,424.07,7,623688.18,0,3,14,6,True
5380268,1110,0,451,4127,881872889,0,0,0,424.22,7,623263.96,0,1,8,7,True
5729517,1116,0,25,1571,881872889,0,0,0,423.99,8,622839.97,24,1,7,7,True
6344508,392,4,451,4518,881872889,0,0,0,424.03,7,622415.94,10,3,13,8,True
6955573,610,0,10,4650,881872889,0,0,0,424.1,0,622840.04,11,1,5,9,True
7240914,564,0,10,4650,881872889,0,0,0,424.04,0,623264.08,17,2,2,9,False
7461155,787,0,-1,3550,881872889,0,1,0,424.5,4,623264.08,14,1,9,10,True
7491396,1110,0,25,2127,881872889,0,0,0,424.16,8,622839.92,0,3,5,11,True
7508976,787,0,30,4127,881872889,0,0,0,423.84,8,622416.08,14,4,8,11,True
7597296,1110,0,30,4127,881872889,0,0,0,424.04,8,621992.04,0,5,12,11,True
7737302,1110,0,25,8990,881872889,0,0,0,424.37,8,621567.67,0,3,2,11,True
7952928,1116,0,-1,2127,881872889,0,1,0,423.96,4,621567.67,24,1,19,12,True
7954206,787,0,451,9476,881872889,0,0,0,424.21,7,621143.46,14,2,21,12,True
7970771,787,0,25,7397,881872889,0,0,0,424.08,8,620719.38,14,3,6,1,True
7997364,787,0,25,3550,881872889,0,0,0,424.33,8,620295.05,14,2,9,1,True
8112277,871,0,-1,9192,881872889,0,1,0,424.2,1,620295.05,24,1,9,2,True
8451307,392,4,451,1651,881872889,0,0,0,423.98,7,619871.07,10,2,4,2,True
8484775,1116,0,-1,5468,881872889,0,1,0,423.92,4,619871.07,24,5,17,2,True
8618490,871,0,25,7580,881872889,0,0,0,424.1,8,619446.97,24,0,17,4,True
8655981,445,0,20,4127,881872889,0,0,0,423.86,5,619023.11,13,4,19,5,True
8847875,1116,0,-1,5356,881872889,0,1,0,423.99,4,619023.11,24,3,21,5,True
8918179,787,0,25,5706,881872889,0,0,0,424.06,8,618599.05,14,1,12,5,True
9251512,1116,0,-1,9876,881872889,0,1,0,424.12,4,618599.05,24,3,3,5,True
9254673,871,0,25,4650,881872889,0,0,0,424.08,8,618174.97,24,6,8,7,True
9377791,392,4,30,7580,881872889,0,0,0,423.99,8,617750.98,10,2,12,8,False
9380190,787,0,451,3550,881872889,0,0,0,423.99,7,617326.99,14,1,3,10,True
1208657,1428,1,25,2725,248434269,0,0,0,192.9,8,91497.1,24,6,2,1,False
1219883,996,0,451,3491,248434269,0,0,0,193.15,7,91303.95,26,1,13,1,False
1528316,996,0,25,5221,248434269,0,0,0,193.22,8,91110.73,26,0,18,2,True
1795359,184,0,451,3491,248434269,0,0,0,193.11,7,90917.62,18,1,12,3,True
1830086,1019,0,20,1956,248434269,0,0,0,193.05,3,90724.57,26,1,21,3,True
1883175,940,1,10,5221,248434269,0,0,0,192.79,6,90917.36,24,2,13,3,True
1934845,767,0,30,5757,248434269,0,0,0,192.96,8,90724.4,14,5,10,3,True
2020633,1428,1,30,3491,248434269,0,0,0,193.08,8,90531.32,24,0,2,3,True
2026194,767,0,25,8949,248434269,0,0,0,193.05,8,90338.27,14,0,6,4,True
2030146,1428,1,451,2625,248434269,0,0,0,192.92,7,90145.35,24,0,11,5,True
2045115,334,0,10,3633,248434269,0,0,0,193.04,6,90338.39,11,2,5,5,True
2065222,1025,1,451,6355,248434269,0,0,0,193.02,7,90145.37,11,2,6,6,True
2344241,1209,4,25,5757,248434269,0,0,0,192.91,8,89952.46,24,6,3,7,True
2379068,1025,1,451,6355,248434269,0,0,0,193.12,7,89759.34,11,3,2,9,True
2499339,184,0,451,1956,248434269,0,0,0,192.96,7,89566.38,18,2,21,10,True
2513988,509,0,10,9058,248434269,0,0,0,192.81,6,89759.19,12,0,2,10,True
2554835,1209,4,451,3633,248434269,0,0,0,193.14,7,89566.05,24,6,0,11,True
2612110,1428,1,-1,4355,248434269,0,1,0,192.88,1,89566.05,24,6,16,11,True
2900268,1428,1,-1,4355,248434269,0,2,0,192.95,4,89566.05,24,0,17,11,True
3254025,811,0,10,4873,248434269,0,0,0,192.94,6,89758.99,18,2,4,11,True
3299522,1428,1,25,5221,248434269,0,0,0,192.9,8,89566.09,24,4,1,12,True
3436472,1209,4,451,6355,248434269,0,0,0,192.84,7,89373.25,24,1,21,12,True
3690167,312,0,20,1503,248434269,0,0,0,193.13,5,89180.12,4,4,19,3,True
4038143,642,0,10,6372,248434269,0,0,0,193.33,0,89373.45,24,3,19,3,True
4255292,1428,1,25,6355,248434269,0,0,0,192.87,8,89180.58,24,3,18,3,True
4569030,767,0,25,2991,248434269,0,0,0,192.93,8,88987.65,14,5,9,4,True
4571227,1428,1,25,2991,248434269,0,0,0,193.1,8,88794.55,24,5,6,5,True
4726749,1428,1,25,5757,248434269,0,0,0,192.97,8,88601.58,24,0,11,6,True
4979650,767,0,-1,6372,248434269,0,1,0,192.83,4,88601.58,14,0,12,6,True
5067015,184,0,25,3633,248434269,0,0,0,192.78,8,88408.8,18,5,0,7,True
5199931,767,0,-1,5214,248434269,0,1,0,193.15,1,88408.8,14,2,10,7,True
5231149,184,0,-1,5221,248434269,0,2,0,192.83,4,88408.8,18,5,10,7,True
5462554,1025,1,30,7466,248434269,0,0,0,192.88,8,88215.92,11,3,3,8,True
5591924,1195,1,10,6838,248434269,0,0,0,193.15,6,88409.07,24,0,20,8,True
5810343,184,0,451,9476,248434269,0,0,0,193.01,7,88216.06,18,0,0,10,True
6248841,394,0,20,5214,248434269,0,0,0,192.99,5,88023.07,10,6,3,10,True
6311304,1425,0,20,2991,248434269,0,0,0,192.85,5,87830.22,24,6,7,11,True
6338153,627,0,20,9476,248434269,0,0,0,192.95,5,87637.27,11,0,0,11,True
6477289,184,0,30,5757,248434269,0,0,0,193.17,8,87444.1,18,5,23,11,True
6687434,218,0,20,5793,248434269,0,0,0,193.18,5,87250.92,9,3,11,11,True
6839738,1382,0,20,8949,248434269,0,0,0,193.11,5,87057.81,16,1,3,1,True
7071177,1428,1,-1,2625,248434269,0,1,0,193.04,1,87057.81,24,1,12,1,True
7080492,1093,0,10,6355,248434269,0,0,0,193.01,6,87250.82,18,1,4,1,False
7219754,1428,1,30,6838,248434269,0,0,0,193.13,8,87057.69,24,5,12,2,True
7306926,996,0,30,9058,248434269,0,0,0,192.88,8,86864.81,26,2,17,2,False
7325389,1209,4,30,6748,248434269,0,0,0,193.1,8,86671.71,24,4,12,3,True
7619340,1025,1,451,5757,248434269,0,0,0,192.84,7,86478.87,11,2,17,3,True
7665350,1209,4,30,6838,248434269,0,0,0,193.04,8,86285.83,24,6,9,3,True
7992516,184,0,451,6838,248434269,0,0,0,193.17,7,86092.66,18,2,2,3,True
8027738,1210,0,10,7084,248434269,0,0,0,192.87,6,86285.53,24,4,13,3,True
8114358,767,0,451,4363,248434269,0,0,0,192.89,7,86092.64,14,3,7,4,True
8357775,767,0,-1,1503,248434269,0,1,0,192.83,4,86092.64,14,3,7,7,True
8492772,560,2,20,7084,248434269,0,0,0,193.0,5,85899.64,17,2,14,8,True
8564867,1019,0,10,1503,248434269,0,0,0,193.04,6,86092.68,26,0,15,9,True
8696107,184,0,451,5413,248434269,0,0,0,193.07,7,85899.61,18,0,16,9,True
9280057,1428,1,-1,4363,248434269,0,1,0,192.97,1,85899.61,24,5,17,9,True
9613411,767,0,451,5757,248434269,0,0,0,192.9,7,85706.71,14,0,9,9,True
9625585,1359,2,20,9255,248434269,0,0,0,193.14,5,85513.57,24,6,7,10,True
9627540,996,0,-1,5221,248434269,0,1,0,193.16,4,85513.57,26,0,16,10,True
1355504,716,0,451,1759,390520369,0,0,0,984.92,7,85250.08,18,4,15,1,True
1641945,965,4,451,4835,390520369,0,0,0,984.93,7,84265.15,13,0,8,2,False
1669749,965,4,451,1522,390520369,0,0,0,985.16,7,83279.99,13,5,4,3,True
1714352,1124,0,30,4050,390520369,0,0,0,984.98,8,82295.01,24,4,20,3,False
1828547,1124,0,451,1579,390520369,0,0,0,984.98,7,81310.03,24,4,12,4,True
2169214,1124,0,-1,6425,390520369,0,1,0,984.81,4,81310.03,24,2,5,5,True
2404006,1328,4,30,6425,390520369,0,0,0,985.07,8,80324.96,18,4,6,5,True
2453103,965,4,-1,7611,390520369,0,1,0,985.23,4,80324.96,13,3,8,5,True
2679022,1118,4,451,4269,390520369,0,0,0,985.02,7,79339.94,24,0,12,5,True
2759445,1118,4,451,1579,390520369,0,0,0,984.98,7,78354.96,24,2,20,7,True
2844292,1118,4,451,1794,390520369,0,0,0,985.24,7,77369.72,24,6,14,7,True
2973435,965,4,25,1759,390520369,0,0,0,985.04,8,76384.68,13,1,1,8,True
3104063,965,4,-1,7611,390520369,0,1,0,985.21,4,76384.68,13,1,16,8,True
3135160,1124,0,30,6552,390520369,0,0,0,985.06,8,75399.62,24,3,8,9,True
3193285,238,0,20,7428,390520369,0,0,0,984.95,3,74414.67,26,4,7,11,True
3531689,965,4,-1,6700,390520369,0,1,0,985.08,4,74414.67,13,3,4,12,True
3549353,965,4,25,1012,390520369,0,0,0,985.18,8,73429.49,13,6,14,12,True
3592151,965,4,30,1850,390520369,0,0,0,985.22,8,72444.27,13,3,1,12,True
3624252,716,0,25,7611,390520369,0,0,0,984.86,8,71459.41,18,3,10,12,True
3847478,716,0,451,6552,390520369,0,0,0,984.84,7,70474.57,18,4,4,12,True
4060654,1264,0,20,4835,390520369,0,0,0,985.02,3,69489.55,23,4,6,12,True
4705788,1124,0,451,7557,390520369,0,0,0,984.96,7,68504.59,24,0,19,12,True
5074955,1328,4,25,5941,390520369,0,0,0,985.02,8,67519.57,18,5,21,12,True
5108043,962,0,20,5941,390520369,0,0,0,984.78,3,66534.79,13,0,5,2,True
5150032,1118,4,25,6425,390520369,0,0,0,985.05,8,65549.74,24,4,17,3,False
5172053,1124,0,30,7428,390520369,0,0,0,985.0,8,64564.74,24,0,10,4,True
5184870,1118,4,451,4659,390520369,0,0,0,985.12,7,63579.62,24,1,14,4,True
5413174,1124,0,30,4269,390520369,0,0,0,984.94,8,62594.68,24,1,18,4,False
5422221,1111,0,10,1012,390520369,0,0,0,984.88,6,63579.56,0,4,9,6,True
5469790,858,1,10,1883,390520369,0,0,0,984.99,6,64564.55,24,0,0,7,True
5492729,1328,4,25,7806,390520369,0,0,0,985.19,8,63579.36,18,2,7,7,True
5905691,1328,4,25,1883,390520369,0,0,0,985.03,8,62594.33,18,2,20,9,True
6175490,965,4,451,9706,390520369,0,0,0,985.07,7,61609.26,13,5,4,10,True
6247784,716,0,451,9706,390520369,0,0,0,985.18,7,60624.08,18,6,15,11,True
6699473,965,4,-1,1883,390520369,0,1,0,985.18,1,60624.08,13,3,21,11,True
6739510,965,4,30,7557,390520369,0,0,0,985.24,8,59638.84,13,2,16,11,True
6957496,716,0,451,6425,390520369,0,0,0,984.78,7,58654.06,18,3,6,2,True
7089787,716,0,25,1522,390520369,0,0,0,985.1,8,57668.96,18,4,18,2,True
7450558,965,4,25,4269,390520369,0,0,0,985.04,8,56683.92,13,6,11,2,True
7737609,1314,2,20,1794,390520369,0,0,0,985.05,5,55698.87,5,6,10,3,True
8353250,965,4,451,1850,390520369,0,0,0,984.87,7,54714.0,13,4,14,3,True
8356246,1328,4,30,4269,390520369,0,0,0,984.99,8,53729.01,18,6,6,6,True
8555898,1124,0,30,6552,390520369,0,0,0,985.38,8,52743.63,24,5,4,8,True
8614508,588,0,10,1883,390520369,0,0,0,985.06,0,53728.69,24,6,7,8,True
8766435,965,4,451,4050,390520369,0,0,0,985.25,7,52743.44,13,1,6,8,True
9360324,1118,4,-1,4269,390520369,0,1,0,985.05,4,52743.44,24,5,1,8,True
9703862,1118,4,25,2424,390520369,0,0,0,984.9,8,51758.54,24,1,14,8,True
9794638,1124,0,25,4835,390520369,0,0,0,984.93,8,50773.61,24,4,12,8,True
9819431,716,0,451,1012,390520369,0,0,0,985.11,7,49788.5,18,5,6,10,True
9997112,1118,4,451,6552,390520369,0,0,0,984.77,7,48803.73,24,6,18,11,True
1169624,160,0,25,2022,828601668,0,0,0,918.08,8,493783.92,24,5,10,1,True
1194600,371,3,30,4544,828601668,0,0,0,917.89,8,492866.03,25,2,7,2,True
1709983,193,1,25,7450,828601668,0,0,0,917.86,8,491948.17,18,2,18,2,True
1826890,160,0,-1,4055,828601668,0,1,0,918.03,4,491948.17,24,2,9,2,True
2048446,21,0,10,2561,828601668,0,0,0,917.77,0,492865.94,11,2,2,5,True
2122475,723,1,451,4605,828601668,0,0,0,918.02,7,491947.92,11,1,18,5,True
2371978,663,4,451,2561,828601668,0,0,0,917.97,7,491029.95,18,4,12,6,True
2392924,885,3,25,8994,828601668,0,0,0,918.1,8,490111.85,24,1,8,6,True
2545645,723,1,451,4055,828601668,0,0,0,918.04,7,489193.81,11,0,20,6,True
2558269,885,3,25,2022,828601668,0,0,0,918.23,8,488275.58,24,4,6,7,True
2701710,723,1,451,8971,828601668,0,0,0,918.35,7,487357.23,11,1,5,7,True
2888643,723,1,30,4544,828601668,0,0,0,918.07,8,486439.16,11,5,3,8,True
3415272,1311,2,20,2561,828601668,0,0,0,918.08,3,485521.08,5,1,3,8,True
3478418,723,1,451,8994,828601668,0,0,0,917.94,7,484603.14,11,4,11,9,True
3723623,371,3,25,5389,828601668,0,0,0,917.99,8,483685.15,25,1,16,9,False
3817861,626,2,451,5712,828601668,0,0,0,917.87,7,482767.28,11,6,3,10,True
3852353,371,3,451,8110,828601668,0,0,0,917.95,7,481849.33,25,6,15,10,True
4165591,160,0,25,8280,828601668,0,0,0,917.87,8,480931.46,24,0,18,10,True
4244717,160,0,30,8994,828601668,0,0,0,918.09,8,480013.37,24,6,7,11,True
4339319,371,3,25,9044,828601668,0,0,0,918.4,8,479094.97,25,0,6,12,True
4365352,885,3,30,8971,828601668,0,0,0,917.88,8,478177.09,24,0,7,12,True
4391960,371,3,451,7450,828601668,0,0,0,917.72,7,477259.37,25,1,18,1,True
5032259,160,0,451,8855,828601668,0,0,0,917.84,7,476341.53,24,2,22,3,True
5162805,626,2,25,1972,828601668,0,0,0,918.02,8,475423.51,11,2,14,3,True
5292131,885,3,-1,4544,828601668,0,1,0,917.84,4,475423.51,24,6,23,3,True
5312541,663,4,451,4605,828601668,0,0,0,917.73,7,474505.78,18,6,2,4,True
5533844,254,0,20,7450,828601668,0,0,0,918.27,5,473587.51,6,5,16,4,True
5627086,1041,0,10,8280,828601668,0,0,0,918.14,0,474505.65,11,2,1,5,True
5748173,160,0,30,2561,828601668,0,0,0,918.14,8,473587.51,24,1,1,5,True
5915792,558,0,20,5389,828601668,0,0,0,917.99,3,472669.52,17,6,6,8,True
5938929,371,3,451,8980,828601668,0,0,0,917.89,7,471751.63,25,2,19,9,True
6273591,714,2,20,8110,828601668,0,0,0,918.1,5,470833.53,18,1,13,12,True
6445254,663,4,451,8994,828601668,0,0,0,917.77,7,469915.76,18,4,22,12,True
6720152,885,3,30,2561,828601668,0,0,0,918.07,8,468997.69,24,3,14,12,True
6921762,160,0,25,4605,828601668,0,0,0,918.2,8,468079.49,24,0,17,1,True
7035180,626,2,-1,2487,828601668,0,1,0,917.99,4,468079.49,11,3,14,1,True
7439745,842,2,20,2022,828601668,0,0,0,918.31,3,467161.18,5,6,5,2,True
7441107,663,4,30,8980,828601668,0,0,0,918.25,8,466242.93,18,6,5,2,True
7610286,20,0,20,2561,828601668,0,0,0,917.89,5,465325.04,24,0,3,3,True
7629647,626,2,-1,5389,828601668,0,1,0,918.06,1,465325.04,11,0,22,4,True
7664751,160,0,25,9065,828601668,0,0,0,917.96,8,464407.08,24,2,14,4,True
7707880,342,0,10,2561,828601668,0,0,0,918.0,6,465325.08,24,4,16,4,True
7812510,885,3,30,8280,828601668,0,0,0,917.58,8,464407.5,24,4,12,4,True
8150050,371,3,451,2022,828601668,0,0,0,917.98,7,463489.52,25,5,19,5,True
8255830,193,1,25,9065,828601668,0,0,0,918.07,8,462571.45,18,3,12,5,True
8261353,1127,0,10,8980,828601668,0,0,0,917.84,6,463489.29,24,5,12,5,True
8381341,583,2,20,4760,828601668,0,0,0,918.11,3,462571.18,11,2,1,6,True
8502772,929,0,10,4544,828601668,0,0,0,917.93,0,463489.11,18,3,10,6,False
8696952,663,4,25,4055,828601668,0,0,0,918.12,8,462570.99,18,5,0,6,False
8915095,723,1,451,4468,828601668,0,0,0,918.36,7,461652.63,11,3,20,7,True
9365241,885,3,30,2561,828601668,0,0,0,917.71,8,460734.92,24,3,17,9,True
9609965,35,2,20,4760,828601668,0,0,0,918.03,5,459816.89,11,2,15,11,True
9658491,880,1,10,2022,828601668,0,0,0,917.91,6,460734.8,27,6,15,11,True
9693194,160,0,25,9065,828601668,0,0,0,918.0,8,459816.8,24,0,23,11,True
9840039,663,4,451,4605,828601668,0,0,0,917.95,7,458898.85,18,4,10,11,True
1735437,312,0,20,7589,193478786,0,0,0,399.97,5,528597.03,4,6,6,1,True
1769802,1175,2,30,5804,193478786,0,0,0,400.33,8,528196.7,24,2,3,2,True
2008284,337,1,25,9024,193478786,0,0,0,399.86,8,527796.84,11,4,20,2,True
2345452,108,2,25,4655,193478786,0,0,0,400.1,8,527396.74,3,0,5,2,True
2522464,384,3,25,9387,193478786,0,0,0,399.93,8,526996.81,25,0,9,3,True
2585278,694,2,20,9621,193478786,0,0,0,400.04,3,526596.77,24,1,23,3,True
2632233,1175,2,25,5623,193478786,0,0,0,400.0,8,526196.77,24,0,22,3,True
2681649,337,1,-1,3757,193478786,0,1,0,399.8,1,526196.77,11,5,1,4,True
3014817,337,1,25,8153,193478786,0,0,0,400.02,8,525796.75,11,5,21,4,True
3303479,337,1,-1,7352,193478786,0,1,0,399.79,1,525796.75,11,3,12,4,True
3740216,1113,1,25,5322,193478786,0,0,0,400.12,8,525396.63,0,4,16,4,True
3779631,467,0,-1,9871,193478786,0,1,0,399.84,4,525396.63,5,5,18,5,True
3853348,467,0,30,3388,193478786,0,0,0,400.16,8,524996.47,5,0,23,6,True
3993346,1175,2,-1,9621,193478786,0,1,0,400.04,1,524996.47,24,4,23,7,True
4060334,1419,1,10,1494,193478786,0,0,0,399.9,6,525396.37,24,4,23,7,True
4063185,1122,1,10,5623,193478786,0,0,0,400.18,6,525796.55,24,1,2,8,True
4179951,337,1,451,8153,193478786,0,0,0,399.9,7,525396.65,11,6,11,8,True
4463101,337,1,25,9641,193478786,0,0,0,399.82,8,524996.83,11,2,10,8,True
4738688,1485,0,20,2079,193478786,0,0,0,399.7,5,524597.13,24,2,3,9,True
4887849,337,1,-1,5623,193478786,0,1,0,399.97,4,524597.13,11,2,1,9,True
4968552,1195,1,10,9387,193478786,0,0,0,400.15,6,524997.28,24,1,16,10,True
5041602,1043,4,25,5623,193478786,0,0,0,400.33,8,524596.95,11,2,13,12,True
5193059,1315,0,20,5804,193478786,0,0,0,400.06,5,524196.89,5,1,0,1,True
5579309,337,1,30,5623,193478786,0,0,0,399.88,8,523797.01,11,5,21,2,True
5604213,35,2,20,1550,193478786,0,0,0,400.04,5,523396.97,11,2,12,3,True
5816564,573,0,25,4655,193478786,0,0,0,400.13,8,522996.84,11,3,19,3,True
5987901,573,0,451,3757,193478786,0,0,0,399.74,7,522597.1,11,1,19,3,True
6149127,573,0,451,1936,193478786,0,0,0,399.91,7,522197.19,11,2,7,4,True
6194131,1175,2,-1,4655,193478786,0,1,0,399.88,1,522197.19,24,6,13,5,True
6510291,467,0,451,9024,193478786,0,0,0,400.17,7,521797.02,5,2,6,5,True
6853304,573,0,451,5623,193478786,0,0,0,400.04,7,521396.98,11,2,16,5,True
7009761,108,2,25,2908,193478786,0,0,0,399.91,8,520997.07,3,5,10,6,True
7124824,384,3,451,9387,193478786,0,0,0,399.87,7,520597.2,25,0,11,6,True
7160363,588,0,10,4030,193478786,0,0,0,400.16,6,520997.36,24,1,11,7,True
7168857,184,0,10,8637,193478786,0,0,0,400.03,6,521397.39,18,3,0,7,True
7220594,384,3,25,5623,193478786,0,0,0,399.74,8,520997.65,25,5,18,9,True
7229202,1377,0,20,7460,193478786,0,0,0,400.11,5,520597.54,16,0,7,9,True
7270837,1043,4,451,9871,193478786,0,0,0,400.14,7,520197.4,11,0,3,10,True
7313954,108,2,30,9387,193478786,0,0,0,399.95,8,519797.45,3,2,17,11,True
7319628,384,3,25,8637,193478786,0,0,0,399.7,8,519397.75,25,4,8,11,True
7397355,573,0,25,2823,193478786,0,0,0,400.0,8,518997.75,11,3,21,12,True
7455983,573,0,25,2679,193478786,0,0,0,399.79,8,518597.96,11,3,19,2,True
7688635,1034,1,10,9641,193478786,0,0,0,400.06,6,518998.02,11,6,14,3,False
7794881,1175,2,451,5415,193478786,0,0,0,399.92,7,518598.1,24,4,17,3,True
7869282,573,0,-1,7352,193478786,0,1,0,400.21,4,518598.1,11,6,5,3,True
8003810,497,0,20,2908,193478786,0,0,0,399.92,3,518198.18,12,6,1,4,True
8249537,355,1,10,9641,193478786,0,0,0,399.97,6,518598.15,24,5,12,4,True
8259750,1113,1,451,8637,193478786,0,0,0,399.92,7,518198.23,0,6,0,4,True
8448943,337,1,25,3757,193478786,0,0,0,399.77,8,517798.46,11,1,7,5,True
8573357,1113,1,-1,7405,193478786,0,1,0,399.86,4,517798.46,0,6,6,5,True
8822959,384,3,25,4676,193478786,0,0,0,399.65,8,517398.81,25,4,20,5,True
8974595,108,2,30,9024,193478786,0,0,0,400.04,8,516998.77,3,4,18,5,True
9072676,715,0,20,2679,193478786,0,0,0,399.81,3,516598.96,18,4,8,7,True
9104349,337,1,451,4655,193478786,0,0,0,400.15,7,516198.81,11,0,12,7,True
9228118,467,0,451,4804,193478786,0,0,0,400.12,7,515798.69,5,2,16,7,True
9319807,573,0,451,4655,193478786,0,0,0,400.01,7,515398.68,11,2,15,8,True
9557220,1113,1,-1,2642,193478786,0,1,0,400.07,1,515398.68,0,4,5,9,True
9696404,58,2,20,5623,193478786,0,0,0,399.86,3,514998.82,20,4,4,9,True
1086192,275,0,10,9410,231469314,1,0,0,193.16,6,714285.16,24,4,4,1,True
1195955,1338,0,30,8147,231469314,1,0,0,192.89,8,714092.27,18,4,22,1,True
1513274,1029,0,10,5535,231469314,1,0,0,193.01,0,714285.28,11,4,1,1,True
1788761,726,0,25,7770,231469314,1,0,0,193.01,8,714092.27,11,4,11,1,True
1833452,726,0,30,9841,231469314,1,0,0,193.15,8,713899.12,11,6,1,1,True
1887586,726,0,451,1937,231469314,1,0,0,192.93,7,713706.19,11,5,16,2,True
2146057,612,4,25,8147,231469314,1,0,0,192.8,8,713513.39,11,0,21,2,True
2201779,612,4,-1,5077,231469314,1,1,0,192.88,1,713513.39,11,4,13,3,True
2259053,1306,4,25,9818,231469314,1,0,0,192.86,8,713320.53,5,5,9,3,True
2515700,1338,0,451,8392,231469314,1,0,0,193.15,7,713127.38,18,0,20,3,True
3061218,1304,0,10,7654,231469314,1,0,0,192.87,0,713320.25,5,0,1,4,True
3087891,303,0,20,2823,231469314,1,0,0,193.06,5,713127.19,4,5,16,5,True
3261563,1306,4,25,9410,231469314,1,0,0,193.06,8,712934.13,5,0,0,6,True
3301060,534,4,30,6220,231469314,1,0,0,192.78,8,712741.35,18,1,4,8,True
3378274,755,3,30,7654,231469314,1,0,0,192.98,8,712548.37,24,1,7,8,True
3780851,116,0,20,6220,231469314,1,0,0,192.92,5,712355.45,3,4,4,8,True
4313596,71,1,10,6242,231469314,1,0,0,193.07,6,712548.52,20,4,13,9,True
4343073,612,4,25,1937,231469314,1,0,0,192.96,8,712355.56,11,6,14,9,True
4613160,1338,0,30,7654,231469314,1,0,0,193.02,8,712162.54,18,1,10,9,True
5123386,755,3,451,6275,231469314,1,0,0,192.94,7,711969.6,24,0,4,10,True
5187409,266,2,20,9931,231469314,1,0,0,193.16,3,711776.44,6,1,13,10,True
5226449,612,4,30,4320,231469314,1,0,0,193.01,8,711583.43,11,2,10,10,True
5406000,1338,0,-1,7770,231469314,1,1,0,193.16,4,711583.43,18,4,23,10,True
5657447,752,0,20,9931,231469314,1,0,0,193.07,5,711390.36,24,1,16,11,True
5828439,726,0,451,5077,231469314,1,0,0,192.75,7,711197.61,11,3,16,11,True
6190043,1306,4,451,2823,231469314,1,0,0,192.98,7,711004.63,5,1,21,11,True
6384860,534,4,25,8076,231469314,1,0,0,192.95,8,710811.68,18,2,20,12,True
6416884,1338,0,-1,5955,231469314,1,1,0,193.1,1,710811.68,18,2,15,2,True
6516418,726,0,451,2823,231469314,1,0,0,193.12,7,710618.56,11,6,14,2,True
6528585,755,3,30,6776,231469314,1,0,0,193.07,8,710425.49,24,3,4,3,True
7096206,612,4,30,1937,231469314,1,0,0,193.1,8,710232.39,11,4,8,3,True
7245608,726,0,30,8392,231469314,1,0,0,192.93,8,710039.46,11,2,17,4,True
7285470,534,4,451,3125,231469314,1,0,0,193.08,7,709846.38,18,2,20,4,True
7744539,1338,0,25,5176,231469314,1,0,0,192.75,8,709653.63,18,2,19,5,True
7762904,612,4,25,8660,231469314,1,0,0,193.05,8,709460.58,11,3,14,6,True
7806973,726,0,451,9931,231469314,1,0,0,193.11,7,709267.47,11,4,2,6,False
7887720,800,0,10,8076,231469314,1,0,0,193.26,0,709460.73,11,4,14,7,True
8012510,286,1,10,2961,231469314,1,0,0,192.99,6,709653.72,24,1,8,8,True
8219728,1455,2,20,6275,231469314,1,0,0,192.8,3,709460.92,11,4,18,8,True
8387119,1242,4,451,6242,231469314,1,0,0,192.94,7,709267.98,18,6,19,8,True
8467650,1338,0,30,8660,231469314,1,0,0,192.84,8,709075.14,18,3,12,10,True
8517683,1242,4,25,6275,231469314,1,0,0,192.97,8,708882.17,18,3,15,2,True
8602766,1338,0,25,5176,231469314,1,0,0,193.22,8,708688.95,18,5,20,2,True
8612360,726,0,-1,6776,231469314,1,1,0,192.87,1,708688.95,11,5,6,2,True
8662960,1164,0,10,1684,231469314,1,0,0,193.04,0,708881.99,24,1,5,3,True
8703092,1242,4,30,4320,231469314,1,0,0,192.97,8,708689.02,18,6,22,4,True
8707482,23,0,20,1937,231469314,1,0,0,193.09,5,708495.93,11,1,5,5,True
9078514,1086,0,10,8076,231469314,1,0,0,193.05,0,708688.98,18,6,22,5,True
9141282,726,0,30,9931,231469314,1,0,0,193.04,8,708495.94,11,2,17,6,True
9151495,726,0,25,9931,231469314,1,0,0,193.16,8,708302.78,11,5,6,6,True
9677430,534,4,25,8392,231469314,1,0,0,193.13,8,708109.65,18,6,0,7,True
9702026,114,0,10,2961,231469314,1,0,0,193.14,6,708302.79,3,2,13,8,True
9743726,260,0,20,8981,231469314,1,0,0,193.11,5,708109.68,6,1,3,8,True
9934667,726,0,451,1636,231469314,1,0,0,192.87,7,707916.81,11,3,21,9,False
9952363,1306,4,-1,2097,231469314,1,1,0,193.33,4,707916.81,5,6,0,10,True
1004857,103,3,451,8085,572024218,0,0,0,527.26,7,668431.74,3,0,10,2,True
1188081,448,0,451,8695,572024218,0,0,0,527.05,7,667904.69,13,1,15,3,True
1249122,530,0,20,1005,572024218,0,0,0,527.17,3,667377.52,18,4,17,3,True
1302349,947,2,25,6840,572024218,0,0,0,526.82,8,666850.7,24,2,12,3,True
1640072,135,2,20,7100,572024218,0,0,0,526.96,5,666323.74,18,4,2,6,True
1839893,1454,1,-1,7100,572024218,0,1,0,526.91,1,666323.74,11,2,5,6,True
1908880,1454,1,30,1984,572024218,0,0,0,526.99,8,665796.75,11,6,20,7,True
1911986,696,2,20,5484,572024218,0,0,0,526.84,3,665269.91,24,1,12,8,True
1914742,1450,4,451,1984,572024218,0,0,0,526.96,7,664742.95,11,5,0,8,True
2329524,448,0,451,1262,572024218,0,0,0,527.03,7,664215.92,13,3,11,9,True
2363354,448,0,25,5681,572024218,0,0,0,527.2,8,663688.72,13,5,1,9,True
2851919,1244,4,-1,4610,572024218,0,1,0,527.05,4,663688.72,18,5,13,9,True
3317714,1010,0,20,7661,572024218,0,0,0,526.85,5,663161.87,26,1,5,10,True
3329584,103,3,451,8982,572024218,0,0,0,526.78,7,662635.09,3,6,18,11,True
3568111,448,0,451,3388,572024218,0,0,0,526.93,7,662108.16,13,1,12,12,True
4486268,1406,0,10,4610,572024218,0,0,0,527.12,6,662635.28,24,5,19,12,True
4511688,428,0,20,7168,572024218,0,0,0,527.14,5,662108.14,18,1,1,1,True
4712692,367,1,10,4610,572024218,0,0,0,527.08,6,662635.22,25,6,6,2,True
4843619,1419,1,10,5484,572024218,0,0,0,526.81,6,663162.03,24,1,7,3,True
4881681,1454,1,-1,4610,572024218,0,1,0,527.04,1,663162.03,11,0,7,4,True
5037185,103,3,30,7661,572024218,0,0,0,527.27,8,662634.76,3,2,9,4,True
5362394,1454,1,451,5681,572024218,0,0,0,527.05,7,662107.71,11,3,16,4,True
5601374,101,3,-1,6840,572024218,0,1,0,526.98,4,662107.71,3,3,5,5,True
5672355,1244,4,30,1984,572024218,0,0,0,526.89,8,661580.82,18,2,11,5,True
5864085,947,2,25,8695,572024218,0,0,0,526.86,8,661053.96,24,1,0,5,True
5989591,103,3,-1,5114,572024218,0,1,0,526.98,1,661053.96,3,6,10,6,True
6308072,1128,2,20,8085,572024218,0,0,0,527.03,3,660526.93,24,4,3,6,True
6322785,1450,4,-1,7100,572024218,0,1,0,526.93,1,660526.93,11,1,11,7,True
6363409,1027,0,10,1262,572024218,0,0,0,527.0,0,661053.93,11,1,14,7,True
6559951,103,3,25,7100,572024218,0,0,0,527.03,8,660526.9,3,1,19,8,True
6620805,448,0,25,7168,572024218,0,0,0,526.76,8,660000.14,13,3,17,9,True
6711390,474,4,30,5484,572024218,0,0,0,527.19,8,659472.95,5,2,23,10,True
6776433,101,3,451,8663,572024218,0,0,0,527.36,7,658945.59,3,0,19,11,True
6826639,101,3,30,8085,572024218,0,0,0,526.99,8,658418.6,3,4,23,11,True
6884869,448,0,451,3388,572024218,0,0,0,527.13,7,657891.47,13,0,16,11,True
7077544,761,2,20,1005,572024218,0,0,0,527.12,3,657364.35,24,6,6,12,True
7523019,1277,2,20,3388,572024218,0,0,0,526.94,3,656837.41,24,2,2,1,True
7688238,1037,0,20,4592,572024218,0,0,0,526.78,5,656310.63,11,6,3,1,True
7720937,1246,0,10,6840,572024218,0,0,0,527.06,6,656837.69,23,1,2,2,True
7825921,1052,0,20,3388,572024218,0,0,0,527.1,5,656310.59,11,4,12,3,True
7878115,448,0,30,8663,572024218,0,0,0,527.07,8,655783.52,13,2,14,3,True
8070278,474,4,25,8817,572024218,0,0,0,526.93,8,655256.59,5,4,14,4,True
8478667,448,0,-1,4592,572024218,0,1,0,526.92,4,655256.59,13,1,13,4,True
8521316,448,0,451,5681,572024218,0,0,0,526.89,7,654729.7,13,5,19,4,True
8592599,1244,4,30,7661,572024218,0,0,0,526.95,8,654202.75,18,0,5,4,True
8648237,1450,4,-1,6818,572024218,0,1,0,527.1,4,654202.75,11,2,0,5,True
8798231,101,3,25,3388,572024218,0,0,0,527.36,8,653675.39,3,0,10,7,True
9097101,944,2,20,7100,572024218,0,0,0,527.13,3,653148.26,24,5,19,9,True
9226002,1454,1,25,4592,572024218,0,0,0,527.17,8,652621.09,11,4,15,9,True
9374960,1303,0,20,4610,572024218,0,0,0,526.84,3,652094.25,5,5,4,10,True
9432999,101,3,30,5484,572024218,0,0,0,526.89,8,651567.36,3,1,19,10,True
9436185,947,2,-1,1005,572024218,0,1,0,526.8,4,651567.36,24,1,20,10,True
9453903,103,3,25,4592,572024218,0,0,0,526.87,8,651040.49,3,5,16,11,True
9560148,1450,4,-1,5484,572024218,0,1,0,526.98,1,651040.49,11,2,20,11,True
9796005,1454,1,-1,1262,572024218,0,2,0,526.93,4,651040.49,11,5,13,11,True
1008572,945,1,451,7724,386896706,0,0,0,904.04,7,756184.96,24,5,6,1,True
1354298,986,4,30,7369,386896706,0,0,0,903.95,8,755281.01,22,3,22,1,True
1678026,588,0,451,4223,386896706,0,0,0,904.01,7,754377.0,24,4,6,2,True
1781704,59,0,451,7148,386896706,0,0,0,903.97,7,753473.03,20,4,10,2,True
2022784,986,4,25,3018,386896706,0,0,0,903.91,8,752569.12,22,6,22,2,True
2265755,952,0,451,2998,386896706,0,0,0,904.01,7,751665.11,13,0,4,5,True
2282033,59,0,20,2680,386896706,0,0,0,904.11,5,750761.0,20,1,8,5,True
2551119,1127,0,10,1398,386896706,0,0,0,904.08,6,751665.08,24,1,9,7,True
2599068,216,4,25,2998,386896706,0,0,0,904.13,8,750760.95,9,4,18,9,True
3017298,945,1,451,7517,386896706,0,0,0,903.82,7,749857.13,24,4,23,10,True
3019388,945,1,25,3201,386896706,0,0,0,903.91,8,748953.22,24,6,2,10,True
3082921,952,0,25,1359,386896706,0,0,0,904.06,8,748049.16,13,4,3,10,True
3098907,59,0,451,2715,386896706,0,0,0,903.82,7,747145.34,20,4,9,11,True
3128167,59,0,25,5375,386896706,0,0,0,903.92,8,746241.42,20,6,23,11,True
3177922,59,0,30,2998,386896706,0,0,0,903.99,8,745337.43,20,4,12,11,True
3270017,945,1,451,2352,386896706,0,0,0,904.18,7,744433.25,24,0,23,11,True
3358690,986,4,30,1398,386896706,0,0,0,904.06,8,743529.19,22,2,2,12,True
3438497,952,0,451,4223,386896706,0,0,0,904.06,7,742625.13,13,1,16,12,True
3454434,59,0,451,1398,386896706,0,0,0,904.01,7,741721.12,20,6,17,12,True
3497361,180,0,20,7148,386896706,0,0,0,904.09,5,740817.03,18,0,4,12,True
3536597,952,0,25,5375,386896706,0,0,0,904.12,8,739912.91,13,3,5,12,True
3713666,588,0,25,2352,386896706,0,0,0,903.86,8,739009.05,24,6,21,12,True
4056163,986,4,451,5779,386896706,0,0,0,904.15,7,738104.9,22,2,20,12,True
4557550,216,4,25,1359,386896706,0,0,0,903.98,8,737200.92,9,1,5,1,True
4662612,1122,1,10,6298,386896706,0,0,0,904.06,6,738104.98,24,2,10,3,True
4809790,986,4,451,1728,386896706,0,0,0,904.08,7,737200.9,22,2,17,3,True
4816713,588,0,30,2945,386896706,0,0,0,904.14,8,736296.76,24,1,5,4,True
4857264,216,4,451,7670,386896706,0,0,0,904.02,7,735392.74,9,0,0,5,True
4970266,446,1,10,7369,386896706,0,0,0,904.13,0,736296.87,13,5,15,5,True
5249985,952,0,25,5779,386896706,0,0,0,903.79,8,735393.08,13,6,10,5,True
5491369,1312,0,20,2352,386896706,0,0,0,904.11,5,734488.97,5,5,9,6,True
5782923,952,0,30,5779,386896706,0,0,0,903.81,8,733585.16,13,0,13,6,True
5849177,687,0,10,7148,386896706,0,0,0,903.96,6,734489.12,24,1,14,6,True
5926097,900,1,10,4223,386896706,0,0,0,904.26,6,735393.38,24,4,15,7,True
5927457,945,1,25,3018,386896706,0,0,0,904.06,8,734489.32,24,4,7,7,True
6006842,359,2,20,5375,386896706,0,0,0,904.24,3,733585.08,24,4,11,8,True
6023252,216,4,30,1728,386896706,0,0,0,903.93,8,732681.15,9,2,20,8,False
6333968,216,4,451,5375,386896706,0,0,0,903.99,7,731777.16,9,5,1,8,True
6342019,216,4,25,7148,386896706,0,0,0,904.1,8,730873.06,9,6,11,9,True
6479555,986,4,451,5937,386896706,0,0,0,904.08,7,729968.98,22,0,14,10,True
6635283,59,0,451,5779,386896706,0,0,0,904.03,7,729064.95,20,2,12,12,True
6674111,986,4,30,3018,386896706,0,0,0,904.25,8,728160.7,22,4,13,12,True
6808821,59,0,30,4223,386896706,0,0,0,903.7,8,727257.0,20,1,9,2,True
6913407,952,0,25,7452,386896706,0,0,0,904.03,8,726352.97,13,3,14,3,True
6925224,302,1,10,1728,386896706,0,0,0,903.99,0,727256.96,4,1,17,4,True
6940133,580,0,20,7369,386896706,0,0,0,904.05,3,726352.91,11,3,15,4,True
7068345,945,1,451,6298,386896706,0,0,0,903.99,7,725448.92,24,0,14,6,True
7482591,986,4,30,3201,386896706,0,0,0,904.03,8,724544.89,22,1,9,6,True
7507890,216,4,451,2945,386896706,0,0,0,904.05,7,723640.84,9,6,2,6,True
7661432,986,4,30,5375,386896706,0,0,0,903.54,8,722737.3,22,1,18,7,True
7707019,216,4,451,2352,386896706,0,0,0,904.05,7,721833.25,9,1,1,7,True
7769458,59,0,30,7724,386896706,0,0,0,904.13,8,720929.12,20,5,8,8,True
7805382,940,1,10,1398,386896706,0,0,0,904.07,6,721833.19,24,6,17,8,True
8139441,654,1,10,7148,386896706,0,0,0,904.05,0,722737.24,18,5,20,8,True
8269149,59,0,25,7452,386896706,0,0,0,904.16,8,721833.08,20,5,2,8,True
8379447,518,2,20,4447,386896706,0,0,0,903.96,3,720929.12,18,4,18,9,True
9133631,910,0,20,1359,386896706,0,0,0,903.75,5,720025.37,18,0,8,9,True
9333110,59,0,-1,2715,386896706,0,1,0,904.19,4,720025.37,20,4,22,10,True
9999424,588,0,-1,7724,386896706,0,2,0,904.03,4,720025.37,24,5,0,10,True
1066071,568,1,-1,9315,901573513,0,1,0,542.04,4,168244.0,11,5,19,1,True
1316800,420,4,30,9507,901573513,0,0,0,541.9,8,167702.1,18,3,16,1,True
1512979,890,4,451,8423,901573513,0,0,0,541.85,7,167160.25,24,6,5,1,True
1681918,1166,2,30,6414,901573513,0,0,0,542.06,8,166618.19,24,5,5,2,True
2050833,568,1,30,8423,901573513,0,0,0,541.98,8,166076.21,11,5,16,2,True
2128357,1166,2,451,2416,901573513,0,0,0,542.01,7,165534.2,24,4,23,4,True
2139822,1166,2,30,5758,901573513,0,0,0,541.92,8,164992.28,24,2,10,4,True
2384227,421,3,451,3225,901573513,0,0,0,541.98,7,164450.3,18,3,5,6,True
2489537,440,4,-1,2416,901573513,0,1,0,541.87,4,164450.3,24,6,6,7,True
2585496,844,1,10,8423,901573513,0,0,0,541.88,6,164992.18,5,5,16,7,True
2926220,759,0,25,5844,901573513,0,0,0,541.89,8,164450.29,24,1,7,8,True
2928337,759,0,-1,9315,901573513,0,1,0,541.76,1,164450.29,24,3,1,9,True
3141146,890,4,-1,9761,901573513,0,2,0,542.0,4,164450.29,24,6,17,11,True
3248719,568,1,451,1237,901573513,0,0,0,542.06,7,163908.23,11,1,23,2,True
3360814,568,1,10,9297,901573513,0,0,0,541.94,6,164450.17,11,5,22,2,True
3380665,759,0,30,3225,901573513,0,0,0,541.77,8,163908.4,24,2,19,2,True
3749708,440,4,-1,9507,901573513,0,1,0,541.94,4,163908.4,24,1,19,3,True
4111892,421,3,451,9507,901573513,0,0,0,541.74,7,163366.66,18,4,3,3,True
4142802,427,2,25,8064,901573513,0,0,0,542.07,8,162824.59,18,3,15,4,True
4170151,656,2,20,6414,901573513,0,0,0,542.19,3,162282.4,18,5,6,4,True
4227722,420,4,-1,9315,901573513,0,1,0,541.95,1,162282.4,18,0,11,5,True
4393613,568,1,451,5758,901573513,0,0,0,542.21,7,161740.19,11,1,1,6,True
4586052,568,1,25,3886,901573513,0,0,0,541.9,8,161198.29,11,3,14,6,True
5052278,218,0,20,8423,901573513,0,0,0,542.07,3,160656.22,9,0,22,7,True
5293050,421,3,25,9315,901573513,0,0,0,542.06,8,160114.16,18,1,3,10,False
5496063,759,0,30,9297,901573513,0,0,0,542.24,8,159571.92,24,6,2,10,True
5688046,421,3,451,6414,901573513,0,0,0,541.97,7,159029.95,18,1,0,10,False
5690306,1166,2,451,9966,901573513,0,0,0,541.79,7,158488.16,24,3,9,11,True
5934388,890,4,25,3886,901573513,0,0,0,542.0,8,157946.16,24,5,23,1,False
6154208,147,0,10,6414,901573513,0,0,0,541.92,0,158488.08,18,1,21,1,True
6242614,568,1,-1,1237,901573513,0,1,0,542.02,1,158488.08,11,2,22,1,True
6884683,440,4,451,3225,901573513,0,0,0,541.89,7,157946.19,24,0,21,1,True
7099128,568,1,-1,9507,901573513,0,1,0,541.93,1,157946.19,11,3,6,1,True
7130870,711,2,20,2416,901573513,0,0,0,542.1,3,157404.09,18,2,3,1,True
7137804,421,3,451,2416,901573513,0,0,0,542.08,7,156862.01,18,4,1,2,True
7479230,440,4,30,5844,901573513,0,0,0,541.89,8,156320.12,24,3,7,2,True
7498519,440,4,451,3225,901573513,0,0,0,542.09,7,155778.03,24,3,2,2,True
7641668,759,0,25,9966,901573513,0,0,0,542.08,8,155235.95,24,1,11,3,True
7643815,420,4,-1,9507,901573513,0,1,0,542.19,4,155235.95,18,2,7,4,True
8177680,421,3,451,8064,901573513,0,0,0,542.23,7,154693.72,18,5,1,5,True
8180845,568,1,30,2416,901573513,0,0,0,542.21,8,154151.51,11,6,17,5,True
8250632,759,0,-1,9507,901573513,0,1,0,541.84,1,154151.51,24,0,14,7,False
8329585,759,0,30,7213,901573513,0,0,0,541.82,8,153609.69,24,5,23,7,True
8513305,759,0,-1,5758,901573513,0,1,0,541.96,1,153609.69,24,6,3,7,True
8517962,568,1,25,8423,901573513,0,0,0,542.21,8,153067.48,11,4,16,8,True
8626427,890,4,25,3225,901573513,0,0,0,541.82,8,152525.66,24,5,2,8,True
9089453,759,0,25,5758,901573513,0,0,0,542.15,8,151983.51,24,3,14,8,True
9244564,759,0,30,8423,901573513,0,0,0,542.06,8,151441.45,24,0,2,9,True
9354647,1064,0,10,9297,901573513,0,0,0,541.85,6,151983.3,11,3,17,10,True
9413851,568,1,451,6414,901573513,0,0,0,541.79,7,151441.51,11,3,13,10,True
9608306,333,1,10,9297,901573513,0,0,0,542.08,6,151983.59,11,6,17,10,True
9664853,713,0,20,9761,901573513,0,0,0,542.12,3,151441.47,18,6,2,10,True
9740625,759,0,451,5758,901573513,0,0,0,542.09,7,150899.38,24,5,14,11,True
9872536,427,2,30,9297,901573513,0,0,0,542.07,8,150357.31,18,4,9,11,True
9935572,427,2,-1,8064,901573513,0,1,0,542.06,4,150357.31,18,1,15,11,True
1078478,967,1,10,8612,172890239,1,0,0,477.85,6,438596.85,13,1,23,4,True
1328916,714,2,25,1204,172890239,1,0,0,478.06,8,438118.79,18,3,4,6,True
1822860,1111,0,20,1613,172890239,1,0,0,477.99,5,437640.8,0,2,6,8,True
1823297,199,0,-1,1276,172890239,1,1,0,478.25,4,437640.8,18,5,13,8,True
1997865,415,4,451,9845,172890239,1,0,0,477.98,7,437162.82,18,5,8,8,True
2095263,818,1,25,2729,172890239,1,0,0,477.96,8,436684.86,18,4,23,8,True
2271668,1377,0,10,8754,172890239,1,0,0,478.12,0,437162.98,16,0,8,9,True
2448476,714,2,25,7265,172890239,1,0,0,477.71,8,436685.27,18,5,15,9,True
2609234,1023,2,20,3973,172890239,1,0,0,478.07,5,436207.2,11,2,10,9,True
2698988,818,1,451,5391,172890239,1,0,0,477.92,7,435729.28,18,3,5,10,True
2772723,199,0,451,4837,172890239,1,0,0,477.87,7,435251.41,18,4,16,11,True
3056032,195,1,10,1836,172890239,1,0,0,478.04,0,435729.45,18,5,12,11,True
3088190,222,2,20,2723,172890239,1,0,0,477.97,3,435251.48,26,4,0,12,True
3096417,364,4,25,7565,172890239,1,0,0,477.75,8,434773.73,25,0,2,2,True
3210990,350,0,10,5391,172890239,1,0,0,478.06,0,435251.79,24,1,20,3,True
3226104,989,1,10,5703,172890239,1,0,0,478.23,0,435730.02,22,0,2,4,True
3234309,714,2,30,5747,172890239,1,0,0,478.01,8,435252.01,18,5,22,7,True
3275492,1445,2,451,9673,172890239,1,0,0,477.97,7,434774.04,24,5,9,7,True
3473129,1445,2,30,8612,172890239,1,0,0,478.17,8,434295.87,24,4,0,8,True
3509850,340,4,451,5721,172890239,1,0,0,478.16,7,433817.71,24,5,16,10,True
3547660,364,4,-1,3660,172890239,1,1,0,477.84,1,433817.71,25,5,11,10,True
3620309,818,1,30,8754,172890239,1,0,0,477.99,8,433339.72,18,1,14,11,True
3682928,806,1,10,8612,172890239,1,0,0,477.96,6,433817.68,11,4,17,12,True
4164455,415,4,-1,9191,172890239,1,1,0,477.97,1,433817.68,18,4,10,12,True
4408566,834,0,10,8754,172890239,1,0,0,477.91,0,434295.59,5,5,7,5,True
4534879,199,0,451,3973,172890239,1,0,0,478.08,7,433817.51,18,6,5,6,True
4678604,364,4,451,2295,172890239,1,0,0,477.88,7,433339.63,25,3,20,6,True
5121372,415,4,-1,8754,172890239,1,1,0,477.85,1,433339.63,18,4,1,7,True
5161096,1445,2,-1,5747,172890239,1,2,0,477.87,4,433339.63,24,2,7,8,False
5164542,364,4,-1,6260,172890239,1,3,1,477.91,4,433339.63,25,5,16,10,True
1078691,307,4,30,3180,522241840,0,0,0,418.98,8,207897.02,4,4,10,1,False
1079414,1256,2,20,8455,522241840,0,0,0,418.96,5,207478.06,23,6,1,1,True
1430686,533,2,20,3180,522241840,0,0,0,418.78,5,207059.28,18,2,5,2,True
1436381,918,2,25,3199,522241840,0,0,0,419.13,8,206640.15,18,2,21,2,True
1544490,46,1,25,9728,522241840,0,0,0,418.96,8,206221.19,24,0,22,2,True
2025830,467,0,20,1851,522241840,0,0,0,419.27,5,205801.92,5,2,2,3,True
2034171,307,4,25,1834,522241840,0,0,0,418.82,8,205383.1,4,1,0,3,True
2104168,918,2,25,1895,522241840,0,0,0,418.94,8,204964.16,18,5,6,3,True
2148633,46,1,-1,1895,522241840,0,1,0,418.9,4,204964.16,24,2,0,3,True
2171433,913,0,-1,9091,522241840,0,2,0,419.28,1,204964.16,18,3,6,4,True
2493845,817,4,451,9091,522241840,0,0,0,419.1,7,204545.06,18,1,16,5,True
2654798,115,2,25,1669,522241840,0,0,0,418.96,8,204126.1,3,5,9,5,True
2667954,46,1,451,6027,522241840,0,0,0,418.91,7,203707.19,24,0,5,6,True
2824690,817,4,30,1669,522241840,0,0,0,418.99,8,203288.2,18,2,11,6,True
2889867,913,0,25,1399,522241840,0,0,0,418.92,8,202869.28,18,3,19,6,True
3182225,817,4,451,9728,522241840,0,0,0,419.12,7,202450.16,18,6,19,7,True
3612085,46,1,-1,1821,522241840,0,1,0,418.67,1,202450.16,24,0,1,7,True
3703484,144,1,10,4246,522241840,0,0,0,418.93,6,202869.09,18,2,8,8,True
3997411,307,4,30,9785,522241840,0,0,0,418.62,8,202450.47,4,0,9,8,True
4273926,817,4,-1,5573,522241840,0,1,0,418.98,4,202450.47,18,2,11,8,True
4310610,53,0,20,1821,522241840,0,0,0,419.29,5,202031.18,20,2,11,9,True
4416921,1461,0,20,9091,522241840,0,0,0,418.75,5,201612.43,11,1,19,9,True
4588156,913,0,25,8455,522241840,0,0,0,419.07,8,201193.36,18,3,17,10,True
4834154,589,1,10,9728,522241840,0,0,0,418.95,0,201612.31,24,5,15,10,True
4855765,115,2,-1,4246,522241840,0,1,0,419.02,4,201612.31,3,5,2,10,True
4928558,307,4,451,1834,522241840,0,0,0,418.91,7,201193.4,4,3,22,11,True
4947468,239,1,10,1895,522241840,0,0,0,418.78,0,201612.18,26,6,15,11,True
5023005,1069,1,10,3280,522241840,0,0,0,419.02,6,202031.2,18,6,16,11,True
5166682,1388,1,10,1895,522241840,0,0,0,419.08,6,202450.28,24,6,21,11,True
5381937,65,3,451,3180,522241840,0,0,0,419.2,7,202031.08,20,2,23,12,True
5404025,913,0,25,3199,522241840,0,0,0,418.97,8,201612.11,18,1,18,2,True
5561764,458,3,451,1655,522241840,0,0,0,418.66,7,201193.45,13,3,5,3,True
5600186,458,3,-1,3247,522241840,0,1,0,418.81,4,201193.45,13,4,19,3,True
5712336,918,2,-1,1669,522241840,0,2,0,418.95,4,201193.45,18,2,17,4,True
5900770,65,3,451,5573,522241840,0,0,0,418.79,7,200774.66,20,5,7,4,True
5996452,183,1,10,8455,522241840,0,0,0,419.11,6,201193.77,18,5,10,4,True
6035982,913,0,451,1834,522241840,0,0,0,418.69,7,200775.08,18,2,7,5,True
6300872,913,0,25,3271,522241840,0,0,0,418.96,8,200356.12,18,6,14,5,True
6306048,1314,2,20,1399,522241840,0,0,0,419.08,5,199937.04,5,4,0,8,True
6411616,918,2,30,4729,522241840,0,0,0,419.25,8,199517.79,18,5,9,9,True
6420277,913,0,-1,3199,522241840,0,1,0,418.8,4,199517.79,18,1,21,10,True
6461248,458,3,451,1821,522241840,0,0,0,418.88,7,199098.91,13,3,10,10,True
6656892,458,3,30,6525,522241840,0,0,0,418.94,8,198679.97,13,0,19,11,False
6907170,498,0,20,1851,522241840,0,0,0,419.09,5,198260.88,12,4,6,2,True
6966385,370,4,25,7568,522241840,0,0,0,419.0,8,197841.88,25,2,1,2,True
7083127,115,2,25,9728,522241840,0,0,0,418.94,8,197422.94,3,4,20,3,True
7146880,115,2,25,3271,522241840,0,0,0,418.72,8,197004.22,3,1,19,4,True
7456061,918,2,30,1834,522241840,0,0,0,418.8,8,196585.42,18,2,4,4,True
7541438,577,0,20,3180,522241840,0,0,0,418.95,3,196166.47,11,1,14,5,True
7687430,817,4,30,1851,522241840,0,0,0,419.08,8,195747.39,18,3,22,6,True
8481704,115,2,30,4246,522241840,0,0,0,418.89,8,195328.5,3,3,23,7,True
8598787,307,4,30,1851,522241840,0,0,0,418.83,8,194909.67,4,3,6,7,True
9048723,362,0,10,1851,522241840,0,0,0,419.05,6,195328.72,24,2,3,7,True
9587566,127,1,10,9091,522241840,0,0,0,418.94,6,195747.66,18,6,19,10,True
9654907,220,0,10,3247,522241840,0,0,0,418.98,6,196166.64,26,6,11,10,True
9721966,370,4,451,6525,522241840,0,0,0,418.67,7,195747.97,25,5,5,11,True
9729747,65,3,25,4729,522241840,0,0,0,418.73,8,195329.24,20,0,12,11,True
1511918,490,4,25,2312,475369946,1,0,0,514.87,8,259440.13,12,1,13,1,True
1519568,268,2,451,5345,475369946,1,0,0,514.98,7,258925.15,24,6,4,2,True
1663151,1052,0,20,5159,475369946,1,0,0,515.25,5,258409.9,11,6,19,2,True
2095449,268,2,-1,1338,475369946,1,1,0,514.82,4,258409.9,24,4,3,3,True
2422064,719,4,451,4299,475369946,1,0,0,514.82,7,257895.08,11,4,12,3,True
2455492,950,0,451,6772,475369946,1,0,0,515.15,7,257379.93,24,5,18,3,True
2500243,268,2,25,1921,475369946,1,0,0,514.88,8,256865.05,24,3,13,3,True
2566765,65,3,30,7953,475369946,1,0,0,514.78,8,256350.27,20,0,5,4,True
2698512,670,0,10,1338,475369946,1,0,0,515.27,6,256865.54,18,6,4,5,True
2952616,268,2,30,5691,475369946,1,0,0,514.9,8,256350.64,24,1,15,5,True
3057192,399,2,20,5345,475369946,1,0,0,514.89,5,255835.75,10,2,22,6,True
3249927,719,4,30,7014,475369946,1,0,0,515.02,8,255320.73,11,5,21,6,True
3251893,215,0,20,4216,475369946,1,0,0,514.79,5,254805.94,9,0,13,6,True
3298596,1271,0,20,1960,475369946,1,0,0,515.13,5,254290.81,23,3,12,7,True
3404728,367,1,10,1338,475369946,1,0,0,514.9,6,254805.71,25,6,22,7,True
3623651,490,4,30,6309,475369946,1,0,0,515.02,8,254290.69,12,5,16,9,True
3985384,719,4,451,5903,475369946,1,0,0,514.7,7,253775.99,11,4,11,10,True
4035894,719,4,25,7953,475369946,1,0,0,515.13,8,253260.86,11,4,17,10,True
4169427,719,4,451,6772,475369946,1,0,0,514.91,7,252745.95,11,5,2,11,True
4284586,719,4,-1,9249,475369946,1,1,0,514.94,4,252745.95,11,1,14,11,True
4432255,65,3,25,7953,475369946,1,0,0,515.2,8,252230.75,20,1,5,12,True
4710021,950,0,30,5345,475369946,1,0,0,515.03,8,251715.72,24,4,18,12,True
4717308,268,2,451,1374,475369946,1,0,0,514.74,7,251200.98,24,1,6,12,True
4754089,490,4,25,5159,475369946,1,0,0,514.89,8,250686.09,12,5,4,12,True
4756339,268,2,451,6309,475369946,1,0,0,514.88,7,250171.21,24,0,6,1,True
4906141,490,4,25,4236,475369946,1,0,0,514.83,8,249656.38,12,0,21,2,True
5025779,1093,0,20,1960,475369946,1,0,0,514.92,3,249141.46,18,4,2,2,True
5132133,719,4,451,9249,475369946,1,0,0,514.79,7,248626.67,11,2,2,4,True
5345791,599,0,10,5903,475369946,1,0,0,514.92,6,249141.59,24,3,5,4,True
5516914,268,2,25,1960,475369946,1,0,0,514.72,8,248626.87,24,4,9,5,True
5697095,807,0,20,8822,475369946,1,0,0,515.01,5,248111.86,11,5,8,5,True
5768575,160,0,10,7014,475369946,1,0,0,514.98,0,248626.84,24,1,15,5,True
5906689,341,0,20,2066,475369946,1,0,0,515.37,5,248111.47,24,6,15,6,True
6025809,950,0,451,1960,475369946,1,0,0,515.05,7,247596.42,24,6,1,6,True
6026921,950,0,25,7422,475369946,1,0,0,515.35,8,247081.07,24,0,4,6,True
6219126,490,4,451,4824,475369946,1,0,0,515.05,7,246566.02,12,4,17,6,True
6362718,950,0,451,1814,475369946,1,0,0,514.63,7,246051.39,24,2,1,7,True
7110250,268,2,451,1374,475369946,1,0,0,514.78,7,245536.61,24,3,13,7,True
7140450,950,0,30,7014,475369946,1,0,0,515.15,8,245021.46,24,1,7,8,True
7266104,951,0,20,4724,475369946,1,0,0,514.79,3,244506.67,24,4,4,8,True
7305405,318,0,10,7014,475369946,1,0,0,514.91,6,245021.58,11,2,2,9,True
7749192,865,0,10,5159,475369946,1,0,0,514.69,6,245536.27,24,1,13,10,False
7834061,1315,0,10,7422,475369946,1,0,0,514.99,6,246051.26,5,1,23,10,True
7853176,268,2,451,1921,475369946,1,0,0,515.01,7,245536.25,24,2,8,11,True
7985158,719,4,-1,6325,475369946,1,1,0,514.92,1,245536.25,11,6,8,11,True
8300869,65,3,451,1960,475369946,1,0,0,514.78,7,245021.47,20,4,8,1,True
8376757,490,4,451,7953,475369946,1,0,0,515.28,7,244506.19,12,1,9,1,True
8582529,950,0,25,2066,475369946,1,0,0,515.09,8,243991.1,24,4,19,1,True
8592500,268,2,30,4299,475369946,1,0,0,514.9,8,243476.2,24,2,16,1,True
8617664,65,3,25,4650,475369946,1,0,0,515.11,8,242961.09,20,3,15,2,True
8821871,1063,0,20,5903,475369946,1,0,0,515.27,5,242445.82,11,0,9,3,True
8922864,1455,2,20,4216,475369946,1,0,0,514.85,5,241930.97,11,1,22,4,True
8946982,1014,1,10,1814,475369946,1,0,0,515.03,6,242446.0,26,6,16,5,True
9036766,268,2,25,9848,475369946,1,0,0,515.23,8,241930.77,24,0,2,6,True
9173247,490,4,-1,6772,475369946,1,1,0,515.08,4,241930.77,12,1,0,7,False
9175004,719,4,25,1338,475369946,1,0,0,515.14,8,241415.63,11,2,15,7,True
9219269,719,4,-1,4236,475369946,1,1,0,514.94,1,241415.63,11,3,13,8,True
9223034,1094,0,20,9249,475369946,1,0,0,515.16,3,240900.47,0,1,18,9,True
9632177,65,3,25,4650,475369946,1,0,0,515.11,8,240385.36,20,3,8,9,True
1242257,487,4,30,3939,374027133,0,0,0,1078.23,8,664768.77,12,3,1,1,True
1374881,211,0,10,3394,374027133,0,0,0,1078.08,0,665846.85,9,1,14,3,True
1394799,51,0,10,3394,374027133,0,0,0,1078.17,6,666925.02,20,0,2,3,True
1538852,96,0,-1,7260,374027133,0,1,0,1077.9,4,666925.02,1,4,7,3,True
1579908,487,4,451,8588,374027133,0,0,0,1077.86,7,665847.16,12,0,9,4,True
1656528,486,4,451,1367,374027133,0,0,0,1077.72,7,664769.44,5,4,1,4,True
1866308,486,4,30,7876,374027133,0,0,0,1077.99,8,663691.45,5,5,21,4,True
1915845,1282,2,451,4387,374027133,0,0,0,1077.99,7,662613.46,24,1,18,4,True
2047097,1436,0,20,3394,374027133,0,0,0,1077.76,5,661535.7,24,0,19,6,True
2117766,486,4,30,4387,374027133,0,0,0,1078.03,8,660457.67,5,4,2,7,True
2121003,228,0,20,8588,374027133,0,0,0,1078.07,3,659379.6,26,2,22,8,True
2879072,718,4,451,8588,374027133,0,0,0,1078.01,7,658301.59,18,1,9,9,True
3044621,487,4,25,9675,374027133,0,0,0,1077.84,8,657223.75,12,3,3,9,True
3149191,718,4,-1,1750,374027133,0,1,0,1077.86,4,657223.75,18,0,21,9,True
3387419,96,0,25,8315,374027133,0,0,0,1077.77,8,656145.98,1,3,1,12,True
3511474,399,2,20,8315,374027133,0,0,0,1078.32,5,655067.66,10,6,2,12,True
3832266,718,4,30,7260,374027133,0,0,0,1077.82,8,653989.84,18,1,17,12,True
3847523,718,4,-1,9675,374027133,0,1,0,1078.17,4,653989.84,18,5,13,12,True
3864618,1273,0,10,7876,374027133,0,0,0,1077.77,6,655067.61,24,6,17,1,True
4183379,1307,0,10,4387,374027133,0,0,0,1077.89,0,656145.5,5,2,4,1,True
4402705,718,4,25,2692,374027133,0,0,0,1077.98,8,655067.52,18,6,12,2,True
4753751,486,4,-1,9374,374027133,0,1,0,1077.77,4,655067.52,5,6,20,2,True
4778064,219,0,20,7793,374027133,0,0,0,1078.08,5,653989.44,9,5,5,2,True
4902055,718,4,451,3167,374027133,0,0,0,1077.96,7,652911.48,18,5,23,4,True
5098212,826,1,30,7941,374027133,0,0,0,1077.98,8,651833.5,18,0,9,6,True
5199341,96,0,30,2692,374027133,0,0,0,1078.17,8,650755.33,1,0,5,7,True
5427292,144,1,10,6222,374027133,0,0,0,1077.77,0,651833.1,18,5,0,7,True
5481206,1468,1,10,8315,374027133,0,0,0,1077.59,0,652910.69,11,4,3,9,True
5613788,826,1,30,9374,374027133,0,0,0,1078.05,8,651832.64,18,3,2,11,True
5845526,486,4,30,6222,374027133,0,0,0,1077.85,8,650754.79,5,1,7,12,True
5893358,96,0,451,3167,374027133,0,0,0,1077.93,7,649676.86,1,0,8,1,True
6139332,487,4,25,4555,374027133,0,0,0,1077.67,8,648599.19,12,4,11,2,True
6176688,826,1,-1,9374,374027133,0,1,0,1078.26,4,648599.19,18,1,17,2,False
6203572,826,1,25,7260,374027133,0,0,0,1077.9,8,647521.29,18,2,13,2,True
6335893,826,1,451,8315,374027133,0,0,0,1078.01,7,646443.28,18,5,3,2,True
6374208,967,1,10,2692,374027133,0,0,0,1078.08,0,647521.36,13,2,16,3,True
6596464,712,0,20,4387,374027133,0,0,0,1078.33,3,646443.03,18,5,23,3,True
6995283,486,4,25,3394,374027133,0,0,0,1077.76,8,645365.27,5,4,19,5,True
7909443,718,4,451,9675,374027133,0,0,0,1078.0,7,644287.27,18,5,22,5,True
7985253,1336,2,20,7941,374027133,0,0,0,1078.09,3,643209.18,18,1,0,5,False
8042423,718,4,-1,2692,374027133,0,1,0,1077.88,4,643209.18,18,2,5,6,False
8343721,826,1,25,4555,374027133,0,0,0,1078.14,8,642131.04,18,4,9,7,True
8380979,96,0,451,3452,374027133,0,0,0,1078.04,7,641053.0,1,4,18,7,False
8546871,1213,2,20,4452,374027133,0,0,0,1077.98,5,639975.02,24,5,22,8,False
8981913,880,1,10,9675,374027133,0,0,0,1078.31,6,641053.33,27,5,0,8,True
9167897,958,2,20,8315,374027133,0,0,0,1077.94,5,639975.39,13,3,0,9,True
9182531,487,4,25,7793,374027133,0,0,0,1078.0,8,638897.39,12,3,6,9,True
9451372,1282,2,451,3452,374027133,0,0,0,1077.88,7,637819.51,24,6,0,9,True
9588960,1113,1,10,3452,374027133,0,0,0,1077.97,6,638897.48,0,1,11,10,True
9754899,1282,2,30,3394,374027133,0,0,0,1077.96,8,637819.52,24,2,22,11,True
9797968,346,0,20,9374,374027133,0,0,0,1077.96,5,636741.56,24,3,6,11,True
9901353,1282,2,451,1367,374027133,0,0,0,1078.13,7,635663.43,24,0,13,11,True
1016856,1115,1,10,7698,284347475,1,0,0,657.07,6,998456.07,0,6,16,3,True
1082349,785,0,10,8117,284347475,1,0,0,657.09,0,999113.16,14,4,9,3,True
1371605,438,1,10,4122,284347475,1,0,0,656.67,0,999769.83,24,6,11,3,True
1517073,564,0,30,6983,284347475,1,0,0,657.24,8,999112.59,17,6,23,3,True
1696623,542,0,10,8861,284347475,1,0,0,657.13,6,999769.72,17,5,6,5,True
1751424,1088,4,30,9012,284347475,1,0,0,656.9,8,999112.82,18,5,22,5,False
1768362,553,1,25,7783,284347475,1,0,0,657.02,8,998455.8,17,6,17,5,True
1929383,1111,0,30,5337,284347475,1,0,0,656.97,8,997798.83,0,5,23,6,True
2091544,1088,4,-1,3465,284347475,1,1,0,656.89,1,997798.83,18,0,1,6,False
2635077,564,0,451,8446,284347475,1,0,0,656.95,7,997141.88,17,2,18,7,True
2650040,553,1,451,7783,284347475,1,0,0,656.79,7,996485.09,17,6,3,8,True
2848969,1111,0,25,8519,284347475,1,0,0,657.25,8,995827.84,0,6,15,8,True
2852804,564,0,-1,8290,284347475,1,1,0,656.8,1,995827.84,17,2,18,10,True
3093621,553,1,30,5458,284347475,1,0,0,656.79,8,995171.05,17,1,13,10,True
3098819,553,1,25,8446,284347475,1,0,0,656.59,8,994514.46,17,3,20,10,True
3249556,497,0,20,7545,284347475,1,0,0,657.09,3,993857.37,12,3,11,11,True
3251960,455,4,25,4122,284347475,1,0,0,657.01,8,993200.36,13,5,3,11,True
3557086,35,2,20,9012,284347475,1,0,0,656.88,5,992543.48,11,3,0,12,True
3686131,1132,0,20,8861,284347475,1,0,0,657.35,5,991886.13,24,4,7,12,False
4165529,1088,4,30,8117,284347475,1,0,0,657.04,8,991229.09,18,6,14,12,False
4213038,1256,2,20,7698,284347475,1,0,0,657.07,5,990572.02,23,2,17,12,True
4213476,823,4,451,6983,284347475,1,0,0,656.99,7,989915.03,18,0,4,1,True
4367060,327,0,10,5458,284347475,1,0,0,657.13,6,990572.16,11,4,12,1,True
4425575,564,0,451,8861,284347475,1,0,0,656.9,7,989915.26,17,3,20,2,True
4505017,1111,0,30,8216,284347475,1,0,0,657.11,8,989258.15,0,5,10,2,True
4645605,1111,0,-1,4122,284347475,1,1,0,657.01,4,989258.15,0,5,4,2,True
4887361,951,0,25,6246,284347475,1,0,0,657.13,8,988601.02,24,0,20,3,True
5136632,362,0,20,8519,284347475,1,0,0,656.9,5,987944.12,24,6,5,3,True
5180264,553,1,30,9012,284347475,1,0,0,656.86,8,987287.26,17,3,8,4,True
5276543,373,1,10,8216,284347475,1,0,0,656.85,0,987944.11,25,4,19,4,True
5685446,234,0,10,8117,284347475,1,0,0,656.94,6,988601.05,26,1,17,5,True
6120461,455,4,451,8216,284347475,1,0,0,656.84,7,987944.21,13,4,14,5,True
6266921,252,4,30,8290,284347475,1,0,0,657.15,8,987287.06,6,5,8,5,True
6365977,642,0,20,5458,284347475,1,0,0,656.96,5,986630.1,24,5,5,6,True
6392966,823,4,451,7783,284347475,1,0,0,657.02,7,985973.08,18,4,3,6,False
6635181,564,0,30,8446,284347475,1,0,0,657.2,8,985315.88,17,4,18,9,True
6756568,1088,4,25,8519,284347475,1,0,0,657.21,8,984658.67,18,0,9,10,True
6891791,1088,4,-1,7545,284347475,1,1,0,657.03,1,984658.67,18,2,9,11,True
7121709,1015,0,10,8290,284347475,1,0,0,657.14,6,985315.81,26,4,8,12,True
7183964,1111,0,30,6246,284347475,1,0,0,657.1,8,984658.71,0,6,14,1,True
7299165,553,1,451,6246,284347475,1,0,0,656.88,7,984001.83,17,6,18,1,True
7495011,252,4,30,8117,284347475,1,0,0,656.82,8,983345.01,6,4,2,2,True
7654235,455,4,451,8216,284347475,1,0,0,656.99,7,982688.02,13,4,19,2,True
7728018,1088,4,451,6983,284347475,1,0,0,657.0,7,982031.02,18,4,5,2,True
7782530,553,1,451,3465,284347475,1,0,0,657.18,7,981373.84,17,4,6,2,False
7842725,553,1,451,8117,284347475,1,0,0,656.93,7,980716.91,17,0,9,3,True
7966222,455,4,451,5337,284347475,1,0,0,657.28,7,980059.63,13,2,19,3,True
8038005,1485,0,10,8290,284347475,1,0,0,656.91,6,980716.54,24,4,11,3,True
8261275,455,4,451,6983,284347475,1,0,0,656.78,7,980059.76,13,1,5,4,True
8488165,1111,0,25,8446,284347475,1,0,0,656.98,8,979402.78,0,3,5,4,True
8570165,951,0,451,7545,284347475,1,0,0,657.23,7,978745.55,24,4,23,6,True
8734415,951,0,30,8519,284347475,1,0,0,656.88,8,978088.67,24,2,6,6,True
9039304,564,0,451,8519,284347475,1,0,0,656.77,7,977431.9,17,2,2,7,True
9199237,727,0,20,5337,284347475,1,0,0,657.1,5,976774.8,11,2,15,8,True
9236481,553,1,451,8861,284347475,1,0,0,657.0,7,976117.8,17,4,8,10,True
9267863,455,4,25,8861,284347475,1,0,0,657.35,8,975460.45,13,3,8,10,True
9486586,1111,0,451,8290,284347475,1,0,0,656.96,7,974803.49,0,6,5,10,True
9952200,1111,0,451,8290,284347475,1,0,0,657.24,7,974146.25,0,5,6,11,True
1036393,1150,0,451,7454,753423592,1,0,0,1163.92,7,583533.08,15,2,5,3,True
1150417,1412,2,20,7454,753423592,1,0,0,1164.12,5,582368.96,24,2,7,4,False
1270201,1327,4,451,9138,753423592,1,0,0,1163.81,7,581205.15,18,2,22,5,True
1558995,1124,0,25,5602,753423592,1,0,0,1164.06,8,580041.09,24,5,7,7,True
1651255,1087,4,25,5385,753423592,1,0,0,1164.01,8,578877.08,18,0,8,7,True
1970875,1297,0,10,5385,753423592,1,0,0,1164.1,0,580041.18,5,0,15,8,True
2177449,634,1,451,4028,753423592,1,0,0,1164.25,7,578876.93,24,2,22,10,True
2297829,1241,3,25,7454,753423592,1,0,0,1164.24,8,577712.69,18,6,9,10,True
2460312,1124,0,25,6567,753423592,1,0,0,1164.02,8,576548.67,24,3,16,11,True
3233197,820,1,10,6567,753423592,1,0,0,1164.12,6,577712.79,18,0,1,5,True
4125651,1142,2,20,7570,753423592,1,0,0,1164.02,5,576548.77,15,2,6,5,True
4141221,1087,4,451,5385,753423592,1,0,0,1164.13,7,575384.64,18,5,17,5,True
4145860,1150,0,451,6727,753423592,1,0,0,1164.15,7,574220.49,15,4,18,7,True
4162885,634,1,30,6492,753423592,1,0,0,1164.1,8,573056.39,24,3,4,8,True
4214232,1124,0,451,3133,753423592,1,0,0,1164.14,7,571892.25,24,4,5,10,True
4348648,1019,0,10,7570,753423592,1,0,0,1164.0,6,573056.25,26,6,16,10,True
4458886,81,0,20,7454,753423592,1,0,0,1164.13,5,571892.12,1,3,10,1,True
4551413,1015,0,20,3133,753423592,1,0,0,1163.92,5,570728.2,26,4,2,3,True
4776854,1087,4,451,6727,753423592,1,0,0,1163.95,7,569564.25,18,4,8,4,True
5071728,851,1,451,7454,753423592,1,0,0,1164.3,7,568399.95,5,0,21,6,True
5171324,1087,4,30,7454,753423592,1,0,0,1164.2,8,567235.75,18,3,7,8,True
5183258,1150,0,-1,2598,753423592,1,1,0,1163.69,4,567235.75,15,5,10,8,True
5218302,634,1,-1,5385,753423592,1,2,0,1164.03,4,567235.75,24,5,22,8,True
5310108,1124,0,-1,6860,753423592,1,3,1,1163.85,4,567235.75,24,3,14,9,True
1161040,718,4,30,8466,502788332,1,0,0,689.0,8,751211.0,18,0,3,1,True
1340732,650,3,30,6547,502788332,1,0,0,689.08,8,750521.92,24,6,7,1,True
1375432,718,4,-1,8485,502788332,1,1,0,688.94,4,750521.92,18,2,19,1,True
1525904,1026,4,-1,8345,502788332,1,2,0,688.92,4,750521.92,11,4,1,1,True
1661690,148,1,10,5634,502788332,1,0,0,689.07,6,751210.99,18,4,3,4,True
1725883,409,4,451,2190,502788332,1,0,0,689.03,7,750521.96,10,6,5,4,True
1904052,800,0,-1,8864,502788332,1,1,0,689.0,4,750521.96,11,1,0,5,True
2454471,800,0,-1,3852,502788332,1,2,0,688.91,1,750521.96,11,4,6,5,True
2888386,409,4,25,5634,502788332,1,0,0,688.85,8,749833.11,10,6,15,5,True
3089113,718,4,25,6547,502788332,1,0,0,688.95,8,749144.16,18,0,5,6,True
3220607,1212,0,10,5941,502788332,1,0,0,689.17,6,749833.33,24,3,7,7,True
3834582,718,4,451,8485,502788332,1,0,0,688.96,7,749144.37,18,0,2,7,True
4102734,409,4,25,6645,502788332,1,0,0,689.12,8,748455.25,10,4,15,7,True
4320033,1026,4,451,1609,502788332,1,0,0,689.04,7,747766.21,11,0,6,8,True
4641440,800,0,25,8345,502788332,1,0,0,689.22,8,747076.99,11,4,10,8,False
4848973,1233,0,20,5811,502788332,1,0,0,688.77,5,746388.22,18,3,22,8,True
4967878,650,3,451,5811,502788332,1,0,0,688.93,7,745699.29,24,1,8,8,True
5063655,800,0,451,8466,502788332,1,0,0,689.0,7,745010.29,11,0,16,9,True
5161287,718,4,451,3852,502788332,1,0,0,689.13,7,744321.16,18,5,16,10,True
5202685,718,4,-1,6547,502788332,1,1,0,689.16,4,744321.16,18,0,14,10,True
5613279,23,0,10,7125,502788332,1,0,0,689.2,6,745010.36,11,3,16,10,True
5749217,274,1,10,1609,502788332,1,0,0,688.82,0,745699.18,24,0,12,10,True
5802360,409,4,451,8495,502788332,1,0,0,688.66,7,745010.52,10,1,0,11,True
5825646,650,3,30,8429,502788332,1,0,0,689.03,8,744321.49,24,1,23,12,True
5850762,1319,1,10,5111,502788332,1,0,0,688.88,6,745010.37,18,4,8,1,True
6171085,1029,0,10,5111,502788332,1,0,0,689.05,6,745699.42,11,3,21,1,True
6420329,445,0,10,3852,502788332,1,0,0,689.02,6,746388.44,13,1,20,1,True
6487654,800,0,451,8485,502788332,1,0,0,689.19,7,745699.25,11,3,16,2,True
6489909,718,4,25,8466,502788332,1,0,0,689.14,8,745010.11,18,0,9,2,True
6717553,718,4,451,8345,502788332,1,0,0,689.01,7,744321.1,18,6,13,4,True
7227123,438,1,10,9218,502788332,1,0,0,689.1,6,745010.2,24,0,18,5,True
7479766,650,3,25,2881,502788332,1,0,0,688.95,8,744321.25,24,3,9,5,False
7573520,834,0,20,9218,502788332,1,0,0,689.25,3,743632.0,5,2,3,6,True
7583866,787,0,10,8345,502788332,1,0,0,688.9,0,744320.9,14,4,13,6,True
7623649,650,3,30,5811,502788332,1,0,0,688.85,8,743632.05,24,6,7,7,True
7849635,409,4,25,2190,502788332,1,0,0,689.09,8,742942.96,10,6,14,11,True
7907529,895,0,20,8495,502788332,1,0,0,688.81,5,742254.15,24,2,15,11,True
7913176,409,4,30,5811,502788332,1,0,0,688.83,8,741565.32,10,5,16,12,True
8029186,650,3,451,5111,502788332,1,0,0,689.13,7,740876.19,24,3,0,12,True
8577954,1026,4,451,2190,502788332,1,0,0,688.93,7,740187.26,11,5,10,2,True
8605287,650,3,30,5111,502788332,1,0,0,688.62,8,739498.64,24,1,4,2,True
8678885,1017,2,20,5237,502788332,1,0,0,688.83,5,738809.81,26,1,15,3,True
8736979,409,4,451,5237,502788332,1,0,0,689.13,7,738120.68,10,0,19,5,True
8740275,1354,0,20,8485,502788332,1,0,0,689.01,3,737431.67,24,1,5,5,True
8821244,812,0,20,5111,502788332,1,0,0,688.89,3,736742.78,18,0,1,6,True
8825667,718,4,25,1609,502788332,1,0,0,689.35,8,736053.43,18,6,16,6,True
8964431,1026,4,-1,5111,502788332,1,1,0,688.87,1,736053.43,11,1,2,6,True
9167688,718,4,25,6547,502788332,1,0,0,688.95,8,735364.48,18,3,20,8,True
9222495,650,3,25,9218,502788332,1,0,0,689.13,8,734675.35,24,5,22,8,True
9297869,718,4,451,6547,502788332,1,0,0,689.18,7,733986.17,18,0,0,9,True
9806907,800,0,30,1609,502788332,1,0,0,688.97,8,733297.2,11,6,0,11,True
9950685,1026,4,451,8864,502788332,1,0,0,688.94,7,732608.26,11,5,18,11,True
1297087,1473,4,-1,6956,256161606,0,1,0,616.88,4,691473.0,24,4,13,1,True
1397263,996,0,20,1319,256161606,0,0,0,617.15,5,690855.85,26,2,22,6,True
1696146,126,1,451,7926,256161606,0,0,0,616.97,7,690238.88,18,1,17,6,True
1772002,812,0,10,2835,256161606,0,0,0,616.89,6,690855.77,18,1,18,6,True
1891801,1199,4,451,6956,256161606,0,0,0,617.18,7,690238.59,24,1,1,6,False
2021266,1473,4,451,1890,256161606,0,0,0,617.05,7,689621.54,24,6,17,7,True
2056395,1284,2,-1,6940,256161606,0,1,0,616.78,4,689621.54,24,3,0,7,True
2088031,1284,2,25,9269,256161606,0,0,0,617.1,8,689004.44,24,1,20,9,True
2226168,634,1,30,1438,256161606,0,0,0,616.89,8,688387.55,24,3,15,12,True
2393103,1284,2,451,6478,256161606,0,0,0,616.92,7,687770.63,24,3,17,1,True
2650729,1199,4,30,3048,256161606,0,0,0,616.96,8,687153.67,24,6,2,1,True
2868945,1473,4,30,6060,256161606,0,0,0,616.88,8,686536.79,24,3,11,1,True
3060024,1364,0,20,1890,256161606,0,0,0,616.98,5,685919.81,16,6,19,1,True
3063615,895,0,10,6060,256161606,0,0,0,617.14,6,686536.95,24,2,6,3,True
3506579,126,1,451,1319,256161606,0,0,0,616.91,7,685920.04,18,4,23,3,True
3629234,1007,2,20,8450,256161606,0,0,0,617.11,3,685302.93,26,2,20,3,True
3763717,1199,4,451,6043,256161606,0,0,0,616.91,7,684686.02,24,3,15,3,True
3930792,126,1,30,6060,256161606,0,0,0,616.86,8,684069.16,18,6,0,4,True
4000406,126,1,30,2249,256161606,0,0,0,617.08,8,683452.08,18,0,12,4,True
4003002,192,2,20,3151,256161606,0,0,0,616.94,5,682835.14,18,4,2,4,True
4043184,126,1,30,7926,256161606,0,0,0,617.18,8,682217.96,18,3,16,5,True
4049308,1199,4,30,2343,256161606,0,0,0,617.11,8,681600.85,24,6,1,6,True
4208479,126,1,451,2110,256161606,0,0,0,616.99,7,680983.86,18,2,8,6,True
4284420,1473,4,30,1438,256161606,0,0,0,617.28,8,680366.58,24,2,8,7,True
4367203,262,2,20,2110,256161606,0,0,0,617.03,5,679749.55,6,6,8,7,True
4589844,1199,4,-1,6043,256161606,0,1,0,616.99,4,679749.55,24,1,1,8,True
4894263,1288,0,10,3702,256161606,0,0,0,617.04,6,680366.59,24,2,9,8,True
4932977,1473,4,451,2602,256161606,0,0,0,617.0,7,679749.59,24,3,10,8,True
5182743,1473,4,-1,2249,256161606,0,1,0,616.95,4,679749.59,24,6,11,9,True
5227530,634,1,-1,5053,256161606,0,2,0,616.79,1,679749.59,24,2,18,9,False
5389977,1227,0,20,1801,256161606,0,0,0,616.82,5,679132.77,18,0,18,9,True
5397873,126,1,30,6540,256161606,0,0,0,617.28,8,678515.49,18,1,4,10,True
5460312,1354,0,10,3702,256161606,0,0,0,617.02,0,679132.51,24,4,11,10,True
5715871,729,0,10,6956,256161606,0,0,0,616.94,0,679749.45,11,2,18,11,True
6044681,942,0,20,3151,256161606,0,0,0,617.05,5,679132.4,24,2,10,11,True
6255430,1284,2,451,2343,256161606,0,0,0,617.01,7,678515.39,24,4,7,12,True
6349709,1127,0,20,6956,256161606,0,0,0,617.2,5,677898.19,24,4,23,1,True
6548663,1199,4,-1,2835,256161606,0,1,0,616.9,4,677898.19,24,5,3,1,False
6869955,1199,4,30,2249,256161606,0,0,0,617.06,8,677281.13,24,6,14,3,True
7151865,1075,0,20,2835,256161606,0,0,0,617.07,3,676664.06,18,4,16,4,True
7426752,1284,2,25,2443,256161606,0,0,0,617.14,8,676046.92,24,1,2,4,True
7750012,1284,2,30,8825,256161606,0,0,0,616.79,8,675430.13,24,2,2,4,True
8052205,126,1,30,7926,256161606,0,0,0,617.17,8,674812.96,18,2,13,5,True
8130217,1199,4,451,2110,256161606,0,0,0,616.68,7,674196.28,24,5,17,6,False
8132303,634,1,25,6043,256161606,0,0,0,616.94,8,673579.34,24,4,8,8,True
8174729,634,1,-1,2343,256161606,0,1,0,617.1,4,673579.34,24,0,14,8,True
8216878,917,0,20,6043,256161606,0,0,0,616.88,5,672962.46,18,6,6,9,True
8261758,1199,4,-1,2156,256161606,0,1,0,616.79,1,672962.46,24,0,19,9,True
8451598,1473,4,451,3048,256161606,0,0,0,617.08,7,672345.38,24,1,19,9,True
9321692,634,1,-1,2343,256161606,0,1,0,617.2,4,672345.38,24,0,15,9,True
9360230,1284,2,451,1438,256161606,0,0,0,617.22,7,671728.16,24,2,2,10,True
9639839,1284,2,-1,2602,256161606,0,1,0,617.26,4,671728.16,24,6,18,10,True
9816039,464,1,10,1801,256161606,0,0,0,617.3,6,672345.46,13,5,22,10,True
1312550,511,1,30,5158,696064152,0,0,0,1183.04,8,804477.96,12,5,22,1,True
1350411,1277,2,25,2235,696064152,0,0,0,1182.81,8,803295.15,24,4,14,1,True
1516357,1164,0,30,9993,696064152,0,0,0,1182.75,8,802112.4,24,1,13,2,True
1677173,470,1,10,4688,696064152,0,0,0,1183.02,0,803295.42,5,3,9,2,True
2041410,1025,1,10,7954,696064152,0,0,0,1183.22,6,804478.64,11,1,1,3,True
2045909,1277,2,451,1664,696064152,0,0,0,1183.27,7,803295.37,24,3,17,3,True
2156043,399,2,20,9741,696064152,0,0,0,1183.35,5,802112.02,10,0,19,3,True
2175387,1304,0,20,1397,696064152,0,0,0,1182.86,5,800929.16,5,0,7,3,True
2339797,1164,0,30,3923,696064152,0,0,0,1183.17,8,799745.99,24,4,17,5,True
2520268,124,3,451,1452,696064152,0,0,0,1183.08,7,798562.91,18,5,15,6,True
2666248,1164,0,25,9536,696064152,0,0,0,1182.79,8,797380.12,24,5,18,6,True
2898293,147,0,20,7954,696064152,0,0,0,1183.08,5,796197.04,18,4,1,6,True
2997515,1203,4,451,8983,696064152,0,0,0,1182.93,7,795014.11,24,3,1,6,True
3026280,811,0,20,2403,696064152,0,0,0,1183.16,5,793830.95,18,4,5,7,True
3144963,446,1,451,6414,696064152,0,0,0,1182.91,7,792648.04,13,6,11,7,True
3339062,907,0,20,6414,696064152,0,0,0,1182.9,5,791465.14,2,1,4,7,True
3342662,446,1,451,1664,696064152,0,0,0,1183.0,7,790282.14,13,4,5,9,True
3377624,511,1,30,5030,696064152,0,0,0,1182.92,8,789099.22,12,3,9,9,True
3463992,124,3,25,5030,696064152,0,0,0,1182.9,8,787916.32,18,4,3,10,True
3933023,1336,2,20,7954,696064152,0,0,0,1182.77,3,786733.55,18,2,10,10,True
4132037,1173,1,30,5030,696064152,0,0,0,1182.93,8,785550.62,24,5,13,11,True
4177937,1173,1,451,7954,696064152,0,0,0,1182.84,7,784367.78,24,5,6,1,True
4483536,511,1,30,2403,696064152,0,0,0,1182.93,8,783184.85,12,5,23,2,True
4543433,446,1,30,3923,696064152,0,0,0,1182.85,8,782002.0,13,3,11,3,True
4719376,1164,0,30,9024,696064152,0,0,0,1183.06,8,780818.94,24,4,17,3,True
4763298,1164,0,25,5030,696064152,0,0,0,1182.98,8,779635.96,24,0,5,4,True
4900450,1277,2,30,8474,696064152,0,0,0,1183.02,8,778452.94,24,5,15,5,True
5408480,714,2,20,4688,696064152,0,0,0,1182.93,5,777270.01,18,4,4,6,True
5684438,1164,0,25,5926,696064152,0,0,0,1183.14,8,776086.87,24,3,11,7,True
5686224,1159,0,20,1397,696064152,0,0,0,1183.15,3,774903.72,15,0,18,7,True
5699455,218,0,20,1397,696064152,0,0,0,1182.94,5,773720.78,9,3,3,8,True
6118730,1401,1,10,1758,696064152,0,0,0,1182.74,0,774903.52,24,1,23,8,True
6128777,297,0,20,3923,696064152,0,0,0,1182.96,5,773720.56,4,0,12,8,True
6529766,537,0,10,1758,696064152,0,0,0,1182.92,6,774903.48,18,1,1,9,True
6650084,1435,2,20,4688,696064152,0,0,0,1183.01,5,773720.47,24,1,9,9,True
6667373,1173,1,451,3135,696064152,0,0,0,1182.89,7,772537.58,24,6,15,11,True
7117647,1203,4,451,7954,696064152,0,0,0,1182.9,7,771354.68,24,4,5,12,True
7186119,1213,2,20,8800,696064152,0,0,0,1183.0,5,770171.68,24,6,0,12,True
7362738,446,1,25,6491,696064152,0,0,0,1183.14,8,768988.54,13,5,0,1,True
7514902,816,0,10,2721,696064152,0,0,0,1182.82,6,770171.36,18,6,13,1,True
7515890,511,1,451,6414,696064152,0,0,0,1182.88,7,768988.48,12,6,1,1,True
7725638,738,2,20,8980,696064152,0,0,0,1182.5,5,767805.98,11,3,10,1,True
7808709,580,0,10,6491,696064152,0,0,0,1182.75,6,768988.73,11,4,11,2,True
8264869,124,3,-1,5158,696064152,0,1,0,1183.01,4,768988.73,18,5,16,3,True
9120535,1277,2,451,1452,696064152,0,0,0,1183.03,7,767805.7,24,3,3,5,True
9127003,1277,2,451,8832,696064152,0,0,0,1182.82,7,766622.88,24,6,16,6,True
9313520,562,1,10,2235,696064152,0,0,0,1182.88,6,767805.76,17,1,6,7,True
9435486,220,0,451,3135,696064152,0,0,0,1182.86,7,766622.9,26,6,20,7,True
9496412,1203,4,25,4688,696064152,0,0,0,1183.13,8,765439.77,24,0,17,10,True
9503959,124,3,451,9024,696064152,0,0,0,1183.24,7,764256.53,18,0,21,11,True
9710704,1203,4,451,8800,696064152,0,0,0,1182.75,7,763073.78,24,1,11,11,True
1033518,274,1,25,1982,316136270,1,0,0,384.11,8,284694.89,24,5,5,1,True
1035453,1228,4,30,2918,316136270,1,0,0,384.31,8,284310.58,18,4,5,1,True
1105779,1239,1,451,4779,316136270,1,0,0,384.0,7,283926.58,18,4,1,3,True
1256970,738,2,20,5533,316136270,1,0,0,383.83,5,283542.75,11,0,10,3,True
1465553,807,0,10,9529,316136270,1,0,0,383.96,6,283926.71,11,5,5,4,True
1549462,618,3,451,9529,316136270,1,0,0,383.79,7,283542.92,11,4,3,4,True
1738946,851,1,10,1982,316136270,1,0,0,383.99,0,283926.91,5,2,16,5,True
1739829,550,0,20,9168,316136270,1,0,0,384.25,5,283542.66,17,3,17,5,True
2005489,618,3,451,9529,316136270,1,0,0,383.9,7,283158.76,11,0,1,5,True
2094960,126,1,10,2900,316136270,1,0,0,383.57,6,283542.33,18,4,17,6,True
2257163,678,4,-1,3462,316136270,1,1,0,383.77,4,283542.33,24,4,2,6,True
2393626,1239,1,30,8626,316136270,1,0,0,384.22,8,283158.11,18,0,4,6,True
2462190,274,1,25,9168,316136270,1,0,0,383.89,8,282774.22,24,5,23,9,True
2886122,618,3,30,3016,316136270,1,0,0,383.78,8,282390.44,11,4,11,9,True
2946618,1228,4,451,3016,316136270,1,0,0,383.99,7,282006.45,18,2,5,10,True
3042088,618,3,30,1982,316136270,1,0,0,384.14,8,281622.31,11,3,11,10,True
3361977,53,0,10,9168,316136270,1,0,0,384.11,6,282006.42,20,5,13,11,True
3392345,634,1,10,1982,316136270,1,0,0,384.18,0,282390.6,24,2,13,12,True
3410431,1228,4,451,9181,316136270,1,0,0,383.95,7,282006.65,18,5,0,12,True
3425095,20,0,20,5533,316136270,1,0,0,384.0,5,281622.65,24,3,10,1,True
4299937,1228,4,-1,9529,316136270,1,1,0,384.15,4,281622.65,18,6,15,1,True
4469417,1228,4,30,3462,316136270,1,0,0,383.97,8,281238.68,18,5,13,3,True
4784722,644,0,20,2900,316136270,1,0,0,384.19,5,280854.49,24,2,21,3,True
4988115,137,2,20,8608,316136270,1,0,0,383.91,5,280470.58,18,5,19,3,True
5049259,678,4,30,9529,316136270,1,0,0,384.02,8,280086.56,24,4,8,3,True
5381100,880,1,25,5870,316136270,1,0,0,384.1,8,279702.46,27,5,18,3,True
5388343,880,1,451,2219,316136270,1,0,0,384.24,7,279318.22,27,0,5,3,True
5571939,1239,1,25,9181,316136270,1,0,0,383.78,8,278934.44,18,1,2,5,True
5625254,1212,0,10,5870,316136270,1,0,0,383.75,0,279318.19,24,1,11,5,True
5686804,618,3,-1,1150,316136270,1,1,0,383.91,4,279318.19,11,6,0,7,True
5768381,618,3,451,5870,316136270,1,0,0,384.04,7,278934.15,11,5,22,7,True
5933927,880,1,451,3016,316136270,1,0,0,384.18,7,278549.97,27,3,11,7,False
5955384,1228,4,451,3462,316136270,1,0,0,383.97,7,278166.0,18,6,11,8,True
6144057,1228,4,451,9529,316136270,1,0,0,383.9,7,277782.1,18,0,20,9,False
6332659,482,1,10,2900,316136270,1,0,0,384.04,6,278166.14,5,3,19,9,True
6373176,567,1,10,5533,316136270,1,0,0,383.86,6,278550.0,11,4,19,12,True
6386568,208,0,451,5533,316136270,1,0,0,384.01,7,278165.99,9,0,19,12,True
6519347,678,4,25,3462,316136270,1,0,0,383.73,8,277782.26,24,5,22,12,True
6538937,1239,1,30,8608,316136270,1,0,0,383.83,8,277398.43,18,4,9,1,True
6793500,895,0,20,8626,316136270,1,0,0,383.82,3,277014.61,24,2,22,1,True
7089412,618,3,-1,2918,316136270,1,1,0,383.85,4,277014.61,11,5,11,2,True
7474663,1170,0,10,8608,316136270,1,0,0,384.21,6,277398.82,24,6,8,2,True
7740006,219,0,10,5533,316136270,1,0,0,384.28,6,277783.1,9,1,0,2,True
7837148,678,4,-1,3016,316136270,1,1,0,383.94,1,277783.1,24,2,7,4,True
7838887,1354,0,10,3462,316136270,1,0,0,383.86,6,278166.96,24,6,19,4,True
8099539,1239,1,30,9181,316136270,1,0,0,384.09,8,277782.87,18,1,5,6,True
8209888,1239,1,-1,5870,316136270,1,1,0,384.17,1,277782.87,18,6,23,6,True
8254226,812,0,10,1982,316136270,1,0,0,383.69,0,278166.56,18,4,1,6,False
8543419,215,0,20,1150,316136270,1,0,0,384.09,5,277782.47,9,4,23,6,True
8546069,1239,1,451,8626,316136270,1,0,0,384.02,7,277398.45,18,1,22,6,True
8763583,618,3,30,9529,316136270,1,0,0,384.11,8,277014.34,11,4,15,6,True
8878737,678,4,451,3462,316136270,1,0,0,383.86,7,276630.48,24,1,7,7,True
9095454,618,3,25,2918,316136270,1,0,0,383.95,8,276246.53,11,5,19,8,True
9178104,1228,4,25,1150,316136270,1,0,0,384.08,8,275862.45,18,0,20,8,True
9472498,880,1,451,2219,316136270,1,0,0,384.01,7,275478.44,27,0,15,9,True
9782919,1228,4,25,3016,316136270,1,0,0,383.96,8,275094.48,18,6,12,9,True
9785521,274,1,30,1150,316136270,1,0,0,384.12,8,274710.36,24,1,2,9,True
9812744,618,3,25,1150,316136270,1,0,0,383.84,8,274326.52,11,3,22,10,True
9819769,208,0,451,1982,316136270,1,0,0,383.94,7,273942.58,9,2,11,10,True
1025545,662,1,25,9284,475293055,0,0,0,793.13,8,973562.87,18,6,15,1,True
1239670,1027,0,20,3417,475293055,0,0,0,793.01,5,972769.86,11,6,6,2,True
1247992,662,1,-1,9032,475293055,0,1,0,793.35,1,972769.86,18,0,2,2,True
1427908,1350,4,30,3376,475293055,0,0,0,793.24,8,971976.62,24,4,14,3,True
2139294,350,0,451,2963,475293055,0,0,0,793.19,7,971183.43,24,1,22,3,True
2458119,1485,0,10,7540,475293055,0,0,0,793.0,6,971976.43,24,0,7,3,True
2528042,605,0,10,2963,475293055,0,0,0,793.24,6,972769.67,24,1,18,3,True
2550591,1350,4,30,4147,475293055,0,0,0,792.98,8,971976.69,24,0,5,4,True
2939799,328,0,30,4323,475293055,0,0,0,792.72,8,971183.97,11,0,10,5,True
3153437,1156,1,10,7125,475293055,0,0,0,793.0,0,971976.97,15,5,5,6,True
3313516,585,2,20,9032,475293055,0,0,0,793.19,3,971183.78,11,6,9,7,True
3666487,394,0,10,7833,475293055,0,0,0,792.89,6,971976.67,10,2,9,7,True
3669497,662,1,451,3376,475293055,0,0,0,792.74,7,971183.93,18,0,23,8,True
3991350,1350,4,25,5015,475293055,0,0,0,792.9,8,970391.03,24,1,23,8,True
4068196,980,1,10,2616,475293055,0,0,0,792.97,6,971184.0,22,0,0,8,True
4130769,1350,4,451,2963,475293055,0,0,0,793.27,7,970390.73,24,1,12,9,True
4207854,350,0,-1,2616,475293055,0,1,0,793.0,1,970390.73,24,2,19,10,True
4284209,1350,4,30,5015,475293055,0,0,0,793.19,8,969597.54,24,1,0,12,True
4391394,804,0,20,1111,475293055,0,0,0,793.01,3,968804.53,11,6,20,12,True
4550489,1148,4,30,3417,475293055,0,0,0,793.0,8,968011.53,15,5,3,12,True
4851962,328,0,451,9032,475293055,0,0,0,792.97,7,967218.56,11,4,18,12,True
5041776,662,1,10,2963,475293055,0,0,0,793.02,6,968011.58,18,0,16,1,True
5105474,806,1,10,7833,475293055,0,0,0,793.1,6,968804.68,11,2,9,1,True
5113880,662,1,-1,5015,475293055,0,1,0,792.85,4,968804.68,18,6,17,2,True
5399449,734,0,10,7125,475293055,0,0,0,792.95,6,969597.63,11,1,16,3,True
5577038,312,0,10,7540,475293055,0,0,0,793.06,6,970390.69,4,5,2,4,True
5735717,328,0,451,5015,475293055,0,0,0,792.71,7,969597.98,11,6,5,4,True
5740882,627,0,20,3417,475293055,0,0,0,792.95,3,968805.03,11,1,10,4,True
5958546,1350,4,25,3417,475293055,0,0,0,792.75,8,968012.28,24,4,18,4,True
6056230,328,0,451,7568,475293055,0,0,0,792.98,7,967219.3,11,0,6,5,True
6370167,1111,0,10,7568,475293055,0,0,0,793.08,6,968012.38,0,3,20,8,True
6412797,879,1,10,4882,475293055,0,0,0,793.01,6,968805.39,27,3,11,9,True
6619161,1148,4,451,7125,475293055,0,0,0,793.15,7,968012.24,15,0,20,10,True
6820251,1148,4,451,7540,475293055,0,0,0,793.0,7,967219.24,15,4,12,11,True
7026652,350,0,451,2616,475293055,0,0,0,793.19,7,966426.05,24,1,6,11,True
7070725,346,0,10,3417,475293055,0,0,0,793.07,6,967219.12,24,0,18,12,True
7070803,350,0,451,3376,475293055,0,0,0,793.18,7,966425.94,24,0,18,2,True
7475938,662,1,451,7568,475293055,0,0,0,792.92,7,965633.02,18,6,14,3,True
7547538,350,0,30,7540,475293055,0,0,0,793.15,8,964839.87,24,1,10,3,True
7698392,1304,0,20,4882,475293055,0,0,0,792.8,5,964047.07,5,4,10,4,True
7714748,350,0,25,6465,475293055,0,0,0,793.08,8,963253.99,24,3,7,5,True
8042710,1148,4,451,3417,475293055,0,0,0,793.06,7,962460.93,15,4,18,5,True
8173742,1350,4,30,3417,475293055,0,0,0,792.93,8,961668.0,24,6,1,5,True
8356607,350,0,25,7540,475293055,0,0,0,793.17,8,960874.83,24,1,8,5,True
8816721,1350,4,25,7125,475293055,0,0,0,793.4,8,960081.43,24,6,4,6,True
8868413,350,0,451,8770,475293055,0,0,0,792.96,7,959288.47,24,3,18,8,True
9207098,350,0,451,9284,475293055,0,0,0,792.97,7,958495.5,24,1,14,9,True
9231685,662,1,451,7540,475293055,0,0,0,793.02,7,957702.48,18,0,23,9,True
9252247,1148,4,25,8770,475293055,0,0,0,793.06,8,956909.42,15,5,16,10,True
9415093,328,0,30,6465,475293055,0,0,0,792.87,8,956116.55,11,4,1,10,True
9457755,1148,4,451,7540,475293055,0,0,0,792.96,7,955323.59,15,2,13,10,True
9883320,662,1,-1,7568,475293055,0,1,0,793.24,4,955323.59,18,5,1,11,True
1013517,1406,0,30,4168,760774347,0,0,0,893.77,8,674210.23,24,2,19,1,True
1350606,591,0,451,8695,760774347,0,0,0,893.92,7,673316.31,24,6,16,1,True
1354910,591,0,451,7933,760774347,0,0,0,893.89,7,672422.42,24,2,23,2,True
1415430,540,4,25,8695,760774347,0,0,0,893.72,8,671528.7,17,0,4,4,True
1668815,1227,0,10,8366,760774347,0,0,0,894.07,0,672422.77,18,4,23,4,True
1707863,1015,0,10,7933,760774347,0,0,0,893.98,0,673316.75,26,5,22,4,True
1935474,591,0,-1,9293,760774347,0,1,0,893.99,4,673316.75,24,6,21,5,True
2229795,1406,0,451,4160,760774347,0,0,0,893.86,7,672422.89,24,1,18,7,True
2414074,591,0,25,8366,760774347,0,0,0,894.13,8,671528.76,24,3,3,7,True
2607266,1300,4,-1,1268,760774347,0,1,0,894.14,4,671528.76,5,2,6,7,True
2833172,540,4,30,7757,760774347,0,0,0,893.74,8,670635.02,17,3,19,8,True
3159411,1311,2,20,8871,760774347,0,0,0,894.05,5,669740.97,5,4,15,9,True
3452035,1034,1,10,5840,760774347,0,0,0,894.07,0,670635.04,11,6,9,10,True
3460930,1047,3,25,9290,760774347,0,0,0,893.89,8,669741.15,11,4,17,10,True
3544804,591,0,451,9293,760774347,0,0,0,894.29,7,668846.86,24,1,17,10,True
3683741,879,1,10,2579,760774347,0,0,0,894.14,6,669741.0,27,3,3,10,True
3709925,1300,4,-1,8734,760774347,0,1,0,894.29,4,669741.0,5,5,22,10,True
3710069,591,0,451,7933,760774347,0,0,0,894.03,7,668846.97,24,0,17,11,True
3759829,1322,2,20,8871,760774347,0,0,0,893.75,5,667953.22,18,3,18,12,True
3823404,1047,3,451,7933,760774347,0,0,0,893.87,7,667059.35,11,3,3,12,True
4035090,1047,3,-1,8734,760774347,0,1,0,893.96,4,667059.35,11,6,6,12,True
4121130,540,4,25,8534,760774347,0,0,0,893.85,8,666165.5,17,2,18,2,True
4167762,540,4,451,6454,760774347,0,0,0,894.15,7,665271.35,17,5,2,3,True
4368392,1406,0,-1,8734,760774347,0,1,0,893.99,4,665271.35,24,2,10,4,True
4432654,1047,3,451,6454,760774347,0,0,0,894.27,7,664377.08,11,2,13,4,True
4605324,1300,4,-1,5840,760774347,0,1,0,893.64,4,664377.08,5,1,9,6,True
4888609,591,0,451,7933,760774347,0,0,0,893.85,7,663483.23,24,3,7,6,True
5002745,1305,2,20,7757,760774347,0,0,0,893.85,5,662589.38,5,4,11,6,True
5496612,1047,3,451,8871,760774347,0,0,0,893.82,7,661695.56,11,5,22,7,True
5521135,1027,0,20,7742,760774347,0,0,0,894.01,3,660801.55,11,3,18,7,True
5582729,1047,3,30,7453,760774347,0,0,0,894.02,8,659907.53,11,0,15,8,True
5684953,540,4,451,5840,760774347,0,0,0,893.92,7,659013.61,17,6,9,10,True
5823651,591,0,30,7933,760774347,0,0,0,893.81,8,658119.8,24,2,11,11,True
6303548,1047,3,451,7757,760774347,0,0,0,894.04,7,657225.76,11,3,15,12,True
6408010,1300,4,451,8366,760774347,0,0,0,893.99,7,656331.77,5,3,18,12,True
6712869,1406,0,451,9293,760774347,0,0,0,894.02,7,655437.75,24,0,12,1,True
6930448,1217,0,10,8672,760774347,0,0,0,894.14,6,656331.89,24,4,6,1,True
6962093,1406,0,25,7757,760774347,0,0,0,893.89,8,655438.0,24,6,17,2,True
7068738,913,0,20,1268,760774347,0,0,0,894.02,3,654543.98,18,3,4,4,True
7116744,591,0,25,1268,760774347,0,0,0,893.96,8,653650.02,24,6,11,4,True
7204937,334,0,10,1321,760774347,0,0,0,894.13,6,654544.15,11,3,13,4,True
7233585,1300,4,25,2579,760774347,0,0,0,894.14,8,653650.01,5,5,18,4,True
7301847,1300,4,30,7933,760774347,0,0,0,894.0,8,652756.01,5,1,11,6,True
7788089,1271,0,20,6454,760774347,0,0,0,894.06,3,651861.95,23,6,0,6,True
8072982,591,0,30,1321,760774347,0,0,0,894.03,8,650967.92,24,2,19,6,True
8293903,591,0,451,5893,760774347,0,0,0,894.27,7,650073.65,24,4,9,6,True
8344147,1047,3,451,1321,760774347,0,0,0,893.96,7,649179.69,11,1,7,7,True
8892104,1300,4,25,7933,760774347,0,0,0,893.9,8,648285.79,5,4,19,7,True
8905403,1406,0,-1,5893,760774347,0,1,0,893.93,4,648285.79,24,5,7,7,True
8945530,129,0,10,8734,760774347,0,0,0,893.95,6,649179.74,18,6,4,8,True
9208178,1300,4,30,8366,760774347,0,0,0,893.83,8,648285.91,5,2,2,8,True
9379382,540,4,451,7742,760774347,0,0,0,894.17,7,647391.74,17,6,8,9,True
9611002,1300,4,-1,8672,760774347,0,1,0,893.85,1,647391.74,5,5,20,11,True
9860847,591,0,451,7933,760774347,0,0,0,893.85,7,646497.89,24,6,8,11,True
9869511,1047,3,30,8672,760774347,0,0,0,893.97,8,645603.92,11,0,12,11,True
1150181,871,0,30,3716,668775790,0,0,0,807.31,8,100296.69,24,0,11,1,False
1433297,190,4,451,2332,668775790,0,0,0,806.92,7,99489.77,18,2,19,1,True
1596188,1461,0,451,7089,668775790,0,0,0,806.9,7,98682.87,11,2,2,5,True
1793787,1326,3,-1,1616,668775790,0,1,0,806.96,4,98682.87,18,4,10,6,True
1844261,190,4,451,7089,668775790,0,0,0,807.21,7,97875.66,18,5,6,7,True
2710012,871,0,451,2446,668775790,0,0,0,806.98,7,97068.68,24,6,16,7,True
2844454,587,2,-1,6652,668775790,0,1,0,807.29,4,97068.68,24,6,20,7,True
3358462,871,0,25,5728,668775790,0,0,0,807.0,8,96261.68,24,0,11,8,True
3384950,579,0,20,5943,668775790,0,0,0,807.16,5,95454.52,11,2,5,8,True
3404719,1146,2,25,8929,668775790,0,0,0,807.15,8,94647.37,15,1,6,9,True
3596523,1461,0,30,3132,668775790,0,0,0,807.02,8,93840.35,11,1,9,9,True
3714871,587,2,451,6652,668775790,0,0,0,806.94,7,93033.41,24,4,14,10,True
3862090,320,1,10,6842,668775790,0,0,0,806.93,6,93840.34,11,6,23,11,True
3897893,871,0,-1,1616,668775790,0,1,0,806.88,4,93840.34,24,0,14,11,True
4023644,838,4,-1,2744,668775790,0,2,0,807.05,4,93840.34,5,5,11,11,True
4162350,1326,3,451,3132,668775790,0,0,0,807.19,7,93033.15,18,6,17,12,True
4387087,1461,0,30,7089,668775790,0,0,0,807.07,8,92226.08,11,5,15,1,True
4846513,29,0,20,2744,668775790,0,0,0,806.85,3,91419.23,11,0,6,1,True
5016005,1326,3,-1,9270,668775790,0,1,0,806.92,1,91419.23,18,3,8,4,True
5360991,1146,2,-1,8303,668775790,0,2,0,806.98,4,91419.23,15,6,8,4,True
5361618,168,0,20,8303,668775790,0,0,0,807.04,5,90612.19,24,5,20,4,True
5909704,190,4,451,6435,668775790,0,0,0,806.87,7,89805.32,18,1,2,4,True
6048009,1146,2,451,8303,668775790,0,0,0,807.01,7,88998.31,15,6,2,4,True
6184809,562,1,451,2332,668775790,0,0,0,806.83,7,88191.48,17,1,20,5,True
6198454,166,4,451,5181,668775790,0,0,0,807.15,7,87384.33,24,6,7,6,True
6251308,871,0,-1,2446,668775790,0,1,0,806.99,4,87384.33,24,2,9,6,True
6334053,1092,1,10,6435,668775790,0,0,0,807.15,6,88191.48,18,6,19,7,True
6546961,166,4,30,8929,668775790,0,0,0,807.13,8,87384.35,24,3,12,9,True
6658729,871,0,30,6435,668775790,0,0,0,806.97,8,86577.38,24,1,0,9,True
6860779,28,1,10,5181,668775790,0,0,0,806.93,0,87384.31,11,2,21,9,True
7082275,1461,0,451,6719,668775790,0,0,0,806.89,7,86577.42,11,2,6,10,True
7191489,1127,0,10,3716,668775790,0,0,0,806.86,6,87384.28,24,2,23,10,True
7208926,522,0,10,9628,668775790,0,0,0,806.82,0,88191.1,18,0,0,11,True
7301804,871,0,451,2744,668775790,0,0,0,806.95,7,87384.15,24,0,18,11,True
7454692,147,0,20,7089,668775790,0,0,0,807.12,5,86577.03,18,1,16,11,True
7587248,1339,2,20,6435,668775790,0,0,0,807.08,3,85769.95,18,4,1,12,True
7648945,574,2,20,6652,668775790,0,0,0,806.98,5,84962.97,11,1,2,12,True
7764318,562,1,25,2566,668775790,0,0,0,806.82,8,84156.15,17,4,15,12,True
7776287,866,0,10,1616,668775790,0,0,0,807.08,6,84963.23,24,1,8,1,True
7794684,1326,3,451,6719,668775790,0,0,0,807.18,7,84156.05,18,4,1,3,True
7926542,562,1,451,9417,668775790,0,0,0,806.82,7,83349.23,17,0,22,3,True
8206085,168,0,10,5728,668775790,0,0,0,806.9,6,84156.13,24,1,10,3,True
8326405,1146,2,30,3825,668775790,0,0,0,807.05,8,83349.08,15,1,19,5,True
8332458,562,1,25,8303,668775790,0,0,0,807.02,8,82542.06,17,3,14,5,True
8532991,166,4,451,2744,668775790,0,0,0,807.0,7,81735.06,24,0,4,5,True
8696168,304,0,20,6652,668775790,0,0,0,806.94,5,80928.12,4,2,3,6,True
8709652,334,0,20,8303,668775790,0,0,0,806.82,5,80121.3,11,6,21,6,True
8798664,28,1,10,1359,668775790,0,0,0,807.05,6,80928.35,11,0,14,7,True
8905853,838,4,451,5181,668775790,0,0,0,806.43,7,80121.92,5,1,17,7,True
9054576,871,0,451,2566,668775790,0,0,0,807.0,7,79314.92,24,2,23,8,True
9083616,687,0,10,3825,668775790,0,0,0,807.03,6,80121.95,24,4,15,8,True
9205723,398,0,20,9628,668775790,0,0,0,807.05,3,79314.9,10,4,23,8,True
9212361,211,0,10,2566,668775790,0,0,0,806.81,6,80121.71,9,2,17,8,True
9410007,838,4,451,6652,668775790,0,0,0,806.88,7,79314.83,5,6,0,9,True
9745965,1461,0,30,7089,668775790,0,0,0,806.97,8,78507.86,11,2,9,9,True
9822534,871,0,25,5181,668775790,0,0,0,806.93,8,77700.93,24,6,4,9,True
9914082,562,1,30,2446,668775790,0,0,0,806.9,8,76894.03,17,6,19,10,True
9918632,838,4,451,8671,668775790,0,0,0,807.23,7,76086.8,5,1,8,10,True
9975241,166,4,-1,3132,668775790,0,1,0,807.44,4,76086.8,24,3,12,10,True
1147925,1084,4,451,7973,704648707,1,0,0,987.83,7,930846.17,18,1,20,1,True
1283843,720,4,30,8072,704648707,1,0,0,988.1,8,929858.07,11,6,21,1,True
1359210,72,4,-1,4389,704648707,1,1,0,988.09,1,929858.07,20,6,12,2,True
1436418,268,2,20,8072,704648707,1,0,0,988.36,5,928869.71,24,0,1,2,True
1673842,720,4,451,1136,704648707,1,0,0,988.03,7,927881.68,11,3,19,3,True
1696275,1470,4,451,3514,704648707,1,0,0,988.2,7,926893.48,11,0,23,3,True
1791244,1470,4,-1,8153,704648707,1,1,0,988.33,4,926893.48,11,4,14,4,True
2351968,72,4,30,1439,704648707,1,0,0,987.9,8,925905.58,20,6,2,4,True
2399849,1112,1,-1,8072,704648707,1,1,0,988.16,4,925905.58,0,3,3,5,True
2485043,1470,4,-1,7973,704648707,1,2,0,987.94,1,925905.58,11,2,9,6,True
2938303,823,4,451,8153,704648707,1,0,0,987.87,7,924917.71,18,4,15,7,True
3042030,1470,4,30,9387,704648707,1,0,0,988.26,8,923929.45,11,2,3,8,True
3052658,1064,0,10,9862,704648707,1,0,0,987.87,6,924917.32,11,4,19,9,True
3310284,1308,3,25,8153,704648707,1,0,0,987.96,8,923929.36,5,0,15,9,True
3662533,720,4,451,7973,704648707,1,0,0,987.98,7,922941.38,11,2,14,10,True
3835247,1112,1,451,1136,704648707,1,0,0,987.8,7,921953.58,0,2,8,11,True
4151396,1470,4,-1,1439,704648707,1,1,0,988.14,4,921953.58,11,3,2,1,True
4228963,72,4,30,8072,704648707,1,0,0,987.86,8,920965.72,20,4,7,2,True
4323576,198,0,20,6655,704648707,1,0,0,988.18,5,919977.54,18,6,6,2,True
4580869,1198,4,30,6699,704648707,1,0,0,988.03,8,918989.51,24,2,16,3,True
4686855,1093,0,10,5450,704648707,1,0,0,987.98,6,919977.49,18,5,23,3,True
4689725,661,4,-1,3337,704648707,1,1,0,988.0,1,919977.49,18,1,20,4,True
4803629,720,4,-1,1889,704648707,1,2,0,988.08,1,919977.49,11,6,19,4,True
5289776,1471,0,20,5450,704648707,1,0,0,987.74,5,918989.75,24,6,14,4,True
5403619,688,0,20,5121,704648707,1,0,0,987.78,5,918001.97,24,2,13,6,True
5425136,695,2,20,4887,704648707,1,0,0,987.96,5,917014.01,24,0,10,6,True
5606341,72,4,-1,2568,704648707,1,1,0,987.9,4,917014.01,20,3,6,8,True
5673012,661,4,30,6699,704648707,1,0,0,987.94,8,916026.07,18,4,17,8,True
6142194,1112,1,25,1439,704648707,1,0,0,987.88,8,915038.19,0,2,11,9,True
6148260,211,0,10,3337,704648707,1,0,0,988.14,6,916026.33,9,4,7,9,True
6487373,1112,1,25,8072,704648707,1,0,0,987.76,8,915038.57,0,5,4,9,True
6547490,1084,4,451,1889,704648707,1,0,0,988.15,7,914050.42,18,6,3,9,True
6558765,1116,0,20,6655,704648707,1,0,0,988.18,5,913062.24,24,2,10,9,True
6715684,720,4,30,6699,704648707,1,0,0,988.07,8,912074.17,11,2,5,10,True
6840210,1308,3,451,6655,704648707,1,0,0,988.17,7,911086.0,5,4,0,11,True
7303426,1084,4,451,8072,704648707,1,0,0,987.85,7,910098.15,18,2,16,1,True
7705679,823,4,30,1136,704648707,1,0,0,988.1,8,909110.05,18,4,6,1,True
7830176,823,4,25,5317,704648707,1,0,0,987.96,8,908122.09,18,4,17,2,True
7855325,1198,4,451,9862,704648707,1,0,0,987.99,7,907134.1,24,4,16,2,True
8069661,1470,4,451,7973,704648707,1,0,0,988.17,7,906145.93,11,6,8,3,True
8345740,341,0,20,6699,704648707,1,0,0,987.69,3,905158.24,24,0,7,3,True
8902008,1308,3,30,3514,704648707,1,0,0,988.15,8,904170.09,5,1,23,3,True
9247170,353,1,10,5317,704648707,1,0,0,988.11,6,905158.2,24,4,7,4,True
9369329,200,0,20,5121,704648707,1,0,0,987.89,5,904170.31,9,4,21,5,True
9462959,1356,2,20,6699,704648707,1,0,0,987.94,5,903182.37,24,6,15,6,True
9494064,1470,4,451,6910,704648707,1,0,0,987.95,7,902194.42,11,3,16,6,True
9832755,823,4,25,8153,704648707,1,0,0,988.12,8,901206.3,18,2,4,7,True
9870881,537,0,10,9862,704648707,1,0,0,987.72,0,902194.02,18,5,4,8,True
9951620,823,4,451,8072,704648707,1,0,0,988.16,7,901205.86,18,0,9,9,True
9969432,1084,4,30,1889,704648707,1,0,0,987.93,8,900217.93,18,2,3,9,True
9991785,1084,4,30,4887,704648707,1,0,0,987.98,8,899229.95,18,3,3,11,True
1144599,502,0,-1,6004,883176016,0,1,0,122.28,4,679719.0,12,1,9,1,True
1196634,502,0,25,5812,883176016,0,0,0,122.11,8,679596.89,12,1,21,1,True
1269358,1112,1,-1,6313,883176016,0,1,0,122.13,4,679596.89,0,5,18,1,False
1307987,1298,0,20,5749,883176016,0,0,0,122.13,3,679474.76,5,0,21,2,True
1503810,502,0,25,3753,883176016,0,0,0,122.11,8,679352.65,12,5,15,3,True
1750701,642,0,20,3434,883176016,0,0,0,122.04,5,679230.61,24,4,6,3,True
2025706,540,4,-1,1845,883176016,0,1,0,121.9,1,679230.61,17,0,23,5,True
2194211,1112,1,451,5812,883176016,0,0,0,121.91,7,679108.7,0,3,12,6,True
2255511,398,0,25,5036,883176016,0,0,0,122.02,8,678986.68,10,3,3,6,True
2374377,787,0,10,9027,883176016,0,0,0,121.82,6,679108.5,14,5,15,7,True
2540988,1319,1,10,6004,883176016,0,0,0,122.06,6,679230.56,18,3,4,8,True
2817006,1249,2,30,2304,883176016,0,0,0,121.75,8,679108.81,23,5,18,8,True
3163939,398,0,451,3753,883176016,0,0,0,122.07,7,678986.74,10,4,0,9,True
3439744,540,4,30,6004,883176016,0,0,0,121.9,8,678864.84,17,0,23,10,True
3772468,1429,0,20,7970,883176016,0,0,0,121.98,5,678742.86,24,0,12,10,True
4005375,944,2,20,3434,883176016,0,0,0,121.86,5,678621.0,24,5,14,10,True
4136117,398,0,451,7970,883176016,0,0,0,121.9,7,678499.1,10,1,14,12,True
4346113,540,4,-1,6004,883176016,0,1,0,122.08,4,678499.1,17,3,16,1,True
4484489,1112,1,25,8622,883176016,0,0,0,121.72,8,678377.38,0,6,11,2,True
4545647,168,0,20,1845,883176016,0,0,0,122.19,5,678255.19,24,5,16,2,True
4916980,502,0,25,1845,883176016,0,0,0,121.99,8,678133.2,12,0,18,2,True
5024295,1249,2,-1,2304,883176016,0,1,0,121.95,4,678133.2,23,6,11,2,True
5031076,540,4,30,7970,883176016,0,0,0,121.79,8,678011.41,17,0,11,3,True
5292057,1112,1,451,3753,883176016,0,0,0,122.09,7,677889.32,0,1,7,4,True
5510607,398,0,451,8622,883176016,0,0,0,121.82,7,677767.5,10,3,14,5,True
5564058,540,4,451,8622,883176016,0,0,0,122.0,7,677645.5,17,0,9,7,True
5640516,1249,2,25,1859,883176016,0,0,0,122.13,8,677523.37,23,1,18,8,True
5677119,502,0,25,7970,883176016,0,0,0,122.09,8,677401.28,12,0,6,9,True
6078541,1112,1,25,3434,883176016,0,0,0,122.24,8,677279.04,0,5,10,9,True
6117263,1249,2,25,3753,883176016,0,0,0,122.06,8,677156.98,23,4,21,10,True
6532390,540,4,25,4877,883176016,0,0,0,122.03,8,677034.95,17,0,12,10,True
6578907,1249,2,25,4877,883176016,0,0,0,121.77,8,676913.18,23,6,21,11,True
6605379,502,0,-1,5223,883176016,0,1,0,121.89,4,676913.18,12,2,22,11,True
6929985,398,0,451,6313,883176016,0,0,0,121.9,7,676791.28,10,4,13,11,True
6955155,268,2,20,7970,883176016,0,0,0,122.05,3,676669.23,24,6,6,12,True
7026375,540,4,25,1859,883176016,0,0,0,121.96,8,676547.27,17,6,16,1,True
7231677,540,4,451,1845,883176016,0,0,0,122.01,7,676425.26,17,2,9,2,True
7267162,398,0,451,7970,883176016,0,0,0,121.72,7,676303.54,10,4,14,2,True
7277360,502,0,451,5223,883176016,0,0,0,122.12,7,676181.42,12,5,18,3,True
7374916,1249,2,25,3434,883176016,0,0,0,122.29,8,676059.13,23,6,9,3,True
7393933,1112,1,451,3753,883176016,0,0,0,122.09,7,675937.04,0,2,4,5,True
7743654,398,0,30,6313,883176016,0,0,0,122.0,8,675815.04,10,0,17,5,True
7864246,502,0,451,1845,883176016,0,0,0,122.0,7,675693.04,12,5,15,6,True
7914056,1249,2,30,5036,883176016,0,0,0,121.96,8,675571.08,23,4,13,7,True
8205226,1152,0,20,3753,883176016,0,0,0,121.8,3,675449.28,15,5,11,7,True
8224553,398,0,-1,1845,883176016,0,1,0,122.09,1,675449.28,10,1,8,7,True
8394858,223,2,20,5749,883176016,0,0,0,121.89,5,675327.39,26,1,15,7,False
8610354,540,4,451,5036,883176016,0,0,0,122.21,7,675205.18,17,5,20,8,True
8665763,929,0,20,8622,883176016,0,0,0,122.2,5,675082.98,18,6,18,8,True
8970971,1426,1,10,5036,883176016,0,0,0,122.06,0,675205.04,24,4,14,8,True
9148588,540,4,25,8622,883176016,0,0,0,122.21,8,675082.83,17,0,7,9,True
9391164,570,2,20,3434,883176016,0,0,0,121.95,3,674960.88,11,5,22,10,True
9606291,502,0,451,2304,883176016,0,0,0,121.86,7,674839.02,12,3,10,10,True
9674020,1267,2,20,6313,883176016,0,0,0,121.99,5,674717.03,23,3,4,10,True
9915465,540,4,30,1845,883176016,0,0,0,121.81,8,674595.22,17,4,12,11,True
1092459,592,4,451,4272,981768769,0,0,0,126.3,7,350974.7,24,4,11,1,True
1535557,1205,0,10,9054,981768769,0,0,0,126.01,6,351100.71,24,1,9,1,True
1916558,1450,4,30,3763,981768769,0,0,0,126.23,8,350974.48,11,3,20,2,True
2085306,910,0,10,7347,981768769,0,0,0,126.17,6,351100.65,18,1,7,3,True
2444684,1450,4,451,7279,981768769,0,0,0,126.12,7,350974.53,11,6,20,4,True
2464283,1017,2,20,9108,981768769,0,0,0,126.12,5,350848.41,26,2,1,4,True
2716708,723,1,-1,7571,981768769,0,1,0,126.01,4,350848.41,11,3,12,4,True
2752063,1206,0,20,3821,981768769,0,0,0,126.06,3,350722.35,24,4,15,4,True
2788857,607,2,-1,7869,981768769,0,1,0,126.24,4,350722.35,24,0,9,5,True
2979231,135,2,20,4240,981768769,0,0,0,125.89,3,350596.46,18,5,9,6,True
3487824,1113,1,-1,7279,981768769,0,1,0,126.17,4,350596.46,0,5,21,6,True
3771663,1113,1,-1,9108,981768769,0,2,0,126.02,1,350596.46,0,6,22,6,True
3771670,403,0,20,3821,981768769,0,0,0,125.99,3,350470.47,10,4,19,6,True
3959715,1113,1,-1,9752,981768769,0,1,0,125.8,4,350470.47,0,6,14,9,True
4667057,1113,1,451,4240,981768769,0,0,0,125.95,7,350344.52,0,6,13,10,True
4774766,147,0,10,2090,981768769,0,0,0,126.03,6,350470.55,18,3,4,11,True
4965205,304,0,10,9788,981768769,0,0,0,126.06,6,350596.61,4,3,21,11,True
5001952,1113,1,30,7347,981768769,0,0,0,126.18,8,350470.43,0,3,14,12,True
5115569,1113,1,30,4272,981768769,0,0,0,125.86,8,350344.57,0,3,14,12,True
5188816,1450,4,451,9108,981768769,0,0,0,126.12,7,350218.45,11,6,7,1,True
5204006,1276,4,451,9788,981768769,0,0,0,126.13,7,350092.32,24,5,13,1,True
5426540,790,0,20,5532,981768769,0,0,0,125.92,3,349966.4,11,4,12,2,True
5620773,1307,0,10,7347,981768769,0,0,0,126.07,6,350092.47,5,2,18,3,True
5683889,607,2,25,5590,981768769,0,0,0,126.13,8,349966.34,24,1,9,4,True
5942752,1113,1,25,1759,981768769,0,0,0,125.9,8,349840.44,0,1,18,5,True
6125906,1276,4,451,3763,981768769,0,0,0,126.22,7,349714.22,24,4,22,6,True
6138434,834,0,451,2090,981768769,0,0,0,125.97,7,349588.25,5,6,4,6,True
6194930,1450,4,30,7869,981768769,0,0,0,126.0,8,349462.25,11,4,20,6,True
6297326,1488,0,20,7347,981768769,0,0,0,125.77,3,349336.48,24,6,11,6,True
6375121,723,1,-1,9054,981768769,0,1,0,126.07,1,349336.48,11,5,8,9,True
6384338,533,2,20,5590,981768769,0,0,0,125.94,5,349210.54,18,5,22,9,True
6399947,723,1,-1,2076,981768769,0,1,0,126.02,4,349210.54,11,0,6,10,True
6473194,834,0,25,2090,981768769,0,0,0,126.1,8,349084.44,5,5,16,11,True
6569126,1307,0,20,4240,981768769,0,0,0,125.8,5,348958.64,5,2,13,11,True
6923369,1459,1,10,2090,981768769,0,0,0,126.08,6,349084.72,11,0,7,12,True
7056566,304,0,451,3763,981768769,0,0,0,125.93,7,348958.79,4,6,3,12,True
7579333,1276,4,451,7869,981768769,0,0,0,125.91,7,348832.88,24,5,17,4,True
7604963,607,2,30,3821,981768769,0,0,0,125.77,8,348707.11,24,3,1,4,True
7624432,735,1,10,2076,981768769,0,0,0,125.91,6,348833.02,11,5,2,6,True
7850164,834,0,30,4272,981768769,0,0,0,126.21,8,348706.81,5,6,10,6,True
8061835,723,1,451,2090,981768769,0,0,0,126.1,7,348580.71,11,3,9,7,True
8585228,1276,4,25,5590,981768769,0,0,0,126.06,8,348454.65,24,2,15,7,True
8958820,723,1,30,9752,981768769,0,0,0,126.12,8,348328.53,11,4,7,7,True
9017830,348,0,20,9752,981768769,0,0,0,125.96,3,348202.57,24,1,8,7,True
9075119,834,0,30,4240,981768769,0,0,0,125.79,8,348076.78,5,6,23,7,True
9295528,1476,0,10,9108,981768769,0,0,0,126.16,6,348202.94,24,5,1,8,True
9413061,304,0,25,7869,981768769,0,0,0,125.91,8,348077.03,4,1,5,8,True
9450625,1276,4,25,3763,981768769,0,0,0,126.06,8,347950.97,24,3,4,9,True
9619328,129,0,10,9054,981768769,0,0,0,125.97,0,348076.94,18,2,13,9,True
9685148,592,4,-1,5532,981768769,0,1,0,126.27,4,348076.94,24,5,16,11,True
9801780,834,0,451,9054,981768769,0,0,0,126.06,7,347950.88,5,0,14,11,True
9816525,428,0,20,1759,981768769,0,0,0,126.04,3,347824.84,18,3,0,11,True
1050223,1270,1,451,6362,512331465,0,0,0,906.99,7,367705.01,23,1,13,2,True
1134086,1267,2,20,1992,512331465,0,0,0,906.93,5,366798.08,23,2,15,2,True
1171529,1270,1,25,9307,512331465,0,0,0,906.82,8,365891.26,23,6,15,3,True
1174376,1245,1,25,9984,512331465,0,0,0,907.0,8,364984.26,18,0,22,3,True
1592798,514,4,-1,1744,512331465,0,1,0,906.69,4,364984.26,12,3,7,3,True
1678545,889,0,20,3313,512331465,0,0,0,907.06,3,364077.2,27,4,14,4,True
1772730,1338,0,20,6168,512331465,0,0,0,907.03,5,363170.17,18,6,5,4,True
1891352,1270,1,30,1988,512331465,0,0,0,906.88,8,362263.29,23,6,19,4,True
2009201,1245,1,30,1988,512331465,0,0,0,907.01,8,361356.28,18,3,23,4,True
2111780,627,0,10,3146,512331465,0,0,0,907.12,0,362263.4,11,1,3,5,True
2284580,514,4,30,9747,512331465,0,0,0,907.1,8,361356.3,12,1,11,5,True
2579192,1122,1,10,9705,512331465,0,0,0,906.97,6,362263.27,24,1,19,5,True
2721459,1421,0,30,2048,512331465,0,0,0,906.85,8,361356.42,24,1,23,7,True
2769035,732,0,20,1992,512331465,0,0,0,907.09,5,360449.33,11,4,23,7,True
3403276,1245,1,-1,8249,512331465,0,1,0,907.05,4,360449.33,18,2,23,7,True
3509986,440,4,451,8526,512331465,0,0,0,906.85,7,359542.48,24,6,5,8,True
3663988,268,2,20,7219,512331465,0,0,0,907.1,5,358635.38,24,2,20,9,True
3910641,440,4,25,8249,512331465,0,0,0,906.76,8,357728.62,24,1,4,11,True
3993551,514,4,30,7452,512331465,0,0,0,906.8,8,356821.82,12,2,6,12,True
4205984,1212,0,10,8625,512331465,0,0,0,907.16,6,357728.98,24,2,14,1,True
4379164,1270,1,451,7232,512331465,0,0,0,907.07,7,356821.91,23,1,4,1,True
4569166,514,4,30,6168,512331465,0,0,0,906.78,8,355915.13,12,0,11,2,True
4818812,514,4,25,3038,512331465,0,0,0,906.98,8,355008.15,12,4,8,3,True
4894590,1270,1,451,5703,512331465,0,0,0,906.87,7,354101.28,23,4,17,3,True
4899051,514,4,-1,3038,512331465,0,1,0,907.1,4,354101.28,12,0,17,3,False
5216010,394,0,20,1988,512331465,0,0,0,906.98,5,353194.3,10,1,20,4,True
5258412,1245,1,451,8526,512331465,0,0,0,906.94,7,352287.36,18,5,8,4,True
5386738,1421,0,451,8249,512331465,0,0,0,907.02,7,351380.34,24,3,16,6,True
5400502,804,0,10,1744,512331465,0,0,0,906.95,0,352287.29,11,1,7,6,True
5771527,1270,1,451,5703,512331465,0,0,0,907.08,7,351380.21,23,0,5,7,True
5923763,1421,0,-1,6168,512331465,0,1,0,906.95,4,351380.21,24,2,4,8,True
6142609,1305,2,20,1992,512331465,0,0,0,906.91,3,350473.3,5,4,3,8,True
6307603,440,4,451,9747,512331465,0,0,0,907.01,7,349566.29,24,0,10,9,True
6458319,1270,1,25,1744,512331465,0,0,0,907.1,8,348659.19,23,1,2,9,True
6534315,1421,0,30,6362,512331465,0,0,0,907.09,8,347752.1,24,2,8,11,False
6652149,1245,1,451,5703,512331465,0,0,0,907.1,7,346845.0,18,3,21,12,True
6806130,514,4,30,7232,512331465,0,0,0,907.23,8,345937.77,12,5,11,12,True
6892508,1421,0,-1,6362,512331465,0,1,0,907.01,1,345937.77,24,5,16,12,True
6903869,1421,0,30,5703,512331465,0,0,0,906.62,8,345031.15,24,1,22,12,True
6983441,1245,1,-1,9705,512331465,0,1,0,906.86,4,345031.15,18,1,4,1,True
7441100,1173,1,10,3819,512331465,0,0,0,906.99,0,345938.14,24,4,4,2,True
7554682,1270,1,25,2073,512331465,0,0,0,907.29,8,345030.85,23,1,13,2,True
7829933,440,4,-1,3819,512331465,0,1,0,906.85,1,345030.85,24,4,23,3,True
8167711,1270,1,30,9705,512331465,0,0,0,906.99,8,344123.86,23,2,8,3,True
8273867,440,4,-1,1992,512331465,0,1,0,907.13,4,344123.86,24,3,9,4,True
8579790,440,4,451,2273,512331465,0,0,0,906.62,7,343217.24,24,0,13,4,True
8801804,440,4,451,8249,512331465,0,0,0,907.1,7,342310.14,24,2,12,5,True
9043745,1270,1,-1,8625,512331465,0,1,0,907.3,1,342310.14,23,1,8,6,True
9065670,253,2,20,4063,512331465,0,0,0,906.69,5,341403.45,6,5,9,6,True
9289696,940,1,10,2159,512331465,0,0,0,907.06,6,342310.51,24,1,14,7,True
9405227,1270,1,451,1992,512331465,0,0,0,906.81,7,341403.7,23,6,9,7,True
9411271,1421,0,30,5920,512331465,0,0,0,907.15,8,340496.55,24,4,7,8,True
9659722,403,0,20,3146,512331465,0,0,0,907.14,5,339589.41,10,0,17,10,True
9705271,603,0,10,7219,512331465,0,0,0,906.82,6,340496.23,24,5,10,10,True
9825839,1076,1,10,7219,512331465,0,0,0,907.04,6,341403.27,18,6,11,11,True
9973912,1245,1,25,5920,512331465,0,0,0,906.97,8,340496.3,18,5,2,11,True
9978658,669,2,20,2073,512331465,0,0,0,906.99,3,339589.31,18,5,4,11,True
1354719,1023,2,25,3153,220432344,1,0,0,490.13,8,286080.87,11,5,20,1,True
1721308,445,0,451,9591,220432344,1,0,0,489.72,7,285591.15,13,2,12,1,True
1843665,1218,4,30,9985,220432344,1,0,0,490.01,8,285101.14,24,5,6,1,True
2072633,677,0,20,7429,220432344,1,0,0,490.26,3,284610.88,24,0,22,2,True
2460476,869,2,-1,2236,220432344,1,1,0,490.12,1,284610.88,24,5,14,3,True
2465662,480,0,20,9799,220432344,1,0,0,489.95,5,284120.93,5,3,7,3,True
2606500,1218,4,451,6529,220432344,1,0,0,489.98,7,283630.95,24,2,5,4,True
2631373,1069,1,10,5607,220432344,1,0,0,489.77,0,284120.72,18,6,9,6,True
2761195,867,0,10,7429,220432344,1,0,0,490.04,0,284610.76,24,3,0,6,True
2814825,445,0,-1,3879,220432344,1,1,0,490.14,4,284610.76,13,3,2,8,True
3224467,1218,4,-1,2678,220432344,1,2,0,490.28,1,284610.76,24,3,14,8,True
3253801,68,0,451,3845,220432344,1,0,0,489.96,7,284120.8,20,0,0,8,True
3422349,869,2,25,6418,220432344,1,0,0,490.0,8,283630.8,24,6,1,9,True
3488495,502,0,20,5089,220432344,1,0,0,489.97,3,283140.83,12,0,0,9,True
3615906,445,0,-1,5417,220432344,1,1,0,489.89,1,283140.83,13,2,4,9,True
4585926,952,0,25,4894,220432344,1,0,0,489.95,8,282650.88,13,2,16,9,True
4678423,63,3,30,9591,220432344,1,0,0,490.22,8,282160.66,20,2,7,10,True
4760354,1461,0,10,3436,220432344,1,0,0,489.88,6,282650.54,11,4,14,10,True
4849543,628,0,10,4286,220432344,1,0,0,490.09,6,283140.63,11,1,14,11,True
5015909,1108,1,10,2678,220432344,1,0,0,489.89,6,283630.52,0,4,18,11,True
5110338,952,0,30,5088,220432344,1,0,0,489.91,8,283140.61,13,1,12,12,True
5144386,445,0,451,8809,220432344,1,0,0,489.88,7,282650.73,13,0,13,1,True
5264798,445,0,451,1280,220432344,1,0,0,489.79,7,282160.94,13,1,4,1,True
5284759,1072,0,20,5749,220432344,1,0,0,490.25,5,281670.69,18,1,12,1,False
5297816,445,0,451,4286,220432344,1,0,0,490.19,7,281180.5,13,3,10,1,True
5333555,952,0,30,9971,220432344,1,0,0,489.86,8,280690.64,13,3,1,3,True
5708748,60,4,30,3845,220432344,1,0,0,489.85,8,280200.79,20,3,17,4,True
5765859,1023,2,451,5749,220432344,1,0,0,489.86,7,279710.93,11,6,12,5,True
5821868,1053,1,10,7429,220432344,1,0,0,490.12,6,280201.05,11,5,4,5,True
5832438,1023,2,25,2124,220432344,1,0,0,489.88,8,279711.17,11,4,9,7,True
5859746,63,3,451,3716,220432344,1,0,0,489.75,7,279221.42,20,0,1,7,True
5887649,952,0,30,3845,220432344,1,0,0,490.11,8,278731.31,13,2,21,9,True
5890251,939,0,10,5089,220432344,1,0,0,489.73,0,279221.04,24,3,12,10,True
6024624,952,0,30,3153,220432344,1,0,0,490.16,8,278730.88,13,2,11,10,True
6163379,1218,4,30,6529,220432344,1,0,0,489.94,8,278240.94,24,4,12,11,True
6163439,952,0,25,3436,220432344,1,0,0,490.06,8,277750.88,13,3,12,11,True
6303925,1023,2,30,6760,220432344,1,0,0,489.75,8,277261.13,11,2,4,1,False
6576769,63,3,-1,9985,220432344,1,1,0,490.07,4,277261.13,20,3,5,1,True
6808838,445,0,25,9985,220432344,1,0,0,489.87,8,276771.26,13,6,18,1,True
6866361,1179,0,25,9591,220432344,1,0,0,490.17,8,276281.09,24,5,6,3,True
6927577,68,0,451,3716,220432344,1,0,0,490.19,7,275790.9,20,6,2,3,True
6929407,68,0,451,5417,220432344,1,0,0,489.93,7,275300.97,20,2,10,4,True
6993085,1179,0,451,7429,220432344,1,0,0,490.14,7,274810.83,24,4,12,4,True
7156031,60,4,451,7732,220432344,1,0,0,489.99,7,274320.84,20,4,18,4,True
7207667,1218,4,25,3845,220432344,1,0,0,489.97,8,273830.87,24,2,16,4,True
7463069,869,2,30,9799,220432344,1,0,0,490.17,8,273340.7,24,3,21,7,True
7511668,60,4,-1,3845,220432344,1,1,0,490.07,4,273340.7,20,0,19,7,True
7617090,1023,2,30,5607,220432344,1,0,0,489.88,8,272850.82,11,4,11,8,True
7798787,952,0,10,3879,220432344,1,0,0,489.78,6,273340.6,13,5,20,8,True
7972807,108,2,20,3845,220432344,1,0,0,489.99,5,272850.61,3,6,20,9,True
8339295,952,0,-1,3436,220432344,1,1,0,490.21,4,272850.61,13,3,2,9,True
8358946,869,2,30,3879,220432344,1,0,0,489.93,8,272360.68,24,1,17,9,True
8512548,60,4,30,9985,220432344,1,0,0,490.08,8,271870.6,20,2,14,10,True
9068404,68,0,30,5818,220432344,1,0,0,490.06,8,271380.54,20,5,5,11,True
9230383,1218,4,30,8041,220432344,1,0,0,489.96,8,270890.58,24,3,21,11,True
9235124,1116,0,10,2124,220432344,1,0,0,490.21,6,271380.79,24,4,10,11,True
1108216,804,0,10,7903,682986333,1,0,0,1084.12,6,952784.12,11,6,22,1,True
1155857,1424,4,451,2651,682986333,1,0,0,1084.05,7,951700.07,24,2,9,1,True
1394039,1355,4,451,7166,682986333,1,0,0,1084.26,7,950615.81,24,1,9,1,True
1486499,1355,4,451,3090,682986333,1,0,0,1083.81,7,949532.0,24,4,2,2,True
1572740,1273,0,451,6428,682986333,1,0,0,1083.9,7,948448.1,24,5,3,2,True
1715968,132,2,30,6123,682986333,1,0,0,1083.93,8,947364.17,18,5,22,2,True
1731324,137,2,451,2010,682986333,1,0,0,1084.03,7,946280.14,18,0,0,3,True
1838089,137,2,30,5518,682986333,1,0,0,1084.08,8,945196.06,18,6,9,3,True
1949492,1355,4,451,5763,682986333,1,0,0,1083.78,7,944112.28,24,5,17,4,True
2270380,611,0,20,1671,682986333,1,0,0,1083.91,3,943028.37,11,1,21,4,True
2405743,132,2,451,5682,682986333,1,0,0,1083.99,7,941944.38,18,4,4,6,True
2488147,1424,4,25,2398,682986333,1,0,0,1083.88,8,940860.5,24,1,14,6,True
2582302,780,0,20,4308,682986333,1,0,0,1084.0,3,939776.5,14,1,11,7,True
2765061,203,0,20,4625,682986333,1,0,0,1084.06,5,938692.44,9,4,11,9,True
2956105,137,2,30,9695,682986333,1,0,0,1084.18,8,937608.26,18,0,0,10,True
3548920,1355,4,-1,9695,682986333,1,1,0,1083.75,4,937608.26,24,4,0,11,True
3578406,329,1,10,6825,682986333,1,0,0,1084.11,0,938692.37,11,3,11,11,True
4024788,137,2,-1,6825,682986333,1,1,0,1083.88,1,938692.37,18,2,3,11,True
4073857,749,4,451,6428,682986333,1,0,0,1084.0,7,937608.37,24,0,11,12,True
4176108,749,4,451,6825,682986333,1,0,0,1083.97,7,936524.4,24,0,23,12,True
4906836,1273,0,451,6123,682986333,1,0,0,1084.17,7,935440.23,24,6,21,1,True
4922465,132,2,25,8332,682986333,1,0,0,1084.02,8,934356.21,18,1,12,1,False
5082914,51,0,20,4308,682986333,1,0,0,1084.12,5,933272.09,20,4,2,2,True
5095634,1276,4,451,5908,682986333,1,0,0,1083.82,7,932188.27,24,0,3,4,True
5122650,1273,0,451,5682,682986333,1,0,0,1083.9,7,931104.37,24,1,3,4,True
5299132,1273,0,451,9695,682986333,1,0,0,1084.11,7,930020.26,24,3,14,5,True
5324343,1276,4,25,7166,682986333,1,0,0,1084.13,8,928936.13,24,1,10,5,True
5427556,1424,4,25,4308,682986333,1,0,0,1084.12,8,927852.01,24,1,11,6,True
5502728,132,2,451,7903,682986333,1,0,0,1084.22,7,926767.79,18,1,7,7,True
5713039,1273,0,30,7903,682986333,1,0,0,1084.11,8,925683.68,24,6,6,8,True
5758293,1424,4,25,1210,682986333,1,0,0,1084.16,8,924599.52,24,4,5,9,True
6034443,1355,4,30,1671,682986333,1,0,0,1084.09,8,923515.43,24,2,5,9,True
6067358,1119,0,10,9695,682986333,1,0,0,1084.12,6,924599.55,24,4,13,10,True
6173189,319,0,20,4308,682986333,1,0,0,1084.04,3,923515.51,11,1,14,10,True
6413734,664,2,20,4308,682986333,1,0,0,1083.91,5,922431.6,18,1,13,10,True
6442222,1276,4,-1,5745,682986333,1,1,0,1084.13,4,922431.6,24,3,0,11,True
6544242,1424,4,25,2651,682986333,1,0,0,1084.06,8,921347.54,24,0,19,1,False
6873411,132,2,25,2398,682986333,1,0,0,1083.9,8,920263.64,18,3,1,1,True
7018122,1355,4,30,1210,682986333,1,0,0,1084.16,8,919179.48,24,0,18,1,True
7859141,132,2,451,3715,682986333,1,0,0,1083.88,7,918095.6,18,3,3,2,True
7999340,1355,4,30,1671,682986333,1,0,0,1084.1,8,917011.5,24,2,6,2,True
8008304,759,0,20,7193,682986333,1,0,0,1083.96,5,915927.54,24,1,6,3,True
8065540,1276,4,25,2651,682986333,1,0,0,1083.99,8,914843.55,24,2,0,3,True
8131800,1355,4,25,5518,682986333,1,0,0,1083.98,8,913759.57,24,3,1,4,True
8305213,749,4,30,5682,682986333,1,0,0,1083.95,8,912675.62,24,5,12,5,True
8501229,819,2,20,9695,682986333,1,0,0,1083.82,3,911591.8,18,4,23,6,False
8719065,1276,4,30,8332,682986333,1,0,0,1083.93,8,910507.87,24,0,17,6,True
8896056,1276,4,30,6825,682986333,1,0,0,1084.24,8,909423.63,24,2,20,6,True
8952166,137,2,451,2398,682986333,1,0,0,1083.87,7,908339.76,18,1,15,7,True
9008062,1424,4,451,4625,682986333,1,0,0,1084.14,7,907255.62,24,2,11,7,True
9115093,137,2,30,3715,682986333,1,0,0,1084.03,8,906171.59,18,0,9,7,True
9380208,1424,4,-1,8332,682986333,1,1,0,1083.81,4,906171.59,24,6,21,9,True
9796978,749,4,25,6825,682986333,1,0,0,1083.96,8,905087.63,24,2,10,9,True
9898624,137,2,25,1671,682986333,1,0,0,1083.99,8,904003.64,18,6,17,9,False
1245749,931,0,451,3897,538406799,1,0,0,394.15,7,316159.85,24,2,1,2,True
1309819,931,0,25,7723,538406799,1,0,0,394.19,8,315765.66,24,0,17,3,False
1497705,227,4,30,8404,538406799,1,0,0,394.08,8,315371.58,26,2,15,3,True
1633794,1418,3,451,7476,538406799,1,0,0,393.96,7,314977.62,24,0,18,4,True
1637489,723,1,451,5932,538406799,1,0,0,393.79,7,314583.83,11,0,13,5,True
1674312,723,1,30,7723,538406799,1,0,0,394.0,8,314189.83,11,1,8,5,True
2205874,317,4,451,5350,538406799,1,0,0,394.05,7,313795.78,4,2,5,5,True
2243778,974,3,451,7677,538406799,1,0,0,394.16,7,313401.62,22,6,10,5,True
2372043,37,3,451,7476,538406799,1,0,0,394.04,7,313007.58,11,6,10,6,True
2489877,1027,0,20,2848,538406799,1,0,0,393.82,3,312613.76,11,6,0,6,True
2577398,580,0,10,4173,538406799,1,0,0,393.91,6,313007.67,11,2,22,6,True
3145853,1297,0,20,4991,538406799,1,0,0,393.9,5,312613.77,5,4,17,7,True
3339026,1421,0,10,7476,538406799,1,0,0,393.81,6,313007.58,24,6,21,7,True
3473447,909,2,20,7044,538406799,1,0,0,393.97,5,312613.61,18,2,18,7,True
3666492,931,0,30,4991,538406799,1,0,0,394.05,8,312219.56,24,4,22,8,True
3911824,550,0,10,6521,538406799,1,0,0,393.89,0,312613.45,17,2,18,10,True
3916497,317,4,25,7723,538406799,1,0,0,393.81,8,312219.64,4,5,14,10,True
4093159,37,3,30,1080,538406799,1,0,0,394.09,8,311825.55,11,5,10,10,False
4556067,882,0,20,1254,538406799,1,0,0,393.95,3,311431.6,27,5,21,10,True
4564721,723,1,451,1328,538406799,1,0,0,393.96,7,311037.64,11,6,23,11,True
4667824,21,0,10,1080,538406799,1,0,0,393.96,6,311431.6,11,1,19,1,True
4816983,227,4,30,5350,538406799,1,0,0,394.22,8,311037.38,26,6,13,1,True
5582117,974,3,451,5350,538406799,1,0,0,394.19,7,310643.19,22,1,2,2,True
5654705,974,3,-1,2848,538406799,1,1,0,393.8,4,310643.19,22,5,3,2,True
5813270,149,2,20,5932,538406799,1,0,0,394.15,3,310249.04,18,5,18,3,True
6045138,227,4,451,5350,538406799,1,0,0,394.0,7,309855.04,26,4,22,3,True
6477572,1401,1,10,1254,538406799,1,0,0,393.94,6,310248.98,24,1,16,5,True
6596076,931,0,-1,7677,538406799,1,1,0,393.81,1,310248.98,24,5,0,6,True
6745206,723,1,30,4173,538406799,1,0,0,394.01,8,309854.97,11,6,15,6,True
7128633,37,3,451,7723,538406799,1,0,0,394.13,7,309460.84,11,4,8,7,True
7350067,1267,2,20,7476,538406799,1,0,0,393.91,5,309066.93,23,6,16,7,True
7392684,1418,3,451,5298,538406799,1,0,0,394.22,7,308672.71,24,3,3,7,True
7442902,37,3,25,7723,538406799,1,0,0,394.12,8,308278.59,11,5,9,9,True
7572186,931,0,30,2848,538406799,1,0,0,393.96,8,307884.63,24,1,10,9,True
7714467,783,0,10,1254,538406799,1,0,0,394.02,6,308278.65,14,6,21,11,True
7775309,37,3,451,5932,538406799,1,0,0,393.84,7,307884.81,11,2,11,11,True
7990194,567,1,10,4173,538406799,1,0,0,393.78,0,308278.59,11,1,5,12,True
8007981,525,0,20,8830,538406799,1,0,0,393.99,5,307884.6,18,0,14,1,True
8049585,1418,3,-1,5350,538406799,1,1,0,393.83,4,307884.6,24,1,7,1,True
8256174,694,2,20,7677,538406799,1,0,0,393.84,3,307490.76,24,5,3,2,True
8379345,1467,0,20,8475,538406799,1,0,0,393.96,5,307096.8,11,2,10,3,True
8447479,1277,2,20,5932,538406799,1,0,0,393.78,5,306703.02,24,6,11,5,True
8684695,794,2,20,4991,538406799,1,0,0,393.89,5,306309.13,11,4,0,5,True
8717421,931,0,451,2848,538406799,1,0,0,394.11,7,305915.02,24,2,20,6,True
9165639,317,4,451,8404,538406799,1,0,0,393.89,7,305521.13,4,5,2,6,True
9230574,1132,0,10,1328,538406799,1,0,0,393.85,6,305914.98,24,2,16,7,True
9241001,931,0,30,3843,538406799,1,0,0,394.14,8,305520.84,24,3,9,7,True
9543552,37,3,30,5350,538406799,1,0,0,393.92,8,305126.92,11,4,8,8,True
9586228,931,0,30,1328,538406799,1,0,0,393.72,8,304733.2,24,2,7,9,True
9723891,931,0,451,8830,538406799,1,0,0,394.2,7,304339.0,24,5,11,10,True
9882947,723,1,-1,4173,538406799,1,1,0,393.9,4,304339.0,11,4,3,11,True
9989002,1380,0,20,7476,538406799,1,0,0,394.02,5,303944.98,16,5,14,11,True
1283092,580,0,451,4314,964163162,0,0,0,304.2,7,569002.8,11,5,22,2,True
1622876,81,0,451,1913,964163162,0,0,0,304.17,7,568698.63,1,6,8,2,True
1634768,1243,2,30,4876,964163162,0,0,0,304.04,8,568394.59,18,3,10,3,True
2429288,303,0,20,4525,964163162,0,0,0,303.73,5,568090.86,4,1,21,3,True
2685670,537,0,10,7459,964163162,0,0,0,304.07,0,568394.93,18,4,14,4,True
2924762,263,3,451,8484,964163162,0,0,0,304.03,7,568090.9,6,4,5,5,True
3303564,314,0,10,9571,964163162,0,0,0,304.18,6,568395.08,4,4,0,7,True
3361510,381,4,-1,4314,964163162,0,1,0,303.97,4,568395.08,25,4,15,7,True
3441385,263,3,451,1913,964163162,0,0,0,303.89,7,568091.19,6,5,22,8,True
3587718,81,0,25,1770,964163162,0,0,0,303.96,8,567787.23,1,6,0,10,True
4048762,369,1,451,4525,964163162,0,0,0,304.25,7,567482.98,25,0,20,10,True
4106081,81,0,-1,7487,964163162,0,1,0,303.73,4,567482.98,1,3,0,10,True
4130540,369,1,30,7459,964163162,0,0,0,304.0,8,567178.98,25,2,8,11,True
4168182,1267,2,20,2908,964163162,0,0,0,304.12,5,566874.86,23,2,19,11,True
4172732,1243,2,451,8484,964163162,0,0,0,303.87,7,566570.99,18,0,11,12,True
4317672,369,1,451,2908,964163162,0,0,0,303.89,7,566267.1,25,6,11,12,True
4664571,263,3,25,9571,964163162,0,0,0,303.99,8,565963.11,6,3,14,12,True
4818013,1488,0,20,7618,964163162,0,0,0,304.01,5,565659.1,24,6,20,1,True
4965230,580,0,451,2908,964163162,0,0,0,303.89,7,565355.21,11,3,18,1,True
5143778,381,4,-1,2849,964163162,0,1,0,303.95,4,565355.21,25,5,19,1,True
5727553,263,3,451,7618,964163162,0,0,0,303.93,7,565051.28,6,2,23,1,True
5801380,381,4,30,7459,964163162,0,0,0,304.06,8,564747.22,25,3,19,2,True
5973909,378,0,10,8205,964163162,0,0,0,304.23,6,565051.45,25,4,22,2,True
6100536,263,3,451,8020,964163162,0,0,0,304.07,7,564747.38,6,2,16,3,True
6396277,580,0,30,2849,964163162,0,0,0,303.8,8,564443.58,11,1,22,3,True
6726656,381,4,30,4876,964163162,0,0,0,303.93,8,564139.65,25,0,5,3,True
6810245,701,2,20,9571,964163162,0,0,0,303.95,5,563835.7,18,1,15,3,True
6824039,580,0,25,8484,964163162,0,0,0,304.03,8,563531.67,11,2,23,4,True
7353527,263,3,-1,4876,964163162,0,1,0,304.23,1,563531.67,6,1,14,5,True
7513327,14,2,20,7487,964163162,0,0,0,303.82,3,563227.85,24,6,12,7,True
7537240,81,0,-1,7459,964163162,0,1,0,303.82,1,563227.85,1,5,18,10,True
7750030,580,0,30,8205,964163162,0,0,0,304.01,8,562923.84,11,5,16,10,True
7782433,381,4,25,7618,964163162,0,0,0,304.06,8,562619.78,25,5,22,10,True
7845322,381,4,30,2849,964163162,0,0,0,304.09,8,562315.69,25,6,19,11,True
7870253,263,3,25,4314,964163162,0,0,0,303.81,8,562011.88,6,5,21,12,True
7988780,1488,0,10,4876,964163162,0,0,0,304.04,6,562315.92,24,3,0,12,True
8061742,381,4,451,8484,964163162,0,0,0,304.09,7,562011.83,25,3,14,12,True
8248125,390,4,-1,6996,964163162,0,1,0,303.84,4,562011.83,10,6,16,12,True
8444955,457,0,10,7618,964163162,0,0,0,304.01,6,562315.84,13,1,7,1,True
8609868,263,3,451,7618,964163162,0,0,0,304.04,7,562011.8,6,5,0,2,True
8670243,1243,2,25,1913,964163162,0,0,0,303.82,8,561707.98,18,2,14,2,True
8872101,381,4,30,4581,964163162,0,0,0,304.05,8,561403.93,25,0,18,3,True
8904675,390,4,451,4314,964163162,0,0,0,303.97,7,561099.96,10,4,0,4,True
9041535,1007,2,20,8020,964163162,0,0,0,303.95,5,560796.01,26,3,3,5,True
9401423,580,0,30,7618,964163162,0,0,0,303.84,8,560492.17,11,1,20,8,True
9420170,1243,2,25,4876,964163162,0,0,0,304.17,8,560188.0,18,3,16,8,True
9430376,81,0,25,2908,964163162,0,0,0,303.79,8,559884.21,1,1,13,9,True
9536588,263,3,30,7618,964163162,0,0,0,303.74,8,559580.47,6,1,1,9,True
9645877,390,4,25,1913,964163162,0,0,0,304.02,8,559276.45,10,3,2,10,True
9788547,580,0,30,7618,964163162,0,0,0,304.04,8,558972.41,11,0,8,10,True
9930222,81,0,451,4876,964163162,0,0,0,303.85,7,558668.56,1,6,7,11,True
1238279,1254,4,451,5959,778133517,0,0,0,623.95,7,856052.05,23,2,0,1,True
1564531,1305,2,30,6514,778133517,0,0,0,623.74,8,855428.31,5,5,0,1,True
1601452,1232,1,-1,2136,778133517,0,1,0,624.21,4,855428.31,18,2,16,3,True
1695331,1305,2,451,7407,778133517,0,0,0,624.12,7,854804.19,5,4,10,3,True
2079223,1305,2,451,5932,778133517,0,0,0,623.97,7,854180.22,5,3,11,3,True
2142431,699,4,-1,5835,778133517,0,1,0,623.99,1,854180.22,18,0,7,3,True
2210059,917,0,10,5835,778133517,0,0,0,624.2,6,854804.42,18,0,17,4,True
2548782,257,1,10,8604,778133517,0,0,0,623.89,6,855428.31,6,1,15,4,True
2549569,1249,2,-1,7922,778133517,0,1,0,624.04,4,855428.31,23,4,9,5,True
2654550,699,4,30,3069,778133517,0,0,0,623.78,8,854804.53,18,6,20,5,False
2783532,1090,0,30,6514,778133517,0,0,0,624.07,8,854180.46,18,5,23,6,True
3297716,699,4,451,2702,778133517,0,0,0,623.77,7,853556.69,18,1,5,6,True
3464410,249,0,30,6514,778133517,0,0,0,624.1,8,852932.59,6,1,23,6,True
3937774,328,0,10,5651,778133517,0,0,0,624.08,6,853556.67,11,6,22,7,True
4031628,1090,0,25,5651,778133517,0,0,0,623.86,8,852932.81,18,0,4,10,True
4035659,663,4,451,3069,778133517,0,0,0,623.9,7,852308.91,18,1,6,10,True
4040126,1232,1,-1,4677,778133517,0,1,0,623.93,4,852308.91,18,1,21,10,True
4169102,663,4,451,5651,778133517,0,0,0,623.82,7,851685.09,18,0,8,11,True
4331006,699,4,451,4337,778133517,0,0,0,623.9,7,851061.19,18,2,14,11,True
4480089,699,4,25,9251,778133517,0,0,0,624.05,8,850437.14,18,3,17,11,True
4534778,1305,2,451,5932,778133517,0,0,0,623.81,7,849813.33,5,1,23,12,True
4551946,1249,2,-1,9251,778133517,0,1,0,623.96,4,849813.33,23,1,18,12,True
4575240,28,1,10,2136,778133517,0,0,0,624.2,6,850437.53,11,4,17,12,True
4587895,883,0,10,6514,778133517,0,0,0,624.1,6,851061.63,24,5,1,12,True
4687519,699,4,30,5932,778133517,0,0,0,623.71,8,850437.92,18,4,19,1,True
4723487,1090,0,25,7407,778133517,0,0,0,623.92,8,849814.0,18,5,6,1,True
4903649,663,4,451,1736,778133517,0,0,0,624.14,7,849189.86,18,2,19,1,True
4936353,1476,0,10,4153,778133517,0,0,0,624.06,0,849813.92,24,3,10,1,True
5055954,1254,4,30,5959,778133517,0,0,0,624.15,8,849189.77,23,1,18,2,True
5101362,1249,2,25,1241,778133517,0,0,0,624.24,8,848565.53,23,6,9,3,True
5213475,1090,0,10,4677,778133517,0,0,0,623.98,0,849189.51,18,4,15,3,True
5222577,910,0,10,5835,778133517,0,0,0,624.29,6,849813.8,18,2,19,4,True
5250111,1249,2,451,6514,778133517,0,0,0,623.92,7,849189.88,23,0,17,4,True
5258560,208,0,20,5651,778133517,0,0,0,623.92,5,848565.96,9,1,3,4,True
5380200,1232,1,-1,6514,778133517,0,1,0,623.99,4,848565.96,18,6,3,4,True
5659825,1249,2,451,7922,778133517,0,0,0,624.06,7,847941.9,23,1,1,6,True
5806692,249,0,25,6514,778133517,0,0,0,623.91,8,847317.99,6,3,22,6,True
5979174,249,0,25,2702,778133517,0,0,0,623.88,8,846694.11,6,4,2,6,True
6087501,1249,2,25,5959,778133517,0,0,0,623.83,8,846070.28,23,3,16,6,True
6254437,1254,4,25,4907,778133517,0,0,0,623.97,8,845446.31,23,0,1,7,True
6468155,343,1,10,5651,778133517,0,0,0,623.99,6,846070.3,24,2,1,7,True
6530648,939,0,30,6514,778133517,0,0,0,623.96,8,845446.34,24,0,0,8,True
6538621,1232,1,451,3069,778133517,0,0,0,623.99,7,844822.35,18,2,1,9,True
6724478,1249,2,25,7922,778133517,0,0,0,623.83,8,844198.52,23,0,3,1,True
6827829,1232,1,451,4337,778133517,0,0,0,623.94,7,843574.58,18,4,5,1,True
6906688,663,4,451,2702,778133517,0,0,0,624.03,7,842950.55,18,2,17,1,True
7497808,699,4,25,8604,778133517,0,0,0,624.14,8,842326.41,18,5,11,3,True
7700717,880,1,10,5932,778133517,0,0,0,623.97,6,842950.38,27,6,21,4,True
7936864,249,0,-1,7407,778133517,0,1,0,624.05,4,842950.38,6,4,10,4,True
8027150,663,4,-1,4677,778133517,0,2,0,624.07,4,842950.38,18,1,20,5,True
8341953,1305,2,30,4337,778133517,0,0,0,623.7,8,842326.68,5,5,2,6,True
8710232,205,0,10,3234,778133517,0,0,0,623.7,6,842950.38,9,0,4,6,True
8730370,663,4,451,6514,778133517,0,0,0,623.79,7,842326.59,18,5,10,6,True
8807091,1305,2,30,5651,778133517,0,0,0,624.37,8,841702.22,5,1,4,7,True
9042167,939,0,451,2136,778133517,0,0,0,623.83,7,841078.39,24,0,11,9,True
9189550,1305,2,451,1496,778133517,0,0,0,624.0,7,840454.39,5,2,21,10,True
9350441,1090,0,30,8604,778133517,0,0,0,623.86,8,839830.53,18,2,22,10,True
9425009,1305,2,30,6990,778133517,0,0,0,623.7,8,839206.83,5,0,6,10,True
9883164,1254,4,30,5932,778133517,0,0,0,623.94,8,838582.89,23,3,20,11,True
1061251,183,1,25,5409,822595728,0,0,0,1028.06,8,271436.94,18,2,6,1,True
1476792,838,4,25,9136,822595728,0,0,0,1028.02,8,270408.92,5,1,20,2,True
1546431,702,4,451,6874,822595728,0,0,0,1027.94,7,269380.98,18,4,0,3,True
1579631,511,1,-1,6150,822595728,0,1,0,1027.88,1,269380.98,12,2,23,4,True
1841767,32,3,451,3484,822595728,0,0,0,1027.87,7,268353.11,11,2,16,6,True
1978863,32,3,451,6927,822595728,0,0,0,1027.97,7,267325.14,11,4,8,7,True
2048345,838,4,25,7275,822595728,0,0,0,1028.03,8,266297.11,5,2,3,7,True
2204580,194,1,10,7571,822595728,0,0,0,1028.26,6,267325.37,18,4,1,9,True
2244429,702,4,30,2984,822595728,0,0,0,1027.83,8,266297.54,18,1,3,10,True
2273984,702,4,30,6874,822595728,0,0,0,1027.9,8,265269.64,18,2,6,2,True
2385133,1369,3,30,2580,822595728,0,0,0,1027.99,8,264241.65,16,1,12,3,True
2858460,183,1,451,4476,822595728,0,0,0,1028.13,7,263213.52,18,6,0,4,False
2892796,1369,3,25,5239,822595728,0,0,0,1027.75,8,262185.77,16,0,21,10,False
3100699,485,1,10,7275,822595728,0,0,0,1028.12,6,263213.89,5,5,8,12,True
3299717,511,1,-1,3049,822595728,0,1,0,1028.03,1,263213.89,12,0,8,3,True
3560435,702,4,-1,1486,822595728,0,2,0,1027.99,4,263213.89,18,4,12,7,True
3628584,32,3,-1,2580,822595728,0,3,1,1027.95,4,0.0,11,0,0,11,True
1187078,128,0,30,5636,801384543,0,0,0,1130.84,8,425808.16,18,0,11,1,True
1606670,394,0,30,2801,801384543,0,0,0,1130.84,8,424677.32,10,5,11,1,True
1719919,1064,0,20,1619,801384543,0,0,0,1131.07,5,423546.25,11,3,15,3,False
2040673,128,0,451,4018,801384543,0,0,0,1130.7,7,422415.55,18,2,15,3,True
2083446,128,0,25,6996,801384543,0,0,0,1130.75,8,421284.8,18,1,3,4,True
2089783,948,4,-1,8346,801384543,0,1,0,1130.99,4,421284.8,24,3,0,4,True
2126066,1034,1,10,7469,801384543,0,0,0,1130.78,6,422415.58,11,0,2,4,False
2154521,485,1,10,7469,801384543,0,0,0,1131.17,0,423546.75,5,1,8,5,True
2163160,394,0,30,8346,801384543,0,0,0,1130.82,8,422415.93,10,3,20,6,True
2252674,394,0,30,8674,801384543,0,0,0,1131.19,8,421284.74,10,1,2,6,True
2268525,360,0,451,4257,801384543,0,0,0,1131.08,7,420153.66,24,1,6,6,True
2490759,394,0,-1,8958,801384543,0,1,0,1130.89,1,420153.66,10,2,15,6,True
2743763,360,0,-1,2801,801384543,0,2,0,1131.03,4,420153.66,24,6,5,7,True
2750712,128,0,30,2801,801384543,0,0,0,1131.03,8,419022.63,18,1,14,7,True
2925896,360,0,451,2784,801384543,0,0,0,1130.98,7,417891.65,24,3,17,9,True
2926153,1297,0,20,6996,801384543,0,0,0,1130.99,5,416760.66,5,5,7,10,True
3286687,673,0,451,6508,801384543,0,0,0,1131.12,7,415629.54,18,5,9,11,True
3299524,1210,0,10,2413,801384543,0,0,0,1131.1,6,416760.64,24,4,3,12,True
3495775,929,0,20,5636,801384543,0,0,0,1130.82,3,415629.82,18,5,18,12,True
3957790,948,4,451,8346,801384543,0,0,0,1131.03,7,414498.79,24,3,13,12,True
4165583,128,0,25,2413,801384543,0,0,0,1131.18,8,413367.61,18,0,8,12,True
4223707,128,0,20,4703,801384543,0,0,0,1130.99,5,412236.62,18,2,12,2,True
4420969,394,0,30,2784,801384543,0,0,0,1131.04,8,411105.58,10,1,13,3,True
4706453,128,0,30,8958,801384543,0,0,0,1130.76,8,409974.82,18,0,5,3,True
4730280,673,0,30,2784,801384543,0,0,0,1130.99,8,408843.83,18,0,13,3,True
4785516,948,4,30,6508,801384543,0,0,0,1130.85,8,407712.98,24,6,23,6,True
4792665,360,0,451,8674,801384543,0,0,0,1131.17,7,406581.81,24,0,7,7,True
4877163,64,0,10,6996,801384543,0,0,0,1131.0,6,407712.81,20,5,16,7,True
4955229,350,0,20,4703,801384543,0,0,0,1130.51,5,406582.3,24,1,0,7,True
4985552,394,0,30,2784,801384543,0,0,0,1130.87,8,405451.43,10,4,14,7,True
4990663,673,0,30,8958,801384543,0,0,0,1130.71,8,404320.72,18,0,16,8,True
5066673,128,0,-1,5636,801384543,0,1,0,1130.93,1,404320.72,18,2,2,9,True
5112392,394,0,451,2784,801384543,0,0,0,1130.98,7,403189.74,10,1,15,10,True
5251319,360,0,451,4128,801384543,0,0,0,1130.92,7,402058.82,24,0,23,10,True
6040447,673,0,-1,5636,801384543,0,1,0,1131.03,1,402058.82,18,6,5,12,True
6049050,948,4,30,8674,801384543,0,0,0,1131.13,8,400927.69,24,0,18,12,True
6253505,360,0,451,5636,801384543,0,0,0,1130.75,7,399796.94,24,4,6,12,False
6289617,948,4,30,9815,801384543,0,0,0,1130.98,8,398665.96,24,2,2,12,True
6489742,673,0,-1,8346,801384543,0,1,0,1130.93,4,398665.96,18,1,1,1,True
6492061,610,0,20,2801,801384543,0,0,0,1130.98,3,397534.98,11,1,10,1,False
6542989,297,0,10,4909,801384543,0,0,0,1130.95,0,398665.93,4,0,14,1,True
6729983,673,0,30,4703,801384543,0,0,0,1130.97,8,397534.96,18,2,18,1,True
6778433,394,0,25,4018,801384543,0,0,0,1131.09,8,396403.87,10,3,3,3,False
6917867,394,0,-1,6508,801384543,0,1,0,1130.84,4,396403.87,10,1,0,3,True
7017283,916,0,20,4257,801384543,0,0,0,1130.67,5,395273.2,18,1,11,4,True
7636547,948,4,25,4257,801384543,0,0,0,1131.05,8,394142.15,24,3,22,5,True
7648588,360,0,451,7469,801384543,0,0,0,1130.91,7,393011.24,24,0,3,5,False
8183995,394,0,25,2413,801384543,0,0,0,1130.79,8,391880.45,10,6,16,6,True
8372677,116,0,10,2784,801384543,0,0,0,1131.2,6,393011.65,3,2,15,6,False
8434647,673,0,25,8674,801384543,0,0,0,1130.93,8,391880.72,18,1,20,7,False
8717975,228,0,10,8958,801384543,0,0,0,1130.97,0,393011.69,26,3,4,9,False
8822828,360,0,25,8674,801384543,0,0,0,1131.06,8,391880.63,24,5,5,9,True
9303466,360,0,30,3761,801384543,0,0,0,1131.05,8,390749.58,24,2,6,11,True
1376064,591,0,10,3850,584520677,1,0,0,861.95,6,669670.95,24,2,1,1,True
1605483,1058,4,25,9265,584520677,1,0,0,861.78,8,668809.17,11,2,15,1,True
1848726,1058,4,451,1091,584520677,1,0,0,861.83,7,667947.34,11,3,13,1,True
1872234,1058,4,25,5116,584520677,1,0,0,862.01,8,667085.33,11,4,21,1,False
1952666,1125,1,451,3567,584520677,1,0,0,861.98,7,666223.35,24,0,19,1,True
2038591,199,0,25,6342,584520677,1,0,0,862.04,8,665361.31,18,4,14,2,True
2706590,486,4,-1,3850,584520677,1,1,0,861.8,1,665361.31,5,6,2,2,True
3045395,860,1,10,5753,584520677,1,0,0,862.01,6,666223.32,24,0,14,3,True
3070583,848,2,20,6053,584520677,1,0,0,862.38,3,665360.94,5,4,18,4,True
3099879,1125,1,25,3850,584520677,1,0,0,862.02,8,664498.92,24,5,23,4,True
3158817,1160,0,20,6342,584520677,1,0,0,861.79,5,663637.13,15,6,11,5,True
3188838,1125,1,30,5985,584520677,1,0,0,861.98,8,662775.15,24,5,10,5,True
3238234,199,0,25,5116,584520677,1,0,0,862.1,8,661913.05,18,6,6,7,True
3343267,16,4,25,3567,584520677,1,0,0,862.05,8,661051.0,24,2,10,8,True
3369701,780,0,20,8860,584520677,1,0,0,862.02,5,660188.98,14,0,6,8,True
3766156,211,0,20,8860,584520677,1,0,0,862.12,5,659326.86,9,6,19,8,True
3945608,215,0,20,1091,584520677,1,0,0,862.22,5,658464.64,9,3,13,10,True
4237832,1125,1,30,3567,584520677,1,0,0,862.05,8,657602.59,24,1,22,1,True
4264529,1125,1,25,1390,584520677,1,0,0,862.06,8,656740.53,24,2,1,1,True
4300016,486,4,451,8199,584520677,1,0,0,861.95,7,655878.58,5,6,1,2,True
4434965,1076,1,451,4487,584520677,1,0,0,861.67,7,655016.91,18,6,23,2,True
4593395,16,4,30,5346,584520677,1,0,0,861.95,8,654154.96,24,1,19,4,True
4719242,918,2,20,6053,584520677,1,0,0,862.14,5,653292.82,18,6,1,5,True
4836339,1058,4,25,5992,584520677,1,0,0,861.88,8,652430.94,11,0,23,6,True
5062256,16,4,451,9443,584520677,1,0,0,861.98,7,651568.96,24,4,10,6,True
5206276,16,4,30,3983,584520677,1,0,0,861.86,8,650707.1,24,4,9,7,True
5259326,446,1,25,5985,584520677,1,0,0,862.29,8,649844.81,13,6,17,8,True
5329327,865,0,20,3983,584520677,1,0,0,862.1,5,648982.71,24,1,11,9,True
5746678,399,2,20,9443,584520677,1,0,0,862.09,5,648120.62,10,6,12,9,True
5893695,16,4,451,8919,584520677,1,0,0,861.96,7,647258.66,24,4,1,9,True
5915886,1058,4,451,5753,584520677,1,0,0,862.06,7,646396.6,11,0,2,10,True
5933117,1076,1,-1,5346,584520677,1,1,0,861.95,1,646396.6,18,1,8,10,True
5945369,155,1,10,3567,584520677,1,0,0,862.04,6,647258.64,18,6,10,10,True
6037076,486,4,451,8199,584520677,1,0,0,862.11,7,646396.53,5,6,5,12,True
6049593,1076,1,-1,6342,584520677,1,1,0,861.73,4,646396.53,18,0,14,1,True
6138029,607,2,20,1091,584520677,1,0,0,862.19,5,645534.34,24,1,14,1,True
6140584,16,4,-1,8860,584520677,1,1,0,861.66,4,645534.34,24,0,17,1,True
6632403,27,0,10,9443,584520677,1,0,0,862.04,6,646396.38,11,3,4,2,True
6651961,16,4,25,3983,584520677,1,0,0,862.04,8,645534.34,24,4,14,3,True
6698703,1058,4,-1,2839,584520677,1,1,0,862.13,1,645534.34,11,5,4,3,True
6727312,1255,0,20,9443,584520677,1,0,0,862.09,3,644672.25,23,0,14,3,True
6899580,16,4,451,9265,584520677,1,0,0,861.87,7,643810.38,24,5,22,4,True
6947344,486,4,30,5992,584520677,1,0,0,862.03,8,642948.35,5,6,6,4,False
7282785,1125,1,451,6342,584520677,1,0,0,861.59,7,642086.76,24,5,15,5,True
7496957,1125,1,451,5116,584520677,1,0,0,862.07,7,641224.69,24,6,5,5,True
7707569,1076,1,451,8919,584520677,1,0,0,861.76,7,640362.93,18,1,4,5,True
8141972,463,1,10,8199,584520677,1,0,0,861.75,0,641224.68,13,2,22,5,False
8142745,1058,4,30,5346,584520677,1,0,0,861.97,8,640362.71,11,1,3,6,True
8449327,486,4,451,5753,584520677,1,0,0,861.91,7,639500.8,5,0,11,6,True
8536856,199,0,-1,9443,584520677,1,1,0,861.95,1,639500.8,18,5,10,7,True
8559516,446,1,30,7927,584520677,1,0,0,862.13,8,638638.67,13,4,11,8,True
8871168,1076,1,30,6053,584520677,1,0,0,862.08,8,637776.59,18,0,0,8,True
9088713,16,4,25,9443,584520677,1,0,0,861.7,8,636914.89,24,3,4,8,True
9276317,1076,1,451,3850,584520677,1,0,0,862.08,7,636052.81,18,4,21,8,False
9367181,1125,1,451,5985,584520677,1,0,0,862.25,7,635190.56,24,0,19,9,True
9435309,446,1,451,3983,584520677,1,0,0,861.96,7,634328.6,13,5,5,9,True
9788462,1425,0,10,5346,584520677,1,0,0,861.92,0,635190.52,24,6,3,10,True
9901278,486,4,-1,3850,584520677,1,1,0,861.94,4,635190.52,5,0,22,10,True
1107651,60,4,30,3401,400668031,0,0,0,390.18,8,683642.82,20,6,12,1,True
1490579,1246,0,10,4445,400668031,0,0,0,390.04,6,684032.86,23,3,6,2,True
1885958,1495,3,30,4445,400668031,0,0,0,390.02,8,683642.84,24,6,3,3,True
2109084,1495,3,25,3791,400668031,0,0,0,390.24,8,683252.6,24,1,13,3,True
2198167,1201,0,451,7474,400668031,0,0,0,390.19,7,682862.41,24,1,19,3,True
2221962,841,1,10,5868,400668031,0,0,0,390.16,6,683252.57,5,4,21,3,True
2310847,634,1,10,4445,400668031,0,0,0,390.06,6,683642.63,24,2,10,4,True
2335488,434,3,30,7474,400668031,0,0,0,390.09,8,683252.54,24,0,2,5,True
2595987,979,0,10,4445,400668031,0,0,0,390.33,6,683642.87,22,2,9,5,True
2891717,1226,2,20,5505,400668031,0,0,0,389.75,5,683253.12,18,3,6,5,True
2941403,434,3,-1,9053,400668031,0,1,0,389.95,1,683253.12,24,2,15,6,True
3239858,1495,3,451,4037,400668031,0,0,0,390.07,7,682863.05,24,5,0,7,True
3469643,1191,4,451,5480,400668031,0,0,0,389.99,7,682473.06,24,4,14,8,True
3584320,1495,3,-1,2683,400668031,0,1,0,390.07,1,682473.06,24,4,17,8,True
3682653,1495,3,451,5480,400668031,0,0,0,389.82,7,682083.24,24,5,10,9,True
3909520,1495,3,30,3873,400668031,0,0,0,389.97,8,681693.27,24,2,3,9,True
4344413,1191,4,451,7175,400668031,0,0,0,390.12,7,681303.15,24,3,3,9,True
4388305,60,4,-1,5480,400668031,0,1,0,390.04,1,681303.15,20,4,2,9,True
4455059,1201,0,451,4445,400668031,0,0,0,389.87,7,680913.28,24,0,15,10,True
4547380,1471,0,10,4687,400668031,0,0,0,389.82,6,681303.1,24,1,12,11,True
5095719,1201,0,451,3791,400668031,0,0,0,389.97,7,680913.13,24,2,5,11,True
5117194,1191,4,25,5505,400668031,0,0,0,389.91,8,680523.22,24,3,23,12,True
5139987,1201,0,-1,3791,400668031,0,1,0,389.82,4,680523.22,24,4,8,12,True
5192445,434,3,30,5505,400668031,0,0,0,389.93,8,680133.29,24,4,11,12,True
5202418,60,4,25,5480,400668031,0,0,0,390.17,8,679743.12,20,5,22,12,True
5207507,1191,4,-1,8719,400668031,0,1,0,390.1,4,679743.12,24,5,8,1,True
5234781,1201,0,-1,3791,400668031,0,2,0,389.81,4,679743.12,24,6,18,2,True
5335578,60,4,451,4445,400668031,0,0,0,390.01,7,679353.11,20,6,3,2,True
5393089,549,1,10,4037,400668031,0,0,0,390.11,6,679743.22,17,0,23,5,True
5699226,434,3,451,4037,400668031,0,0,0,389.73,7,679353.49,24,1,15,6,True
5700706,1495,3,451,9053,400668031,0,0,0,389.97,7,678963.52,24,3,9,7,True
5817284,434,3,451,7474,400668031,0,0,0,390.17,7,678573.35,24,6,12,7,True
5878188,1319,1,10,4037,400668031,0,0,0,390.13,6,678963.48,18,3,5,8,True
6013540,642,0,20,4037,400668031,0,0,0,390.14,5,678573.34,24,1,4,9,True
6023096,60,4,25,4687,400668031,0,0,0,390.07,8,678183.27,20,1,6,10,True
6204301,239,1,10,4445,400668031,0,0,0,389.97,6,678573.24,26,0,20,11,True
6695663,434,3,451,3791,400668031,0,0,0,389.84,7,678183.4,24,0,13,11,True
6914517,1495,3,25,4037,400668031,0,0,0,389.89,8,677793.51,24,5,19,12,True
7232004,211,0,20,7175,400668031,0,0,0,390.08,5,677403.43,9,6,2,12,True
7482138,854,0,10,3791,400668031,0,0,0,390.15,0,677793.58,24,1,14,12,True
7491083,60,4,451,5505,400668031,0,0,0,390.05,7,677403.53,20,2,7,12,True
7769833,1201,0,25,4445,400668031,0,0,0,390.16,8,677013.37,24,6,8,1,True
7918091,1009,0,20,2683,400668031,0,0,0,390.12,5,676623.25,26,1,20,1,True
7995418,512,0,20,3873,400668031,0,0,0,390.19,3,676233.06,12,0,19,1,True
8052972,1195,1,10,8719,400668031,0,0,0,390.07,6,676623.13,24,0,12,3,True
8069861,60,4,-1,4037,400668031,0,1,0,390.02,4,676623.13,20,4,8,4,True
8154188,1201,0,451,3791,400668031,0,0,0,389.99,7,676233.14,24,4,16,4,True
8231162,1191,4,451,8719,400668031,0,0,0,390.01,7,675843.13,24,5,9,4,True
8258850,228,0,10,7474,400668031,0,0,0,390.09,6,676233.22,26,5,1,4,True
8409432,1255,0,10,4037,400668031,0,0,0,390.09,0,676623.31,23,0,9,4,True
8463021,60,4,25,3791,400668031,0,0,0,390.0,8,676233.31,20,0,21,5,True
8739791,434,3,30,3791,400668031,0,0,0,390.04,8,675843.27,24,1,18,6,True
8775809,369,1,10,9053,400668031,0,0,0,389.84,0,676233.11,25,3,14,7,True
8809655,1495,3,30,9053,400668031,0,0,0,390.03,8,675843.08,24,0,20,7,True
8886001,434,3,30,4037,400668031,0,0,0,389.91,8,675453.17,24,2,15,7,False
9388208,1495,3,25,4445,400668031,0,0,0,389.87,8,675063.3,24,5,0,8,True
9554202,1191,4,30,7175,400668031,0,0,0,390.05,8,674673.25,24,5,6,10,True
9870116,434,3,-1,3401,400668031,0,1,0,390.19,4,674673.25,24,3,19,10,True
1760220,631,3,25,6683,339881146,1,0,0,1196.09,8,201995.91,11,5,17,1,True
1909372,951,0,20,7586,339881146,1,0,0,1195.98,3,200799.93,24,4,7,1,True
2026561,642,0,30,8258,339881146,1,0,0,1196.13,8,199603.8,24,3,19,3,True
2067428,385,1,30,4022,339881146,1,0,0,1195.9,8,198407.9,25,1,10,3,True
2099295,259,4,451,1867,339881146,1,0,0,1195.87,7,197212.03,6,2,5,3,True
2224595,278,1,451,4032,339881146,1,0,0,1195.98,7,196016.05,24,0,2,3,True
2934158,211,0,10,4032,339881146,1,0,0,1195.93,0,197211.98,9,2,19,5,True
3055419,259,4,-1,1590,339881146,1,1,0,1195.83,1,197211.98,6,6,13,5,True
3199070,27,0,25,2393,339881146,1,0,0,1195.93,8,196016.05,11,3,7,6,True
3464667,1277,2,-1,5297,339881146,1,1,0,1195.89,1,196016.05,24,3,13,6,True
3711061,1277,2,451,1171,339881146,1,0,0,1196.19,7,194819.86,24,4,3,7,True
3838128,642,0,25,8258,339881146,1,0,0,1195.95,8,193623.91,24,1,19,7,True
3954304,631,3,25,7586,339881146,1,0,0,1195.74,8,192428.17,11,5,6,8,True
4250807,631,3,451,2127,339881146,1,0,0,1195.88,7,191232.29,11,4,15,9,True
4414307,278,1,25,9203,339881146,1,0,0,1196.1,8,190036.19,24,6,6,9,True
4585792,385,1,25,1867,339881146,1,0,0,1196.13,8,188840.06,25,2,5,10,True
4664291,1278,0,20,6683,339881146,1,0,0,1196.17,5,187643.89,24,3,0,10,True
4757928,27,0,451,2127,339881146,1,0,0,1196.04,7,186447.85,11,0,4,10,True
4807542,117,1,10,3210,339881146,1,0,0,1196.07,6,187643.92,18,0,13,10,True
4849431,966,4,25,4736,339881146,1,0,0,1195.83,8,186448.09,13,2,21,11,True
5001920,1277,2,451,1867,339881146,1,0,0,1195.82,7,185252.27,24,5,4,12,True
5042765,1318,0,10,8574,339881146,1,0,0,1195.92,6,186448.19,18,5,23,12,True
5189312,939,0,10,9203,339881146,1,0,0,1196.19,6,187644.38,24,0,2,2,True
5632660,631,3,451,2271,339881146,1,0,0,1196.04,7,186448.34,11,3,10,2,True
5843522,966,4,451,3524,339881146,1,0,0,1196.15,7,185252.19,13,3,21,5,True
5854194,557,1,10,1635,339881146,1,0,0,1196.12,6,186448.31,17,5,0,8,True
6111448,259,4,30,1635,339881146,1,0,0,1195.89,8,185252.42,6,4,18,9,True
6117107,278,1,25,1867,339881146,1,0,0,1195.83,8,184056.59,24,2,1,11,True
6124955,966,4,451,1385,339881146,1,0,0,1195.87,7,182860.72,13,1,16,12,True
6155303,465,0,20,4736,339881146,1,0,0,1195.84,5,181664.88,13,3,3,12,True
6296336,259,4,451,2271,339881146,1,0,0,1196.33,7,180468.55,6,4,8,1,True
6523575,642,0,25,1635,339881146,1,0,0,1195.53,8,179273.02,24,1,9,1,False
6589615,1277,2,-1,1171,339881146,1,1,0,1195.97,4,179273.02,24,6,12,1,True
6626769,642,0,451,4736,339881146,1,0,0,1196.18,7,178076.84,24,0,5,3,True
6700513,27,0,30,1590,339881146,1,0,0,1195.86,8,176880.98,11,3,22,3,True
6807309,1277,2,-1,1867,339881146,1,1,0,1196.03,4,176880.98,24,4,20,4,True
6827335,1277,2,25,1635,339881146,1,0,0,1195.99,8,175684.99,24,5,13,6,True
6940055,278,1,451,8574,339881146,1,0,0,1196.07,7,174488.92,24,0,10,6,True
7310119,1468,1,10,2271,339881146,1,0,0,1196.21,6,175685.13,11,5,23,6,True
7317761,27,0,25,4022,339881146,1,0,0,1196.23,8,174488.9,11,2,17,8,True
7495447,404,1,10,9203,339881146,1,0,0,1195.81,0,175684.71,10,5,14,8,True
7689155,484,0,10,1867,339881146,1,0,0,1195.77,6,176880.48,5,5,9,9,True
7887138,642,0,-1,4032,339881146,1,1,0,1196.05,1,176880.48,24,6,2,9,True
8269269,385,1,-1,8574,339881146,1,2,0,1195.86,4,176880.48,25,5,21,10,True
8294038,197,4,-1,9162,339881146,1,3,1,1196.12,1,176880.48,18,3,11,10,True
1022762,842,2,451,1170,348889955,0,0,0,157.16,7,450831.84,5,5,19,1,True
1069094,831,1,30,2027,348889955,0,0,0,157.02,8,450674.82,5,3,11,2,True
1208981,334,0,20,3078,348889955,0,0,0,156.95,5,450517.87,11,1,9,2,True
1384371,1019,0,451,4049,348889955,0,0,0,156.93,7,450360.94,26,4,8,3,True
1445690,185,1,451,4434,348889955,0,0,0,156.95,7,450203.99,18,4,12,3,True
1545177,819,2,20,6754,348889955,0,0,0,157.03,5,450046.96,18,5,23,6,True
1594791,1449,0,20,1182,348889955,0,0,0,156.78,5,449890.18,11,2,12,6,True
1911625,239,1,10,4959,348889955,0,0,0,156.84,0,450047.02,26,1,7,7,True
1935020,276,0,20,1079,348889955,0,0,0,157.11,5,449889.91,24,3,21,8,True
1952014,842,2,451,3869,348889955,0,0,0,157.24,7,449732.67,5,4,20,8,True
2323897,944,2,451,4049,348889955,0,0,0,156.93,7,449575.74,24,1,22,8,True
2369887,842,2,25,6381,348889955,0,0,0,157.23,8,449418.51,5,1,14,8,True
2398192,46,1,10,1518,348889955,0,0,0,156.98,6,449575.49,24,4,18,8,True
2751932,944,2,30,6754,348889955,0,0,0,157.06,8,449418.43,24,0,12,9,True
2774113,1123,2,20,1170,348889955,0,0,0,157.18,5,449261.25,24,1,20,11,True
3064640,1243,2,20,1518,348889955,0,0,0,156.81,3,449104.44,18,0,19,11,True
3482285,929,0,20,3438,348889955,0,0,0,156.92,5,448947.52,18,6,17,11,True
3572072,944,2,30,6754,348889955,0,0,0,156.94,8,448790.58,24,2,21,12,True
3692782,735,1,10,1182,348889955,0,0,0,157.25,6,448947.83,11,3,23,12,True
3869384,185,1,-1,4821,348889955,0,1,0,156.96,4,448947.83,18,6,13,1,True
3963003,1364,0,20,4242,348889955,0,0,0,157.12,3,448790.71,16,2,8,1,True
4030060,1404,2,20,3869,348889955,0,0,0,156.97,5,448633.74,24,1,6,2,True
4100398,204,0,451,4821,348889955,0,0,0,156.83,7,448476.91,9,6,8,3,True
4192859,1019,0,30,4959,348889955,0,0,0,156.71,8,448320.2,26,4,20,3,True
4194081,204,0,-1,6381,348889955,0,1,0,157.07,4,448320.2,9,2,11,3,True
4533928,219,0,-1,1079,348889955,0,2,0,157.1,1,448320.2,9,0,16,4,True
4779040,842,2,30,3078,348889955,0,0,0,156.96,8,448163.24,5,3,5,4,True
4782211,944,2,-1,1182,348889955,0,1,0,156.93,1,448163.24,24,6,18,5,True
4948438,204,0,451,4049,348889955,0,0,0,157.05,7,448006.19,9,4,20,5,True
5160113,993,0,20,4049,348889955,0,0,0,157.31,5,447848.88,22,1,4,6,True
5273955,185,1,451,4959,348889955,0,0,0,156.89,7,447691.99,18,4,22,8,True
5326951,185,1,451,4242,348889955,0,0,0,157.07,7,447534.92,18,2,8,8,True
5385690,260,0,10,4049,348889955,0,0,0,156.88,6,447691.8,6,3,10,9,True
5392314,219,0,451,4959,348889955,0,0,0,157.19,7,447534.61,9,4,16,9,True
5462017,573,0,20,4049,348889955,0,0,0,156.82,5,447377.79,11,2,21,10,True
5546562,185,1,30,4242,348889955,0,0,0,157.06,8,447220.73,18,4,1,10,True
6043181,990,0,10,3869,348889955,0,0,0,157.13,0,447377.86,22,2,3,10,True
6362033,219,0,-1,3869,348889955,0,1,0,156.91,4,447377.86,9,1,7,10,True
6592453,831,1,25,1079,348889955,0,0,0,157.08,8,447220.78,5,5,4,11,True
6609232,448,0,20,1170,348889955,0,0,0,157.35,5,447063.43,13,0,18,11,True
7251426,1210,0,10,7856,348889955,0,0,0,157.07,6,447220.5,24,4,1,12,False
7285606,41,2,451,1182,348889955,0,0,0,156.72,7,447063.78,11,6,23,12,True
7757425,1019,0,451,4242,348889955,0,0,0,156.99,7,446906.79,26,5,15,2,True
7780224,1271,0,10,4049,348889955,0,0,0,156.9,0,447063.69,23,4,16,3,True
8223946,219,0,30,4821,348889955,0,0,0,156.85,8,446906.84,9,1,19,5,True
8353106,812,0,10,7856,348889955,0,0,0,156.93,6,447063.77,18,3,22,6,True
8380963,1019,0,451,4049,348889955,0,0,0,157.0,7,446906.77,26,4,14,7,True
8442709,1019,0,25,1182,348889955,0,0,0,156.91,8,446749.86,26,2,17,7,True
8639623,1411,0,20,4049,348889955,0,0,0,156.93,5,446592.93,24,4,8,7,True
9240906,944,2,30,4821,348889955,0,0,0,156.77,8,446436.16,24,2,18,7,True
9286587,689,0,10,1518,348889955,0,0,0,156.72,0,446592.88,24,2,22,7,True
9316744,238,0,20,1182,348889955,0,0,0,156.96,5,446435.92,26,4,14,8,True
9542700,588,0,20,1518,348889955,0,0,0,156.99,5,446278.93,24,5,11,8,True
9671948,787,0,10,1079,348889955,0,0,0,157.0,6,446435.93,14,1,19,9,True
9896994,944,2,25,1079,348889955,0,0,0,156.84,8,446279.09,24,1,14,10,True
9901817,726,0,10,4434,348889955,0,0,0,156.91,6,446436.0,11,3,12,11,True
1240341,144,1,10,1545,516090826,1,0,0,1009.0,6,169705.0,18,5,14,1,True
1522921,1212,0,25,4326,516090826,1,0,0,1008.97,8,168696.03,24,2,17,1,True
1599505,665,2,25,5985,516090826,1,0,0,1009.19,8,167686.84,18,4,11,2,True
1769691,1426,1,-1,9924,516090826,1,1,0,1009.05,4,167686.84,24,1,11,2,True
1995017,1426,1,25,4453,516090826,1,0,0,1008.84,8,166678.0,24,4,5,3,True
2005768,710,3,-1,6973,516090826,1,1,0,1009.12,1,166678.0,18,6,8,4,True
2013848,1256,2,20,3836,516090826,1,0,0,1008.93,5,165669.07,23,6,14,4,True
2473576,665,2,30,8297,516090826,1,0,0,1009.12,8,164659.95,18,0,19,6,True
2545454,1021,4,25,6508,516090826,1,0,0,1008.75,8,163651.2,11,4,22,8,True
2584792,534,4,451,8297,516090826,1,0,0,1008.81,7,162642.39,18,1,14,8,True
2721654,665,2,30,4528,516090826,1,0,0,1008.89,8,161633.5,18,0,12,8,True
2801512,203,0,10,6973,516090826,1,0,0,1009.04,6,162642.54,9,6,12,10,True
2806755,1426,1,451,3836,516090826,1,0,0,1009.02,7,161633.52,24,0,18,10,True
2963797,1212,0,25,9537,516090826,1,0,0,1008.87,8,160624.65,24,4,11,11,True
3211241,869,2,20,4489,516090826,1,0,0,1009.13,5,159615.52,24,3,4,11,True
3587503,914,2,451,9253,516090826,1,0,0,1008.86,7,158606.66,18,6,17,12,True
3641621,710,3,25,3235,516090826,1,0,0,1008.94,8,157597.72,18,1,19,12,False
3648656,880,1,10,9253,516090826,1,0,0,1008.93,6,158606.65,27,5,16,12,True
3691653,710,3,451,1545,516090826,1,0,0,1009.08,7,157597.57,18,6,9,1,True
3765131,914,2,451,4326,516090826,1,0,0,1008.89,7,156588.68,18,5,9,1,True
3787216,914,2,451,6782,516090826,1,0,0,1008.75,7,155579.93,18,5,0,1,True
3787861,1155,0,20,8299,516090826,1,0,0,1009.23,5,154570.7,15,3,14,3,True
3950754,914,2,451,8127,516090826,1,0,0,1008.7,7,153562.0,18,3,15,4,True
3974108,710,3,25,3836,516090826,1,0,0,1008.99,8,152553.01,18,2,18,5,True
4361124,1021,4,451,8297,516090826,1,0,0,1009.25,7,151543.76,11,4,16,6,True
4426081,200,0,20,3836,516090826,1,0,0,1008.81,5,150534.95,9,3,20,6,True
4626237,1426,1,25,9924,516090826,1,0,0,1008.95,8,149526.0,24,0,11,10,True
4854794,534,4,30,4326,516090826,1,0,0,1009.29,8,148516.71,18,2,8,10,True
5159434,234,0,10,9253,516090826,1,0,0,1009.15,6,149525.86,26,6,14,10,True
5411045,1318,0,20,3235,516090826,1,0,0,1009.08,5,148516.78,18,0,9,10,True
5424579,1426,1,-1,8245,516090826,1,1,0,1008.92,4,148516.78,24,5,18,11,True
5431044,1476,0,10,8299,516090826,1,0,0,1009.02,6,149525.8,24,3,3,11,True
5574434,914,2,30,4326,516090826,1,0,0,1009.13,8,148516.67,18,5,6,12,True
5626506,914,2,451,4528,516090826,1,0,0,1008.82,7,147507.85,18,5,14,12,True
5635446,1212,0,30,9253,516090826,1,0,0,1008.94,8,146498.91,24,1,6,12,True
5699091,114,0,20,5850,516090826,1,0,0,1008.96,5,145489.95,3,5,12,12,True
6107406,1021,4,30,9924,516090826,1,0,0,1009.02,8,144480.93,11,0,1,1,True
6304003,1021,4,30,4528,516090826,1,0,0,1009.1,8,143471.83,11,5,22,2,True
6321114,1093,0,10,8127,516090826,1,0,0,1008.72,0,144480.55,18,2,19,2,True
6463624,914,2,30,8297,516090826,1,0,0,1009.1,8,143471.45,18,6,12,3,True
6973879,287,0,10,3235,516090826,1,0,0,1009.07,0,144480.52,24,5,1,3,True
7013013,1123,2,20,8299,516090826,1,0,0,1009.23,3,143471.29,24,3,19,3,True
7072678,1246,0,10,1956,516090826,1,0,0,1009.2,6,144480.49,23,2,23,4,True
7556133,535,0,10,8245,516090826,1,0,0,1008.89,6,145489.38,18,2,5,4,False
7709698,534,4,-1,1697,516090826,1,1,0,1008.64,4,145489.38,18,1,19,5,True
7835831,665,2,-1,1545,516090826,1,2,0,1009.18,4,145489.38,18,6,6,5,True
7877661,1429,0,20,4489,516090826,1,0,0,1008.73,5,144480.65,24,3,6,5,True
7971618,1035,0,20,4489,516090826,1,0,0,1009.13,5,143471.52,11,6,15,5,True
8078137,1212,0,30,4528,516090826,1,0,0,1008.72,8,142462.8,24,5,1,6,True
8087154,710,3,451,7251,516090826,1,0,0,1009.01,7,141453.79,18,6,22,6,True
8096231,989,1,10,4326,516090826,1,0,0,1009.01,6,142462.8,22,0,0,6,True
8488385,574,2,20,8127,516090826,1,0,0,1008.95,5,141453.85,11,5,12,6,True
8699690,1356,2,20,9537,516090826,1,0,0,1009.02,5,140444.83,24,6,14,8,False
8910886,1426,1,-1,3235,516090826,1,1,0,1008.95,4,140444.83,24,5,0,9,True
8992243,1021,4,30,8299,516090826,1,0,0,1009.02,8,139435.81,11,0,13,9,True
9176316,534,4,451,6973,516090826,1,0,0,1009.08,7,138426.73,18,0,12,10,True
9300430,1212,0,25,4453,516090826,1,0,0,1008.83,8,137417.9,24,0,14,10,True
9908767,665,2,30,1697,516090826,1,0,0,1008.86,8,136409.04,18,2,0,11,True
1247268,1282,2,25,3825,265025860,0,0,0,588.21,8,767149.79,24,0,11,1,True
1774219,603,0,20,8713,265025860,0,0,0,588.16,5,766561.63,24,4,14,1,True
2048222,652,0,25,7775,265025860,0,0,0,587.89,8,765973.74,24,6,18,1,False
2164527,642,0,20,4385,265025860,0,0,0,588.0,5,765385.74,24,6,8,1,True
2336791,1303,0,30,7775,265025860,0,0,0,587.97,8,764797.77,5,4,9,2,True
2380548,622,4,451,6300,265025860,0,0,0,587.92,7,764209.85,11,4,4,3,True
2617775,362,0,20,6300,265025860,0,0,0,588.2,5,763621.65,24,2,23,4,True
2967749,223,2,20,1502,265025860,0,0,0,588.08,5,763033.57,26,3,1,5,True
3034198,1282,2,25,2078,265025860,0,0,0,588.05,8,762445.52,24,5,0,5,True
3117675,1170,0,20,1056,265025860,0,0,0,588.1,5,761857.42,24,1,19,6,True
3215136,588,0,20,9273,265025860,0,0,0,587.97,3,761269.45,24,1,0,8,True
3767165,1076,1,10,9192,265025860,0,0,0,588.27,6,761857.72,18,0,12,8,True
4216796,1239,1,10,1056,265025860,0,0,0,588.15,0,762445.87,18,4,22,9,False
4296097,159,2,20,1056,265025860,0,0,0,588.32,3,761857.55,24,0,4,9,True
4575265,503,0,30,8006,265025860,0,0,0,588.0,8,761269.55,12,6,11,9,True
4633121,1029,0,10,1502,265025860,0,0,0,587.87,6,761857.42,11,1,4,10,True
4728517,622,4,25,7604,265025860,0,0,0,587.92,8,761269.5,11,0,11,10,True
4760785,761,2,451,9867,265025860,0,0,0,587.87,7,760681.63,24,0,3,11,True
4913778,369,1,10,7604,265025860,0,0,0,588.14,6,761269.77,25,0,8,11,True
5027244,238,0,-1,3176,265025860,0,1,0,588.07,4,761269.77,26,1,20,12,True
5082031,761,2,-1,2663,265025860,0,2,0,588.28,4,761269.77,24,1,18,1,True
5085581,1231,2,20,3176,265025860,0,0,0,588.21,5,760681.56,18,3,0,1,True
5107448,503,0,451,2663,265025860,0,0,0,588.01,7,760093.55,12,4,1,1,True
5282077,715,0,-1,4385,265025860,0,1,0,587.84,1,760093.55,18,0,5,1,True
5283252,303,0,10,9867,265025860,0,0,0,588.03,0,760681.58,4,0,0,2,True
5872106,238,0,25,3275,265025860,0,0,0,588.05,8,760093.53,26,1,12,2,True
5994427,1270,1,451,3825,265025860,0,0,0,588.14,7,759505.39,23,3,4,3,True
6022384,715,0,451,2663,265025860,0,0,0,588.22,7,758917.17,18,4,12,4,True
6182439,1282,2,30,5397,265025860,0,0,0,588.07,8,758329.1,24,5,6,4,True
6202900,238,0,451,3275,265025860,0,0,0,587.78,7,757741.32,26,6,13,6,True
6236556,1303,0,25,1056,265025860,0,0,0,588.08,8,757153.24,5,5,23,8,True
6327127,238,0,30,2078,265025860,0,0,0,588.13,8,756565.11,26,3,18,8,True
6638021,1270,1,25,9273,265025860,0,0,0,587.85,8,755977.26,23,2,0,8,True
6941745,673,0,10,8713,265025860,0,0,0,588.33,0,756565.59,18,6,9,9,True
6950547,238,0,25,1875,265025860,0,0,0,588.09,8,755977.5,26,4,16,10,True
7046636,95,2,20,2078,265025860,0,0,0,587.97,5,755389.53,1,3,16,10,True
7097722,761,2,-1,5711,265025860,0,1,0,588.06,4,755389.53,24,4,14,10,True
7342974,238,0,451,9192,265025860,0,0,0,588.06,7,754801.47,26,6,6,11,True
7352113,1270,1,25,8440,265025860,0,0,0,587.81,8,754213.66,23,0,5,12,True
7388503,503,0,30,7604,265025860,0,0,0,588.29,8,753625.37,12,6,1,2,True
7546659,553,1,10,8506,265025860,0,0,0,587.74,6,754213.11,17,1,5,5,True
7583123,1282,2,451,5745,265025860,0,0,0,588.0,7,753625.11,24,3,17,5,True
7905750,1303,0,-1,1875,265025860,0,1,0,588.02,4,753625.11,5,2,11,5,False
8097015,1270,1,25,5397,265025860,0,0,0,587.97,8,753037.14,23,2,21,6,True
8211975,1282,2,451,8713,265025860,0,0,0,588.18,7,752448.96,24,4,6,6,True
8286675,1170,0,10,5745,265025860,0,0,0,588.08,6,753037.04,24,3,4,7,True
8508605,503,0,25,5397,265025860,0,0,0,588.01,8,752449.03,12,3,2,7,True
8917774,438,1,10,5120,265025860,0,0,0,587.96,6,753036.99,24,1,5,7,True
9358665,715,0,-1,8713,265025860,0,1,0,587.91,1,753036.99,18,4,22,8,True
9375179,898,1,10,5397,265025860,0,0,0,587.91,6,753624.9,24,5,17,8,True
9613817,715,0,451,8440,265025860,0,0,0,588.26,7,753036.64,18,6,16,8,True
9661283,622,4,-1,5828,265025860,0,1,0,588.01,1,753036.64,11,2,10,10,True
9992650,1270,1,451,5711,265025860,0,0,0,587.71,7,752448.93,23,1,8,11,True
1070933,816,0,20,6325,724193028,1,0,0,712.97,5,554114.03,18,6,6,1,True
1111068,1181,2,-1,5179,724193028,1,1,0,712.91,1,554114.03,24,6,0,2,True
1227463,1181,2,30,2342,724193028,1,0,0,712.91,8,553401.12,24,5,9,2,True
1257202,1015,0,20,4668,724193028,1,0,0,713.15,5,552687.97,26,0,5,2,False
1265217,198,0,10,7899,724193028,1,0,0,713.22,6,553401.19,18,2,20,3,True
1431881,1264,0,30,6684,724193028,1,0,0,713.16,8,552688.03,23,2,23,4,True
1433546,840,3,451,6325,724193028,1,0,0,713.05,7,551974.98,5,4,19,4,True
1479226,1388,1,25,1406,724193028,1,0,0,713.02,8,551261.96,24,6,9,5,True
1876276,1388,1,451,1667,724193028,1,0,0,712.92,7,550549.04,24,4,4,5,True
2317090,467,0,10,9451,724193028,1,0,0,712.97,6,551262.01,5,0,22,5,True
2454670,727,0,20,3542,724193028,1,0,0,713.04,5,550548.97,11,6,19,6,True
2507424,1181,2,25,6684,724193028,1,0,0,712.86,8,549836.11,24,5,5,6,True
2514028,926,4,-1,6257,724193028,1,1,0,712.88,4,549836.11,18,0,13,7,True
2670432,840,3,451,3511,724193028,1,0,0,712.8,7,549123.31,5,2,11,7,True
2704259,1181,2,451,5236,724193028,1,0,0,713.11,7,548410.2,24,6,19,8,True
2797285,926,4,30,9348,724193028,1,0,0,713.06,8,547697.14,18,4,9,8,True
2981631,1264,0,451,1960,724193028,1,0,0,713.08,7,546984.06,23,3,4,8,True
3021367,1181,2,30,1960,724193028,1,0,0,713.02,8,546271.04,24,4,22,8,False
3277104,1044,0,10,8428,724193028,1,0,0,713.26,0,546984.3,11,4,12,9,True
3691710,391,3,451,3542,724193028,1,0,0,713.16,7,546271.14,10,5,21,9,True
4102001,85,2,451,7340,724193028,1,0,0,712.89,7,545558.25,1,0,4,10,True
4931652,391,3,451,6257,724193028,1,0,0,713.17,7,544845.08,10,2,18,11,True
5022600,1247,0,20,6235,724193028,1,0,0,712.88,5,544132.2,23,2,11,12,True
5174092,85,2,451,6325,724193028,1,0,0,713.03,7,543419.17,1,3,2,1,True
5262782,840,3,-1,2218,724193028,1,1,0,713.14,4,543419.17,5,5,7,3,True
5378961,840,3,451,6684,724193028,1,0,0,712.86,7,542706.31,5,5,7,4,True
5420552,926,4,30,1667,724193028,1,0,0,712.92,8,541993.39,18,3,5,5,True
5432832,897,0,10,9348,724193028,1,0,0,712.99,6,542706.38,24,0,6,6,True
5627227,1264,0,451,6235,724193028,1,0,0,712.93,7,541993.45,23,2,23,6,True
5647813,926,4,451,7340,724193028,1,0,0,713.08,7,541280.37,18,4,12,6,True
5678374,1181,2,30,9451,724193028,1,0,0,712.81,8,540567.56,24,5,20,7,True
5858357,840,3,30,4911,724193028,1,0,0,712.94,8,539854.62,5,5,22,7,True
5869485,391,3,451,2218,724193028,1,0,0,713.0,7,539141.62,10,4,19,7,True
5912485,85,2,451,5179,724193028,1,0,0,713.17,7,538428.45,1,1,10,10,True
6175209,1181,2,451,1003,724193028,1,0,0,712.92,7,537715.53,24,3,5,10,True
6321524,926,4,-1,3511,724193028,1,1,0,713.02,4,537715.53,18,0,21,10,True
6432821,1181,2,451,2218,724193028,1,0,0,713.12,7,537002.41,24,6,0,10,True
6740863,391,3,-1,6325,724193028,1,1,0,712.76,1,537002.41,10,0,9,10,True
7034658,542,0,20,7340,724193028,1,0,0,713.15,3,536289.26,17,2,18,11,True
7091069,276,0,10,2342,724193028,1,0,0,712.72,0,537001.98,24,0,3,2,True
7121816,276,0,10,1960,724193028,1,0,0,713.15,6,537715.13,24,0,15,3,True
7151777,85,2,25,3511,724193028,1,0,0,712.76,8,537002.37,1,2,20,4,True
7582442,670,0,10,6235,724193028,1,0,0,712.79,6,537715.16,18,1,5,4,True
7847307,85,2,25,5316,724193028,1,0,0,713.07,8,537002.09,1,2,20,5,True
8130655,1264,0,451,3511,724193028,1,0,0,713.02,7,536289.07,23,4,22,5,True
8210322,1467,0,20,9451,724193028,1,0,0,712.89,5,535576.18,11,0,0,6,True
8299185,1486,2,-1,2635,724193028,1,1,0,713.02,4,535576.18,24,0,13,7,True
8439912,926,4,30,3172,724193028,1,0,0,712.8,8,534863.38,18,4,3,7,True
8768816,1388,1,-1,3511,724193028,1,1,0,713.19,4,534863.38,24,0,2,8,True
8845807,950,0,10,8428,724193028,1,0,0,713.24,6,535576.62,24,0,12,9,True
8887135,1282,2,20,1406,724193028,1,0,0,712.81,5,534863.81,24,4,2,9,True
9113939,840,3,451,6325,724193028,1,0,0,712.79,7,534151.02,5,3,13,10,True
9639150,681,2,20,9451,724193028,1,0,0,713.39,5,533437.63,24,6,0,10,True
9895510,85,2,30,6325,724193028,1,0,0,712.94,8,532724.69,1,1,7,11,True
1120438,533,2,451,1057,703497824,1,0,0,809.09,7,127241.91,18,5,2,1,True
1210916,749,4,25,7436,703497824,1,0,0,809.2,8,126432.71,24,1,16,2,True
1287991,108,2,30,1057,703497824,1,0,0,808.93,8,125623.78,3,3,5,3,True
1301519,10,4,-1,9494,703497824,1,1,0,809.13,4,125623.78,24,4,2,3,False
1570919,1421,0,10,8820,703497824,1,0,0,808.97,6,126432.75,24,5,9,3,True
1658034,871,0,20,9494,703497824,1,0,0,809.0,3,125623.75,24,1,22,3,True
2239552,924,4,30,8756,703497824,1,0,0,808.83,8,124814.92,18,0,5,5,True
2284205,1132,0,20,9001,703497824,1,0,0,809.11,5,124005.81,24,2,3,5,True
2527230,108,2,25,9494,703497824,1,0,0,809.24,8,123196.57,3,3,13,5,True
2561094,302,1,10,6891,703497824,1,0,0,809.01,6,124005.58,4,6,1,6,True
2653136,689,0,451,6917,703497824,1,0,0,808.99,7,123196.59,24,5,20,6,True
2758767,59,0,10,5601,703497824,1,0,0,808.79,0,124005.38,20,6,8,8,True
2911588,300,0,20,8756,703497824,1,0,0,809.09,5,123196.29,4,6,16,9,True
2962992,108,2,30,2293,703497824,1,0,0,808.98,8,122387.31,3,2,7,9,True
3027092,749,4,451,8756,703497824,1,0,0,809.0,7,121578.31,24,5,16,10,True
3469290,108,2,30,5700,703497824,1,0,0,809.02,8,120769.29,3,0,4,10,True
3583844,1354,0,20,8756,703497824,1,0,0,808.93,5,119960.36,24,2,13,10,True
3738910,689,0,451,8560,703497824,1,0,0,808.78,7,119151.58,24,6,18,10,True
3945167,689,0,-1,9922,703497824,1,1,0,808.96,4,119151.58,24,2,1,10,True
4102343,533,2,-1,2293,703497824,1,2,0,808.96,4,119151.58,18,1,22,11,True
4197799,108,2,451,8820,703497824,1,0,0,809.19,7,118342.39,3,5,11,12,True
4199063,10,4,25,6212,703497824,1,0,0,808.99,8,117533.4,24,2,23,1,True
4412662,318,0,20,6891,703497824,1,0,0,808.86,5,116724.54,11,5,22,2,True
4743960,1345,2,25,3409,703497824,1,0,0,808.75,8,115915.79,24,1,21,2,True
4791176,1345,2,25,6891,703497824,1,0,0,809.07,8,115106.72,24,5,23,3,True
4913077,689,0,25,5236,703497824,1,0,0,809.1,8,114297.62,24,5,1,3,True
4920686,10,4,451,8820,703497824,1,0,0,809.24,7,113488.38,24,4,4,4,True
5115477,378,0,20,5601,703497824,1,0,0,809.01,5,112679.37,25,2,11,4,True
5202170,10,4,-1,2293,703497824,1,1,0,809.0,4,112679.37,24,3,7,5,True
6076459,533,2,451,3409,703497824,1,0,0,808.88,7,111870.49,18,2,0,7,True
6194002,689,0,30,2293,703497824,1,0,0,809.22,8,111061.27,24,2,16,7,True
6220980,10,4,-1,7300,703497824,1,1,0,808.95,4,111061.27,24,1,21,8,True
6222800,557,1,10,5582,703497824,1,0,0,809.1,6,111870.37,17,4,16,9,True
6265660,10,4,25,2406,703497824,1,0,0,809.0,8,111061.37,24,6,23,10,True
6394527,689,0,451,8560,703497824,1,0,0,809.11,7,110252.26,24,1,0,10,True
6515114,716,0,20,1689,703497824,1,0,0,808.98,5,109443.28,18,6,12,11,True
6701853,108,2,-1,8756,703497824,1,1,0,808.77,4,109443.28,3,4,12,11,True
6968326,1255,0,10,9001,703497824,1,0,0,808.92,6,110252.2,23,2,12,1,True
7039246,790,0,20,5497,703497824,1,0,0,808.96,5,109443.24,11,3,0,2,True
7173143,533,2,451,1117,703497824,1,0,0,808.81,7,108634.43,18,5,16,3,True
7239993,749,4,-1,5236,703497824,1,1,0,808.93,1,108634.43,24,0,11,4,False
7244850,689,0,25,1689,703497824,1,0,0,808.93,8,107825.5,24,6,17,4,True
7426196,10,4,-1,9494,703497824,1,1,0,808.99,4,107825.5,24,1,5,4,True
8181294,68,0,10,9922,703497824,1,0,0,809.02,0,108634.52,20,3,17,5,True
8245203,1345,2,30,5700,703497824,1,0,0,808.97,8,107825.55,24,0,15,5,True
8435432,160,0,10,2468,703497824,1,0,0,809.04,6,108634.59,24,6,5,6,True
8665548,924,4,25,2406,703497824,1,0,0,808.85,8,107825.74,18,0,3,7,True
8714597,1345,2,451,9922,703497824,1,0,0,808.99,7,107016.75,24,1,20,7,True
8858096,1345,2,30,8756,703497824,1,0,0,809.11,8,106207.64,24,6,22,8,True
8880605,108,2,30,5623,703497824,1,0,0,808.99,8,105398.65,3,0,11,9,True
8945875,454,1,10,1057,703497824,1,0,0,808.98,0,106207.63,13,5,21,9,True
9021237,950,0,10,9001,703497824,1,0,0,809.06,6,107016.69,24,3,9,10,True
9230047,533,2,25,5582,703497824,1,0,0,809.17,8,106207.52,18,4,23,11,True
9795518,108,2,-1,8756,703497824,1,1,0,809.09,4,106207.52,3,2,4,11,True
1291480,673,0,10,6250,301324542,1,0,0,1034.09,0,170737.09,18,5,1,1,True
2050814,962,0,30,1344,301324542,1,0,0,1033.93,8,169703.16,13,3,15,1,True
2094418,998,0,10,1344,301324542,1,0,0,1033.97,6,170737.13,26,5,13,1,False
2095289,829,4,25,2463,301324542,1,0,0,1034.05,8,169703.08,18,0,18,2,True
2121595,1217,0,10,4734,301324542,1,0,0,1033.89,6,170736.97,24,0,19,2,True
2468364,829,4,25,1902,301324542,1,0,0,1034.08,8,169702.89,18,2,4,3,True
2775244,299,1,10,3556,301324542,1,0,0,1034.21,0,170737.1,4,1,21,3,True
2873061,890,4,25,3045,301324542,1,0,0,1033.87,8,169703.23,24,4,14,4,True
3070008,719,4,25,9355,301324542,1,0,0,1034.11,8,168669.12,11,1,17,5,True
3080214,1471,0,20,2646,301324542,1,0,0,1033.85,5,167635.27,24,5,19,5,False
3253085,1037,0,10,3556,301324542,1,0,0,1033.87,6,168669.14,11,4,12,6,True
3852776,829,4,-1,9264,301324542,1,1,0,1033.89,4,168669.14,18,6,8,6,True
3983395,378,0,20,1344,301324542,1,0,0,1033.92,5,167635.22,25,4,18,7,True
4187290,1355,4,25,8546,301324542,1,0,0,1034.08,8,166601.14,24,0,18,7,True
4406238,656,2,20,6250,301324542,1,0,0,1034.0,3,165567.14,18,3,1,7,True
4488670,572,0,-1,4734,301324542,1,1,0,1034.21,4,165567.14,11,1,6,7,True
4542871,950,0,20,9264,301324542,1,0,0,1033.77,5,164533.37,24,2,20,7,True
4862137,719,4,451,8546,301324542,1,0,0,1034.1,7,163499.27,11,4,15,8,True
5051905,1231,2,20,2463,301324542,1,0,0,1033.92,5,162465.35,18,6,14,8,True
5192415,1093,0,20,2646,301324542,1,0,0,1033.96,5,161431.39,18,3,14,9,True
5203674,1355,4,451,9890,301324542,1,0,0,1033.96,7,160397.43,24,5,6,10,True
5245668,829,4,30,3556,301324542,1,0,0,1033.82,8,159363.61,18,4,23,11,True
5487374,719,4,25,2463,301324542,1,0,0,1034.08,8,158329.53,11,3,12,1,True
5619035,314,0,20,8546,301324542,1,0,0,1034.04,5,157295.49,4,6,0,2,True
5662928,714,2,20,7173,301324542,1,0,0,1034.12,3,156261.37,18,5,11,3,True
5695908,1315,0,20,2463,301324542,1,0,0,1033.83,3,155227.54,5,2,2,3,True
5830661,890,4,25,1902,301324542,1,0,0,1033.95,8,154193.59,24,6,4,3,True
6251782,719,4,451,1634,301324542,1,0,0,1033.92,7,153159.67,11,6,3,4,True
6344828,719,4,30,4734,301324542,1,0,0,1033.95,8,152125.72,11,5,16,4,True
6666386,393,1,10,2646,301324542,1,0,0,1034.05,6,153159.77,10,3,7,5,True
6738315,719,4,451,1634,301324542,1,0,0,1033.98,7,152125.79,11,2,3,5,True
6909512,890,4,30,3556,301324542,1,0,0,1033.82,8,151091.97,24,6,20,6,True
7506407,572,0,25,9264,301324542,1,0,0,1033.97,8,150058.0,11,1,6,6,True
7548711,829,4,25,2066,301324542,1,0,0,1034.09,8,149023.91,18,4,1,8,True
7594009,829,4,451,2463,301324542,1,0,0,1033.89,7,147990.02,18,0,9,11,True
7825925,719,4,-1,9264,301324542,1,1,0,1033.73,4,147990.02,11,0,1,1,True
7933906,1180,1,10,9890,301324542,1,0,0,1034.05,6,149024.07,24,6,7,1,True
8028879,829,4,451,2646,301324542,1,0,0,1034.08,7,147989.99,18,3,12,2,True
8185719,829,4,25,3511,301324542,1,0,0,1033.97,8,146956.02,18,2,13,2,True
8210522,1434,0,10,3511,301324542,1,0,0,1033.95,6,147989.97,24,0,1,4,True
8287084,890,4,451,1344,301324542,1,0,0,1034.05,7,146955.92,24,1,10,5,True
8791109,1090,0,20,9355,301324542,1,0,0,1033.96,5,145921.96,18,5,19,6,True
8992388,1355,4,451,9264,301324542,1,0,0,1033.96,7,144888.0,24,1,10,7,True
9072373,719,4,451,4734,301324542,1,0,0,1033.9,7,143854.1,11,1,18,7,True
9109481,829,4,25,8546,301324542,1,0,0,1034.03,8,142820.07,18,3,14,7,True
9242222,572,0,30,8546,301324542,1,0,0,1034.06,8,141786.01,11,6,1,8,True
9381792,962,0,25,3556,301324542,1,0,0,1033.78,8,140752.23,13,6,18,8,True
9551861,890,4,30,2066,301324542,1,0,0,1034.11,8,139718.12,24,0,7,8,True
9670536,465,0,20,9355,301324542,1,0,0,1033.89,5,138684.23,13,0,15,9,False
9770678,1355,4,-1,7290,301324542,1,1,0,1034.05,4,138684.23,24,2,18,9,True
9804341,1355,4,30,6250,301324542,1,0,0,1034.21,8,137650.02,24,0,5,9,True
9989339,829,4,30,3045,301324542,1,0,0,1033.89,8,136616.13,18,3,12,11,True
1206811,811,0,20,6112,584035289,0,0,0,1034.08,3,459780.92,18,5,1,1,True
1484989,328,0,451,4285,584035289,0,0,0,1034.14,7,458746.78,11,5,3,1,True
1564115,1449,0,451,7590,584035289,0,0,0,1033.92,7,457712.86,11,4,8,2,True
1769094,961,4,451,7752,584035289,0,0,0,1033.95,7,456678.91,13,0,17,3,True
1777935,961,4,30,8367,584035289,0,0,0,1034.19,8,455644.72,13,1,8,3,True
1795705,665,2,451,2811,584035289,0,0,0,1033.96,7,454610.76,18,3,8,3,True
1817799,961,4,451,2865,584035289,0,0,0,1034.02,7,453576.74,13,0,23,4,True
2348374,64,0,20,5590,584035289,0,0,0,1034.19,5,452542.55,20,2,12,4,True
2462744,328,0,25,8308,584035289,0,0,0,1034.27,8,451508.28,11,6,5,4,True
2534683,180,0,451,8948,584035289,0,0,0,1034.11,7,450474.17,18,1,8,4,True
2541859,1328,4,451,5408,584035289,0,0,0,1033.96,7,449440.21,18,6,22,5,True
3146866,1210,0,30,8948,584035289,0,0,0,1033.99,8,448406.22,24,1,13,5,True
3285538,328,0,-1,8100,584035289,0,1,0,1033.95,4,448406.22,11,6,3,6,True
3578528,1328,4,451,1473,584035289,0,0,0,1034.13,7,447372.09,18,6,6,7,True
3695548,961,4,30,1473,584035289,0,0,0,1033.97,8,446338.12,13,2,9,8,True
3769139,961,4,25,5360,584035289,0,0,0,1034.02,8,445304.1,13,0,13,10,True
3852629,211,0,451,7100,584035289,0,0,0,1034.07,7,444270.03,9,4,2,10,True
3863965,328,0,30,9517,584035289,0,0,0,1034.2,8,443235.83,11,3,17,12,True
3946982,599,0,10,2865,584035289,0,0,0,1033.93,6,444269.76,24,0,10,1,True
4455283,211,0,-1,6511,584035289,0,1,0,1034.02,4,444269.76,9,5,6,2,True
4798305,1449,0,451,7752,584035289,0,0,0,1033.88,7,443235.88,11,1,2,2,True
4849722,279,2,20,1498,584035289,0,0,0,1033.69,3,442202.19,24,5,11,5,True
5997302,665,2,30,8308,584035289,0,0,0,1033.87,8,441168.32,18,4,9,6,True
6144586,180,0,25,9483,584035289,0,0,0,1033.94,8,440134.38,18,4,23,8,True
6223402,1449,0,25,6480,584035289,0,0,0,1034.02,8,439100.36,11,2,1,8,True
6449563,1023,2,20,8308,584035289,0,0,0,1033.93,5,438066.43,11,4,12,9,True
6631099,1210,0,451,3476,584035289,0,0,0,1033.76,7,437032.67,24,5,6,9,True
6885290,128,0,20,4439,584035289,0,0,0,1033.97,5,435998.7,18,5,18,9,True
6887495,665,2,451,6480,584035289,0,0,0,1033.98,7,434964.72,18,6,19,10,True
7002264,180,0,451,4439,584035289,0,0,0,1034.09,7,433930.63,18,1,21,12,True
7389015,1449,0,451,1498,584035289,0,0,0,1033.85,7,432896.78,11,2,4,12,True
7479128,1075,0,10,6112,584035289,0,0,0,1033.95,0,433930.73,18,3,18,12,True
7533834,665,2,451,1498,584035289,0,0,0,1034.13,7,432896.6,18,2,5,1,True
7560592,961,4,25,8100,584035289,0,0,0,1034.4,8,431862.2,13,5,7,2,True
7820114,180,0,451,3404,584035289,0,0,0,1033.99,7,430828.21,18,5,15,3,True
7956533,443,2,451,6648,584035289,0,0,0,1034.16,7,429794.05,24,5,11,3,True
8081620,1092,1,10,4439,584035289,0,0,0,1033.93,6,430827.98,18,1,9,4,True
8096866,211,0,451,5360,584035289,0,0,0,1034.06,7,429793.92,9,1,15,4,True
8182400,443,2,451,7590,584035289,0,0,0,1033.98,7,428759.94,24,6,18,5,True
8284461,220,0,10,1473,584035289,0,0,0,1033.68,6,429793.62,26,3,0,5,True
8355660,1328,4,451,1833,584035289,0,0,0,1033.96,7,428759.66,18,4,10,5,True
8449666,1391,2,20,8367,584035289,0,0,0,1033.83,5,427725.83,24,0,9,6,True
8455208,1328,4,30,3476,584035289,0,0,0,1034.12,8,426691.71,18,0,12,6,True
8668030,1436,0,20,2811,584035289,0,0,0,1033.97,5,425657.74,24,5,12,7,True
8729619,328,0,30,8367,584035289,0,0,0,1034.09,8,424623.65,11,0,1,8,True
8823570,665,2,451,4996,584035289,0,0,0,1034.06,7,423589.59,18,2,9,8,True
9240734,1210,0,-1,6480,584035289,0,1,0,1034.35,1,423589.59,24,3,4,8,True
9447787,155,1,10,8367,584035289,0,0,0,1034.01,6,424623.6,18,3,3,9,True
9592751,665,2,30,8308,584035289,0,0,0,1033.89,8,423589.71,18,5,22,9,False
9638328,1210,0,451,5360,584035289,0,0,0,1033.98,7,422555.73,24,3,20,10,True
9774801,1210,0,25,9869,584035289,0,0,0,1033.81,8,421521.92,24,6,15,11,True
1073094,942,0,10,8322,517195670,1,0,0,846.95,0,938492.95,24,6,8,2,True
1156529,944,2,20,1948,517195670,1,0,0,847.13,5,937645.82,24,1,15,2,True
1264997,1170,0,10,6218,517195670,1,0,0,847.05,6,938492.87,24,6,11,3,True
1303843,1132,0,10,3437,517195670,1,0,0,846.99,6,939339.86,24,0,3,3,True
1332464,1029,0,10,4986,517195670,1,0,0,846.95,0,940186.81,11,1,5,6,True
1404224,29,0,10,9567,517195670,1,0,0,847.17,6,941033.98,11,1,20,6,True
1791572,819,2,-1,5089,517195670,1,1,0,847.08,4,941033.98,18,3,6,6,True
1804005,693,4,25,5089,517195670,1,0,0,847.06,8,940186.92,24,4,4,7,True
1881856,988,3,451,9010,517195670,1,0,0,847.08,7,939339.84,22,6,17,7,True
1958209,909,2,20,6218,517195670,1,0,0,846.86,3,938492.98,18,3,15,8,True
2023611,1053,1,10,5089,517195670,1,0,0,847.19,0,939340.17,11,2,6,9,True
2131464,1069,1,25,3916,517195670,1,0,0,846.78,8,938493.39,18,6,6,11,True
2197709,693,4,451,1902,517195670,1,0,0,847.16,7,937646.23,24,3,7,12,True
2224053,819,2,25,9567,517195670,1,0,0,847.46,8,936798.77,18,3,19,12,False
2883492,467,0,20,6060,517195670,1,0,0,847.36,5,935951.41,5,6,4,12,False
3034544,819,2,30,9010,517195670,1,0,0,846.94,8,935104.47,18,3,6,12,True
3181961,748,1,10,8322,517195670,1,0,0,847.09,6,935951.56,24,6,20,1,True
3192872,329,1,-1,9644,517195670,1,1,0,846.67,4,935951.56,11,6,15,1,True
3337844,693,4,451,7244,517195670,1,0,0,847.15,7,935104.41,24,6,18,5,True
3349436,885,3,-1,6081,517195670,1,1,0,846.75,1,935104.41,24,1,9,5,True
3386614,664,2,20,8482,517195670,1,0,0,847.07,5,934257.34,18,0,12,6,True
3693878,728,1,10,3916,517195670,1,0,0,846.67,6,935104.01,11,3,10,6,True
3995864,329,1,451,3916,517195670,1,0,0,847.13,7,934256.88,11,1,17,8,True
4088410,693,4,451,6218,517195670,1,0,0,847.16,7,933409.72,24,4,18,8,True
4108225,329,1,-1,3916,517195670,1,1,0,846.84,4,933409.72,11,2,1,9,True
5154974,1201,0,451,8364,517195670,1,0,0,846.88,7,932562.84,24,1,10,10,True
5483935,885,3,451,8322,517195670,1,0,0,847.24,7,931715.6,24,3,10,10,True
5758831,819,2,25,4986,517195670,1,0,0,847.06,8,930868.54,18,0,10,10,True
6050453,675,2,20,9010,517195670,1,0,0,847.12,5,930021.42,24,6,2,10,True
6148154,1300,4,451,1902,517195670,1,0,0,846.97,7,929174.45,5,5,21,11,True
6321466,1201,0,25,1948,517195670,1,0,0,846.98,8,928327.47,24,6,16,11,False
6541040,819,2,30,6081,517195670,1,0,0,847.12,8,927480.35,18,5,2,11,True
6607623,885,3,451,3916,517195670,1,0,0,846.77,7,926633.58,24,1,1,11,True
6751336,530,0,20,8364,517195670,1,0,0,847.0,5,925786.58,18,1,3,11,True
7154379,1201,0,-1,8364,517195670,1,1,0,847.05,1,925786.58,24,1,22,12,True
7399435,988,3,25,9567,517195670,1,0,0,846.65,8,924939.93,22,1,7,1,True
7646883,393,1,10,1902,517195670,1,0,0,847.04,6,925786.97,10,6,1,2,True
7819383,329,1,30,9010,517195670,1,0,0,846.89,8,924940.08,11,5,22,3,True
7847751,819,2,-1,8364,517195670,1,1,0,846.76,4,924940.08,18,1,18,3,True
7987842,1325,0,10,1948,517195670,1,0,0,847.0,6,925787.08,18,3,14,4,True
8401900,693,4,451,5089,517195670,1,0,0,846.85,7,924940.23,24,5,16,5,True
8503729,1009,0,20,6081,517195670,1,0,0,846.99,5,924093.24,26,5,8,5,True
8509678,1069,1,30,3437,517195670,1,0,0,847.2,8,923246.04,18,4,15,5,True
8679430,988,3,25,5089,517195670,1,0,0,847.12,8,922398.92,22,5,17,6,True
8683869,885,3,25,6218,517195670,1,0,0,846.96,8,921551.96,24,6,15,6,True
8939472,1217,0,10,9010,517195670,1,0,0,847.16,6,922399.12,24,0,3,7,True
9351118,116,0,10,5089,517195670,1,0,0,847.13,6,923246.25,3,0,20,8,True
9390873,329,1,-1,6060,517195670,1,1,0,847.35,4,923246.25,11,6,0,8,True
9480346,1201,0,451,6218,517195670,1,0,0,847.0,7,922399.25,24,2,20,9,True
9499786,329,1,451,8293,517195670,1,0,0,846.85,7,921552.4,11,3,23,9,True
9506676,329,1,30,4986,517195670,1,0,0,846.95,8,920705.45,11,5,17,10,True
9890608,882,0,10,5089,517195670,1,0,0,846.95,6,921552.4,27,1,0,10,True
1030159,1283,2,30,6404,412833308,1,0,0,1110.02,8,750901.98,24,4,4,1,True
1057035,502,0,10,6019,412833308,1,0,0,1109.87,0,752011.85,12,1,16,2,True
1224164,840,3,30,4661,412833308,1,0,0,1110.05,8,750901.8,5,6,7,2,True
1691224,263,3,30,9885,412833308,1,0,0,1110.12,8,749791.68,6,1,2,2,False
1738206,1015,0,-1,1494,412833308,1,1,0,1110.35,4,749791.68,26,3,11,3,False
1821693,1015,0,451,6404,412833308,1,0,0,1110.28,7,748681.4,26,6,22,4,True
1834012,1308,3,-1,7153,412833308,1,1,0,1109.92,4,748681.4,5,0,15,5,True
2027631,263,3,451,1894,412833308,1,0,0,1110.21,7,747571.19,6,6,17,6,True
2042097,1015,0,-1,9989,412833308,1,1,0,1110.11,1,747571.19,26,5,16,6,True
2089500,1015,0,451,1494,412833308,1,0,0,1110.08,7,746461.11,26,5,8,7,True
2307938,840,3,30,2583,412833308,1,0,0,1110.13,8,745350.98,5,4,21,8,True
2309746,257,1,10,6991,412833308,1,0,0,1110.05,6,746461.03,6,4,23,8,True
2373132,1308,3,451,4522,412833308,1,0,0,1110.31,7,745350.72,5,5,16,9,True
3258309,465,0,10,7332,412833308,1,0,0,1110.0,6,746460.72,13,6,1,9,True
3536597,1015,0,-1,7153,412833308,1,1,0,1109.56,4,746460.72,26,6,9,9,True
3666707,840,3,451,6991,412833308,1,0,0,1110.06,7,745350.66,5,6,20,10,True
3764296,130,0,10,4863,412833308,1,0,0,1110.13,6,746460.79,18,4,9,10,True
4153077,1023,2,30,1894,412833308,1,0,0,1109.72,8,745351.07,11,5,23,10,True
4611074,1308,3,25,1079,412833308,1,0,0,1109.81,8,744241.26,5,2,18,11,True
4652390,694,2,20,6991,412833308,1,0,0,1109.88,3,743131.38,24,0,18,11,True
4661180,1308,3,-1,7153,412833308,1,1,0,1109.91,4,743131.38,5,1,1,12,True
4724877,348,0,20,1079,412833308,1,0,0,1109.76,3,742021.62,24,1,20,2,True
4935709,1023,2,451,9989,412833308,1,0,0,1109.88,7,740911.74,11,4,23,2,True
5288459,535,0,20,1494,412833308,1,0,0,1110.1,3,739801.64,18,2,8,3,True
5327960,1315,0,20,7567,412833308,1,0,0,1110.2,3,738691.44,5,5,23,3,True
5425213,1308,3,-1,6404,412833308,1,1,0,1110.04,4,738691.44,5,0,15,3,True
5731653,263,3,30,3989,412833308,1,0,0,1110.11,8,737581.33,6,4,15,3,True
5755098,263,3,30,6056,412833308,1,0,0,1110.23,8,736471.1,6,5,17,4,True
5770672,263,3,-1,3989,412833308,1,1,0,1109.8,1,736471.1,6,0,10,5,True
5972915,260,0,10,3989,412833308,1,0,0,1110.06,0,737581.16,6,4,8,5,True
6054537,297,0,10,2583,412833308,1,0,0,1110.04,0,738691.2,4,3,22,5,True
6169820,630,0,10,2583,412833308,1,0,0,1110.16,6,739801.36,11,2,17,6,True
6176236,1072,0,25,6404,412833308,1,0,0,1110.01,8,738691.35,18,3,6,6,True
6227324,1283,2,451,4863,412833308,1,0,0,1110.07,7,737581.28,24,4,0,7,True
6496223,840,3,30,8026,412833308,1,0,0,1110.19,8,736471.09,5,4,15,8,True
6504301,1283,2,25,8026,412833308,1,0,0,1110.27,8,735360.82,24,1,21,8,True
6753540,1388,1,10,5257,412833308,1,0,0,1110.26,6,736471.08,24,3,16,9,True
7411730,916,0,10,8629,412833308,1,0,0,1109.84,6,737580.92,18,3,20,9,True
7425572,1072,0,-1,7332,412833308,1,1,0,1110.21,1,737580.92,18,6,0,10,True
7446014,1015,0,30,2696,412833308,1,0,0,1110.0,8,736470.92,26,4,17,10,True
7487254,931,0,20,4522,412833308,1,0,0,1110.2,5,735360.72,24,2,4,11,True
7800834,51,0,20,2486,412833308,1,0,0,1109.78,3,734250.94,20,3,12,11,True
7998591,1308,3,30,9062,412833308,1,0,0,1109.83,8,733141.11,5,2,5,12,True
8075519,840,3,30,6650,412833308,1,0,0,1109.96,8,732031.15,5,4,20,12,True
8135554,1467,0,10,9950,412833308,1,0,0,1109.96,6,733141.11,11,6,0,1,True
8189349,1072,0,-1,6650,412833308,1,1,0,1110.22,1,733141.11,18,5,2,2,True
8244560,1072,0,451,8629,412833308,1,0,0,1109.92,7,732031.19,18,6,9,2,True
8489839,1072,0,451,8047,412833308,1,0,0,1109.94,7,730921.25,18,0,7,3,True
8685968,1023,2,451,2486,412833308,1,0,0,1110.2,7,729811.05,11,1,22,4,True
8790362,1023,2,451,9062,412833308,1,0,0,1110.18,7,728700.87,11,6,17,4,True
8939057,840,3,30,2486,412833308,1,0,0,1109.93,8,727590.94,5,4,7,4,True
8960051,263,3,-1,8026,412833308,1,1,0,1109.87,4,727590.94,6,6,22,6,True
8965122,1015,0,25,2696,412833308,1,0,0,1110.01,8,726480.93,26,1,6,6,True
9141590,1308,3,451,2486,412833308,1,0,0,1110.11,7,725370.82,5,1,18,7,True
9150685,1023,2,25,9950,412833308,1,0,0,1110.28,8,724260.54,11,3,1,7,True
9173018,574,2,20,6650,412833308,1,0,0,1110.11,5,723150.43,11,1,4,8,True
9274113,385,1,10,9530,412833308,1,0,0,1110.06,6,724260.49,25,2,18,8,True
9731743,234,0,10,4522,412833308,1,0,0,1110.04,6,725370.53,26,5,12,11,True
9774390,1015,0,25,9989,412833308,1,0,0,1110.11,8,724260.42,26,2,4,11,True
1111858,599,0,20,9434,253020703,1,0,0,408.99,3,971944.01,24,0,19,1,True
1483537,727,0,20,4656,253020703,1,0,0,409.12,5,971534.89,11,4,11,2,True
1492203,1025,1,10,3727,253020703,1,0,0,408.78,6,971943.67,11,3,3,2,True
1913877,467,0,30,1854,253020703,1,0,0,409.22,8,971534.45,5,3,17,5,True
2014979,467,0,451,4656,253020703,1,0,0,408.93,7,971125.52,5,2,0,5,True
2075674,627,0,20,4081,253020703,1,0,0,409.11,5,970716.41,11,3,19,6,True
3032404,1391,2,-1,3919,253020703,1,1,0,409.02,4,970716.41,24,6,18,6,True
3202687,1283,2,451,7759,253020703,1,0,0,408.94,7,970307.47,24,5,4,8,True
3243399,675,2,20,9821,253020703,1,0,0,408.74,5,969898.73,24,3,6,9,True
3288430,467,0,451,2193,253020703,1,0,0,409.13,7,969489.6,5,4,21,9,True
3541577,1278,0,20,2703,253020703,1,0,0,408.93,5,969080.67,24,0,19,9,True
3665451,235,4,30,3727,253020703,1,0,0,408.73,8,968671.94,26,0,1,10,True
3707101,1283,2,451,9242,253020703,1,0,0,408.78,7,968263.16,24,0,10,10,True
3732488,1206,0,10,2826,253020703,1,0,0,408.79,6,968671.95,24,5,9,12,True
3768262,1150,0,20,4181,253020703,1,0,0,409.18,5,968262.77,15,4,12,1,True
3793073,1101,2,20,4181,253020703,1,0,0,409.31,5,967853.46,0,4,1,2,True
4033608,1377,0,-1,7860,253020703,1,1,0,408.89,1,967853.46,16,2,21,3,True
4034787,29,0,10,8201,253020703,1,0,0,408.98,0,968262.44,11,5,22,4,True
4149776,166,4,451,9242,253020703,1,0,0,409.0,7,967853.44,24,4,19,4,True
4150082,189,4,30,2826,253020703,1,0,0,409.0,8,967444.44,18,6,1,4,True
4220504,806,1,10,9242,253020703,1,0,0,408.95,6,967853.39,11,0,22,5,True
4355837,180,0,10,3727,253020703,1,0,0,408.95,6,968262.34,18,3,6,5,True
5060327,685,3,30,9821,253020703,1,0,0,409.04,8,967853.3,24,1,10,7,True
5109720,1283,2,30,9821,253020703,1,0,0,408.9,8,967444.4,24,6,7,8,True
5120807,467,0,451,4656,253020703,1,0,0,409.09,7,967035.31,5,2,9,8,True
5377850,189,4,30,2193,253020703,1,0,0,409.22,8,966626.09,18,0,18,9,True
5516188,712,0,10,2226,253020703,1,0,0,408.79,6,967034.88,18,0,1,9,True
5658603,235,4,30,3481,253020703,1,0,0,408.71,8,966626.17,26,0,16,9,True
5698280,235,4,30,4181,253020703,1,0,0,408.92,8,966217.25,26,1,20,9,True
5770085,1283,2,-1,9434,253020703,1,1,0,409.17,4,966217.25,24,2,3,10,True
5979703,685,3,30,9242,253020703,1,0,0,409.18,8,965808.07,24,1,8,10,True
6067554,1160,0,20,8201,253020703,1,0,0,409.12,5,965398.95,15,2,16,10,True
6303291,757,0,20,2601,253020703,1,0,0,409.07,3,964989.88,24,1,17,11,True
6318886,166,4,451,3919,253020703,1,0,0,408.91,7,964580.97,24,3,16,12,True
6416198,189,4,451,3727,253020703,1,0,0,408.67,7,964172.3,18,5,2,1,True
6524594,1283,2,30,6287,253020703,1,0,0,409.0,8,963763.3,24,0,9,1,True
6963758,166,4,451,1729,253020703,1,0,0,408.86,7,963354.44,24,3,13,3,True
7171408,166,4,30,9392,253020703,1,0,0,408.94,8,962945.5,24,5,20,4,True
7218434,1298,0,10,4081,253020703,1,0,0,409.14,0,963354.64,5,5,8,4,True
7303769,467,0,451,9434,253020703,1,0,0,408.87,7,962945.77,5,5,17,4,True
7728680,204,0,20,8201,253020703,1,0,0,409.0,5,962536.77,9,1,5,4,True
7896658,319,0,10,7860,253020703,1,0,0,408.81,6,962945.58,11,4,5,5,True
8064416,189,4,25,2601,253020703,1,0,0,409.03,8,962536.55,18,3,8,5,True
8166063,235,4,30,2226,253020703,1,0,0,408.89,8,962127.66,26,4,13,5,True
8486375,20,0,10,2193,253020703,1,0,0,408.92,0,962536.58,24,3,22,6,True
8693464,685,3,25,9434,253020703,1,0,0,408.97,8,962127.61,24,2,7,7,True
9253749,166,4,25,4081,253020703,1,0,0,408.96,8,961718.65,24,2,11,7,True
9285598,166,4,451,3727,253020703,1,0,0,409.04,7,961309.61,24,6,8,9,True
9410251,23,0,10,4656,253020703,1,0,0,409.08,6,961718.69,11,5,20,9,True
9475539,166,4,25,3481,253020703,1,0,0,408.94,8,961309.75,24,0,5,9,True
9478852,1476,0,10,3512,253020703,1,0,0,408.97,0,961718.72,24,4,23,10,True
9669827,1377,0,30,8297,253020703,1,0,0,409.07,8,961309.65,16,6,6,10,True
1174403,1069,1,451,3998,125855613,1,0,0,185.04,7,198638.96,18,2,8,1,True
1403088,300,0,10,3998,125855613,1,0,0,184.77,6,198823.73,4,4,21,1,True
1490728,1069,1,30,8385,125855613,1,0,0,185.01,8,198638.72,18,2,7,5,False
1594645,68,0,-1,1106,125855613,1,1,0,184.91,1,198638.72,20,2,15,6,True
2013635,1052,0,25,2119,125855613,1,0,0,184.91,8,198453.81,11,3,20,9,True
2052621,1107,3,30,5180,125855613,1,0,0,185.12,8,198268.69,0,1,5,10,True
2148474,58,2,20,4802,125855613,1,0,0,184.95,5,198083.74,20,0,13,11,True
2153202,370,4,30,6449,125855613,1,0,0,185.13,8,197898.61,25,0,22,11,True
2269841,395,4,451,1642,125855613,1,0,0,185.06,7,197713.55,10,6,6,11,True
2650450,588,0,20,6449,125855613,1,0,0,185.12,5,197528.43,24,1,15,11,True
2788728,1307,0,10,2119,125855613,1,0,0,185.21,6,197713.64,5,2,3,11,True
3166119,824,2,20,5180,125855613,1,0,0,185.2,3,197528.44,18,5,10,12,True
3380238,1052,0,30,9326,125855613,1,0,0,185.06,8,197343.38,11,1,6,12,True
3444479,538,0,20,3738,125855613,1,0,0,185.12,3,197158.26,18,5,6,12,True
3540798,755,3,25,5872,125855613,1,0,0,185.02,8,196973.24,24,5,13,1,True
3583257,1107,3,-1,8385,125855613,1,1,0,185.04,1,196973.24,0,2,13,2,True
3587299,1069,1,25,5869,125855613,1,0,0,184.78,8,196788.46,18,0,2,2,True
4007163,812,0,10,9326,125855613,1,0,0,185.05,0,196973.51,18,2,18,3,True
4025834,1107,3,451,7007,125855613,1,0,0,185.11,7,196788.4,0,3,0,3,True
4359909,729,0,10,4802,125855613,1,0,0,185.14,0,196973.54,11,5,19,3,True
4550754,1052,0,25,3738,125855613,1,0,0,185.03,8,196788.51,11,3,20,4,True
4650703,1052,0,25,2119,125855613,1,0,0,184.91,8,196603.6,11,1,20,5,True
4805402,1107,3,451,9310,125855613,1,0,0,185.14,7,196418.46,0,2,5,9,False
4960846,1069,1,30,5869,125855613,1,0,0,185.11,8,196233.35,18,6,15,12,True
5079505,1053,1,10,9043,125855613,1,0,0,184.99,6,196418.34,11,6,14,12,True
5450593,370,4,30,7724,125855613,1,0,0,185.21,8,196233.13,25,5,22,2,True
5508039,68,0,-1,4314,125855613,1,1,0,185.13,1,196233.13,20,1,11,3,True
5594742,68,0,30,2338,125855613,1,0,0,185.05,8,196048.08,20,4,5,5,True
5940846,755,3,-1,2283,125855613,1,1,0,185.03,1,196048.08,24,4,16,5,True
6274961,755,3,25,8385,125855613,1,0,0,184.94,8,195863.14,24,5,23,5,True
6443451,21,0,20,9326,125855613,1,0,0,185.32,5,195677.82,11,1,3,6,True
6497691,1159,0,10,7724,125855613,1,0,0,184.92,6,195862.74,15,1,4,7,True
6707296,215,0,20,4802,125855613,1,0,0,185.22,3,195677.52,9,6,10,7,True
6727094,1052,0,30,1106,125855613,1,0,0,185.13,8,195492.39,11,4,23,8,True
7077158,755,3,-1,6449,125855613,1,1,0,184.67,4,195492.39,24,6,14,8,True
7174383,68,0,-1,4802,125855613,1,2,0,184.87,4,195492.39,20,0,0,9,True
7344973,1052,0,-1,9310,125855613,1,3,1,185.19,4,195492.39,11,3,19,11,True
1224310,480,0,25,5788,403085721,0,0,0,557.18,8,979691.82,5,6,21,1,True
1255653,203,0,10,2329,403085721,0,0,0,556.92,6,980248.74,9,0,18,1,True
1277546,1313,4,451,7847,403085721,0,0,0,557.1,7,979691.64,5,1,8,1,True
1342127,1264,0,10,3740,403085721,0,0,0,557.08,0,980248.72,23,3,17,1,True
1370273,464,1,451,7944,403085721,0,0,0,557.03,7,979691.69,13,1,5,1,True
1460946,480,0,451,6194,403085721,0,0,0,557.15,7,979134.54,5,1,14,1,True
1549664,802,2,20,2329,403085721,0,0,0,557.18,5,978577.36,11,2,2,1,True
1551640,269,0,20,5507,403085721,0,0,0,556.66,5,978020.7,24,0,9,2,True
1650032,1495,3,25,8364,403085721,0,0,0,557.2,8,977463.5,24,2,6,3,True
1986222,480,0,451,8364,403085721,0,0,0,556.9,7,976906.6,5,4,11,4,True
2024928,480,0,-1,8935,403085721,0,1,0,557.08,4,976906.6,5,0,23,5,True
2096127,205,0,10,2358,403085721,0,0,0,556.96,0,977463.56,9,2,0,5,True
2273985,1115,1,10,9347,403085721,0,0,0,556.94,6,978020.5,0,2,11,5,True
2547191,1313,4,-1,6194,403085721,0,1,0,556.87,4,978020.5,5,0,10,5,True
2761129,1495,3,451,8364,403085721,0,0,0,557.27,7,977463.23,24,4,4,8,True
2962775,1313,4,451,6194,403085721,0,0,0,556.97,7,976906.26,5,1,18,9,True
3049086,695,2,20,2526,403085721,0,0,0,556.97,3,976349.29,24,4,12,9,True
3261820,1495,3,25,8364,403085721,0,0,0,557.2,8,975792.09,24,1,4,10,True
3436012,464,1,25,8364,403085721,0,0,0,557.04,8,975235.05,13,5,20,10,True
3492184,1495,3,-1,8364,403085721,0,1,0,557.17,4,975235.05,24,2,12,10,True
3626424,463,1,10,8364,403085721,0,0,0,557.29,0,975792.34,13,6,2,11,True
3872533,20,0,10,7847,403085721,0,0,0,557.0,6,976349.34,24,1,14,12,True
4130751,1495,3,25,5788,403085721,0,0,0,556.68,8,975792.66,24,1,23,1,True
4651293,1495,3,25,6134,403085721,0,0,0,556.92,8,975235.74,24,0,19,1,True
4726720,724,3,25,6194,403085721,0,0,0,557.38,8,974678.36,11,3,12,3,True
5043467,724,3,451,3801,403085721,0,0,0,557.0,7,974121.36,11,5,0,4,True
5184354,464,1,-1,2329,403085721,0,1,0,557.15,4,974121.36,13,2,2,5,True
5435172,1227,0,10,1409,403085721,0,0,0,557.09,6,974678.45,18,6,1,5,True
5792994,1495,3,451,1409,403085721,0,0,0,557.24,7,974121.21,24,5,23,6,True
5939515,952,0,20,5507,403085721,0,0,0,557.19,5,973564.02,13,6,11,6,True
6008459,724,3,-1,1409,403085721,0,1,0,557.12,4,973564.02,11,4,4,6,True
6248791,464,1,451,6134,403085721,0,0,0,557.13,7,973006.89,13,5,3,6,True
6278743,68,0,10,6194,403085721,0,0,0,557.08,6,973563.97,20,0,20,6,True
6558934,362,0,20,3740,403085721,0,0,0,557.1,5,973006.87,24,6,2,7,True
6566733,480,0,30,7847,403085721,0,0,0,556.88,8,972449.99,5,2,1,7,True
6806077,942,0,10,9347,403085721,0,0,0,557.32,6,973007.31,24,0,10,7,True
6910408,854,0,10,8935,403085721,0,0,0,557.01,6,973564.32,24,5,14,8,True
7108194,1313,4,30,3901,403085721,0,0,0,556.95,8,973007.37,5,4,12,8,True
7388586,1227,0,10,7847,403085721,0,0,0,556.99,6,973564.36,18,3,13,10,True
7526796,1313,4,451,8364,403085721,0,0,0,556.88,7,973007.48,5,4,21,12,True
7680398,1090,0,10,5507,403085721,0,0,0,556.66,6,973564.14,18,2,21,1,True
7709098,480,0,25,3740,403085721,0,0,0,556.85,8,973007.29,5,2,6,2,True
7751322,1313,4,25,3901,403085721,0,0,0,557.06,8,972450.23,5,4,18,3,True
7792367,464,1,451,6804,403085721,0,0,0,557.21,7,971893.02,13,2,15,3,True
7971208,1313,4,451,1914,403085721,0,0,0,556.93,7,971336.09,5,4,16,3,True
8487281,1471,0,10,5507,403085721,0,0,0,557.18,6,971893.27,24,5,14,3,True
8504176,1495,3,451,3801,403085721,0,0,0,556.97,7,971336.3,24,0,20,4,True
8776674,1313,4,451,3801,403085721,0,0,0,557.17,7,970779.13,5,2,15,5,True
8870566,464,1,451,7944,403085721,0,0,0,557.13,7,970222.0,13,1,23,6,True
8884120,480,0,451,8935,403085721,0,0,0,557.05,7,969664.95,5,1,1,7,True
8962395,724,3,451,2358,403085721,0,0,0,556.86,7,969108.09,11,0,5,7,True
9074701,1313,4,25,6134,403085721,0,0,0,556.9,8,968551.19,5,2,4,8,True
9141117,1382,0,10,6804,403085721,0,0,0,557.11,6,969108.3,16,3,5,10,True
9679960,883,0,20,7509,403085721,0,0,0,556.91,3,968551.39,24,0,18,11,True
1375673,955,4,451,1461,212991804,0,0,0,734.91,7,78341.09,13,3,7,2,True
1417860,377,4,451,5850,212991804,0,0,0,734.82,7,77606.27,25,4,3,2,True
1468556,779,4,30,5987,212991804,0,0,0,735.19,8,76871.08,14,3,4,3,True
1751242,176,3,-1,4921,212991804,0,1,0,735.09,4,76871.08,24,4,2,3,True
1922388,551,0,25,3722,212991804,0,0,0,734.99,8,76136.09,17,1,4,3,True
1968627,647,4,451,6087,212991804,0,0,0,734.94,7,75401.15,24,3,11,6,True
1988725,51,0,25,7975,212991804,0,0,0,734.95,8,74666.2,20,2,7,6,True
2009670,269,0,20,2173,212991804,0,0,0,734.77,5,73931.43,24,3,4,6,True
2216289,1212,0,20,5987,212991804,0,0,0,735.12,5,73196.31,24,6,11,7,True
2243905,51,0,451,6106,212991804,0,0,0,734.92,7,72461.39,20,3,3,8,True
2466069,180,0,10,4155,212991804,0,0,0,735.01,6,73196.4,18,2,16,8,True
2822955,779,4,-1,6106,212991804,0,1,0,734.74,4,73196.4,14,0,6,9,True
3042814,377,4,451,6441,212991804,0,0,0,735.08,7,72461.32,25,5,12,10,True
3147567,1164,0,10,7975,212991804,0,0,0,734.84,0,73196.16,24,2,7,10,True
3168865,913,0,10,7975,212991804,0,0,0,735.17,6,73931.33,18,6,4,10,True
3239837,757,0,20,7548,212991804,0,0,0,735.11,5,73196.22,24,3,8,11,True
3457618,551,0,30,8442,212991804,0,0,0,734.97,8,72461.25,17,4,19,11,True
3563832,551,0,-1,6441,212991804,0,1,0,735.23,4,72461.25,17,6,9,1,True
3596761,1384,4,451,9789,212991804,0,0,0,734.83,7,71726.42,24,2,22,1,True
3690031,779,4,451,7021,212991804,0,0,0,735.2,7,70991.22,14,1,8,1,True
3711642,51,0,20,9944,212991804,0,0,0,734.94,3,70256.28,20,1,12,2,True
3763701,1173,1,10,6441,212991804,0,0,0,735.03,0,70991.31,24,3,16,3,True
3978155,1380,0,10,1572,212991804,0,0,0,735.11,0,71726.42,16,0,1,3,True
4094606,955,4,451,6106,212991804,0,0,0,734.81,7,70991.61,13,6,19,3,True
4134398,448,0,20,2173,212991804,0,0,0,734.91,5,70256.7,13,3,20,4,True
4246057,653,1,451,7021,212991804,0,0,0,734.95,7,69521.75,24,3,6,5,True
4404789,502,0,10,3722,212991804,0,0,0,734.99,6,70256.74,12,2,18,5,True
4478726,51,0,451,1572,212991804,0,0,0,734.87,7,69521.87,20,2,13,5,True
4749209,176,3,451,4921,212991804,0,0,0,735.28,7,68786.59,24,5,13,6,True
5597118,991,1,10,5850,212991804,0,0,0,735.24,6,69521.83,22,2,23,6,True
5732953,577,0,20,6893,212991804,0,0,0,735.08,5,68786.75,11,2,15,6,True
5770777,145,0,20,9944,212991804,0,0,0,735.12,3,68051.63,18,1,23,8,False
5817989,779,4,25,5576,212991804,0,0,0,735.11,8,67316.52,14,3,2,8,True
6197128,183,1,10,3722,212991804,0,0,0,735.02,6,68051.54,18,4,3,9,True
6368335,448,0,10,4155,212991804,0,0,0,734.95,6,68786.49,13,6,0,11,True
6956639,51,0,25,4155,212991804,0,0,0,734.79,8,68051.7,20,2,3,11,False
6959745,551,0,-1,3722,212991804,0,1,0,735.03,1,68051.7,17,0,18,12,True
7241806,779,4,451,5987,212991804,0,0,0,734.95,7,67316.75,14,0,18,12,True
7702654,779,4,451,9944,212991804,0,0,0,735.08,7,66581.67,14,0,12,1,True
7968149,1255,0,10,3722,212991804,0,0,0,734.79,6,67316.46,23,4,17,1,True
8020700,147,0,20,9064,212991804,0,0,0,734.9,5,66581.56,18,0,11,2,True
8106594,1384,4,451,9385,212991804,0,0,0,735.22,7,65846.34,24,2,2,2,True
8428511,955,4,25,8491,212991804,0,0,0,735.19,8,65111.15,13,0,3,2,True
8524654,1384,4,451,5576,212991804,0,0,0,735.02,7,64376.13,24,1,15,3,True
8544557,551,0,25,3076,212991804,0,0,0,734.92,8,63641.21,17,0,9,5,True
8893111,403,0,10,2173,212991804,0,0,0,734.95,0,64376.16,10,2,20,5,True
8965600,51,0,30,9789,212991804,0,0,0,734.69,8,63641.47,20,2,23,5,True
8975670,393,1,10,1461,212991804,0,0,0,735.05,6,64376.52,10,3,14,6,True
9020789,779,4,451,9317,212991804,0,0,0,734.92,7,63641.6,14,5,23,7,True
9055153,367,1,10,1572,212991804,0,0,0,734.94,0,64376.54,25,4,10,8,True
9144162,955,4,451,3549,212991804,0,0,0,734.77,7,63641.77,13,4,18,8,True
9193675,1116,0,20,4875,212991804,0,0,0,734.75,5,62907.02,24,2,4,10,True
9656051,1015,0,10,9385,212991804,0,0,0,734.94,0,63641.96,26,3,11,10,False
9817560,951,0,20,6106,212991804,0,0,0,735.04,5,62906.92,24,6,12,11,True
9923274,653,1,451,5987,212991804,0,0,0,734.91,7,62172.01,24,5,5,11,True
1008796,1277,2,30,7029,496919397,1,0,0,371.11,8,782132.89,24,6,17,1,True
1106684,889,0,30,2585,496919397,1,0,0,371.1,8,781761.79,27,0,18,2,True
1548726,889,0,451,6879,496919397,1,0,0,370.91,7,781390.88,27,1,19,2,True
1566892,644,0,451,4276,496919397,1,0,0,371.22,7,781019.66,24,1,17,3,True
1667124,889,0,451,5374,496919397,1,0,0,370.96,7,780648.7,27,1,11,3,True
2081992,1277,2,451,5374,496919397,1,0,0,371.3,7,780277.4,24,2,9,3,True
2350445,573,0,10,1420,496919397,1,0,0,370.94,6,780648.34,11,6,15,4,True
2432725,644,0,-1,1565,496919397,1,1,0,371.16,1,780648.34,24,5,2,4,True
2434672,889,0,451,2996,496919397,1,0,0,370.88,7,780277.46,27,5,8,4,True
2727043,1277,2,-1,1299,496919397,1,1,0,370.92,4,780277.46,24,2,8,6,True
2957602,509,0,-1,7029,496919397,1,2,0,370.86,4,780277.46,12,4,0,7,True
3187197,51,0,20,6636,496919397,1,0,0,370.62,5,779906.84,20,6,12,8,True
3270323,1277,2,451,1299,496919397,1,0,0,371.16,7,779535.68,24,6,22,8,True
3309501,128,0,10,5359,496919397,1,0,0,371.13,6,779906.81,18,0,5,8,True
3425630,644,0,451,1299,496919397,1,0,0,371.01,7,779535.8,24,2,12,9,True
3511269,628,0,10,8528,496919397,1,0,0,371.07,6,779906.87,11,5,7,11,True
3690967,958,2,-1,5374,496919397,1,1,0,371.21,4,779906.87,13,6,10,12,True
3810115,1277,2,-1,6636,496919397,1,2,0,371.13,4,779906.87,24,0,23,12,True
3833192,958,2,25,7112,496919397,1,0,0,370.96,8,779535.91,13,0,7,12,True
3848407,1277,2,451,9828,496919397,1,0,0,371.02,7,779164.89,24,3,12,1,False
4349816,958,2,25,5303,496919397,1,0,0,371.12,8,778793.77,13,4,18,2,True
4419608,644,0,451,5359,496919397,1,0,0,371.42,7,778422.35,24,5,1,2,True
4559544,1255,0,20,3426,496919397,1,0,0,371.02,5,778051.33,23,6,7,2,True
4631195,509,0,30,3426,496919397,1,0,0,371.07,8,777680.26,12,6,16,2,True
4821117,509,0,30,2996,496919397,1,0,0,371.14,8,777309.12,12,0,23,4,True
5266886,990,0,20,3426,496919397,1,0,0,371.06,5,776938.06,22,4,23,4,True
5697088,958,2,-1,2996,496919397,1,1,0,371.04,4,776938.06,13,0,14,5,True
5850882,889,0,451,1565,496919397,1,0,0,371.19,7,776566.87,27,2,13,5,True
5966324,958,2,30,5303,496919397,1,0,0,371.21,8,776195.66,13,6,19,6,True
6025860,644,0,25,2585,496919397,1,0,0,370.84,8,775824.82,24,2,6,6,True
6501544,889,0,25,7112,496919397,1,0,0,370.76,8,775454.06,27,6,21,7,True
6509284,958,2,451,1299,496919397,1,0,0,370.83,7,775083.23,13,3,10,7,True
6787328,1027,0,20,6636,496919397,1,0,0,370.87,5,774712.36,11,6,7,8,True
6794975,509,0,451,6879,496919397,1,0,0,370.86,7,774341.5,12,5,8,10,True
7209038,958,2,451,5374,496919397,1,0,0,370.8,7,773970.7,13,4,22,10,True
7222009,889,0,25,5359,496919397,1,0,0,371.16,8,773599.54,27,4,18,11,True
7264540,1090,0,10,5359,496919397,1,0,0,371.04,0,773970.58,18,6,14,12,True
7590630,889,0,-1,9935,496919397,1,1,0,371.05,4,773970.58,27,0,5,1,True
7662290,958,2,451,7029,496919397,1,0,0,371.1,7,773599.48,13,3,18,2,True
7883595,1277,2,451,9828,496919397,1,0,0,370.98,7,773228.5,24,0,19,2,True
8031105,889,0,451,9935,496919397,1,0,0,370.96,7,772857.54,27,3,12,3,False
8148310,958,2,20,6879,496919397,1,0,0,370.91,3,772486.63,13,2,8,4,True
8438773,958,2,451,7029,496919397,1,0,0,371.07,7,772115.56,13,1,15,4,True
8532049,958,2,451,6636,496919397,1,0,0,371.0,7,771744.56,13,3,23,5,True
8666327,644,0,451,3426,496919397,1,0,0,370.7,7,771373.86,24,3,3,6,True
8667783,958,2,451,2585,496919397,1,0,0,371.1,7,771002.76,13,3,21,6,True
8801201,774,2,20,4554,496919397,1,0,0,371.12,5,770631.64,14,2,10,7,True
9038889,1314,2,20,3426,496919397,1,0,0,371.15,5,770260.49,5,1,12,8,True
9170875,1277,2,451,7029,496919397,1,0,0,371.16,7,769889.33,24,5,6,8,True
9191969,1277,2,-1,3254,496919397,1,1,0,371.16,4,769889.33,24,5,12,9,True
9348628,889,0,-1,1299,496919397,1,2,0,371.27,1,769889.33,27,3,15,10,True
9524131,818,1,10,7112,496919397,1,0,0,371.26,6,770260.59,18,6,19,10,True
9700989,572,0,20,1299,496919397,1,0,0,371.12,3,769889.47,11,0,1,11,True
9728377,958,2,-1,1565,496919397,1,1,0,371.03,4,769889.47,13,0,18,11,True
1021178,1166,2,30,1746,169968618,1,0,0,410.9,8,585399.1,24,5,7,2,True
1289802,1380,0,20,4317,169968618,1,0,0,410.61,5,584988.49,16,0,20,3,True
1330887,824,2,20,4635,169968618,1,0,0,411.15,5,584577.34,18,0,20,3,True
1344319,910,0,10,1746,169968618,1,0,0,410.94,0,584988.28,18,0,23,3,True
1489673,918,2,451,7915,169968618,1,0,0,411.02,7,584577.26,18,6,20,4,True
1528482,695,2,20,7457,169968618,1,0,0,411.03,3,584166.23,24,5,22,4,True
1605097,719,4,-1,2783,169968618,1,1,0,411.15,4,584166.23,11,6,11,5,True
1901818,785,0,10,9442,169968618,1,0,0,410.88,0,584577.11,14,1,6,5,True
1909194,1166,2,451,2783,169968618,1,0,0,411.16,7,584165.95,24,1,3,5,True
1960642,918,2,30,1469,169968618,1,0,0,410.92,8,583755.03,18,2,5,6,True
2322895,1166,2,25,9442,169968618,1,0,0,411.02,8,583344.01,24,0,11,6,True
2415469,719,4,451,4475,169968618,1,0,0,411.15,7,582932.86,11,6,0,7,True
2813557,719,4,451,7915,169968618,1,0,0,410.87,7,582521.99,11,1,3,8,True
2834854,1166,2,25,6820,169968618,1,0,0,411.09,8,582110.9,24,0,3,9,True
3127404,1166,2,451,3684,169968618,1,0,0,410.54,7,581700.36,24,3,2,11,True
3147155,918,2,451,7203,169968618,1,0,0,411.06,7,581289.3,18,0,0,12,True
3336326,1317,4,451,4317,169968618,1,0,0,410.72,7,580878.58,18,2,11,1,True
3462283,918,2,30,4302,169968618,1,0,0,410.98,8,580467.6,18,5,13,2,True
3473796,913,0,20,2824,169968618,1,0,0,411.05,3,580056.55,18,1,1,3,True
3515677,719,4,30,3419,169968618,1,0,0,411.35,8,579645.2,11,2,5,5,True
3661642,918,2,451,4302,169968618,1,0,0,411.07,7,579234.13,18,4,1,5,True
4051683,1315,0,10,7203,169968618,1,0,0,410.85,0,579644.98,5,4,2,6,True
4123170,918,2,451,5154,169968618,1,0,0,410.98,7,579234.0,18,2,21,6,True
4659254,1166,2,30,6820,169968618,1,0,0,411.18,8,578822.82,24,2,22,6,True
4694342,1317,4,451,3684,169968618,1,0,0,410.93,7,578411.89,18,0,14,7,True
4974304,719,4,-1,7915,169968618,1,1,0,410.77,4,578411.89,11,4,18,7,True
5203771,918,2,30,7457,169968618,1,0,0,410.83,8,578001.06,18,1,2,7,True
5329830,1166,2,25,7679,169968618,1,0,0,410.91,8,577590.15,24,0,18,7,True
5467233,719,4,25,6820,169968618,1,0,0,411.23,8,577178.92,11,6,8,8,True
5580718,1317,4,30,3684,169968618,1,0,0,410.88,8,576768.04,18,0,3,9,True
5607068,1166,2,451,2783,169968618,1,0,0,411.07,7,576356.97,24,1,17,9,True
5651236,1317,4,-1,7457,169968618,1,1,0,410.96,1,576356.97,18,1,21,10,True
5975599,1317,4,30,4475,169968618,1,0,0,410.98,8,575945.99,18,4,7,11,True
6393234,918,2,-1,9442,169968618,1,1,0,411.19,4,575945.99,18,6,18,11,True
6481494,1166,2,25,7457,169968618,1,0,0,410.99,8,575535.0,24,4,17,11,True
6699058,353,1,10,6820,169968618,1,0,0,410.88,0,575945.88,24,2,23,12,True
6701233,918,2,451,6820,169968618,1,0,0,411.25,7,575534.63,18,5,18,2,True
6726819,1166,2,451,5983,169968618,1,0,0,411.07,7,575123.56,24,1,11,4,True
6761194,1166,2,451,4302,169968618,1,0,0,411.38,7,574712.18,24,0,16,4,True
6994530,1166,2,30,1469,169968618,1,0,0,411.08,8,574301.1,24,3,17,6,True
7252213,918,2,451,2198,169968618,1,0,0,411.1,7,573890.0,18,6,22,8,True
7290857,918,2,451,4475,169968618,1,0,0,411.05,7,573478.95,18,2,10,8,True
7533052,918,2,451,5983,169968618,1,0,0,411.05,7,573067.9,18,2,0,9,True
7702899,1317,4,-1,2824,169968618,1,1,0,410.95,4,573067.9,18,2,10,11,True
7867185,1166,2,-1,6820,169968618,1,2,0,410.85,4,573067.9,24,5,20,11,True
7990776,1166,2,-1,6460,169968618,1,3,1,410.69,1,573067.9,24,6,23,11,True
1276993,877,2,-1,1330,250329786,0,1,0,744.01,1,565506.0,24,0,9,2,False
1379669,78,3,25,9667,250329786,0,0,0,744.1,8,564761.9,1,4,6,2,True
1571179,951,0,20,4967,250329786,0,0,0,743.94,5,564017.96,24,6,8,3,True
1628228,1162,2,30,8928,250329786,0,0,0,743.58,8,563274.38,24,5,7,3,True
1732391,259,4,-1,6218,250329786,0,1,0,743.8,4,563274.38,6,0,19,3,True
1859788,1255,0,20,8682,250329786,0,0,0,743.79,5,562530.59,23,2,13,3,True
1879445,1190,3,451,9009,250329786,0,0,0,743.88,7,561786.71,24,3,13,5,True
1935811,1190,3,-1,1330,250329786,0,1,0,744.12,1,561786.71,24,6,4,5,True
2074920,267,0,451,3103,250329786,0,0,0,744.09,7,561042.62,6,6,23,5,True
2132165,78,3,451,7537,250329786,0,0,0,744.26,7,560298.36,1,0,6,5,True
2134751,1409,1,30,7537,250329786,0,0,0,744.22,8,559554.14,24,4,15,6,True
2312863,1190,3,25,4487,250329786,0,0,0,744.11,8,558810.03,24,2,18,6,True
2318919,78,3,25,8682,250329786,0,0,0,744.01,8,558066.02,1,6,6,8,True
2896404,1162,2,-1,5937,250329786,0,1,0,744.06,4,558066.02,24,4,7,8,True
3068935,1190,3,-1,6218,250329786,0,2,0,743.85,1,558066.02,24,6,4,8,True
3422592,463,1,10,1383,250329786,0,0,0,744.03,6,558810.05,13,6,8,8,True
3696467,1101,2,25,5199,250329786,0,0,0,744.09,8,558065.96,0,6,13,8,True
3985578,259,4,-1,8928,250329786,0,1,0,743.98,4,558065.96,6,0,11,10,True
4011763,1036,1,10,4967,250329786,0,0,0,743.93,0,558809.89,11,3,2,10,True
4248187,1162,2,30,7537,250329786,0,0,0,743.91,8,558065.98,24,2,7,10,True
4410164,394,0,20,8682,250329786,0,0,0,743.82,5,557322.16,10,5,1,11,True
4826723,259,4,30,4487,250329786,0,0,0,743.98,8,556578.18,6,4,18,11,True
4850662,1190,3,25,4522,250329786,0,0,0,744.01,8,555834.17,24,5,12,11,True
5325036,184,0,20,4487,250329786,0,0,0,743.81,5,555090.36,18,3,0,12,True
5349173,482,1,10,8140,250329786,0,0,0,743.99,6,555834.35,5,4,18,1,True
5565308,259,4,451,4021,250329786,0,0,0,743.78,7,555090.57,6,2,22,2,True
5804480,259,4,25,1601,250329786,0,0,0,743.9,8,554346.67,6,6,5,4,True
5954895,259,4,-1,9667,250329786,0,1,0,744.07,1,554346.67,6,6,2,5,True
5981307,877,2,451,4522,250329786,0,0,0,743.77,7,553602.9,24,3,17,5,True
6169784,1063,0,10,4522,250329786,0,0,0,744.05,6,554346.95,11,3,21,8,True
6239560,1409,1,25,1601,250329786,0,0,0,743.95,8,553603.0,24,0,9,10,True
6280334,259,4,-1,9009,250329786,0,1,0,744.34,1,553603.0,6,6,14,10,True
6367649,1271,0,20,9048,250329786,0,0,0,743.78,5,552859.22,23,5,13,11,True
6556398,1405,4,30,4021,250329786,0,0,0,744.28,8,552114.94,24,5,5,11,True
6816105,729,0,10,6218,250329786,0,0,0,743.89,6,552858.83,11,2,5,12,True
7024549,1190,3,25,5199,250329786,0,0,0,743.97,8,552114.86,24,2,16,12,True
7088239,267,0,25,4256,250329786,0,0,0,743.75,8,551371.11,6,5,22,2,True
7093266,877,2,451,6218,250329786,0,0,0,743.85,7,550627.26,24,5,12,2,True
7140043,1405,4,30,4967,250329786,0,0,0,743.75,8,549883.51,24,4,5,3,True
7171978,877,2,25,7537,250329786,0,0,0,744.05,8,549139.46,24,5,2,3,True
7446883,577,0,20,4522,250329786,0,0,0,743.78,5,548395.68,11,0,11,3,True
7513573,1434,0,10,1383,250329786,0,0,0,744.14,6,549139.82,24,4,3,4,True
7571213,871,0,10,4487,250329786,0,0,0,743.79,6,549883.61,24,4,4,4,True
8124667,78,3,25,8502,250329786,0,0,0,744.12,8,549139.49,1,3,11,4,True
8591523,1409,1,30,5937,250329786,0,0,0,744.23,8,548395.26,24,6,7,4,True
8833959,1190,3,-1,4967,250329786,0,1,0,744.09,4,548395.26,24,6,8,6,True
8867694,1101,2,25,1601,250329786,0,0,0,743.94,8,547651.32,0,0,16,9,True
9113475,267,0,451,4487,250329786,0,0,0,743.79,7,546907.53,6,1,14,9,True
9532542,1162,2,30,4021,250329786,0,0,0,744.05,8,546163.48,24,0,22,9,True
9604251,155,1,10,3103,250329786,0,0,0,744.07,0,546907.55,18,0,12,9,True
9659557,78,3,451,4487,250329786,0,0,0,744.09,7,546163.46,1,6,20,10,True
9728355,78,3,451,1383,250329786,0,0,0,744.18,7,545419.28,1,2,10,11,True
9959303,1321,0,20,8140,250329786,0,0,0,744.08,3,544675.2,18,6,23,11,True
1051567,1377,0,30,5958,388241689,1,0,0,503.39,8,315381.61,16,2,14,1,True
1603581,1123,2,451,4121,388241689,1,0,0,502.84,7,314878.77,24,5,6,1,True
2502741,537,0,10,5722,388241689,1,0,0,502.85,6,315381.62,18,3,18,1,True
2547627,928,3,451,8127,388241689,1,0,0,502.64,7,314878.98,18,2,2,3,True
2972373,194,1,25,9497,388241689,1,0,0,503.1,8,314375.88,18,2,3,3,True
3141315,1377,0,25,1355,388241689,1,0,0,502.99,8,313872.89,16,6,5,4,True
3379918,807,0,30,6976,388241689,1,0,0,503.13,8,313369.76,11,3,6,6,True
3391121,1377,0,451,3458,388241689,1,0,0,503.05,7,312866.71,16,5,20,6,True
3601835,584,0,20,8625,388241689,1,0,0,503.15,5,312363.56,11,6,17,6,True
3748755,249,0,451,1355,388241689,1,0,0,502.82,7,311860.74,6,6,16,7,False
3789398,1159,0,20,9249,388241689,1,0,0,503.08,5,311357.66,15,0,9,8,True
3805046,498,0,451,6523,388241689,1,0,0,502.75,7,310854.91,12,3,22,8,True
4312648,498,0,451,9497,388241689,1,0,0,503.0,7,310351.91,12,4,5,8,True
4487096,498,0,25,3458,388241689,1,0,0,503.07,8,309848.84,12,1,10,8,True
4609732,1377,0,25,3635,388241689,1,0,0,503.05,8,309345.79,16,6,17,9,True
4687756,1377,0,25,5292,388241689,1,0,0,503.12,8,308842.67,16,2,3,11,True
4714234,1123,2,451,8625,388241689,1,0,0,502.72,7,308339.95,24,0,19,12,True
4755183,807,0,30,8685,388241689,1,0,0,502.82,8,307837.13,11,1,14,12,True
4954267,498,0,451,3458,388241689,1,0,0,503.24,7,307333.89,12,6,19,12,True
5143638,194,1,451,2450,388241689,1,0,0,503.06,7,306830.83,18,3,13,12,True
5180801,579,0,10,5722,388241689,1,0,0,503.33,6,307334.16,11,2,10,1,True
5251882,611,0,20,2450,388241689,1,0,0,503.24,5,306830.92,11,6,0,2,True
5263765,194,1,30,3458,388241689,1,0,0,502.89,8,306328.03,18,4,9,2,True
5597560,928,3,25,2691,388241689,1,0,0,502.78,8,305825.25,18,4,6,2,True
5723372,1123,2,30,3629,388241689,1,0,0,503.06,8,305322.19,24,5,12,4,True
6248449,1323,4,30,1355,388241689,1,0,0,503.03,8,304819.16,18,3,21,5,False
6540188,167,2,20,5722,388241689,1,0,0,503.22,5,304315.94,24,3,18,5,True
6540782,350,0,20,9993,388241689,1,0,0,502.9,5,303813.04,24,5,23,5,True
6541340,1015,0,10,6523,388241689,1,0,0,502.82,6,304315.86,26,1,7,5,True
7004021,1205,0,10,1432,388241689,1,0,0,503.34,6,304819.2,24,1,7,6,True
7055683,498,0,451,2691,388241689,1,0,0,502.79,7,304316.41,12,4,14,6,True
7125676,184,0,10,5292,388241689,1,0,0,503.06,6,304819.47,18,0,21,8,True
7497976,928,3,30,5958,388241689,1,0,0,503.19,8,304316.28,18,4,22,8,True
7579183,249,0,-1,6523,388241689,1,1,0,503.14,4,304316.28,6,0,3,8,True
7581039,249,0,-1,6523,388241689,1,2,0,502.94,1,304316.28,6,2,10,8,True
7655504,1123,2,30,9497,388241689,1,0,0,502.92,8,303813.36,24,2,22,9,True
7677300,1449,0,20,8127,388241689,1,0,0,503.06,5,303310.3,11,2,5,9,True
7870265,194,1,25,5958,388241689,1,0,0,502.95,8,302807.35,18,0,23,9,True
8343346,576,2,20,8597,388241689,1,0,0,502.98,5,302304.37,11,6,23,10,True
8509438,889,0,10,2857,388241689,1,0,0,503.08,6,302807.45,27,2,23,11,True
8517037,928,3,30,3629,388241689,1,0,0,503.05,8,302304.4,18,0,6,12,True
8521391,29,0,20,6523,388241689,1,0,0,503.02,5,301801.38,11,1,10,12,True
8623656,1377,0,30,6976,388241689,1,0,0,503.08,8,301298.3,16,6,20,12,True
8790150,723,1,10,3458,388241689,1,0,0,502.83,6,301801.13,11,1,1,1,True
8801391,1323,4,451,9993,388241689,1,0,0,502.95,7,301298.18,18,3,8,2,True
8816244,249,0,451,1432,388241689,1,0,0,503.06,7,300795.12,6,1,8,3,True
8925155,928,3,451,5664,388241689,1,0,0,503.0,7,300292.12,18,0,4,3,True
8945366,807,0,-1,1432,388241689,1,1,0,502.94,4,300292.12,11,6,10,3,True
9117055,584,0,20,6976,388241689,1,0,0,502.95,5,299789.17,11,4,2,3,True
9140290,809,3,451,8597,388241689,1,0,0,503.01,7,299286.16,11,2,1,5,False
9315095,222,2,20,5664,388241689,1,0,0,503.04,5,298783.12,26,2,5,5,True
9489559,498,0,-1,2450,388241689,1,1,0,503.15,4,298783.12,12,4,5,5,True
9529676,444,2,20,9139,388241689,1,0,0,503.1,5,298280.02,24,0,12,5,True
9633406,1123,2,451,3635,388241689,1,0,0,503.07,7,297776.95,24,6,19,5,False
9732682,1323,4,25,3458,388241689,1,0,0,502.87,8,297274.08,18,5,20,5,True
9784208,809,3,30,6206,388241689,1,0,0,502.99,8,296771.09,11,1,16,8,True
9899282,59,0,10,9139,388241689,1,0,0,502.56,0,297273.65,20,4,5,10,True
9924206,807,0,30,5722,388241689,1,0,0,503.15,8,296770.5,11,1,13,11,True
1009494,854,0,451,3553,582783010,0,0,0,293.97,7,214381.03,24,1,15,1,True
1094964,276,0,20,9504,582783010,0,0,0,293.79,5,214087.24,24,3,15,2,False
1333597,711,2,30,5868,582783010,0,0,0,293.69,8,213793.55,18,6,14,2,True
1371183,114,0,451,8185,582783010,0,0,0,293.88,7,213499.67,3,3,14,3,True
1621203,448,0,10,6784,582783010,0,0,0,294.25,6,213793.92,13,6,10,4,True
1670181,711,2,451,6715,582783010,0,0,0,294.13,7,213499.79,18,3,7,5,True
1907281,796,2,20,5868,582783010,0,0,0,294.13,5,213205.66,11,5,15,6,True
2117605,989,1,10,7060,582783010,0,0,0,294.15,0,213499.81,22,1,1,6,True
2154732,1072,0,20,3553,582783010,0,0,0,293.93,3,213205.88,18,4,6,8,True
2304263,114,0,451,4367,582783010,0,0,0,293.97,7,212911.91,3,5,8,8,True
2888697,114,0,-1,9504,582783010,0,1,0,293.7,4,212911.91,3,6,4,9,True
2939085,114,0,30,9896,582783010,0,0,0,293.94,8,212617.97,3,0,0,10,True
3071611,854,0,30,9474,582783010,0,0,0,293.99,8,212323.98,24,2,8,11,True
3109053,1068,2,451,7060,582783010,0,0,0,294.07,7,212029.91,18,3,4,11,True
3761399,572,0,10,5490,582783010,0,0,0,294.14,0,212324.05,11,4,19,12,True
4025353,1328,4,-1,5990,582783010,0,1,0,293.95,1,212324.05,18,6,8,12,True
4056005,1155,0,451,8185,582783010,0,0,0,294.36,7,212029.69,15,1,7,12,True
4461986,711,2,-1,7060,582783010,0,1,0,293.95,4,212029.69,18,2,7,2,False
4768870,854,0,451,5990,582783010,0,0,0,294.24,7,211735.45,24,3,10,2,True
5140629,662,1,30,7497,582783010,0,0,0,293.78,8,211441.67,18,0,4,2,True
5148837,1155,0,451,8828,582783010,0,0,0,293.98,7,211147.69,15,1,14,3,True
5149979,1328,4,451,8882,582783010,0,0,0,293.93,7,210853.76,18,6,12,5,True
5229811,114,0,25,6784,582783010,0,0,0,294.14,8,210559.62,3,1,6,5,True
5464764,854,0,30,3553,582783010,0,0,0,294.15,8,210265.47,24,1,8,5,True
5842479,1037,0,20,7060,582783010,0,0,0,294.14,3,209971.33,11,3,9,6,True
5880314,662,1,451,2184,582783010,0,0,0,293.86,7,209677.47,18,0,15,7,True
5965949,1110,0,10,6014,582783010,0,0,0,293.87,0,209971.34,0,1,10,7,True
6001627,662,1,25,7060,582783010,0,0,0,294.01,8,209677.33,18,2,7,7,True
6211906,114,0,451,7497,582783010,0,0,0,294.03,7,209383.3,3,3,13,8,True
6353413,1155,0,-1,6784,582783010,0,1,0,294.02,1,209383.3,15,5,12,8,True
6453942,376,0,10,6715,582783010,0,0,0,293.83,0,209677.13,25,0,23,8,True
6457799,1068,2,-1,9504,582783010,0,1,0,293.96,4,209677.13,18,2,5,8,True
6493345,854,0,25,8882,582783010,0,0,0,293.81,8,209383.32,24,4,21,9,True
6582353,1112,1,10,6784,582783010,0,0,0,293.91,6,209677.23,0,6,9,9,True
6705975,979,0,10,7497,582783010,0,0,0,294.09,0,209971.32,22,2,2,9,True
6719979,114,0,451,5868,582783010,0,0,0,293.94,7,209677.38,3,1,14,10,True
6756095,854,0,25,8828,582783010,0,0,0,294.34,8,209383.04,24,1,20,11,True
6897911,662,1,25,8882,582783010,0,0,0,294.01,8,209089.03,18,3,19,1,True
7187826,218,0,10,8828,582783010,0,0,0,293.74,6,209382.77,9,5,8,1,True
7796478,1068,2,25,7497,582783010,0,0,0,294.03,8,209088.74,18,6,21,1,True
7834652,346,0,10,9504,582783010,0,0,0,294.12,0,209382.86,24,3,17,1,True
7956986,220,0,20,8882,582783010,0,0,0,294.01,5,209088.85,26,6,6,1,True
8005615,114,0,-1,5666,582783010,0,1,0,294.13,4,209088.85,3,5,10,2,True
8451813,1155,0,30,6715,582783010,0,0,0,293.84,8,208795.01,15,4,6,2,True
8483766,1278,0,10,5990,582783010,0,0,0,293.68,6,209088.69,24,2,1,2,True
8502311,662,1,451,4882,582783010,0,0,0,293.82,7,208794.87,18,2,12,3,True
8506497,97,0,10,6715,582783010,0,0,0,293.86,0,209088.73,3,5,15,3,True
8652648,854,0,-1,6784,582783010,0,1,0,293.85,4,209088.73,24,6,0,3,True
8726051,1247,0,10,3553,582783010,0,0,0,293.73,6,209382.46,23,2,1,4,True
9022851,854,0,-1,9896,582783010,0,1,0,294.15,4,209382.46,24,4,1,5,True
9108955,454,1,10,5868,582783010,0,0,0,293.92,6,209676.38,13,4,12,5,True
9138957,1459,1,10,9474,582783010,0,0,0,294.2,6,209970.58,11,2,4,5,True
9323390,711,2,-1,8828,582783010,0,1,0,293.92,4,209970.58,18,4,0,6,True
9344571,854,0,451,4367,582783010,0,0,0,294.07,7,209676.51,24,1,21,7,True
9390532,1155,0,-1,2184,582783010,0,1,0,293.96,4,209676.51,15,6,8,8,True
9507844,854,0,451,9896,582783010,0,0,0,293.99,7,209382.52,24,6,0,9,True
9660631,1328,4,25,4367,582783010,0,0,0,293.6,8,209088.92,18,4,9,11,True
9848260,854,0,451,4882,582783010,0,0,0,293.97,7,208794.95,24,2,23,11,True
9881359,1068,2,30,2184,582783010,0,0,0,294.11,8,208500.84,18,4,16,11,True
1170226,887,2,451,4985,339231358,1,0,0,1023.97,7,559166.03,27,2,13,1,True
1340940,580,0,20,2500,339231358,1,0,0,1024.12,5,558141.91,11,0,7,1,True
1903313,1315,0,30,9223,339231358,1,0,0,1023.98,8,557117.93,5,2,0,2,True
1975670,1315,0,451,2538,339231358,1,0,0,1024.03,7,556093.9,5,0,0,3,True
1986147,887,2,30,2538,339231358,1,0,0,1023.77,8,555070.13,27,3,16,3,True
2159720,1315,0,10,1858,339231358,1,0,0,1024.15,6,556094.28,5,2,12,3,True
2365803,1384,4,-1,9060,339231358,1,1,0,1024.0,1,556094.28,24,5,6,4,True
3032603,1384,4,451,9060,339231358,1,0,0,1023.79,7,555070.49,24,6,1,4,True
3062716,1315,0,30,1657,339231358,1,0,0,1024.03,8,554046.46,5,6,9,5,True
3155061,1172,3,451,2278,339231358,1,0,0,1023.86,7,553022.6,24,0,3,6,True
3408649,1435,2,20,8872,339231358,1,0,0,1024.15,5,551998.45,24,1,10,6,True
3492472,1102,2,20,3957,339231358,1,0,0,1023.81,5,550974.64,0,3,7,6,True
3561649,1072,0,20,8872,339231358,1,0,0,1024.06,5,549950.58,18,3,14,7,True
4194101,665,2,20,7464,339231358,1,0,0,1023.99,5,548926.59,18,3,22,9,True
4251365,1325,0,20,3957,339231358,1,0,0,1024.15,3,547902.44,18,3,2,9,True
4323888,1410,1,25,1657,339231358,1,0,0,1024.06,8,546878.38,24,3,0,10,True
4476434,1315,0,451,8812,339231358,1,0,0,1023.81,7,545854.57,5,4,14,11,True
4700644,1037,0,10,9223,339231358,1,0,0,1024.12,0,546878.69,11,2,17,12,True
4797011,1315,0,451,8456,339231358,1,0,0,1024.03,7,545854.66,5,4,16,12,True
4856804,1384,4,451,4985,339231358,1,0,0,1023.89,7,544830.77,24,2,16,1,True
4947628,1061,2,20,3957,339231358,1,0,0,1024.07,5,543806.7,11,2,0,1,True
4948484,1315,0,30,7464,339231358,1,0,0,1023.97,8,542782.73,5,0,14,2,True
5041617,1410,1,451,7464,339231358,1,0,0,1024.1,7,541758.63,24,3,0,3,True
5155372,887,2,30,1657,339231358,1,0,0,1024.34,8,540734.29,27,0,22,5,True
5193151,198,0,10,8872,339231358,1,0,0,1024.22,6,541758.51,18,0,17,6,True
5245337,219,0,10,2538,339231358,1,0,0,1024.18,6,542782.69,9,0,10,7,True
5989731,1015,0,20,2278,339231358,1,0,0,1023.97,3,541758.72,26,2,4,8,True
6003965,1459,1,10,2278,339231358,1,0,0,1023.85,6,542782.57,11,2,14,10,True
6035031,887,2,451,9060,339231358,1,0,0,1024.02,7,541758.55,27,3,23,2,True
6745176,1172,3,30,9060,339231358,1,0,0,1024.16,8,540734.39,24,4,15,2,True
6816802,1172,3,451,7203,339231358,1,0,0,1024.12,7,539710.27,24,4,19,2,True
7037164,1384,4,25,9223,339231358,1,0,0,1023.99,8,538686.28,24,0,17,2,True
7522566,1037,0,10,9223,339231358,1,0,0,1024.0,6,539710.28,11,5,3,2,True
7581886,1172,3,451,1858,339231358,1,0,0,1024.13,7,538686.15,24,6,20,2,True
7931198,887,2,30,2500,339231358,1,0,0,1023.89,8,537662.26,27,3,15,3,True
7979114,1172,3,451,2538,339231358,1,0,0,1024.03,7,536638.23,24,4,7,3,True
8156640,1150,0,10,8812,339231358,1,0,0,1023.86,0,537662.09,15,4,21,3,True
8369270,887,2,451,2538,339231358,1,0,0,1024.04,7,536638.05,27,6,2,4,True
8511630,937,0,10,6490,339231358,1,0,0,1024.04,0,537662.09,24,6,8,6,True
8566299,1410,1,-1,2278,339231358,1,1,0,1024.14,1,537662.09,24,4,22,6,True
8588319,1315,0,-1,2538,339231358,1,2,0,1023.83,4,537662.09,5,6,15,6,True
8896350,1410,1,25,9223,339231358,1,0,0,1024.07,8,536638.02,24,2,9,6,True
8905902,1172,3,451,1858,339231358,1,0,0,1024.04,7,535613.98,24,0,14,7,True
9070641,1172,3,-1,7203,339231358,1,1,0,1023.74,4,535613.98,24,1,14,8,True
9273748,1172,3,-1,3760,339231358,1,2,0,1023.96,4,535613.98,24,1,18,8,True
9361583,887,2,25,2500,339231358,1,0,0,1024.25,8,534589.73,27,1,14,9,True
9442256,1410,1,25,6689,339231358,1,0,0,1024.22,8,533565.51,24,5,23,9,False
9561492,269,0,20,8854,339231358,1,0,0,1023.93,5,532541.58,24,1,6,10,True
9675171,1384,4,30,9223,339231358,1,0,0,1023.8,8,531517.78,24,3,13,10,True
9977325,1384,4,451,1858,339231358,1,0,0,1024.16,7,530493.62,24,1,10,11,True
9984648,319,0,10,7464,339231358,1,0,0,1023.79,6,531517.41,11,1,13,11,True
1244588,977,4,25,7695,541574267,1,0,0,1180.13,8,982076.87,22,6,11,1,True
1271407,476,1,451,9941,541574267,1,0,0,1180.3,7,980896.57,5,2,17,1,True
1387398,167,2,20,7008,541574267,1,0,0,1180.16,3,979716.41,24,2,1,1,True
1738439,977,4,451,9941,541574267,1,0,0,1179.99,7,978536.42,22,6,20,1,True
1857554,476,1,30,3908,541574267,1,0,0,1180.18,8,977356.24,5,1,10,2,True
1972253,819,2,451,8486,541574267,1,0,0,1179.95,7,976176.29,18,0,21,3,True
2532879,1169,0,20,6007,541574267,1,0,0,1180.02,5,974996.27,24,4,15,3,True
2633032,618,3,451,9941,541574267,1,0,0,1179.98,7,973816.29,11,2,1,3,True
2760654,819,2,25,9267,541574267,1,0,0,1180.21,8,972636.08,18,1,2,4,True
2790161,144,1,10,9941,541574267,1,0,0,1180.12,6,973816.2,18,1,7,5,True
2991330,819,2,30,3908,541574267,1,0,0,1179.83,8,972636.37,18,6,17,5,False
3156088,909,2,20,2893,541574267,1,0,0,1180.09,3,971456.28,18,0,11,6,True
3185036,1255,0,10,3520,541574267,1,0,0,1180.02,6,972636.3,23,2,23,6,True
3289237,913,0,10,5761,541574267,1,0,0,1179.88,6,973816.18,18,5,12,7,True
3336485,589,1,10,3520,541574267,1,0,0,1180.07,0,974996.25,24,4,22,7,True
3784396,1338,0,10,9941,541574267,1,0,0,1179.63,6,976175.88,18,3,1,7,True
3853177,503,0,25,8486,541574267,1,0,0,1180.24,8,974995.64,12,5,20,7,True
3866662,819,2,-1,3908,541574267,1,1,0,1179.88,4,974995.64,18,2,7,8,True
3906380,503,0,-1,3908,541574267,1,2,0,1179.82,4,974995.64,12,4,9,9,True
3995795,503,0,25,3090,541574267,1,0,0,1180.08,8,973815.56,12,4,3,10,True
4516128,689,0,10,5761,541574267,1,0,0,1180.0,0,974995.56,24,6,16,10,True
4998375,201,1,10,4965,541574267,1,0,0,1179.97,6,976175.53,9,5,3,11,True
5018099,204,0,20,3908,541574267,1,0,0,1179.99,5,974995.54,9,4,13,11,True
5216094,41,2,20,2112,541574267,1,0,0,1179.98,3,973815.56,11,4,8,12,True
5254740,819,2,30,9192,541574267,1,0,0,1179.86,8,972635.7,18,1,22,1,True
5382230,977,4,451,2072,541574267,1,0,0,1179.96,7,971455.74,22,5,13,2,True
5550054,977,4,25,7008,541574267,1,0,0,1180.1,8,970275.64,22,3,15,2,True
5585565,1408,1,10,6007,541574267,1,0,0,1180.14,0,971455.78,24,5,17,2,True
5684361,819,2,30,3090,541574267,1,0,0,1179.83,8,970275.95,18,0,2,2,True
6285093,819,2,-1,5761,541574267,1,1,0,1180.05,4,970275.95,18,1,23,3,True
6461176,880,1,10,9306,541574267,1,0,0,1180.07,6,971456.02,27,2,18,4,True
6538862,819,2,25,9192,541574267,1,0,0,1179.91,8,970276.11,18,4,20,4,True
6753023,503,0,30,4482,541574267,1,0,0,1179.93,8,969096.18,12,3,16,4,True
6769861,819,2,-1,2668,541574267,1,1,0,1180.34,1,969096.18,18,0,23,6,True
6916324,476,1,451,4965,541574267,1,0,0,1180.0,7,967916.18,5,0,23,7,True
7074517,503,0,451,2072,541574267,1,0,0,1179.87,7,966736.31,12,1,4,8,True
7074797,1169,0,20,9941,541574267,1,0,0,1180.06,5,965556.25,24,3,19,8,True
7110549,579,0,20,3675,541574267,1,0,0,1179.9,3,964376.35,11,6,5,8,True
7450532,1015,0,10,2668,541574267,1,0,0,1179.75,6,965556.1,26,0,5,9,True
7612116,818,1,10,2893,541574267,1,0,0,1180.18,6,966736.28,18,4,15,9,True
7639266,1124,0,20,9192,541574267,1,0,0,1179.93,5,965556.35,24,2,21,10,True
7664171,476,1,451,6007,541574267,1,0,0,1179.72,7,964376.63,5,4,4,10,True
7691290,819,2,25,3520,541574267,1,0,0,1179.99,8,963196.64,18,2,17,10,True
8095607,1132,0,10,2893,541574267,1,0,0,1180.05,6,964376.69,24,2,1,3,True
8149997,1092,1,10,3908,541574267,1,0,0,1179.79,0,965556.48,18,2,7,3,True
8177085,819,2,25,6105,541574267,1,0,0,1180.07,8,964376.41,18,0,4,3,True
8220831,618,3,25,3908,541574267,1,0,0,1180.02,8,963196.39,11,1,10,3,True
8231949,819,2,30,4965,541574267,1,0,0,1179.82,8,962016.57,18,3,8,4,True
8457656,618,3,-1,9306,541574267,1,1,0,1180.07,4,962016.57,11,1,12,4,True
8598369,314,0,10,3675,541574267,1,0,0,1180.23,0,963196.8,4,4,21,4,True
8661055,618,3,30,4965,541574267,1,0,0,1179.85,8,962016.95,11,5,4,4,True
8847823,618,3,30,7695,541574267,1,0,0,1179.96,8,960836.99,11,6,2,5,True
8974268,977,4,-1,6007,541574267,1,1,0,1180.13,4,960836.99,22,6,10,8,False
9008744,618,3,451,9267,541574267,1,0,0,1179.81,7,959657.18,11,2,18,8,True
9064901,977,4,-1,9941,541574267,1,1,0,1180.22,1,959657.18,22,5,18,8,True
9209317,977,4,451,2188,541574267,1,0,0,1179.81,7,958477.37,22,1,8,10,True
9406310,476,1,451,6007,541574267,1,0,0,1180.02,7,957297.35,5,2,12,10,True
9762236,618,3,25,3090,541574267,1,0,0,1179.96,8,956117.39,11,3,13,11,True
9956458,738,2,20,2188,541574267,1,0,0,1180.15,3,954937.24,11,4,1,11,True
1006874,796,2,25,5993,703914321,1,0,0,1169.88,8,458757.12,11,1,9,1,True
1242683,567,1,451,8168,703914321,1,0,0,1169.81,7,457587.31,11,5,10,2,True
1421606,1176,4,30,7980,703914321,1,0,0,1170.06,8,456417.25,24,1,22,3,True
1471412,1176,4,-1,8887,703914321,1,1,0,1170.15,4,456417.25,24,1,1,3,True
1530641,1119,0,30,8168,703914321,1,0,0,1170.29,8,455246.96,24,2,0,5,True
1585812,818,1,10,7574,703914321,1,0,0,1170.04,6,456417.0,18,6,14,6,True
1835738,1039,1,25,8793,703914321,1,0,0,1170.1,8,455246.9,11,2,11,8,True
1861353,567,1,451,7980,703914321,1,0,0,1170.08,7,454076.82,11,2,14,8,True
1916224,653,1,30,6494,703914321,1,0,0,1170.06,8,452906.76,24,6,12,9,True
1922579,796,2,30,2472,703914321,1,0,0,1169.8,8,451736.96,11,0,7,10,False
1968975,443,2,30,3008,703914321,1,0,0,1170.28,8,450566.68,24,4,0,11,True
2182358,1413,0,20,9587,703914321,1,0,0,1170.1,5,449396.58,24,0,15,11,True
2183782,796,2,451,7214,703914321,1,0,0,1169.93,7,448226.65,11,3,5,12,True
2313704,1176,4,30,1111,703914321,1,0,0,1169.76,8,447056.89,24,0,2,1,True
2337210,653,1,451,6494,703914321,1,0,0,1170.23,7,445886.66,24,6,17,1,True
2667292,653,1,30,4550,703914321,1,0,0,1169.97,8,444716.69,24,4,1,2,True
2673171,443,2,30,7768,703914321,1,0,0,1170.03,8,443546.66,24,3,7,4,True
2983130,1119,0,30,7980,703914321,1,0,0,1170.12,8,442376.54,24,2,15,4,True
3105789,1119,0,-1,3008,703914321,1,1,0,1169.78,4,442376.54,24,6,14,4,True
3525729,1176,4,30,4550,703914321,1,0,0,1169.99,8,441206.55,24,6,21,5,True
3916064,1122,1,10,3599,703914321,1,0,0,1169.96,6,442376.51,24,5,4,5,True
3940008,990,0,10,7574,703914321,1,0,0,1169.95,6,443546.46,22,4,19,5,True
4284495,406,1,10,5839,703914321,1,0,0,1169.91,6,444716.37,10,4,4,6,True
4319438,350,0,20,8168,703914321,1,0,0,1170.03,5,443546.34,24,0,19,6,True
4569897,567,1,25,4008,703914321,1,0,0,1170.43,8,442375.91,11,2,2,8,True
4585201,796,2,451,5918,703914321,1,0,0,1170.12,7,441205.79,11,1,23,8,True
4595500,180,0,20,5918,703914321,1,0,0,1170.01,5,440035.78,18,2,5,8,True
4801005,653,1,25,2257,703914321,1,0,0,1170.05,8,438865.73,24,4,1,9,True
5009002,443,2,30,8887,703914321,1,0,0,1169.95,8,437695.78,24,3,20,9,False
5016376,871,0,10,5993,703914321,1,0,0,1169.83,6,438865.61,24,6,20,10,True
5102745,796,2,25,7980,703914321,1,0,0,1170.06,8,437695.55,11,1,15,10,True
5126426,796,2,451,7768,703914321,1,0,0,1169.85,7,436525.7,11,3,21,11,True
5689243,705,1,10,8309,703914321,1,0,0,1170.08,0,437695.78,18,2,16,11,True
5737381,929,0,20,4550,703914321,1,0,0,1169.81,3,436525.97,18,4,19,11,True
5784277,726,0,10,2595,703914321,1,0,0,1169.73,6,437695.7,11,4,1,12,True
6050600,611,0,20,9231,703914321,1,0,0,1170.13,5,436525.57,11,6,1,1,True
6053717,860,1,10,5839,703914321,1,0,0,1170.08,0,437695.65,24,2,9,2,True
6514877,443,2,25,8793,703914321,1,0,0,1170.16,8,436525.49,24,2,13,2,True
6630387,567,1,25,3599,703914321,1,0,0,1169.86,8,435355.63,11,0,21,2,True
7408845,567,1,25,2257,703914321,1,0,0,1170.14,8,434185.49,11,3,11,2,True
7625376,796,2,-1,7574,703914321,1,1,0,1169.85,4,434185.49,11,0,2,3,True
7817905,1176,4,451,7980,703914321,1,0,0,1170.06,7,433015.43,24,4,2,4,True
7863475,1176,4,451,2595,703914321,1,0,0,1170.04,7,431845.39,24,4,16,5,True
8038395,567,1,451,9231,703914321,1,0,0,1170.11,7,430675.28,11,6,5,5,True
8394917,653,1,25,2257,703914321,1,0,0,1169.96,8,429505.32,24,0,5,5,True
8536350,459,1,10,8887,703914321,1,0,0,1170.09,0,430675.41,13,4,16,6,True
8539550,1060,1,10,5918,703914321,1,0,0,1170.09,6,431845.5,11,5,0,6,True
8648733,1039,1,451,5839,703914321,1,0,0,1170.15,7,430675.35,11,4,12,10,True
8880383,443,2,25,5839,703914321,1,0,0,1169.79,8,429505.56,24,2,9,10,True
9346835,443,2,451,5417,703914321,1,0,0,1170.12,7,428335.44,24,3,6,10,True
9572967,443,2,451,5417,703914321,1,0,0,1170.17,7,427165.27,24,5,0,11,False
9648144,443,2,25,6718,703914321,1,0,0,1169.88,8,425995.39,24,2,13,11,False
9895722,1176,4,30,8793,703914321,1,0,0,1169.95,8,424825.44,24,3,9,11,True
1028226,1351,4,451,6514,841284706,0,0,0,122.0,7,572433.0,24,1,13,1,True
1154368,1381,4,451,9758,841284706,0,0,0,121.87,7,572311.13,16,1,2,2,True
1239193,642,0,25,4834,841284706,0,0,0,122.11,8,572189.02,24,2,18,2,True
1318544,1271,0,30,7691,841284706,0,0,0,121.9,8,572067.12,23,3,10,3,True
1443962,217,4,451,8677,841284706,0,0,0,121.92,7,571945.2,9,2,22,3,True
1583243,217,4,451,2102,841284706,0,0,0,122.18,7,571823.02,9,4,6,3,True
1682161,1271,0,25,8199,841284706,0,0,0,121.85,8,571701.17,23,3,9,3,True
1806525,642,0,25,5444,841284706,0,0,0,121.86,8,571579.31,24,4,6,4,False
1890164,112,4,451,8199,841284706,0,0,0,121.9,7,571457.41,3,5,19,4,True
2150836,1351,4,25,1444,841284706,0,0,0,122.13,8,571335.28,24,6,9,5,True
2536085,1271,0,-1,6362,841284706,0,1,0,121.89,4,571335.28,23,0,13,6,True
2713315,1474,0,20,6514,841284706,0,0,0,122.05,3,571213.23,24,0,7,8,True
2791472,112,4,451,6362,841284706,0,0,0,121.84,7,571091.39,3,3,13,8,True
2826838,1351,4,-1,9084,841284706,0,1,0,121.91,1,571091.39,24,5,15,8,True
3222491,1351,4,451,5444,841284706,0,0,0,122.08,7,570969.31,24,5,23,9,True
3397482,1381,4,25,9084,841284706,0,0,0,121.81,8,570847.5,16,6,17,10,True
3541001,317,4,25,6563,841284706,0,0,0,121.67,8,570725.83,4,5,20,1,True
3874932,217,4,451,5973,841284706,0,0,0,121.86,7,570603.97,9,0,2,2,False
4027158,317,4,451,3692,841284706,0,0,0,122.11,7,570481.86,4,2,5,2,True
4082374,269,0,30,6514,841284706,0,0,0,121.9,8,570359.96,24,2,18,2,True
4090223,913,0,10,6362,841284706,0,0,0,121.8,6,570481.76,18,3,17,2,True
4457078,112,4,451,6563,841284706,0,0,0,122.15,7,570359.61,3,4,9,4,True
4649196,807,0,10,9084,841284706,0,0,0,122.12,0,570481.73,11,2,5,4,True
4775063,112,4,30,5533,841284706,0,0,0,121.94,8,570359.79,3,6,9,4,False
4841439,317,4,-1,7691,841284706,0,1,0,122.12,4,570359.79,4,4,1,5,True
4871012,1271,0,451,7691,841284706,0,0,0,121.96,7,570237.83,23,0,16,5,True
5090676,217,4,451,9084,841284706,0,0,0,122.02,7,570115.81,9,4,10,5,True
5332369,1381,4,-1,1312,841284706,0,1,0,121.8,4,570115.81,16,5,4,6,True
5452991,269,0,451,6514,841284706,0,0,0,122.03,7,569993.78,24,6,20,6,True
5480575,53,0,10,5533,841284706,0,0,0,122.09,6,570115.87,20,6,3,6,True
5530671,317,4,30,1444,841284706,0,0,0,121.9,8,569993.97,4,5,12,6,True
5584389,1271,0,451,9758,841284706,0,0,0,121.8,7,569872.17,23,1,14,8,True
5686556,1271,0,451,9084,841284706,0,0,0,122.1,7,569750.07,23,6,5,9,True
5851264,269,0,451,1969,841284706,0,0,0,121.86,7,569628.21,24,6,23,11,True
5903220,317,4,30,7166,841284706,0,0,0,122.28,8,569505.93,4,1,14,1,True
5942629,112,4,451,2259,841284706,0,0,0,122.13,7,569383.8,3,2,3,1,True
6346946,269,0,451,9758,841284706,0,0,0,121.84,7,569261.96,24,5,12,2,True
6352619,112,4,25,3692,841284706,0,0,0,122.16,8,569139.8,3,5,19,2,True
6808368,1412,2,20,2259,841284706,0,0,0,122.06,5,569017.74,24,3,4,2,True
6821683,269,0,451,2259,841284706,0,0,0,121.99,7,568895.75,24,2,8,3,True
6840814,1467,0,10,5495,841284706,0,0,0,122.06,6,569017.81,11,1,22,4,True
6841884,1113,1,10,5973,841284706,0,0,0,121.86,6,569139.67,0,6,23,4,True
7463799,372,0,20,2102,841284706,0,0,0,122.05,5,569017.62,25,5,10,4,True
7766074,317,4,30,9758,841284706,0,0,0,121.85,8,568895.77,4,5,0,5,True
7924117,1271,0,451,4834,841284706,0,0,0,121.8,7,568773.97,23,3,7,7,True
8093048,1101,2,20,9085,841284706,0,0,0,122.08,5,568651.89,0,0,2,7,True
8106786,1381,4,451,6049,841284706,0,0,0,122.21,7,568529.68,16,3,12,7,True
8221274,642,0,451,4429,841284706,0,0,0,122.1,7,568407.58,24,0,22,8,True
8556536,642,0,451,3692,841284706,0,0,0,122.01,7,568285.57,24,1,18,9,True
8878725,1271,0,25,2102,841284706,0,0,0,122.25,8,568163.32,23,5,22,9,True
8943650,642,0,25,1312,841284706,0,0,0,122.08,8,568041.24,24,0,6,10,True
8945443,444,2,20,6514,841284706,0,0,0,122.12,5,567919.12,24,2,9,10,True
9165060,1351,4,25,6514,841284706,0,0,0,122.11,8,567797.01,24,3,19,10,True
9400458,1381,4,25,4429,841284706,0,0,0,121.83,8,567675.18,16,0,7,11,True
9611163,642,0,-1,3692,841284706,0,1,0,122.0,1,567675.18,24,4,10,11,False
9874238,317,4,451,9084,841284706,0,0,0,121.89,7,567553.29,4,5,16,11,True
9949323,394,0,20,5533,841284706,0,0,0,121.82,3,567431.47,10,0,16,11,True
1013772,826,1,10,3497,514990118,1,0,0,661.11,0,751032.11,18,2,2,1,True
1244801,89,3,-1,7056,514990118,1,1,0,661.12,1,751032.11,1,5,5,2,True
1442144,235,4,451,4875,514990118,1,0,0,661.08,7,750371.03,26,1,21,2,True
1622383,355,1,30,6482,514990118,1,0,0,660.98,8,749710.05,24,4,17,3,True
1624930,235,4,-1,3825,514990118,1,1,0,661.01,4,749710.05,26,0,14,3,True
1664129,917,0,20,9724,514990118,1,0,0,660.96,5,749049.09,18,0,10,4,True
1891052,355,1,451,3825,514990118,1,0,0,661.01,7,748388.08,24,3,23,4,True
1987979,1119,0,10,7725,514990118,1,0,0,660.96,6,749049.04,24,5,12,4,True
2232882,20,0,10,5193,514990118,1,0,0,661.2,0,749710.24,24,3,19,5,True
2270176,1218,4,-1,3868,514990118,1,1,0,661.44,4,749710.24,24,4,19,5,True
2756141,1009,0,451,8031,514990118,1,0,0,660.72,7,749049.52,26,0,12,5,True
2914791,1218,4,451,2679,514990118,1,0,0,660.93,7,748388.59,24,4,0,5,True
3240220,355,1,30,5193,514990118,1,0,0,660.96,8,747727.63,24,4,2,6,True
3314228,355,1,451,8730,514990118,1,0,0,660.99,7,747066.64,24,4,11,7,True
3388823,1321,0,20,9914,514990118,1,0,0,661.04,3,746405.6,18,0,12,8,True
3414324,1009,0,25,6482,514990118,1,0,0,660.87,8,745744.73,26,3,5,8,True
3534982,341,0,20,4063,514990118,1,0,0,661.01,5,745083.72,24,5,4,9,True
3728942,1232,1,10,4063,514990118,1,0,0,660.91,6,745744.63,18,2,3,9,True
3779329,89,3,451,9987,514990118,1,0,0,660.98,7,745083.65,1,4,19,10,True
3802001,1493,4,25,8127,514990118,1,0,0,661.1,8,744422.55,24,1,2,10,True
3934189,1218,4,30,5409,514990118,1,0,0,660.99,8,743761.56,24,0,1,10,False
4330911,235,4,451,3825,514990118,1,0,0,660.96,7,743100.6,26,3,21,11,True
4334757,1493,4,451,4619,514990118,1,0,0,661.17,7,742439.43,24,5,22,11,True
4742913,355,1,451,4875,514990118,1,0,0,661.26,7,741778.17,24,2,13,12,True
4804502,913,0,10,9914,514990118,1,0,0,660.96,6,742439.13,18,2,18,1,True
4880729,235,4,451,8127,514990118,1,0,0,661.11,7,741778.02,26,4,0,2,True
5092318,1493,4,451,8127,514990118,1,0,0,661.1,7,741116.92,24,5,19,3,True
5125933,1218,4,25,4980,514990118,1,0,0,660.95,8,740455.97,24,6,20,3,True
5201664,1436,0,25,8440,514990118,1,0,0,661.03,8,739794.94,24,5,7,4,True
5202882,130,0,10,4875,514990118,1,0,0,660.81,0,740455.75,18,0,1,4,True
5396539,89,3,451,7056,514990118,1,0,0,660.89,7,739794.86,1,1,23,5,True
5622008,1493,4,451,4063,514990118,1,0,0,661.23,7,739133.63,24,5,18,7,True
5659732,89,3,25,4875,514990118,1,0,0,661.09,8,738472.54,1,1,17,7,True
5876883,428,0,10,9668,514990118,1,0,0,660.7,6,739133.24,18,5,3,7,True
5919709,355,1,30,8107,514990118,1,0,0,660.75,8,738472.49,24,4,10,7,True
5976933,995,1,10,3868,514990118,1,0,0,660.88,0,739133.37,22,2,13,8,True
6092021,1436,0,-1,8699,514990118,1,1,0,660.96,4,739133.37,24,0,0,10,True
6092362,1493,4,25,8699,514990118,1,0,0,661.12,8,738472.25,24,2,3,11,True
6177405,235,4,30,8031,514990118,1,0,0,660.97,8,737811.28,26,2,10,11,True
6250497,1436,0,-1,9987,514990118,1,1,0,661.03,4,737811.28,24,6,10,1,True
6511533,1009,0,-1,3825,514990118,1,2,0,661.01,4,737811.28,26,0,16,1,True
6564706,269,0,10,8031,514990118,1,0,0,660.86,6,738472.14,24,6,15,1,True
6583121,235,4,451,8699,514990118,1,0,0,661.12,7,737811.02,26,2,23,3,True
7202393,1195,1,10,8031,514990118,1,0,0,660.67,6,738471.69,24,6,4,4,True
7286844,128,0,10,4875,514990118,1,0,0,661.11,6,739132.8,18,1,19,6,True
7421907,235,4,451,9900,514990118,1,0,0,661.02,7,738471.78,26,4,7,6,True
7472291,654,1,10,9900,514990118,1,0,0,661.19,0,739132.97,18,1,22,6,True
7670095,1436,0,451,4980,514990118,1,0,0,661.14,7,738471.83,24,3,4,7,False
7893086,355,1,-1,8107,514990118,1,1,0,661.32,4,738471.83,24,1,13,8,True
8349418,404,1,10,4619,514990118,1,0,0,661.01,6,739132.84,10,0,12,8,True
8366277,1493,4,451,8127,514990118,1,0,0,661.12,7,738471.72,24,1,0,9,True
8370168,1483,0,20,7056,514990118,1,0,0,660.91,5,737810.81,24,1,8,9,True
8451026,1436,0,451,5193,514990118,1,0,0,660.79,7,737150.02,24,6,7,9,True
8538782,355,1,25,9914,514990118,1,0,0,661.21,8,736488.81,24,0,12,9,True
8716665,1493,4,451,3497,514990118,1,0,0,661.22,7,735827.59,24,5,22,10,True
9567697,89,3,30,3825,514990118,1,0,0,660.89,8,735166.7,1,1,1,10,True
9667783,355,1,30,4980,514990118,1,0,0,661.27,8,734505.43,24,6,15,11,True
9944817,355,1,451,3868,514990118,1,0,0,660.95,7,733844.48,24,6,19,11,True
1071393,240,4,30,8994,138843487,0,0,0,328.05,8,447708.95,26,3,10,1,True
1092683,224,3,25,7591,138843487,0,0,0,327.98,8,447380.97,26,3,0,6,True
1238947,1393,3,451,2723,138843487,0,0,0,327.94,7,447053.03,24,0,10,7,True
1472789,1278,0,20,9122,138843487,0,0,0,327.77,5,446725.26,24,2,12,12,True
1773671,1060,1,451,8994,138843487,0,0,0,327.99,7,446397.27,11,1,8,1,True
1864805,1418,3,25,4608,138843487,0,0,0,327.83,8,446069.44,24,1,10,3,True
1935181,1060,1,451,9321,138843487,0,0,0,328.2,7,445741.24,11,2,11,7,True
2126971,1060,1,25,9511,138843487,0,0,0,328.09,8,445413.15,11,6,3,9,True
2130837,1418,3,451,8994,138843487,0,0,0,328.19,7,445084.96,24,2,21,11,True
2153356,961,4,451,2523,138843487,0,0,0,327.8,7,444757.16,13,4,16,1,True
2264047,961,4,451,5637,138843487,0,0,0,328.37,7,444428.79,13,3,11,1,True
2458932,1393,3,991,4608,138843487,0,0,1,328.02,2,0.0,24,5,0,8,True
1005987,1170,0,30,7496,418851665,1,0,0,897.92,8,991908.08,24,4,20,1,False
1213131,1068,2,20,9195,418851665,1,0,0,897.99,3,991010.09,18,2,17,1,True
1283695,1443,4,30,4090,418851665,1,0,0,897.91,8,990112.18,24,3,14,2,True
1474249,1297,0,451,9899,418851665,1,0,0,897.99,7,989214.19,5,6,22,2,True
1523561,642,0,20,9337,418851665,1,0,0,898.03,3,988316.16,24,6,0,3,True
1533800,1170,0,451,1554,418851665,1,0,0,898.16,7,987418.0,24,2,6,4,True
1783988,1426,1,25,6058,418851665,1,0,0,897.95,8,986520.05,24,6,18,5,True
1934694,160,0,20,1756,418851665,1,0,0,897.88,5,985622.17,24,6,19,5,True
2046841,496,1,10,1756,418851665,1,0,0,898.12,6,986520.29,12,3,17,5,True
2072809,1297,0,-1,8483,418851665,1,1,0,898.11,4,986520.29,5,3,16,5,True
2294922,1170,0,25,9164,418851665,1,0,0,897.9,8,985622.39,24,0,3,8,True
2718801,1321,0,10,8131,418851665,1,0,0,897.92,6,986520.31,18,1,0,8,True
2828039,96,0,-1,1752,418851665,1,1,0,897.91,4,986520.31,1,3,9,9,True
2923242,1443,4,25,1748,418851665,1,0,0,898.01,8,985622.3,24,1,17,9,True
3106569,610,0,10,1453,418851665,1,0,0,897.79,6,986520.09,11,0,2,9,True
3188751,1170,0,-1,9899,418851665,1,1,0,897.83,4,986520.09,24,0,21,10,True
3626220,1297,0,451,3571,418851665,1,0,0,898.17,7,985621.92,5,2,18,11,True
3930834,1297,0,-1,1453,418851665,1,1,0,898.14,4,985621.92,5,3,8,12,True
3959979,1461,0,20,1756,418851665,1,0,0,897.78,5,984724.14,11,4,14,1,True
4174986,1443,4,-1,9195,418851665,1,1,0,898.01,4,984724.14,24,6,19,2,True
4368651,807,0,10,6058,418851665,1,0,0,898.0,6,985622.14,11,5,14,4,True
4539649,1170,0,30,6920,418851665,1,0,0,897.88,8,984724.26,24,3,0,4,True
4549750,1297,0,25,7950,418851665,1,0,0,897.95,8,983826.31,5,3,6,4,True
4585412,866,0,20,6757,418851665,1,0,0,897.79,5,982928.52,24,1,1,5,True
4781563,498,0,20,7807,418851665,1,0,0,897.83,3,982030.69,12,1,4,5,True
4908906,96,0,-1,4090,418851665,1,1,0,897.88,1,982030.69,1,1,9,6,True
5006163,1170,0,-1,6757,418851665,1,2,0,897.79,4,982030.69,24,6,8,6,True
5156602,1443,4,25,9568,418851665,1,0,0,898.02,8,981132.67,24,5,19,7,True
5226153,1426,1,25,3446,418851665,1,0,0,897.91,8,980234.76,24,5,22,7,True
5344185,1297,0,451,9164,418851665,1,0,0,897.76,7,979337.0,5,2,22,7,True
5778320,1288,0,10,9568,418851665,1,0,0,897.74,0,980234.74,24,2,15,8,True
5780670,1297,0,30,6058,418851665,1,0,0,898.12,8,979336.62,5,4,13,8,True
6018828,1443,4,30,6058,418851665,1,0,0,897.81,8,978438.81,24,5,9,10,True
6046961,416,2,20,6058,418851665,1,0,0,898.06,3,977540.75,18,2,3,10,True
6052913,1170,0,25,1748,418851665,1,0,0,897.9,8,976642.85,24,5,23,10,True
6513848,635,2,20,3446,418851665,1,0,0,898.23,5,975744.62,24,0,7,10,True
6664370,1297,0,451,6757,418851665,1,0,0,897.85,7,974846.77,5,4,17,11,True
6790787,148,1,10,6058,418851665,1,0,0,897.9,6,975744.67,18,6,1,11,True
6826470,1170,0,451,6058,418851665,1,0,0,898.24,7,974846.43,24,0,9,12,True
6934532,96,0,30,6757,418851665,1,0,0,897.71,8,973948.72,1,3,0,1,True
6987048,1443,4,451,9337,418851665,1,0,0,898.21,7,973050.51,24,2,4,1,True
7139539,96,0,451,6655,418851665,1,0,0,898.28,7,972152.23,1,3,7,2,True
7177393,1297,0,451,6641,418851665,1,0,0,898.09,7,971254.14,5,1,11,4,False
7221142,1443,4,-1,6655,418851665,1,1,0,898.11,4,971254.14,24,0,16,4,True
7221226,1443,4,-1,9337,418851665,1,2,0,898.08,4,971254.14,24,2,6,5,False
7680812,1434,0,10,1453,418851665,1,0,0,897.78,6,972151.92,24,5,13,6,True
7859522,1443,4,30,9669,418851665,1,0,0,897.87,8,971254.05,24,4,22,6,False
8403109,1012,0,20,1756,418851665,1,0,0,897.93,3,970356.12,26,5,0,7,True
8434805,96,0,-1,6920,418851665,1,1,0,898.01,4,970356.12,1,1,13,8,True
8614245,774,2,20,9669,418851665,1,0,0,898.1,5,969458.02,14,4,16,8,True
8922435,1297,0,451,8483,418851665,1,0,0,898.08,7,968559.94,5,1,16,8,True
9088387,96,0,25,6757,418851665,1,0,0,898.18,8,967661.76,1,3,20,8,True
9302647,577,0,10,6920,418851665,1,0,0,897.84,0,968559.6,11,0,3,9,True
9452052,1426,1,451,6655,418851665,1,0,0,898.03,7,967661.57,24,4,4,9,True
9515245,1270,1,10,9297,418851665,1,0,0,897.81,6,968559.38,23,0,2,9,True
9580394,1426,1,25,1756,418851665,1,0,0,898.12,8,967661.26,24,0,19,9,True
9969456,1443,4,451,1554,418851665,1,0,0,898.05,7,966763.21,24,1,15,10,True
1168521,695,2,-1,2299,254699086,1,1,0,1161.04,4,421019.0,24,0,6,1,True
1173594,455,4,25,2639,254699086,1,0,0,1160.93,8,419858.07,13,3,13,3,True
1245335,814,4,451,2002,254699086,1,0,0,1160.8,7,418697.27,18,0,20,3,True
1381911,814,4,25,9141,254699086,1,0,0,1160.88,8,417536.39,18,3,3,3,True
1460639,1212,0,20,6822,254699086,1,0,0,1160.72,5,416375.67,24,0,14,4,True
1506941,318,0,451,4719,254699086,1,0,0,1160.94,7,415214.73,11,6,9,5,True
1507957,695,2,30,4465,254699086,1,0,0,1160.95,8,414053.78,24,3,21,5,True
1645263,455,4,25,3104,254699086,1,0,0,1161.16,8,412892.62,13,3,4,6,True
2099732,814,4,25,4764,254699086,1,0,0,1161.13,8,411731.49,18,6,20,6,True
2467256,818,1,451,7028,254699086,1,0,0,1161.13,7,410570.36,18,6,20,7,True
2511520,1250,1,10,7748,254699086,1,0,0,1160.79,0,411731.15,23,2,19,12,True
2533516,1243,2,20,3525,254699086,1,0,0,1161.05,5,410570.1,18,1,16,3,True
2568313,1280,3,451,4465,254699086,1,0,0,1160.85,7,409409.25,24,5,1,3,True
2633976,151,4,25,4668,254699086,1,0,0,1160.85,8,408248.4,18,2,9,3,True
3001680,628,0,20,4764,254699086,1,0,0,1160.96,5,407087.44,11,6,11,4,True
3001730,1280,3,30,7748,254699086,1,0,0,1160.98,8,405926.46,24,0,13,5,True
3007647,151,4,25,2549,254699086,1,0,0,1160.69,8,404765.77,18,2,3,5,True
3025976,318,0,451,3525,254699086,1,0,0,1160.88,7,403604.89,11,0,20,6,True
3300560,416,2,20,2639,254699086,1,0,0,1160.98,3,402443.91,18,1,6,6,True
3474561,151,4,-1,2549,254699086,1,1,0,1161.17,1,402443.91,18,1,23,6,True
3551857,818,1,-1,2639,254699086,1,2,0,1160.89,4,402443.91,18,4,3,7,True
4491578,151,4,451,9141,254699086,1,0,0,1161.0,7,401282.91,18,2,9,7,True
4674724,811,0,-1,2639,254699086,1,1,0,1160.71,4,401282.91,18,4,3,7,True
4978512,1127,0,20,2639,254699086,1,0,0,1161.09,5,400121.82,24,6,5,7,True
5117734,151,4,25,7322,254699086,1,0,0,1160.99,8,398960.83,18,2,22,7,True
5127418,269,0,20,3681,254699086,1,0,0,1161.32,3,397799.51,24,6,15,8,True
5752452,818,1,25,3104,254699086,1,0,0,1161.02,8,396638.49,18,4,15,9,True
5868312,98,0,20,3525,254699086,1,0,0,1160.73,5,395477.76,3,6,16,9,True
6127066,205,0,20,4668,254699086,1,0,0,1160.9,5,394316.86,9,5,10,9,True
6192755,151,4,25,6102,254699086,1,0,0,1161.03,8,393155.83,18,2,10,10,True
6636217,818,1,451,4190,254699086,1,0,0,1161.03,7,391994.8,18,1,12,11,True
6695871,814,4,30,3104,254699086,1,0,0,1161.05,8,390833.75,18,6,3,11,True
7331321,757,0,10,3681,254699086,1,0,0,1160.98,6,391994.73,24,5,20,12,True
7533676,695,2,30,2639,254699086,1,0,0,1160.96,8,390833.77,24,4,12,12,True
7611844,695,2,-1,1331,254699086,1,1,0,1161.11,4,390833.77,24,5,17,1,False
7729717,465,0,20,5251,254699086,1,0,0,1160.99,5,389672.78,13,6,13,1,False
7783788,790,0,20,1331,254699086,1,0,0,1160.84,5,388511.94,11,1,5,1,True
7955486,234,0,20,4719,254699086,1,0,0,1161.14,5,387350.8,26,2,19,3,True
8080911,318,0,451,4668,254699086,1,0,0,1160.81,7,386189.99,11,0,23,5,True
8198629,318,0,451,2775,254699086,1,0,0,1160.88,7,385029.11,11,1,8,5,True
8409503,234,0,20,7748,254699086,1,0,0,1161.05,3,383868.06,26,6,10,5,True
8593274,811,0,-1,4190,254699086,1,1,0,1161.13,1,383868.06,18,3,7,5,True
8753215,455,4,30,4719,254699086,1,0,0,1161.06,8,382707.0,13,3,6,6,True
8764562,151,4,30,7748,254699086,1,0,0,1160.82,8,381546.18,18,2,10,8,True
8781205,634,1,10,6102,254699086,1,0,0,1160.99,6,382707.17,24,4,20,8,False
8784207,818,1,451,2775,254699086,1,0,0,1161.14,7,381546.03,18,0,15,8,True
8964476,1411,0,20,2549,254699086,1,0,0,1161.27,5,380384.76,24,4,1,8,True
9124013,811,0,451,7322,254699086,1,0,0,1160.95,7,379223.81,18,2,11,8,True
9311452,1321,0,20,6822,254699086,1,0,0,1161.21,5,378062.6,18,6,18,9,True
9579583,811,0,30,7322,254699086,1,0,0,1160.96,8,376901.64,18,2,3,9,True
9657494,1110,0,10,1765,254699086,1,0,0,1160.91,6,378062.55,0,5,11,10,True
9782653,980,1,10,1765,254699086,1,0,0,1161.0,6,379223.55,22,0,8,10,True
9911055,318,0,30,2639,254699086,1,0,0,1160.83,8,378062.72,11,3,20,10,True
9934704,818,1,-1,2110,254699086,1,1,0,1161.08,4,378062.72,18,3,13,11,True
1088466,885,3,25,5298,607981614,0,0,0,448.94,8,393878.06,24,5,17,3,True
1579759,1402,4,451,1349,607981614,0,0,0,449.12,7,393428.94,24,0,7,3,True
1956108,885,3,451,8191,607981614,0,0,0,449.1,7,392979.84,24,6,12,4,True
2087744,239,1,30,8191,607981614,0,0,0,448.98,8,392530.86,26,2,5,4,True
2202703,316,2,20,8444,607981614,0,0,0,448.7,3,392082.16,4,0,5,4,False
2608070,239,1,-1,8544,607981614,0,1,0,448.89,4,392082.16,26,3,22,5,False
2706670,1334,3,25,5702,607981614,0,0,0,449.03,8,391633.13,18,4,17,7,True
2921995,303,0,30,8191,607981614,0,0,0,449.04,8,391184.09,4,4,14,7,True
3054114,303,0,30,8191,607981614,0,0,0,449.04,8,390735.05,4,1,9,8,True
3141811,885,3,30,1555,607981614,0,0,0,449.23,8,390285.82,24,5,14,9,True
3232573,885,3,451,4299,607981614,0,0,0,449.14,7,389836.68,24,6,6,9,True
3531126,239,1,30,8544,607981614,0,0,0,448.81,8,389387.87,26,0,20,12,True
3589426,303,0,-1,7708,607981614,0,1,0,448.86,4,389387.87,4,0,7,1,True
3772383,1233,0,-1,4436,607981614,0,2,0,448.73,1,389387.87,18,3,0,3,True
3775504,1278,0,30,5960,607981614,0,0,0,448.99,8,388938.88,24,2,19,4,True
3837552,1334,3,25,8634,607981614,0,0,0,448.83,8,388490.05,18,4,22,6,True
3907323,239,1,-1,2252,607981614,0,1,0,448.82,4,388490.05,26,1,1,6,True
4018060,360,0,10,5055,607981614,0,0,0,449.06,6,388939.11,24,2,6,7,True
4284850,1402,4,451,2252,607981614,0,0,0,449.06,7,388490.05,24,3,23,8,True
4360562,303,0,25,1349,607981614,0,0,0,448.75,8,388041.3,4,4,7,8,True
4561814,885,3,30,1349,607981614,0,0,0,448.81,8,387592.49,24,5,21,8,True
4577858,303,0,-1,8634,607981614,0,1,0,449.08,4,387592.49,4,6,17,8,True
4602948,1233,0,451,5298,607981614,0,0,0,448.74,7,387143.75,18,3,18,8,True
5121965,600,4,451,3524,607981614,0,0,0,449.08,7,386694.67,24,2,17,9,True
5471406,1402,4,451,3746,607981614,0,0,0,449.11,7,386245.56,24,0,23,9,True
5666734,303,0,25,2304,607981614,0,0,0,449.2,8,385796.36,4,2,19,10,True
6063509,81,0,20,2252,607981614,0,0,0,449.02,3,385347.34,1,1,16,10,True
6148239,1278,0,25,7202,607981614,0,0,0,449.01,8,384898.33,24,4,16,11,True
6244373,1303,0,20,7202,607981614,0,0,0,449.06,5,384449.27,5,6,6,12,True
6379551,1402,4,-1,4402,607981614,0,1,0,449.19,4,384449.27,24,3,6,12,True
6422989,548,2,20,1349,607981614,0,0,0,448.62,5,384000.65,17,4,4,12,True
6437751,1485,0,20,7708,607981614,0,0,0,449.11,5,383551.54,24,3,5,12,True
6678409,752,0,10,3524,607981614,0,0,0,448.98,6,384000.52,24,6,17,1,True
7089078,393,1,10,8444,607981614,0,0,0,448.75,0,384449.27,10,4,11,1,True
7310804,865,0,20,8634,607981614,0,0,0,449.31,5,383999.96,24,4,16,1,True
7395878,1402,4,451,8444,607981614,0,0,0,449.01,7,383550.95,24,6,9,2,False
7466068,913,0,20,1555,607981614,0,0,0,448.98,5,383101.97,18,0,5,2,True
7923263,249,0,20,5298,607981614,0,0,0,449.34,5,382652.63,6,6,0,4,True
8072943,64,0,10,4843,607981614,0,0,0,448.92,6,383101.55,20,1,7,4,True
8145312,239,1,25,3834,607981614,0,0,0,448.87,8,382652.68,26,2,21,6,True
8452629,1402,4,451,3746,607981614,0,0,0,449.0,7,382203.68,24,2,9,7,True
8459545,303,0,451,8544,607981614,0,0,0,449.31,7,381754.37,4,1,13,8,True
8755781,1155,0,10,7202,607981614,0,0,0,449.2,6,382203.57,15,0,20,8,True
8869307,303,0,20,1967,607981614,0,0,0,448.9,5,381754.67,4,1,9,9,True
8909257,1278,0,25,4299,607981614,0,0,0,449.25,8,381305.42,24,0,11,9,True
8974020,1311,2,20,1555,607981614,0,0,0,448.95,5,380856.47,5,0,18,9,True
9059857,137,2,20,3524,607981614,0,0,0,448.94,5,380407.53,18,0,14,10,True
9222470,1402,4,30,2304,607981614,0,0,0,448.7,8,379958.83,24,1,12,10,True
9516816,1402,4,451,1349,607981614,0,0,0,448.81,7,379510.02,24,1,6,11,True
9684713,1233,0,451,4843,607981614,0,0,0,449.15,7,379060.87,18,5,21,11,True
1073195,658,4,451,9770,327114013,1,0,0,395.22,7,365475.78,18,2,23,2,True
1100735,334,0,10,3256,327114013,1,0,0,394.84,0,365870.62,11,1,5,2,True
1224562,958,2,25,3256,327114013,1,0,0,394.99,8,365475.63,13,6,19,3,True
1286269,1044,0,-1,1935,327114013,1,1,0,395.14,4,365475.63,11,3,0,4,True
1305763,1044,0,-1,3664,327114013,1,2,0,395.35,4,365475.63,11,2,8,4,True
1323300,993,0,20,5249,327114013,1,0,0,395.0,5,365080.63,22,0,2,4,True
1502120,1004,4,30,8662,327114013,1,0,0,395.31,8,364685.32,26,3,15,5,True
1624659,658,4,30,1619,327114013,1,0,0,394.64,8,364290.68,18,3,4,6,True
1777739,1219,1,451,1619,327114013,1,0,0,394.89,7,363895.79,24,5,22,6,True
1848508,327,0,20,2186,327114013,1,0,0,394.89,5,363500.9,11,1,0,6,True
2240750,658,4,30,5249,327114013,1,0,0,395.3,8,363105.6,18,3,2,7,True
2290852,1262,0,20,2745,327114013,1,0,0,394.86,5,362710.74,23,4,8,7,True
2342474,965,4,30,2166,327114013,1,0,0,395.16,8,362315.58,13,5,21,7,True
2493577,965,4,30,4154,327114013,1,0,0,394.78,8,361920.8,13,4,18,9,True
2503762,958,2,451,4632,327114013,1,0,0,395.22,7,361525.58,13,3,12,9,True
2778581,1044,0,451,2186,327114013,1,0,0,395.02,7,361130.56,11,1,21,1,True
2842025,1044,0,25,5522,327114013,1,0,0,395.0,8,360735.56,11,2,12,1,True
2933625,658,4,-1,9251,327114013,1,1,0,395.01,4,360735.56,18,4,7,1,True
3197479,658,4,-1,1619,327114013,1,2,0,394.94,4,360735.56,18,3,23,2,True
3232959,658,4,25,4632,327114013,1,0,0,395.0,8,360340.56,18,6,14,2,True
3264628,1041,0,25,9794,327114013,1,0,0,394.89,8,359945.67,11,3,16,2,True
3379049,958,2,451,1935,327114013,1,0,0,395.41,7,359550.26,13,3,21,3,True
3402178,1044,0,451,4213,327114013,1,0,0,395.0,7,359155.26,11,4,21,3,True
3510443,144,1,10,9770,327114013,1,0,0,395.14,0,359550.4,18,5,16,3,True
3815549,1219,1,451,2385,327114013,1,0,0,395.18,7,359155.22,24,3,20,3,True
3991684,965,4,-1,1935,327114013,1,1,0,394.87,1,359155.22,13,2,4,5,True
4106003,1041,0,-1,1935,327114013,1,2,0,394.94,4,359155.22,11,3,23,6,True
4257797,1044,0,30,5249,327114013,1,0,0,394.95,8,358760.27,11,6,11,7,True
4390874,658,4,30,5465,327114013,1,0,0,394.85,8,358365.42,18,6,12,7,True
4742740,1004,4,25,1619,327114013,1,0,0,394.94,8,357970.48,26,3,8,7,True
4765281,1041,0,25,3256,327114013,1,0,0,394.89,8,357575.59,11,0,21,7,True
5779055,965,4,30,9705,327114013,1,0,0,395.05,8,357180.54,13,0,16,8,True
5885507,965,4,451,7520,327114013,1,0,0,394.99,7,356785.55,13,1,20,9,True
6145691,651,4,25,3256,327114013,1,0,0,394.92,8,356390.63,24,1,8,10,True
6146238,1219,1,30,4154,327114013,1,0,0,395.24,8,355995.39,24,5,11,11,True
6313080,454,1,10,9794,327114013,1,0,0,394.95,6,356390.34,13,0,22,11,True
6384571,1044,0,-1,4213,327114013,1,1,0,395.03,1,356390.34,11,2,17,11,True
6522771,1406,0,10,4213,327114013,1,0,0,395.32,6,356785.66,24,5,13,12,False
6569599,503,0,20,3256,327114013,1,0,0,395.12,5,356390.54,12,6,12,12,True
6710762,1004,4,25,6460,327114013,1,0,0,395.04,8,355995.5,26,6,10,1,True
6935848,651,4,451,9705,327114013,1,0,0,394.9,7,355600.6,24,2,21,1,True
7071874,1041,0,451,1935,327114013,1,0,0,394.77,7,355205.83,11,4,13,1,True
7181896,1044,0,25,9754,327114013,1,0,0,395.13,8,354810.7,11,2,13,1,True
7297300,1219,1,30,2166,327114013,1,0,0,394.79,8,354415.91,24,1,0,2,True
7315884,537,0,10,1619,327114013,1,0,0,395.01,6,354810.92,18,0,7,3,True
7518789,965,4,451,9754,327114013,1,0,0,394.9,7,354416.02,13,2,5,3,True
8111138,1041,0,451,2385,327114013,1,0,0,395.15,7,354020.87,11,5,15,5,True
8382865,958,2,30,4213,327114013,1,0,0,395.08,8,353625.79,13,2,13,5,True
8808404,651,4,451,6850,327114013,1,0,0,394.97,7,353230.82,24,2,15,7,True
8860414,958,2,451,3256,327114013,1,0,0,394.81,7,352836.01,13,3,20,8,True
9246352,1125,1,10,1935,327114013,1,0,0,394.73,6,353230.74,24,1,3,8,True
9265892,1260,0,10,7520,327114013,1,0,0,395.15,0,353625.89,23,0,8,9,True
9513155,266,2,20,6460,327114013,1,0,0,394.93,5,353230.96,6,6,18,11,True
1072158,866,0,-1,3903,918561795,0,1,0,1087.87,4,616458.0,24,0,19,1,True
1115651,417,3,-1,4397,918561795,0,2,0,1087.82,4,616458.0,18,5,12,1,True
1129767,417,3,30,5837,918561795,0,0,0,1087.91,8,615370.09,18,6,6,1,True
1181862,1082,3,30,5895,918561795,0,0,0,1088.16,8,614281.93,18,0,17,2,True
1256713,353,1,30,3645,918561795,0,0,0,1087.81,8,613194.12,24,2,18,3,True
1791080,574,2,20,2664,918561795,0,0,0,1088.09,5,612106.03,11,1,16,3,True
1974890,1459,1,25,7637,918561795,0,0,0,1087.87,8,611018.16,11,2,4,3,False
2087449,372,0,20,9397,918561795,0,0,0,1087.97,5,609930.19,25,4,14,4,True
2093638,1064,0,10,9602,918561795,0,0,0,1088.05,0,611018.24,11,0,16,4,True
2116890,467,0,20,9242,918561795,0,0,0,1087.84,5,609930.4,5,4,6,7,True
2266887,1400,3,451,1801,918561795,0,0,0,1087.84,7,608842.56,24,1,5,7,True
2329434,1400,3,30,4241,918561795,0,0,0,1087.9,8,607754.66,24,5,14,7,True
2355993,1459,1,451,3574,918561795,0,0,0,1088.22,7,606666.44,11,0,2,9,True
2379521,738,2,20,4241,918561795,0,0,0,1087.93,5,605578.51,11,5,15,10,False
2477202,1033,4,451,9008,918561795,0,0,0,1087.83,7,604490.68,11,5,20,10,True
2498713,1192,2,20,4241,918561795,0,0,0,1087.96,5,603402.72,24,5,5,10,True
2754421,1033,4,451,3259,918561795,0,0,0,1088.13,7,602314.59,11,6,20,11,False
3064345,334,0,20,9008,918561795,0,0,0,1088.07,5,601226.52,11,6,4,1,True
3087473,572,0,10,8423,918561795,0,0,0,1088.16,6,602314.68,11,1,2,1,True
3276851,859,2,451,6361,918561795,0,0,0,1088.24,7,601226.44,24,4,9,1,True
3474150,866,0,451,7370,918561795,0,0,0,1088.05,7,600138.39,24,3,1,2,True
3564919,417,3,25,9810,918561795,0,0,0,1088.01,8,599050.38,18,6,21,2,True
3609223,1082,3,451,3903,918561795,0,0,0,1088.15,7,597962.23,18,0,21,3,True
3985377,1304,0,20,9008,918561795,0,0,0,1088.07,5,596874.16,5,1,23,4,True
4219890,1089,0,20,4460,918561795,0,0,0,1087.83,5,595786.33,18,6,7,5,True
4494092,866,0,451,3470,918561795,0,0,0,1088.23,7,594698.1,24,1,20,7,True
4702953,467,0,20,2664,918561795,0,0,0,1088.12,5,593609.98,5,1,0,7,False
4721066,353,1,451,4717,918561795,0,0,0,1087.96,7,592522.02,24,4,21,7,True
4949378,366,0,10,6361,918561795,0,0,0,1087.96,6,593609.98,25,5,18,7,True
4979775,417,3,30,4460,918561795,0,0,0,1087.77,8,592522.21,18,5,19,7,True
5054825,205,0,10,4717,918561795,0,0,0,1087.97,6,593610.18,9,5,4,9,True
5118562,1033,4,30,3470,918561795,0,0,0,1087.9,8,592522.28,11,0,19,9,True
5164038,353,1,451,3903,918561795,0,0,0,1088.17,7,591434.11,24,1,2,9,True
5376316,1459,1,451,3903,918561795,0,0,0,1087.88,7,590346.23,11,1,23,9,True
5494524,1201,0,20,3645,918561795,0,0,0,1087.89,5,589258.34,24,1,3,10,True
5720534,1033,4,-1,4717,918561795,0,1,0,1087.9,4,589258.34,11,3,0,10,True
5745087,1179,0,10,3470,918561795,0,0,0,1087.9,6,590346.24,24,4,8,12,True
5899256,1325,0,30,5837,918561795,0,0,0,1087.95,8,589258.29,18,0,6,1,True
5987472,353,1,451,9008,918561795,0,0,0,1087.98,7,588170.31,24,4,17,1,True
6237176,1082,3,30,5736,918561795,0,0,0,1087.9,8,587082.41,18,2,3,1,True
6428682,1114,1,10,9008,918561795,0,0,0,1087.93,6,588170.34,0,3,2,1,True
6507668,1082,3,30,3645,918561795,0,0,0,1087.9,8,587082.44,18,1,8,2,True
6555072,859,2,451,5895,918561795,0,0,0,1087.86,7,585994.58,24,1,5,4,True
6848070,108,2,20,9397,918561795,0,0,0,1088.07,3,584906.51,3,0,4,4,True
6918496,1082,3,451,9003,918561795,0,0,0,1088.06,7,583818.45,18,0,20,4,True
6939324,353,1,30,9602,918561795,0,0,0,1087.97,8,582730.48,24,6,3,4,True
7167338,916,0,10,7370,918561795,0,0,0,1087.97,0,583818.45,18,0,13,5,True
7216340,1400,3,25,4397,918561795,0,0,0,1088.11,8,582730.34,24,1,16,5,True
7514965,471,0,10,4241,918561795,0,0,0,1087.93,6,583818.27,5,0,21,5,True
7947107,1459,1,451,7637,918561795,0,0,0,1088.07,7,582730.2,11,6,10,6,True
8153591,944,2,20,5895,918561795,0,0,0,1088.12,3,581642.08,24,3,18,6,True
8287353,502,0,10,3903,918561795,0,0,0,1088.15,0,582730.23,12,3,2,8,True
8409341,1459,1,451,9789,918561795,0,0,0,1088.13,7,581642.1,11,0,19,8,True
9172001,859,2,25,3645,918561795,0,0,0,1088.17,8,580553.93,24,6,16,9,True
9504992,1459,1,-1,9789,918561795,0,1,0,1087.84,1,580553.93,11,5,4,9,True
9539638,1037,0,20,6585,918561795,0,0,0,1088.1,5,579465.83,11,0,7,10,True
9755368,417,3,451,4019,918561795,0,0,0,1088.09,7,578377.74,18,0,9,10,True
9794185,1082,3,451,7370,918561795,0,0,0,1087.88,7,577289.86,18,2,1,10,True
9969987,1033,4,451,1801,918561795,0,0,0,1087.99,7,576201.87,11,3,3,10,True
1199206,131,4,30,3780,747551031,0,0,0,674.01,8,719450.99,18,1,0,2,True
1428878,130,0,10,8877,747551031,0,0,0,673.91,6,720124.9,18,6,17,3,True
1549947,998,0,20,5712,747551031,0,0,0,674.1,3,719450.8,26,0,22,5,True
1775332,131,4,25,9453,747551031,0,0,0,673.99,8,718776.81,18,0,6,6,False
1919918,131,4,30,7183,747551031,0,0,0,673.99,8,718102.82,18,0,18,7,True
2342628,1187,4,25,5712,747551031,0,0,0,674.06,8,717428.76,24,6,6,8,True
2361867,1341,4,451,1113,747551031,0,0,0,674.28,7,716754.48,24,4,0,8,True
2621013,131,4,451,1113,747551031,0,0,0,674.02,7,716080.46,18,5,13,8,True
2642742,1187,4,451,3780,747551031,0,0,0,674.21,7,715406.25,24,6,6,9,True
2789083,650,3,-1,1683,747551031,0,1,0,674.15,4,715406.25,24,0,23,10,True
2864114,131,4,451,4565,747551031,0,0,0,674.13,7,714732.12,18,6,7,11,True
3323059,1187,4,30,5404,747551031,0,0,0,673.84,8,714058.28,24,1,13,12,True
3540275,1187,4,451,4378,747551031,0,0,0,673.95,7,713384.33,24,1,11,1,True
3561183,767,0,451,4549,747551031,0,0,0,674.02,7,712710.31,14,3,7,1,True
4160503,1187,4,-1,7388,747551031,0,1,0,674.03,4,712710.31,24,0,1,3,True
4334746,616,1,10,2574,747551031,0,0,0,673.95,6,713384.26,11,3,9,4,True
4708428,577,0,-1,7388,747551031,0,1,0,673.99,4,713384.26,11,1,21,5,True
5018265,131,4,-1,8739,747551031,0,2,0,673.95,4,713384.26,18,6,1,5,True
5132317,780,0,20,7183,747551031,0,0,0,673.9,5,712710.36,14,2,11,5,True
5405533,360,0,10,7183,747551031,0,0,0,674.27,6,713384.63,24,6,21,6,True
5440959,577,0,30,5419,747551031,0,0,0,674.01,8,712710.62,11,0,21,6,True
5502234,767,0,451,9210,747551031,0,0,0,674.17,7,712036.45,14,0,12,7,True
5502972,1187,4,451,9685,747551031,0,0,0,674.13,7,711362.32,24,1,18,7,True
5901631,767,0,30,8877,747551031,0,0,0,674.13,8,710688.19,14,6,16,8,True
5982334,650,3,25,7183,747551031,0,0,0,674.06,8,710014.13,24,6,22,8,True
6103298,51,0,20,4623,747551031,0,0,0,673.85,5,709340.28,20,1,1,9,True
6115803,1341,4,451,4623,747551031,0,0,0,674.18,7,708666.1,24,5,8,9,True
6142854,1341,4,30,5419,747551031,0,0,0,674.15,8,707991.95,24,0,17,10,True
6220377,254,0,10,3499,747551031,0,0,0,674.01,6,708665.96,6,1,3,10,True
6229196,767,0,-1,4623,747551031,0,1,0,673.95,4,708665.96,14,3,19,11,True
6297218,767,0,-1,7388,747551031,0,2,0,674.26,4,708665.96,14,1,4,11,True
6336185,131,4,30,4642,747551031,0,0,0,673.95,8,707992.01,18,2,23,11,True
6458792,650,3,-1,2574,747551031,0,1,0,673.92,4,707992.01,24,2,11,1,True
6593992,650,3,451,1113,747551031,0,0,0,674.26,7,707317.75,24,5,11,1,True
6769333,1341,4,-1,7388,747551031,0,1,0,674.07,1,707317.75,24,6,9,2,True
7202214,650,3,30,7183,747551031,0,0,0,674.19,8,706643.56,24,0,21,2,True
7275576,767,0,25,9453,747551031,0,0,0,673.94,8,705969.62,14,6,1,2,True
7556932,650,3,-1,4270,747551031,0,1,0,674.1,4,705969.62,24,6,21,3,True
7741510,444,2,20,8877,747551031,0,0,0,674.2,5,705295.42,24,0,16,3,True
7865298,1187,4,451,4642,747551031,0,0,0,673.92,7,704621.5,24,3,20,3,True
7983416,577,0,30,5712,747551031,0,0,0,674.04,8,703947.46,11,1,6,4,True
8329039,650,3,30,9685,747551031,0,0,0,673.78,8,703273.68,24,3,10,6,True
8403875,577,0,30,5419,747551031,0,0,0,673.83,8,702599.85,11,0,20,7,True
8459435,650,3,-1,5712,747551031,0,1,0,674.06,4,702599.85,24,3,22,8,True
8474100,1187,4,451,3499,747551031,0,0,0,674.1,7,701925.75,24,2,5,8,True
8790000,650,3,25,8877,747551031,0,0,0,674.06,8,701251.69,24,6,19,9,True
8869900,650,3,30,4378,747551031,0,0,0,673.89,8,700577.8,24,1,21,9,True
8954749,650,3,30,4270,747551031,0,0,0,673.68,8,699904.12,24,6,13,9,True
9173996,806,1,10,7388,747551031,0,0,0,674.24,0,700578.36,11,4,23,9,True
9709213,767,0,25,4549,747551031,0,0,0,674.07,8,699904.29,14,1,4,10,True
1243806,1201,0,10,8317,150978640,0,0,0,677.79,6,875475.79,24,3,0,2,True
1420037,882,0,30,6949,150978640,0,0,0,678.06,8,874797.73,27,6,0,2,True
1500048,27,0,25,8317,150978640,0,0,0,677.85,8,874119.88,11,5,5,2,True
1504147,346,0,451,6697,150978640,0,0,0,678.27,7,873441.61,24,3,9,2,True
1515156,129,0,20,1823,150978640,0,0,0,677.73,5,872763.88,18,3,5,3,True
1537961,794,2,20,9253,150978640,0,0,0,678.25,5,872085.63,11,6,17,5,True
1702938,882,0,451,8583,150978640,0,0,0,678.12,7,871407.51,27,2,4,5,True
1772110,462,4,-1,1496,150978640,0,1,0,678.05,4,871407.51,13,5,6,5,True
2029034,346,0,451,6919,150978640,0,0,0,678.05,7,870729.46,24,6,10,5,True
2309452,1187,4,-1,6903,150978640,0,1,0,678.04,4,870729.46,24,1,15,6,True
2390238,346,0,451,4778,150978640,0,0,0,678.08,7,870051.38,24,2,3,7,True
2581188,1187,4,25,2883,150978640,0,0,0,677.97,8,869373.41,24,4,2,8,True
2972573,170,4,30,6903,150978640,0,0,0,677.9,8,868695.51,24,4,10,10,True
3577515,346,0,30,6949,150978640,0,0,0,678.07,8,868017.44,24,6,10,10,True
3625259,1063,0,20,6949,150978640,0,0,0,678.11,5,867339.33,11,0,14,11,True
4004630,1377,0,10,4114,150978640,0,0,0,677.92,0,868017.25,16,4,11,11,True
4084122,346,0,25,2800,150978640,0,0,0,678.16,8,867339.09,24,2,16,11,True
4211813,27,0,30,2800,150978640,0,0,0,678.03,8,866661.06,11,0,18,12,True
4340810,1187,4,-1,3994,150978640,0,1,0,677.89,4,866661.06,24,2,1,12,True
4436038,1227,0,10,3994,150978640,0,0,0,677.93,6,867338.99,18,5,0,1,True
4534204,1187,4,30,3994,150978640,0,0,0,678.24,8,866660.75,24,1,3,1,True
4574982,854,0,20,8206,150978640,0,0,0,677.99,5,865982.76,24,2,11,2,True
5005739,1187,4,451,5164,150978640,0,0,0,678.0,7,865304.76,24,0,19,2,True
5085998,27,0,451,9230,150978640,0,0,0,678.0,7,864626.76,11,4,9,2,True
5157913,794,2,20,9253,150978640,0,0,0,677.88,5,863948.88,11,2,1,3,True
5205757,1187,4,30,6919,150978640,0,0,0,678.02,8,863270.86,24,6,4,4,False
5289643,303,0,10,1496,150978640,0,0,0,678.08,6,863948.94,4,2,2,4,False
5309366,1446,1,10,3709,150978640,0,0,0,678.17,0,864627.11,24,3,19,4,True
5374714,939,0,10,9253,150978640,0,0,0,678.02,6,865305.13,24,3,10,5,True
5700813,1304,0,20,2670,150978640,0,0,0,678.35,5,864626.78,5,6,12,5,True
5969205,1201,0,10,8583,150978640,0,0,0,677.93,0,865304.71,24,0,0,6,False
6043703,346,0,25,9253,150978640,0,0,0,677.94,8,864626.77,24,2,8,6,True
6083196,81,0,20,4778,150978640,0,0,0,678.08,5,863948.69,1,3,21,6,True
6187309,346,0,25,6919,150978640,0,0,0,678.02,8,863270.67,24,5,1,7,True
6941904,882,0,451,9230,150978640,0,0,0,677.9,7,862592.77,27,6,8,7,True
7081328,34,1,10,6697,150978640,0,0,0,678.24,6,863271.01,11,4,23,7,False
7403029,1187,4,30,9253,150978640,0,0,0,678.01,8,862593.0,24,3,17,9,True
7405429,1187,4,30,4114,150978640,0,0,0,677.94,8,861915.06,24,4,13,9,False
7474910,27,0,451,4114,150978640,0,0,0,678.14,7,861236.92,11,0,10,10,True
7580954,27,0,25,9230,150978640,0,0,0,677.85,8,860559.07,11,5,10,11,True
7776600,882,0,25,5164,150978640,0,0,0,677.81,8,859881.26,27,6,23,11,True
7790161,319,0,10,2670,150978640,0,0,0,678.06,6,860559.32,11,1,8,11,True
8102371,346,0,25,4169,150978640,0,0,0,677.97,8,859881.35,24,4,17,12,True
8183512,462,4,25,8317,150978640,0,0,0,678.08,8,859203.27,13,1,1,12,True
8294611,882,0,451,9250,150978640,0,0,0,678.14,7,858525.13,27,2,4,12,True
8383824,27,0,30,6697,150978640,0,0,0,677.71,8,857847.42,11,2,7,12,True
8433238,1262,0,20,3709,150978640,0,0,0,677.93,5,857169.49,23,0,20,1,True
8530305,1377,0,10,8206,150978640,0,0,0,678.24,6,857847.73,16,2,14,3,True
8607944,462,4,-1,2800,150978640,0,1,0,678.18,4,857847.73,13,1,8,5,True
8759317,1404,2,20,9253,150978640,0,0,0,677.93,5,857169.8,24,1,6,5,True
8817354,346,0,30,2800,150978640,0,0,0,678.19,8,856491.61,24,3,8,6,True
9019973,170,4,25,2883,150978640,0,0,0,678.01,8,855813.6,24,6,6,6,True
9291890,747,1,10,6903,150978640,0,0,0,677.77,6,856491.37,24,6,20,7,True
9354510,346,0,25,4778,150978640,0,0,0,677.9,8,855813.47,24,5,8,8,True
9382280,27,0,451,6949,150978640,0,0,0,678.1,7,855135.37,11,2,9,8,True
9456152,170,4,25,6697,150978640,0,0,0,677.95,8,854457.42,24,5,16,8,True
9694097,27,0,451,4169,150978640,0,0,0,677.91,7,853779.51,11,4,15,10,True
9838782,882,0,451,6697,150978640,0,0,0,678.2,7,853101.31,27,1,9,11,True
1071178,1399,0,25,1282,171487032,1,0,0,1142.95,8,462404.05,24,1,5,2,True
1324098,535,0,10,8872,171487032,1,0,0,1143.18,0,463547.23,18,1,11,4,True
1478366,594,0,-1,1526,171487032,1,1,0,1142.83,4,463547.23,24,1,9,4,True
1545758,743,4,451,5341,171487032,1,0,0,1142.94,7,462404.29,24,1,9,4,True
1662181,1399,0,451,2557,171487032,1,0,0,1143.02,7,461261.27,24,6,23,7,False
1781627,1399,0,30,1282,171487032,1,0,0,1142.99,8,460118.28,24,1,20,7,True
1827375,986,4,25,4328,171487032,1,0,0,1143.16,8,458975.12,22,3,1,8,True
1911559,594,0,-1,5341,171487032,1,1,0,1143.01,1,458975.12,24,4,19,8,True
2436891,986,4,30,6574,171487032,1,0,0,1143.15,8,457831.97,22,2,20,8,True
2582083,898,1,10,1526,171487032,1,0,0,1142.92,6,458974.89,24,3,5,9,True
2724933,743,4,-1,1341,171487032,1,1,0,1143.12,1,458974.89,24,3,10,9,False
2897803,1035,0,20,6023,171487032,1,0,0,1142.82,3,457832.07,11,0,22,9,True
3101997,53,0,30,6023,171487032,1,0,0,1143.03,8,456689.04,20,6,23,10,True
3185938,641,0,10,4441,171487032,1,0,0,1142.98,0,457832.02,24,0,17,10,False
3583442,1389,4,451,5341,171487032,1,0,0,1142.89,7,456689.13,24,4,19,10,True
3767468,1399,0,451,6762,171487032,1,0,0,1143.0,7,455546.13,24,6,12,10,True
3829551,1389,4,30,6537,171487032,1,0,0,1143.06,8,454403.07,24,4,19,11,True
4201231,594,0,30,1282,171487032,1,0,0,1143.25,8,453259.82,24,6,0,12,True
4434015,594,0,451,1282,171487032,1,0,0,1142.55,7,452117.27,24,1,3,1,True
4515231,1389,4,451,6537,171487032,1,0,0,1143.03,7,450974.24,24,2,9,1,True
5015464,779,4,30,4250,171487032,1,0,0,1143.19,8,449831.05,14,1,1,2,False
5057261,1389,4,25,5341,171487032,1,0,0,1142.76,8,448688.29,24,2,15,4,True
5081722,1140,0,10,6762,171487032,1,0,0,1143.13,6,449831.42,15,5,2,5,True
5381995,34,1,10,7285,171487032,1,0,0,1142.72,6,450974.14,11,1,4,5,True
5468373,779,4,-1,7285,171487032,1,1,0,1142.87,1,450974.14,14,1,22,6,True
5474484,603,0,20,3867,171487032,1,0,0,1142.92,5,449831.22,24,2,12,7,True
5521898,687,0,10,8872,171487032,1,0,0,1143.27,0,450974.49,24,3,2,7,False
5542375,986,4,451,4328,171487032,1,0,0,1143.0,7,449831.49,22,6,1,8,True
5909503,53,0,451,6023,171487032,1,0,0,1143.03,7,448688.46,20,0,11,8,True
6094101,986,4,-1,4441,171487032,1,1,0,1142.91,4,448688.46,22,6,14,8,True
6164726,53,0,-1,1526,171487032,1,2,0,1142.86,1,448688.46,20,0,22,9,True
6313710,53,0,451,9144,171487032,1,0,0,1142.86,7,447545.6,20,2,7,11,True
6390941,743,4,-1,6574,171487032,1,1,0,1143.33,4,447545.6,24,2,8,11,True
6423038,1072,0,20,5973,171487032,1,0,0,1143.25,3,446402.35,18,3,8,12,True
6490926,1399,0,30,8872,171487032,1,0,0,1143.05,8,445259.3,24,0,1,1,True
6930156,594,0,451,1341,171487032,1,0,0,1143.02,7,444116.28,24,2,16,1,True
7195253,1399,0,451,7285,171487032,1,0,0,1143.02,7,442973.26,24,6,17,1,True
7299758,1389,4,30,7285,171487032,1,0,0,1143.0,8,441830.26,24,2,18,2,True
7338679,53,0,451,6762,171487032,1,0,0,1143.12,7,440687.14,20,1,11,2,True
7439383,594,0,25,4328,171487032,1,0,0,1143.13,8,439544.01,24,4,14,3,True
7458387,573,0,10,6537,171487032,1,0,0,1142.82,6,440686.83,11,3,17,4,True
7469369,1399,0,25,1282,171487032,1,0,0,1143.06,8,439543.77,24,5,11,4,True
8007770,594,0,30,6877,171487032,1,0,0,1143.01,8,438400.76,24,3,7,5,True
8013526,319,0,10,5341,171487032,1,0,0,1142.96,6,439543.72,11,3,23,6,True
8701753,53,0,451,8872,171487032,1,0,0,1142.89,7,438400.83,20,4,8,6,True
8752914,406,1,10,6537,171487032,1,0,0,1143.07,6,439543.9,10,1,22,8,True
8790982,1169,0,10,4250,171487032,1,0,0,1143.08,0,440686.98,24,2,15,8,True
9044867,986,4,451,9144,171487032,1,0,0,1143.14,7,439543.84,22,1,12,8,True
9083509,743,4,451,6537,171487032,1,0,0,1143.14,7,438400.7,24,6,5,9,True
9305863,779,4,451,1282,171487032,1,0,0,1142.89,7,437257.81,14,1,18,9,True
9510866,1389,4,451,6877,171487032,1,0,0,1143.05,7,436114.76,24,1,12,10,True
9864166,123,0,10,6537,171487032,1,0,0,1142.69,6,437257.45,18,1,13,10,True
1021784,1203,4,-1,3426,241679527,1,1,0,876.1,1,697052.0,24,3,3,3,True
1060214,757,0,20,7161,241679527,1,0,0,875.97,5,696176.03,24,2,14,4,True
1130241,627,0,-1,5290,241679527,1,1,0,876.3,4,696176.03,11,4,20,4,True
1286747,130,0,30,9974,241679527,1,0,0,876.13,8,695299.9,18,2,10,4,True
1322247,1239,1,10,2928,241679527,1,0,0,875.93,0,696175.83,18,3,16,5,True
1564938,627,0,-1,5290,241679527,1,1,0,876.02,4,696175.83,11,3,21,6,True
1829440,1203,4,451,6579,241679527,1,0,0,875.89,7,695299.94,24,4,6,7,True
1832903,1004,4,451,2900,241679527,1,0,0,875.63,7,694424.31,26,2,4,7,True
1997660,1203,4,-1,5290,241679527,1,1,0,876.13,4,694424.31,24,6,2,8,True
2193432,123,0,10,3426,241679527,1,0,0,876.08,6,695300.39,18,3,18,8,True
2197307,1004,4,30,3426,241679527,1,0,0,875.83,8,694424.56,26,4,8,9,True
2230092,233,4,30,3220,241679527,1,0,0,875.69,8,693548.87,26,5,13,10,True
2259943,1195,1,10,1646,241679527,1,0,0,876.12,6,694424.99,24,5,0,11,True
2305148,1203,4,30,9151,241679527,1,0,0,876.1,8,693548.89,24,6,20,11,True
2836736,1004,4,451,3220,241679527,1,0,0,875.92,7,692672.97,26,3,21,11,True
3158270,1404,2,20,9974,241679527,1,0,0,875.7,3,691797.27,24,5,4,12,True
3268923,233,4,30,9974,241679527,1,0,0,876.15,8,690921.12,26,5,22,12,True
3505060,1272,0,10,9151,241679527,1,0,0,876.04,6,691797.16,24,1,16,12,False
4003462,1089,0,20,2900,241679527,1,0,0,875.99,5,690921.17,18,5,1,1,True
4206926,1203,4,451,3220,241679527,1,0,0,876.05,7,690045.12,24,6,21,1,True
5176131,580,0,10,2928,241679527,1,0,0,876.14,0,690921.26,11,1,20,2,True
5265519,1114,1,10,6579,241679527,1,0,0,876.24,6,691797.5,0,2,17,3,True
5519808,1010,0,10,2928,241679527,1,0,0,876.05,6,692673.55,26,6,6,4,True
5645924,130,0,25,3220,241679527,1,0,0,876.0,8,691797.55,18,6,18,4,True
6353495,627,0,25,3220,241679527,1,0,0,875.92,8,690921.63,11,1,22,5,True
6367743,653,1,25,6105,241679527,1,0,0,876.04,8,690045.59,24,0,20,6,False
6430336,653,1,451,2016,241679527,1,0,0,876.02,7,689169.57,24,4,2,7,True
6443267,233,4,30,2016,241679527,1,0,0,876.02,8,688293.55,26,5,19,7,True
6495320,233,4,451,3220,241679527,1,0,0,875.98,7,687417.57,26,0,17,7,True
6564748,1061,2,20,7161,241679527,1,0,0,876.05,3,686541.52,11,4,9,8,True
6708605,1004,4,451,3426,241679527,1,0,0,876.16,7,685665.36,26,5,18,9,True
6748026,130,0,25,9974,241679527,1,0,0,875.64,8,684789.72,18,0,19,9,True
6754611,1110,0,10,9974,241679527,1,0,0,875.76,0,685665.48,0,0,9,10,True
6884872,1356,2,20,3220,241679527,1,0,0,876.01,3,684789.47,24,6,18,11,True
6916821,1004,4,451,3426,241679527,1,0,0,875.96,7,683913.51,26,6,4,12,True
6918982,653,1,25,6105,241679527,1,0,0,876.12,8,683037.39,24,2,19,12,True
6930709,1399,0,20,2266,241679527,1,0,0,875.96,3,682161.43,24,4,23,12,True
7062349,616,1,10,1646,241679527,1,0,0,876.06,6,683037.49,11,1,23,1,True
7081597,233,4,30,2928,241679527,1,0,0,875.96,8,682161.53,26,5,0,1,True
7097401,627,0,-1,6105,241679527,1,1,0,875.96,4,682161.53,11,0,18,1,True
7420395,945,1,10,3220,241679527,1,0,0,876.18,6,683037.71,24,5,18,2,True
7838549,1203,4,-1,2900,241679527,1,1,0,875.93,4,683037.71,24,3,8,5,True
8136028,1203,4,-1,3426,241679527,1,2,0,876.03,1,683037.71,24,4,1,5,True
8161941,359,2,20,6105,241679527,1,0,0,876.2,5,682161.51,24,1,23,5,True
8172701,1004,4,30,5290,241679527,1,0,0,875.97,8,681285.54,26,0,13,6,True
8315245,130,0,451,2266,241679527,1,0,0,875.9,7,680409.64,18,0,23,7,True
8518085,1411,0,20,5290,241679527,1,0,0,875.94,5,679533.7,24,0,12,7,True
8603595,653,1,25,2900,241679527,1,0,0,875.88,8,678657.82,24,1,9,7,True
8851168,752,0,10,1646,241679527,1,0,0,876.03,0,679533.85,24,5,19,8,True
8996041,1111,0,10,2928,241679527,1,0,0,875.89,0,680409.74,0,6,1,8,True
9268189,1203,4,451,3135,241679527,1,0,0,876.1,7,679533.64,24,2,6,8,True
9538754,1004,4,25,2016,241679527,1,0,0,875.99,8,678657.65,26,1,6,9,True
9846143,1122,1,10,2266,241679527,1,0,0,875.86,6,679533.51,24,2,9,9,True
9914492,372,0,20,2928,241679527,1,0,0,875.87,5,678657.64,25,1,4,10,True
1005763,117,1,451,6613,785077432,0,0,0,434.04,7,159356.96,18,4,3,2,True
1217813,1471,0,25,2682,785077432,0,0,0,433.94,8,158923.02,24,1,18,2,True
2096256,591,0,20,7219,785077432,0,0,0,433.98,5,158489.04,24,3,22,2,True
2206516,1262,0,10,4145,785077432,0,0,0,433.84,0,158922.88,23,0,4,3,False
2356042,275,0,10,6382,785077432,0,0,0,433.98,6,159356.86,24,2,4,3,True
2831489,549,1,451,3850,785077432,0,0,0,434.34,7,158922.52,17,5,10,3,True
2925217,1066,4,-1,7943,785077432,0,1,0,434.07,4,158922.52,11,2,14,3,True
3088423,1412,2,451,7428,785077432,0,0,0,433.94,7,158488.58,24,5,13,4,True
3152849,530,0,10,8505,785077432,0,0,0,433.99,6,158922.57,18,4,1,4,True
3447492,1412,2,30,7219,785077432,0,0,0,433.84,8,158488.73,24,6,3,5,True
3744216,1041,0,20,7943,785077432,0,0,0,433.78,3,158054.95,11,2,5,6,True
4107680,1066,4,-1,8505,785077432,0,1,0,434.02,4,158054.95,11,1,11,6,True
4186763,1412,2,25,2665,785077432,0,0,0,434.1,8,157620.85,24,0,20,6,True
4332584,51,0,10,1901,785077432,0,0,0,434.25,0,158055.1,20,3,10,6,True
4411701,549,1,451,8737,785077432,0,0,0,434.23,7,157620.87,17,6,10,7,True
4457095,117,1,30,6613,785077432,0,0,0,433.88,8,157186.99,18,3,3,7,True
4550019,1377,0,10,8089,785077432,0,0,0,433.82,6,157620.81,16,2,23,8,True
4551745,549,1,451,1073,785077432,0,0,0,433.98,7,157186.83,17,6,9,10,True
4618395,544,3,451,5730,785077432,0,0,0,434.0,7,156752.83,17,3,22,10,True
4660055,1066,4,451,4145,785077432,0,0,0,433.89,7,156318.94,11,3,6,11,True
4744280,544,3,451,3850,785077432,0,0,0,433.97,7,155884.97,17,3,1,12,True
4760804,29,0,10,9167,785077432,0,0,0,434.14,6,156319.11,11,5,13,12,True
4788624,1023,2,20,6569,785077432,0,0,0,433.96,5,155885.15,11,1,12,1,True
4789284,1411,0,10,8505,785077432,0,0,0,434.11,6,156319.26,24,6,14,2,True
4794161,1066,4,-1,7943,785077432,0,1,0,434.07,1,156319.26,11,0,7,2,True
5009645,544,3,30,4145,785077432,0,0,0,434.19,8,155885.07,17,0,9,3,False
5342613,512,0,451,2959,785077432,0,0,0,433.94,7,155451.13,12,2,18,5,True
5383054,642,0,20,8737,785077432,0,0,0,434.28,5,155016.85,24,6,13,6,True
5453473,783,0,10,6382,785077432,0,0,0,434.05,6,155450.9,14,1,10,7,True
5539692,1066,4,451,2665,785077432,0,0,0,433.99,7,155016.91,11,2,0,8,True
6074502,117,1,25,6569,785077432,0,0,0,433.9,8,154583.01,18,5,19,9,True
6583066,1471,0,-1,8089,785077432,0,1,0,434.04,4,154583.01,24,6,22,10,True
6620993,1471,0,451,6569,785077432,0,0,0,434.23,7,154148.78,24,1,8,10,True
6646490,1412,2,30,1073,785077432,0,0,0,433.95,8,153714.83,24,2,11,11,True
6757064,512,0,30,4145,785077432,0,0,0,433.85,8,153280.98,12,4,9,11,True
6936126,1471,0,451,2682,785077432,0,0,0,434.05,7,152846.93,24,2,9,12,True
7076772,346,0,10,3850,785077432,0,0,0,434.04,6,153280.97,24,0,16,12,True
7421662,1412,2,451,8505,785077432,0,0,0,434.04,7,152846.93,24,6,0,2,True
8188840,512,0,25,7943,785077432,0,0,0,434.01,8,152412.92,12,4,14,3,True
8424729,1066,4,451,4145,785077432,0,0,0,433.95,7,151978.97,11,5,3,4,True
8435684,544,3,451,2665,785077432,0,0,0,433.82,7,151545.15,17,0,10,7,True
8515884,544,3,451,3850,785077432,0,0,0,433.75,7,151111.4,17,0,5,7,True
8652655,1471,0,30,5730,785077432,0,0,0,433.99,8,150677.41,24,1,12,7,True
8790367,512,0,30,5590,785077432,0,0,0,434.07,8,150243.34,12,2,4,10,True
9086254,544,3,30,1179,785077432,0,0,0,433.89,8,149809.45,17,1,13,10,True
9136921,1412,2,451,7943,785077432,0,0,0,433.65,7,149375.8,24,4,3,10,True
9173613,512,0,451,5590,785077432,0,0,0,433.91,7,148941.89,12,2,5,11,True
9641219,1066,4,-1,1247,785077432,0,1,0,433.94,4,148941.89,11,0,17,11,True
9729562,117,1,30,7686,785077432,0,0,0,434.23,8,148507.66,18,6,20,11,False
9784649,889,0,10,4258,785077432,0,0,0,433.93,6,148941.59,27,2,13,11,True
1326742,1397,4,451,9372,789035154,0,0,0,675.01,7,109794.99,24,4,20,2,True
1530985,694,2,-1,5474,789035154,0,1,0,675.14,4,109794.99,24,5,18,2,True
1625522,292,1,30,3774,789035154,0,0,0,674.78,8,109120.21,4,2,6,3,True
1667716,180,0,30,4228,789035154,0,0,0,674.96,8,108445.25,18,3,19,5,True
1854851,1254,4,451,3797,789035154,0,0,0,675.03,7,107770.22,23,5,15,5,True
1958244,727,0,20,9372,789035154,0,0,0,675.27,3,107094.95,11,6,8,7,True
2207609,732,0,10,5134,789035154,0,0,0,675.18,6,107770.13,11,0,19,7,True
2228923,1397,4,-1,9146,789035154,0,1,0,674.99,1,107770.13,24,0,11,8,True
2337546,1052,0,20,6362,789035154,0,0,0,674.82,3,107095.31,11,4,18,8,True
2590495,694,2,25,9372,789035154,0,0,0,674.86,8,106420.45,24,0,15,8,True
2638092,1063,0,10,5474,789035154,0,0,0,674.68,0,107095.13,11,0,22,9,True
2860351,1397,4,30,8660,789035154,0,0,0,674.79,8,106420.34,24,4,4,9,True
2889468,180,0,25,8660,789035154,0,0,0,674.85,8,105745.49,18,2,8,10,True
3131223,292,1,30,9317,789035154,0,0,0,674.94,8,105070.55,4,0,22,12,True
3253773,116,0,10,1083,789035154,0,0,0,674.99,6,105745.54,3,1,0,12,True
3396145,1397,4,451,4313,789035154,0,0,0,675.2,7,105070.34,24,2,0,1,True
3474659,1047,3,25,4313,789035154,0,0,0,675.04,8,104395.3,11,3,0,2,True
3586533,180,0,451,9146,789035154,0,0,0,674.94,7,103720.36,18,3,8,2,True
3784170,1254,4,30,3661,789035154,0,0,0,675.21,8,103045.15,23,0,23,2,True
4049604,180,0,30,6362,789035154,0,0,0,675.04,8,102370.11,18,4,2,2,True
4092501,879,1,10,9332,789035154,0,0,0,674.88,0,103044.99,27,0,3,4,False
4132287,292,1,-1,8325,789035154,0,1,0,674.75,4,103044.99,4,5,0,4,True
4282986,1397,4,30,1767,789035154,0,0,0,675.03,8,102369.96,24,1,4,4,True
4327889,1254,4,25,4268,789035154,0,0,0,674.7,8,101695.26,23,3,23,5,True
4437711,694,2,451,8660,789035154,0,0,0,674.95,7,101020.31,24,6,11,5,True
4538647,694,2,451,7414,789035154,0,0,0,675.21,7,100345.1,24,5,16,6,True
4655462,292,1,25,1083,789035154,0,0,0,674.87,8,99670.23,4,4,7,6,True
4938902,180,0,-1,2634,789035154,0,1,0,674.93,1,99670.23,18,6,6,6,True
5102939,1254,4,30,3661,789035154,0,0,0,674.83,8,98995.4,23,2,22,6,True
5749450,292,1,30,9372,789035154,0,0,0,675.03,8,98320.37,4,2,22,7,True
5822401,292,1,30,8660,789035154,0,0,0,674.8,8,97645.57,4,5,11,8,True
5833023,1047,3,30,3774,789035154,0,0,0,675.02,8,96970.55,11,3,13,8,True
6008891,319,0,10,3797,789035154,0,0,0,674.97,0,97645.52,11,6,21,8,True
6203578,512,0,20,4228,789035154,0,0,0,675.07,3,96970.45,12,1,2,9,True
6408736,694,2,30,6312,789035154,0,0,0,675.03,8,96295.42,24,3,8,9,True
6430581,292,1,25,3797,789035154,0,0,0,675.18,8,95620.24,4,1,13,10,True
7002867,185,1,10,4542,789035154,0,0,0,674.8,6,96295.04,18,3,20,11,True
7209057,1254,4,-1,9332,789035154,0,1,0,675.21,1,96295.04,23,1,17,12,False
7640076,1254,4,451,5134,789035154,0,0,0,674.88,7,95620.16,23,1,13,1,False
7910664,1047,3,30,5835,789035154,0,0,0,675.22,8,94944.94,11,3,17,2,True
7967311,1047,3,451,4438,789035154,0,0,0,674.81,7,94270.13,11,4,10,2,True
8139733,653,1,10,9332,789035154,0,0,0,674.92,0,94945.05,24,5,2,3,True
8379402,292,1,451,9332,789035154,0,0,0,674.91,7,94270.14,4,1,1,3,True
8418195,1146,2,20,3797,789035154,0,0,0,675.18,3,93594.96,15,0,6,4,False
9045956,1047,3,451,8660,789035154,0,0,0,675.01,7,92919.95,11,2,10,4,True
9139616,180,0,451,3774,789035154,0,0,0,674.7,7,92245.25,18,1,5,4,True
9647687,424,1,10,3661,789035154,0,0,0,675.19,6,92920.44,18,6,14,7,True
9742960,1397,4,30,5835,789035154,0,0,0,674.93,8,92245.51,24,2,5,9,True
9744243,694,2,30,1767,789035154,0,0,0,674.96,8,91570.55,24,5,6,9,True
9788411,292,1,451,9372,789035154,0,0,0,675.21,7,90895.34,4,3,16,10,True
9917378,1397,4,30,7189,789035154,0,0,0,675.1,8,90220.24,24,3,21,11,True
1105568,525,0,20,8154,970437056,0,0,0,236.16,5,711330.84,18,1,12,1,True
1161156,1397,4,30,8231,970437056,0,0,0,236.03,8,711094.81,24,2,3,1,True
1242168,197,4,30,4352,970437056,0,0,0,236.15,8,710858.66,18,5,9,1,True
1265702,520,4,-1,9240,970437056,0,1,0,236.28,1,710858.66,18,1,5,1,True
1344995,1382,0,10,1725,970437056,0,0,0,235.85,6,711094.51,16,5,9,2,True
1390882,520,4,30,9240,970437056,0,0,0,236.04,8,710858.47,18,5,7,3,True
1723285,774,2,20,3991,970437056,0,0,0,236.01,3,710622.46,14,1,12,3,True
1779415,360,0,20,6267,970437056,0,0,0,236.08,3,710386.38,24,5,15,4,True
1866922,1425,0,20,6850,970437056,0,0,0,235.85,5,710150.53,24,3,0,4,True
1940503,520,4,451,5505,970437056,0,0,0,235.8,7,709914.73,18,5,4,4,True
2273198,1397,4,30,9240,970437056,0,0,0,236.02,8,709678.71,24,2,4,5,True
2399274,1282,2,25,3694,970437056,0,0,0,236.14,8,709442.57,24,2,1,6,True
2552062,1397,4,451,3694,970437056,0,0,0,235.72,7,709206.85,24,1,1,7,True
2895156,810,4,451,8154,970437056,0,0,0,236.18,7,708970.67,18,0,15,8,True
2943905,520,4,25,8154,970437056,0,0,0,235.92,8,708734.75,18,5,16,8,True
3400790,1397,4,451,2185,970437056,0,0,0,235.98,7,708498.77,24,5,18,9,True
3418604,1397,4,25,5732,970437056,0,0,0,235.65,8,708263.12,24,5,21,10,True
3764878,197,4,30,8154,970437056,0,0,0,236.01,8,708027.11,18,0,21,10,True
3886861,1397,4,-1,3694,970437056,0,1,0,235.84,1,708027.11,24,5,13,12,True
3923679,715,0,20,6292,970437056,0,0,0,236.11,5,707791.0,18,0,14,12,True
4037724,1262,0,10,5505,970437056,0,0,0,236.08,6,708027.08,23,2,8,12,True
4125943,810,4,25,3694,970437056,0,0,0,235.96,8,707791.12,18,3,22,1,True
4361702,197,4,25,1737,970437056,0,0,0,235.88,8,707555.24,18,2,22,1,True
4393009,520,4,25,3694,970437056,0,0,0,236.01,8,707319.23,18,3,2,2,True
4407514,197,4,30,5732,970437056,0,0,0,236.04,8,707083.19,18,2,7,4,True
4555344,688,0,10,9240,970437056,0,0,0,236.08,6,707319.27,24,5,2,4,True
4653672,557,1,10,8154,970437056,0,0,0,236.18,6,707555.45,17,0,22,4,True
4709209,1282,2,-1,1725,970437056,0,1,0,235.91,4,707555.45,24,2,1,6,True
4729798,1282,2,451,6025,970437056,0,0,0,235.82,7,707319.63,24,0,17,8,True
4804462,197,4,451,6267,970437056,0,0,0,236.01,7,707083.62,18,0,17,8,True
4890330,662,1,-1,3991,970437056,0,1,0,235.98,4,707083.62,18,6,23,9,True
4985473,1282,2,-1,5066,970437056,0,2,0,236.01,4,707083.62,24,6,17,9,True
5314818,1397,4,25,5066,970437056,0,0,0,235.95,8,706847.67,24,1,18,9,True
5335826,810,4,25,1725,970437056,0,0,0,235.88,8,706611.79,18,2,11,9,True
5353573,662,1,25,6292,970437056,0,0,0,236.17,8,706375.62,18,4,12,9,True
5685660,197,4,30,5505,970437056,0,0,0,235.91,8,706139.71,18,0,16,10,True
5783579,349,2,20,1737,970437056,0,0,0,236.16,3,705903.55,24,0,19,10,True
5822033,1397,4,25,3130,970437056,0,0,0,235.94,8,705667.61,24,3,13,11,True
5893471,810,4,-1,6267,970437056,0,1,0,235.92,4,705667.61,18,0,23,11,True
6121583,520,4,-1,3130,970437056,0,2,0,236.08,4,705667.61,18,5,8,12,False
6138768,197,4,25,3991,970437056,0,0,0,236.14,8,705431.47,18,4,9,12,False
7001500,197,4,-1,8154,970437056,0,1,0,235.92,4,705431.47,18,5,20,12,True
7022202,810,4,451,8778,970437056,0,0,0,235.82,7,705195.65,18,5,14,12,True
7477172,260,0,20,5732,970437056,0,0,0,235.94,5,704959.71,6,4,5,12,True
7649396,644,0,20,1737,970437056,0,0,0,236.07,5,704723.64,24,1,6,1,True
7662835,149,2,20,4685,970437056,0,0,0,235.89,3,704487.75,18,5,13,3,True
7905764,1397,4,451,2185,970437056,0,0,0,235.73,7,704252.02,24,2,15,3,True
7927703,197,4,-1,4196,970437056,0,1,0,235.75,1,704252.02,18,0,0,5,True
7998459,998,0,10,2185,970437056,0,0,0,236.18,0,704488.2,26,6,13,6,False
8063128,520,4,30,8154,970437056,0,0,0,235.95,8,704252.25,18,1,2,7,True
8747995,1397,4,30,4685,970437056,0,0,0,236.13,8,704016.12,24,2,17,7,True
8780346,577,0,20,3130,970437056,0,0,0,236.37,3,703779.75,11,1,15,7,False
9117631,662,1,451,6850,970437056,0,0,0,236.05,7,703543.7,18,3,21,8,True
9174377,810,4,30,8778,970437056,0,0,0,235.94,8,703307.76,18,6,14,9,True
9270639,1304,0,20,5505,970437056,0,0,0,235.71,5,703072.05,5,5,7,10,True
9465544,1397,4,451,8154,970437056,0,0,0,235.96,7,702836.09,24,3,6,10,True
9544373,304,0,20,6025,970437056,0,0,0,235.96,3,702600.13,4,6,3,11,True
9768509,1282,2,25,3991,970437056,0,0,0,236.1,8,702364.03,24,2,11,11,True
9933785,197,4,451,5505,970437056,0,0,0,236.07,7,702127.96,18,3,18,11,True
1002941,151,4,25,6023,178679032,1,0,0,628.89,8,484407.11,18,1,12,1,True
1143510,159,2,451,1397,178679032,1,0,0,628.88,7,483778.23,24,4,8,1,True
1838679,159,2,25,7944,178679032,1,0,0,628.88,8,483149.35,24,2,6,1,True
1873587,287,0,10,1659,178679032,1,0,0,629.09,0,483778.44,24,5,13,1,True
2018967,231,4,451,1145,178679032,1,0,0,628.59,7,483149.85,26,2,8,7,True
2046633,1470,4,25,7944,178679032,1,0,0,629.31,8,482520.54,11,5,0,8,True
2063212,159,2,25,2213,178679032,1,0,0,629.11,8,481891.43,24,1,14,8,True
2066374,341,0,20,5632,178679032,1,0,0,629.24,3,481262.19,24,6,5,8,True
2279811,1476,0,10,4146,178679032,1,0,0,629.0,6,481891.19,24,4,5,8,True
2370740,1470,4,451,4974,178679032,1,0,0,628.9,7,481262.29,11,4,20,9,True
2406504,81,0,20,1599,178679032,1,0,0,629.22,5,480633.07,1,5,12,10,True
2449758,589,1,451,1397,178679032,1,0,0,628.84,7,480004.23,24,2,20,10,True
2468119,630,0,10,4791,178679032,1,0,0,629.22,6,480633.45,11,3,6,10,True
2528422,220,0,20,7934,178679032,1,0,0,628.93,5,480004.52,26,2,12,11,True
2664586,1470,4,451,9922,178679032,1,0,0,628.97,7,479375.55,11,6,10,12,True
3308079,1041,0,10,5550,178679032,1,0,0,628.98,6,480004.53,11,0,12,12,True
3339597,589,1,30,1397,178679032,1,0,0,629.13,8,479375.4,24,2,0,1,True
3724891,715,0,10,4791,178679032,1,0,0,629.02,6,480004.42,18,3,11,1,True
3771482,589,1,-1,6527,178679032,1,1,0,629.07,1,480004.42,24,6,9,2,False
3829318,1421,0,-1,5550,178679032,1,2,0,628.9,1,480004.42,24,0,16,2,True
4122024,159,2,30,9777,178679032,1,0,0,628.94,8,479375.48,24,3,10,3,True
4364690,193,1,10,1659,178679032,1,0,0,629.17,6,480004.65,18,3,2,3,True
4602121,589,1,25,7934,178679032,1,0,0,628.96,8,479375.69,24,3,11,3,True
4616570,1468,1,10,9922,178679032,1,0,0,628.76,0,480004.45,11,0,0,4,True
4915189,1470,4,-1,2213,178679032,1,1,0,629.0,1,480004.45,11,4,7,5,True
5153033,1421,0,451,1938,178679032,1,0,0,628.99,7,479375.46,24,4,17,5,True
5280563,931,0,20,6023,178679032,1,0,0,629.25,3,478746.21,24,0,19,5,False
5309265,1090,0,20,9976,178679032,1,0,0,629.04,5,478117.17,18,3,19,6,True
5845777,734,0,10,1659,178679032,1,0,0,629.07,6,478746.24,11,1,15,7,True
5857872,1090,0,20,5550,178679032,1,0,0,629.09,3,478117.15,18,3,6,7,True
5979427,151,4,451,9922,178679032,1,0,0,628.86,7,477488.29,18,4,20,7,True
6328262,355,1,10,5100,178679032,1,0,0,629.18,6,478117.47,24,0,21,8,False
6337046,1112,1,10,7944,178679032,1,0,0,628.98,6,478746.45,0,5,3,8,True
6580117,457,0,20,5550,178679032,1,0,0,629.19,5,478117.26,13,4,17,10,True
6732131,341,0,10,9922,178679032,1,0,0,629.15,6,478746.41,24,2,8,11,True
6958111,533,2,451,6019,178679032,1,0,0,629.15,7,478117.26,18,2,12,12,True
6977449,1297,0,10,1938,178679032,1,0,0,629.02,0,478746.28,5,4,4,12,True
7059538,1470,4,451,4146,178679032,1,0,0,629.02,7,478117.26,11,6,15,1,True
7215535,1421,0,-1,4791,178679032,1,1,0,628.65,1,478117.26,24,2,7,1,False
7236898,589,1,25,1145,178679032,1,0,0,629.02,8,477488.24,24,5,11,2,True
7312128,533,2,451,9922,178679032,1,0,0,629.11,7,476859.13,18,4,6,2,True
7355801,1470,4,30,7944,178679032,1,0,0,628.92,8,476230.21,11,0,2,3,True
7650333,589,1,25,5550,178679032,1,0,0,629.07,8,475601.14,24,6,10,3,True
7835312,589,1,30,9777,178679032,1,0,0,629.08,8,474972.06,24,0,13,4,True
7903857,159,2,451,1938,178679032,1,0,0,628.84,7,474343.22,24,4,9,4,True
8359540,1470,4,30,1938,178679032,1,0,0,629.14,8,473714.08,11,4,21,4,True
8495736,159,2,-1,1145,178679032,1,1,0,629.11,4,473714.08,24,3,9,5,True
8696630,572,0,10,1599,178679032,1,0,0,628.81,0,474342.89,11,3,9,7,True
8951699,1387,1,10,4041,178679032,1,0,0,628.79,6,474971.68,24,3,1,8,True
9042034,151,4,25,1145,178679032,1,0,0,628.85,8,474342.83,18,3,17,8,True
9412801,1470,4,30,7934,178679032,1,0,0,629.19,8,473713.64,11,1,7,8,True
9435500,159,2,30,7934,178679032,1,0,0,629.02,8,473084.62,24,3,20,10,True
9469222,1421,0,-1,5632,178679032,1,1,0,629.1,4,473084.62,24,0,9,10,True
9615791,1421,0,30,5632,178679032,1,0,0,629.01,8,472455.61,24,4,7,10,True
9951576,159,2,-1,5874,178679032,1,1,0,628.93,4,472455.61,24,6,7,10,True
1508971,319,0,10,1256,983813572,1,0,0,1060.93,0,784317.93,11,4,16,1,True
1654259,1402,4,30,4718,983813572,1,0,0,1061.05,8,783256.88,24,3,13,2,True
2078717,502,0,20,4231,983813572,1,0,0,1060.82,3,782196.06,12,2,2,2,True
2154657,348,0,10,7953,983813572,1,0,0,1061.02,0,783257.08,24,0,20,3,True
2244228,1224,4,25,3458,983813572,1,0,0,1061.17,8,782195.91,24,3,8,3,True
2368509,1402,4,451,4718,983813572,1,0,0,1061.15,7,781134.76,24,5,23,4,True
2374338,348,0,10,5818,983813572,1,0,0,1061.06,6,782195.82,24,0,22,4,True
2423687,1196,4,451,8702,983813572,1,0,0,1061.2,7,781134.62,24,5,21,5,True
2449299,642,0,10,4718,983813572,1,0,0,1060.96,6,782195.58,24,0,8,5,True
2642765,168,0,25,5368,983813572,1,0,0,1061.29,8,781134.29,24,3,7,6,True
2682320,1402,4,451,3458,983813572,1,0,0,1060.87,7,780073.42,24,3,2,7,True
2779593,1402,4,451,7171,983813572,1,0,0,1060.78,7,779012.64,24,0,4,9,True
2908148,1402,4,451,3126,983813572,1,0,0,1061.12,7,777951.52,24,6,21,10,True
3062525,1224,4,451,4718,983813572,1,0,0,1060.79,7,776890.73,24,0,13,10,True
3391963,168,0,30,4231,983813572,1,0,0,1061.27,8,775829.46,24,6,4,10,True
3464412,168,0,-1,4231,983813572,1,1,0,1060.97,4,775829.46,24,3,21,11,True
3612857,1196,4,451,5525,983813572,1,0,0,1060.84,7,774768.62,24,3,23,12,True
3811000,1402,4,30,6573,983813572,1,0,0,1061.16,8,773707.46,24,4,14,1,True
3899825,1009,0,10,8292,983813572,1,0,0,1061.06,6,774768.52,26,1,8,1,True
4015698,168,0,25,2262,983813572,1,0,0,1060.96,8,773707.56,24,5,11,3,True
4610876,1196,4,30,7171,983813572,1,0,0,1060.67,8,772646.89,24,3,19,4,True
4889241,1402,4,451,4718,983813572,1,0,0,1061.08,7,771585.81,24,4,3,4,True
5318082,1224,4,25,3126,983813572,1,0,0,1060.73,8,770525.08,24,0,18,4,True
5405268,1000,0,451,2262,983813572,1,0,0,1061.49,7,769463.59,26,4,23,4,False
5493855,341,0,20,3458,983813572,1,0,0,1061.2,5,768402.39,24,3,6,4,True
5579807,1035,0,20,7171,983813572,1,0,0,1061.03,3,767341.36,11,2,8,5,True
5633214,572,0,10,1256,983813572,1,0,0,1060.98,0,768402.34,11,5,13,5,True
5682708,857,1,10,8702,983813572,1,0,0,1060.96,6,769463.3,24,4,11,6,True
6009559,791,3,30,3458,983813572,1,0,0,1060.85,8,768402.45,11,3,3,6,True
6084910,1402,4,25,4231,983813572,1,0,0,1060.87,8,767341.58,24,3,2,7,True
6235083,1134,1,10,5368,983813572,1,0,0,1061.02,6,768402.6,24,6,6,7,True
6316992,1402,4,25,3458,983813572,1,0,0,1060.97,8,767341.63,24,1,16,7,True
6490112,1196,4,451,3204,983813572,1,0,0,1061.26,7,766280.37,24,5,9,8,True
6534476,1000,0,451,3204,983813572,1,0,0,1061.07,7,765219.3,26,0,13,9,True
6596213,1000,0,451,5818,983813572,1,0,0,1061.05,7,764158.25,26,1,20,10,True
6624345,1000,0,25,8292,983813572,1,0,0,1060.92,8,763097.33,26,4,2,11,False
6981607,168,0,451,3204,983813572,1,0,0,1060.92,7,762036.41,24,4,1,12,True
7059743,1412,2,20,4718,983813572,1,0,0,1061.08,3,760975.33,24,5,23,12,False
7346099,791,3,25,7953,983813572,1,0,0,1060.77,8,759914.56,11,6,1,12,True
7449072,1196,4,451,5660,983813572,1,0,0,1061.01,7,758853.55,24,2,1,4,True
7518645,791,3,451,3458,983813572,1,0,0,1061.15,7,757792.4,11,3,15,4,True
7525050,1264,0,10,4231,983813572,1,0,0,1061.16,0,758853.56,23,6,18,6,True
7629450,1224,4,451,6573,983813572,1,0,0,1060.89,7,757792.67,24,0,7,6,True
8157835,1402,4,30,5660,983813572,1,0,0,1060.9,8,756731.77,24,1,23,6,True
8182898,168,0,30,5660,983813572,1,0,0,1061.03,8,755670.74,24,1,4,7,True
8549914,168,0,-1,7953,983813572,1,1,0,1061.12,1,755670.74,24,2,21,8,True
8780955,560,2,20,2782,983813572,1,0,0,1060.93,5,754609.81,17,4,14,8,True
8855300,791,3,30,7953,983813572,1,0,0,1061.28,8,753548.53,11,4,9,8,True
9124515,1196,4,25,5368,983813572,1,0,0,1060.91,8,752487.62,24,3,18,9,True
9411318,791,3,30,2782,983813572,1,0,0,1060.68,8,751426.94,11,0,2,9,True
9798987,485,1,10,7171,983813572,1,0,0,1060.66,0,752487.6,5,1,6,10,True
1194530,570,2,30,7505,430766543,0,0,0,756.03,8,776293.97,11,6,12,1,True
1220304,577,0,10,2927,430766543,0,0,0,755.84,6,777049.81,11,5,23,1,True
1295331,1090,0,25,7980,430766543,0,0,0,755.92,8,776293.89,18,1,3,2,True
1374237,402,3,30,5082,430766543,0,0,0,756.11,8,775537.78,10,5,19,2,True
1487131,481,3,30,7569,430766543,0,0,0,756.23,8,774781.55,5,6,13,3,True
1609783,1227,0,10,7502,430766543,0,0,0,756.39,0,775537.94,18,6,1,3,True
1679341,402,3,-1,3717,430766543,0,1,0,755.97,4,775537.94,10,2,11,5,True
1758484,402,3,30,7589,430766543,0,0,0,756.06,8,774781.88,10,0,13,5,True
1828444,1009,0,10,4157,430766543,0,0,0,756.15,6,775538.03,26,2,0,5,True
1865400,402,3,25,5827,430766543,0,0,0,756.1,8,774781.93,10,5,8,6,True
1907611,255,2,20,3470,430766543,0,0,0,755.94,5,774025.99,6,4,12,6,True
1919490,481,3,30,1213,430766543,0,0,0,756.08,8,773269.91,5,3,2,6,True
2222545,341,0,20,5545,430766543,0,0,0,755.76,3,772514.15,24,6,6,8,True
2512001,299,1,10,1574,430766543,0,0,0,756.25,0,773270.4,4,3,12,8,True
2549863,402,3,451,1213,430766543,0,0,0,755.76,7,772514.64,10,6,16,9,True
2574409,318,0,10,5228,430766543,0,0,0,755.84,6,773270.48,11,3,12,9,True
2602211,1311,2,-1,1574,430766543,0,1,0,755.9,4,773270.48,5,0,14,10,True
2830411,1461,0,20,5082,430766543,0,0,0,755.95,3,772514.53,11,1,14,11,True
2846978,862,4,451,7589,430766543,0,0,0,755.97,7,771758.56,24,6,20,11,True
3130898,1162,2,30,7505,430766543,0,0,0,756.2,8,771002.36,24,6,20,12,True
3172654,1422,1,10,7505,430766543,0,0,0,756.1,0,771758.46,24,3,10,12,True
3525862,570,2,25,5976,430766543,0,0,0,756.03,8,771002.43,11,3,12,12,True
3973853,1090,0,30,5228,430766543,0,0,0,755.97,8,770246.46,18,3,3,1,True
4001858,1162,2,451,3717,430766543,0,0,0,755.96,7,769490.5,24,3,4,1,True
4145610,1311,2,451,2927,430766543,0,0,0,755.83,7,768734.67,5,6,10,1,True
4195223,1311,2,30,3470,430766543,0,0,0,756.19,8,767978.48,5,0,19,1,True
4415646,1090,0,-1,5827,430766543,0,1,0,756.03,4,767978.48,18,6,7,1,True
5017527,312,0,451,7589,430766543,0,0,0,755.77,7,767222.71,4,1,4,3,True
5547635,568,1,10,3470,430766543,0,0,0,756.03,6,767978.74,11,0,9,3,True
5712641,1311,2,30,5976,430766543,0,0,0,755.98,8,767222.76,5,4,13,6,False
5986237,1311,2,451,6471,430766543,0,0,0,756.25,7,766466.51,5,1,21,6,True
6051961,570,2,30,3717,430766543,0,0,0,755.99,8,765710.52,11,1,2,7,True
6281588,446,1,10,7980,430766543,0,0,0,756.25,0,766466.77,13,1,6,10,True
6391703,1090,0,25,5228,430766543,0,0,0,756.05,8,765710.72,18,4,16,12,True
6677042,995,1,10,2659,430766543,0,0,0,755.86,6,766466.58,22,6,13,12,True
6878775,487,4,30,7505,430766543,0,0,0,756.03,8,765710.55,12,1,22,12,True
7181285,1090,0,451,6098,430766543,0,0,0,756.02,7,764954.53,18,5,6,12,True
7223469,1162,2,30,7589,430766543,0,0,0,755.76,8,764198.77,24,1,1,1,True
7381480,487,4,451,7589,430766543,0,0,0,755.83,7,763442.94,12,4,13,2,True
7514484,1162,2,25,5827,430766543,0,0,0,756.11,8,762686.83,24,5,8,3,True
7533906,402,3,30,7047,430766543,0,0,0,756.02,8,761930.81,10,0,15,3,True
7591200,1142,2,20,4157,430766543,0,0,0,755.96,5,761174.85,15,0,15,3,True
7708742,708,2,20,1992,430766543,0,0,0,755.99,5,760418.86,18,6,12,3,True
7781979,402,3,451,7569,430766543,0,0,0,756.05,7,759662.81,10,5,15,4,True
8038532,525,0,20,6098,430766543,0,0,0,755.91,5,758906.9,18,2,4,4,True
8149193,570,2,25,5545,430766543,0,0,0,755.93,8,758150.97,11,6,17,5,True
8205631,487,4,25,2659,430766543,0,0,0,756.13,8,757394.84,12,4,4,5,True
8525838,487,4,25,3861,430766543,0,0,0,756.27,8,756638.57,12,1,21,7,True
8625014,570,2,-1,5228,430766543,0,1,0,756.03,4,756638.57,11,2,22,7,True
8639807,402,3,451,5827,430766543,0,0,0,756.14,7,755882.43,10,6,0,9,True
8725950,564,0,10,7047,430766543,0,0,0,755.86,0,756638.29,17,0,12,9,True
9152092,1090,0,30,6471,430766543,0,0,0,755.72,8,755882.57,18,5,2,10,True
9607601,1311,2,451,2927,430766543,0,0,0,755.97,7,755126.6,5,4,2,10,True
9794470,459,1,10,5228,430766543,0,0,0,755.85,0,755882.45,13,1,7,10,True
9794895,487,4,451,7047,430766543,0,0,0,755.9,7,755126.55,12,4,0,11,True
9816872,402,3,451,1992,430766543,0,0,0,755.98,7,754370.57,10,3,9,11,True
1127232,97,0,-1,6581,901505935,0,1,0,596.03,4,432321.0,3,1,6,2,True
1201415,135,2,30,1096,901505935,0,0,0,595.94,8,431725.06,18,1,5,3,True
1324132,97,0,-1,8619,901505935,0,1,0,595.78,4,431725.06,3,2,2,3,True
1782663,303,0,10,8278,901505935,0,0,0,596.05,0,432321.11,4,4,3,3,True
1982878,1383,4,25,5122,901505935,0,0,0,596.19,8,431724.92,16,2,21,4,True
2183977,1284,2,451,7957,901505935,0,0,0,595.88,7,431129.04,24,0,3,4,True
2951464,1303,0,10,6696,901505935,0,0,0,595.89,6,431724.93,5,1,0,4,True
3092335,1418,3,451,4714,901505935,0,0,0,596.03,7,431128.9,24,6,18,5,True
3154563,97,0,30,4927,901505935,0,0,0,596.08,8,430532.82,3,6,21,6,True
3226422,1284,2,25,7957,901505935,0,0,0,596.07,8,429936.75,24,3,14,6,True
3443449,1113,1,25,6116,901505935,0,0,0,596.08,8,429340.67,0,2,8,6,True
3832431,135,2,30,9408,901505935,0,0,0,596.1,8,428744.57,18,4,20,7,True
4119736,1035,0,10,6581,901505935,0,0,0,596.27,0,429340.84,11,3,3,7,True
4201652,97,0,25,3549,901505935,0,0,0,595.81,8,428745.03,3,3,22,8,True
4278146,739,1,10,8619,901505935,0,0,0,595.84,6,429340.87,24,4,13,8,True
4424413,1316,3,-1,1096,901505935,0,1,0,596.05,4,429340.87,5,2,3,8,True
4548873,1418,3,451,3549,901505935,0,0,0,595.95,7,428744.92,24,6,21,8,True
4750546,1306,4,25,4927,901505935,0,0,0,595.98,8,428148.94,5,6,11,9,True
4899121,1086,0,10,2447,901505935,0,0,0,596.04,6,428744.98,18,1,3,9,True
5046630,1383,4,-1,8619,901505935,0,1,0,596.1,4,428744.98,16,2,0,11,True
5135200,309,0,20,4400,901505935,0,0,0,596.01,3,428148.97,4,6,7,11,True
5418535,1284,2,451,6696,901505935,0,0,0,595.86,7,427553.11,24,6,3,12,True
5441627,1316,3,30,5122,901505935,0,0,0,596.04,8,426957.07,5,6,12,12,True
5612334,97,0,25,1096,901505935,0,0,0,595.97,8,426361.1,3,5,0,12,True
5614207,1383,4,30,4927,901505935,0,0,0,596.01,8,425765.09,16,2,8,3,True
5617185,1336,2,20,9008,901505935,0,0,0,596.15,5,425168.94,18,4,13,3,True
5643647,135,2,-1,5122,901505935,0,1,0,596.02,4,425168.94,18,4,0,7,True
5731263,1306,4,30,2490,901505935,0,0,0,596.09,8,424572.85,5,1,9,7,True
5913301,865,0,10,6116,901505935,0,0,0,596.12,0,425168.97,24,2,9,7,True
5968564,1383,4,25,1656,901505935,0,0,0,595.85,8,424573.12,16,4,14,9,True
6327335,97,0,451,4400,901505935,0,0,0,595.86,7,423977.26,3,6,0,10,True
6659949,97,0,30,9914,901505935,0,0,0,596.05,8,423381.21,3,2,12,11,True
6669047,1435,2,20,9008,901505935,0,0,0,595.95,5,422785.26,24,3,14,11,True
6804471,362,0,10,4400,901505935,0,0,0,596.0,6,423381.26,24,4,16,11,True
6818779,1383,4,-1,8278,901505935,0,1,0,596.2,4,423381.26,16,1,2,12,True
6942431,1485,0,10,4930,901505935,0,0,0,595.96,6,423977.22,24,5,23,1,True
7195253,97,0,25,8619,901505935,0,0,0,596.16,8,423381.06,3,0,10,1,True
7380757,1069,1,10,4400,901505935,0,0,0,596.04,0,423977.1,18,4,5,1,False
7473696,97,0,451,1096,901505935,0,0,0,595.93,7,423381.17,3,0,4,1,True
7523782,1418,3,25,2447,901505935,0,0,0,596.27,8,422784.9,24,6,11,2,True
7561876,893,4,-1,8619,901505935,0,1,0,595.88,4,422784.9,24,3,4,3,True
7568211,1113,1,25,1096,901505935,0,0,0,595.97,8,422188.93,0,6,21,3,True
7776696,97,0,25,4930,901505935,0,0,0,596.14,8,421592.79,3,0,16,4,True
8176009,1306,4,451,6696,901505935,0,0,0,596.19,7,420996.6,5,5,23,5,True
8195628,1383,4,451,5122,901505935,0,0,0,595.97,7,420400.63,16,0,21,5,True
8502618,1288,0,20,6696,901505935,0,0,0,595.81,5,419804.82,24,6,15,5,True
8528638,1284,2,-1,6116,901505935,0,1,0,595.99,1,419804.82,24,1,6,6,True
8549326,1418,3,-1,1096,901505935,0,2,0,596.22,4,419804.82,24,1,9,6,True
8870257,97,0,25,1096,901505935,0,0,0,595.92,8,419208.9,3,2,20,7,True
8888849,97,0,25,5125,901505935,0,0,0,595.84,8,418613.06,3,6,11,8,True
8900614,135,2,451,6581,901505935,0,0,0,595.88,7,418017.18,18,4,23,8,True
9041292,1284,2,30,8619,901505935,0,0,0,595.8,8,417421.38,24,0,1,9,False
9142444,1284,2,451,9408,901505935,0,0,0,595.91,7,416825.47,24,2,14,9,True
9793582,1065,0,10,1096,901505935,0,0,0,596.04,6,417421.51,11,5,3,10,True
1197073,1167,4,451,3484,101814879,0,0,0,385.13,7,104899.87,24,5,12,2,True
1457322,218,0,-1,2607,101814879,0,1,0,384.98,1,104899.87,9,1,1,3,True
1564640,193,1,10,1291,101814879,0,0,0,384.89,6,105284.76,18,4,19,4,True
1566445,1117,4,451,4908,101814879,0,0,0,384.94,7,104899.82,24,0,3,4,True
1666248,572,0,20,2607,101814879,0,0,0,384.85,3,104514.97,11,2,16,4,False
1831046,1167,4,30,2250,101814879,0,0,0,384.92,8,104130.05,24,3,14,4,False
1863817,218,0,25,2607,101814879,0,0,0,385.07,8,103744.98,9,5,5,6,True
1895474,560,2,451,2250,101814879,0,0,0,385.02,7,103359.96,17,0,20,6,True
1977074,1352,1,-1,6248,101814879,0,1,0,385.04,4,103359.96,24,0,17,7,False
2001925,1117,4,451,6248,101814879,0,0,0,385.02,7,102974.94,24,2,5,8,True
2043550,1167,4,451,2607,101814879,0,0,0,384.92,7,102590.02,24,6,21,8,True
2283104,218,0,-1,4933,101814879,0,1,0,384.93,4,102590.02,9,0,6,9,True
2386491,1167,4,25,3837,101814879,0,0,0,384.73,8,102205.29,24,1,1,10,True
2591571,1167,4,451,6318,101814879,0,0,0,384.98,7,101820.31,24,2,8,10,True
2658359,599,0,20,8642,101814879,0,0,0,385.01,3,101435.3,24,1,8,11,True
2686164,560,2,30,4908,101814879,0,0,0,384.89,8,101050.41,17,6,10,11,True
2792848,1352,1,25,8274,101814879,0,0,0,385.1,8,100665.31,24,1,9,12,True
2802764,1117,4,30,2732,101814879,0,0,0,384.83,8,100280.48,24,0,12,12,True
2812637,503,0,20,6318,101814879,0,0,0,385.08,5,99895.4,12,0,23,12,True
2833741,1117,4,-1,6318,101814879,0,1,0,385.06,4,99895.4,24,4,8,12,True
2885697,1455,2,30,2607,101814879,0,0,0,385.29,8,99510.11,11,3,2,2,True
2901634,1455,2,30,3837,101814879,0,0,0,385.05,8,99125.06,11,0,14,2,True
3022920,1117,4,-1,3837,101814879,0,1,0,384.89,1,99125.06,24,3,18,4,True
3023911,1421,0,20,4155,101814879,0,0,0,385.04,5,98740.02,24,5,5,4,True
3040751,1167,4,451,3577,101814879,0,0,0,384.77,7,98355.25,24,6,14,4,True
3077503,1167,4,30,2250,101814879,0,0,0,384.89,8,97970.36,24,0,7,5,True
3406786,867,0,20,2732,101814879,0,0,0,384.67,5,97585.69,24,6,1,5,True
3715996,1455,2,30,8642,101814879,0,0,0,384.75,8,97200.94,11,0,3,5,True
3777259,1352,1,451,6248,101814879,0,0,0,384.78,7,96816.16,24,3,7,6,True
3907711,1124,0,20,8642,101814879,0,0,0,385.08,3,96431.08,24,0,8,6,True
4126626,1455,2,-1,6248,101814879,0,1,0,385.17,1,96431.08,11,2,9,6,True
4587202,1117,4,-1,6248,101814879,0,2,0,385.07,4,96431.08,24,0,18,8,True
4958589,1455,2,451,3577,101814879,0,0,0,385.02,7,96046.06,11,3,0,8,True
4967877,1023,2,20,2732,101814879,0,0,0,384.89,5,95661.17,11,3,14,9,True
5226258,1455,2,-1,1291,101814879,0,1,0,385.23,4,95661.17,11,6,18,9,True
5360730,342,0,10,4933,101814879,0,0,0,385.15,0,96046.32,24,5,11,9,True
5390379,550,0,10,7285,101814879,0,0,0,384.85,0,96431.17,17,4,0,10,True
5521618,1352,1,451,4933,101814879,0,0,0,385.11,7,96046.06,24,2,6,10,True
5628642,218,0,30,2250,101814879,0,0,0,385.08,8,95660.98,9,5,21,12,True
5815736,560,2,30,3837,101814879,0,0,0,384.83,8,95276.15,17,3,22,12,True
6033394,1352,1,451,2732,101814879,0,0,0,385.1,7,94891.05,24,3,17,12,True
6210761,550,0,10,7285,101814879,0,0,0,384.7,6,95275.75,17,6,8,12,True
6687275,218,0,30,6248,101814879,0,0,0,384.72,8,94891.03,9,6,2,12,True
6991640,1167,4,25,2250,101814879,0,0,0,384.62,8,94506.41,24,3,17,12,True
7186701,1189,2,20,8274,101814879,0,0,0,384.96,3,94121.45,24,3,7,1,True
7214183,1093,0,20,8642,101814879,0,0,0,384.84,3,93736.61,18,4,1,1,True
7216679,1117,4,451,3484,101814879,0,0,0,384.87,7,93351.74,24,4,14,1,True
7245640,1167,4,-1,3484,101814879,0,1,0,385.14,1,93351.74,24,6,10,3,True
7345815,653,1,10,4908,101814879,0,0,0,385.08,6,93736.82,24,5,16,4,True
7464692,1352,1,451,8274,101814879,0,0,0,385.1,7,93351.72,24,6,7,5,True
8020174,560,2,451,4155,101814879,0,0,0,384.91,7,92966.81,17,2,10,5,True
8317383,1117,4,-1,6318,101814879,0,1,0,385.03,4,92966.81,24,5,20,6,True
8382728,560,2,30,4933,101814879,0,0,0,384.7,8,92582.11,17,0,20,6,True
8408053,1238,0,20,6318,101814879,0,0,0,384.93,5,92197.18,18,5,19,9,True
8895309,605,0,10,8274,101814879,0,0,0,385.11,6,92582.29,24,6,15,9,True
9248725,1010,0,10,8642,101814879,0,0,0,384.82,6,92967.11,26,4,9,9,True
9407934,1014,1,10,3837,101814879,0,0,0,385.06,6,93352.17,26,2,14,11,True
9993957,1455,2,451,4933,101814879,0,0,0,385.0,7,92967.17,11,4,17,11,True
1038361,1463,2,30,2390,963281221,1,0,0,839.9,8,254151.1,11,4,4,1,True
1200435,1463,2,451,4756,963281221,1,0,0,840.15,7,253310.95,11,3,3,2,True
1330451,726,0,10,7239,963281221,1,0,0,840.0,0,254150.95,11,2,2,2,True
1495314,1141,4,30,4662,963281221,1,0,0,839.93,8,253311.02,15,4,22,2,False
1562051,348,0,10,7239,963281221,1,0,0,840.04,6,254151.06,24,2,21,4,True
1582087,574,2,25,2865,963281221,1,0,0,839.89,8,253311.17,11,2,21,4,True
2064818,1407,4,451,6233,963281221,1,0,0,839.69,7,252471.48,24,0,6,5,True
2101480,1321,0,30,4756,963281221,1,0,0,839.77,8,251631.71,18,6,8,5,True
2278023,1407,4,25,9755,963281221,1,0,0,839.99,8,250791.72,24,0,8,5,True
2616852,1321,0,451,8069,963281221,1,0,0,839.85,7,249951.87,18,4,12,6,True
2661234,1260,0,20,6567,963281221,1,0,0,840.23,5,249111.64,23,3,15,7,True
2664085,1463,2,-1,4662,963281221,1,1,0,840.12,4,249111.64,11,3,6,7,True
2863683,1217,0,10,1924,963281221,1,0,0,840.16,6,249951.8,24,5,11,9,True
3008656,726,0,20,1924,963281221,1,0,0,839.95,5,249111.85,11,2,15,10,True
3428380,733,3,451,6233,963281221,1,0,0,839.87,7,248271.98,11,4,1,10,True
3483695,1463,2,451,4784,963281221,1,0,0,839.98,7,247432.0,11,1,13,10,True
3526328,1407,4,451,4660,963281221,1,0,0,840.01,7,246591.99,24,2,13,10,True
3690292,733,3,451,4869,963281221,1,0,0,840.02,7,245751.97,11,1,12,11,True
3734102,1075,0,25,5038,963281221,1,0,0,840.08,8,244911.89,18,1,23,12,True
3850373,234,0,20,7245,963281221,1,0,0,840.13,5,244071.76,26,3,19,12,True
3887795,574,2,25,4784,963281221,1,0,0,840.0,8,243231.76,11,6,14,1,True
3897373,393,1,10,6857,963281221,1,0,0,839.96,0,244071.72,10,2,8,2,True
4173632,733,3,30,7496,963281221,1,0,0,839.98,8,243231.74,11,2,14,2,True
4186765,1390,0,20,9796,963281221,1,0,0,840.01,3,242391.73,24,6,7,3,True
4471615,1305,2,20,1128,963281221,1,0,0,839.89,5,241551.84,5,6,0,4,True
4563715,605,0,20,1128,963281221,1,0,0,840.02,5,240711.82,24,0,19,4,True
4711012,1407,4,-1,6567,963281221,1,1,0,840.05,4,240711.82,24,5,23,4,True
4760038,1141,4,25,1924,963281221,1,0,0,840.1,8,239871.72,15,5,14,5,True
4805329,1463,2,-1,5075,963281221,1,1,0,839.98,4,239871.72,11,0,22,5,True
5018803,733,3,25,6233,963281221,1,0,0,839.83,8,239031.89,11,6,6,5,True
5154148,1063,0,10,4784,963281221,1,0,0,840.04,0,239871.93,11,5,15,6,True
5310909,1450,4,25,5038,963281221,1,0,0,840.13,8,239031.8,11,5,0,8,True
5353786,1086,0,20,9755,963281221,1,0,0,840.25,5,238191.55,18,4,19,8,True
5434945,1463,2,25,5038,963281221,1,0,0,839.8,8,237351.75,11,4,8,9,True
6009565,889,0,20,5038,963281221,1,0,0,840.1,5,236511.65,27,4,7,9,True
6348257,193,1,10,6233,963281221,1,0,0,840.28,6,237351.93,18,5,4,10,True
6434659,1321,0,451,3757,963281221,1,0,0,840.03,7,236511.9,18,2,16,10,True
6673968,444,2,20,2390,963281221,1,0,0,840.08,3,235671.82,24,4,20,12,True
7158048,745,4,451,6857,963281221,1,0,0,839.99,7,234831.83,24,4,7,12,False
7283811,1463,2,30,4784,963281221,1,0,0,840.05,8,233991.78,11,0,4,1,True
7306855,807,0,20,5913,963281221,1,0,0,839.98,3,233151.8,11,5,14,1,True
7990199,1407,4,451,8069,963281221,1,0,0,839.97,7,232311.83,24,5,10,2,True
8148495,1407,4,25,2390,963281221,1,0,0,839.81,8,231472.02,24,4,17,3,True
8343715,1463,2,451,8069,963281221,1,0,0,840.06,7,230631.96,11,5,6,4,True
8352881,745,4,25,4662,963281221,1,0,0,840.0,8,229791.96,24,2,6,5,True
8504215,1075,0,-1,9755,963281221,1,1,0,840.22,4,229791.96,18,1,21,6,True
8696013,745,4,-1,7239,963281221,1,2,0,840.05,4,229791.96,24,2,18,7,True
8874549,726,0,10,4662,963281221,1,0,0,840.17,0,230632.13,11,0,19,7,True
9266562,733,3,25,8069,963281221,1,0,0,839.83,8,229792.3,11,4,23,8,True
9756600,1141,4,30,6567,963281221,1,0,0,840.12,8,228952.18,15,4,6,8,False
9776320,733,3,451,8510,963281221,1,0,0,839.98,7,228112.2,11,4,15,9,False
9777464,1463,2,451,7239,963281221,1,0,0,840.13,7,227272.07,11,0,23,9,True
9787042,1141,4,451,4660,963281221,1,0,0,840.01,7,226432.06,15,1,7,10,True
9809154,1141,4,30,5075,963281221,1,0,0,839.86,8,225592.2,15,1,2,11,True
1087945,266,2,451,6751,807400201,1,0,0,557.75,7,900824.25,6,5,14,1,True
1469431,266,2,25,5842,807400201,1,0,0,558.06,8,900266.19,6,5,16,1,False
2245295,360,0,-1,2936,807400201,1,1,0,558.01,4,900266.19,24,1,10,1,True
2296169,327,0,25,5783,807400201,1,0,0,557.92,8,899708.27,11,0,15,1,True
2419080,1473,4,-1,8290,807400201,1,1,0,557.98,1,899708.27,24,2,12,1,True
2640508,1102,2,451,7638,807400201,1,0,0,557.95,7,899150.32,0,3,10,1,False
2682321,327,0,451,7638,807400201,1,0,0,558.23,7,898592.09,11,2,4,2,True
2849267,135,2,451,7638,807400201,1,0,0,558.0,7,898034.09,18,6,23,2,True
2892093,497,0,10,8632,807400201,1,0,0,557.95,6,898592.04,12,0,11,2,True
3025281,360,0,30,5783,807400201,1,0,0,558.15,8,898033.89,24,5,8,3,True
3242350,360,0,451,5783,807400201,1,0,0,557.92,7,897475.97,24,2,20,4,True
3390490,1119,0,10,8632,807400201,1,0,0,558.23,6,898034.2,24,2,13,4,True
3455811,1111,0,25,2679,807400201,1,0,0,558.01,8,897476.19,0,1,12,5,True
3777550,269,0,20,6751,807400201,1,0,0,557.82,5,896918.37,24,3,10,5,True
3835272,918,2,20,2679,807400201,1,0,0,557.86,5,896360.51,18,1,23,6,True
4172433,360,0,451,4487,807400201,1,0,0,558.03,7,895802.48,24,6,20,7,True
4570849,1102,2,451,1261,807400201,1,0,0,557.83,7,895244.65,0,5,21,8,True
4610698,865,0,10,8290,807400201,1,0,0,557.65,6,895802.3,24,0,15,9,True
4901505,360,0,451,6751,807400201,1,0,0,557.92,7,895244.38,24,1,2,9,False
4919828,783,0,10,7638,807400201,1,0,0,558.03,6,895802.41,14,0,11,10,True
4956224,1102,2,-1,7638,807400201,1,1,0,557.99,4,895802.41,0,3,9,11,True
5304541,1473,4,25,4487,807400201,1,0,0,558.0,8,895244.41,24,4,16,12,True
5395156,1102,2,-1,1261,807400201,1,1,0,557.89,1,895244.41,0,6,3,12,True
5454998,360,0,451,6197,807400201,1,0,0,557.88,7,894686.53,24,6,14,12,True
5555600,360,0,30,6197,807400201,1,0,0,558.02,8,894128.51,24,2,13,12,True
5607840,1102,2,30,6197,807400201,1,0,0,557.85,8,893570.66,0,0,23,2,True
5640724,360,0,451,5842,807400201,1,0,0,558.12,7,893012.54,24,5,16,3,True
6390540,360,0,30,8657,807400201,1,0,0,557.76,8,892454.78,24,2,23,3,True
6472280,1422,1,10,8657,807400201,1,0,0,557.66,6,893012.44,24,5,4,4,True
6485388,266,2,30,2396,807400201,1,0,0,557.97,8,892454.47,6,5,15,4,True
6688539,135,2,-1,8632,807400201,1,1,0,557.97,4,892454.47,18,4,2,5,True
6816467,334,0,10,6751,807400201,1,0,0,558.11,0,893012.58,11,5,1,5,True
7149584,360,0,30,7638,807400201,1,0,0,558.11,8,892454.47,24,3,11,6,True
7249621,266,2,451,2396,807400201,1,0,0,558.08,7,891896.39,6,4,19,7,True
7339759,239,1,10,6197,807400201,1,0,0,558.1,6,892454.49,26,5,19,7,True
7488443,135,2,451,1261,807400201,1,0,0,558.22,7,891896.27,18,3,20,8,True
7580352,1102,2,-1,1261,807400201,1,1,0,558.29,4,891896.27,0,2,13,9,True
7937366,550,0,20,5783,807400201,1,0,0,557.97,3,891338.3,17,4,2,9,True
8081213,1111,0,451,6751,807400201,1,0,0,558.11,7,890780.19,0,5,3,11,True
8104953,135,2,25,2936,807400201,1,0,0,558.06,8,890222.13,18,4,15,1,True
8292377,108,2,20,8632,807400201,1,0,0,558.34,5,889663.79,3,1,10,1,True
8401859,205,0,20,4487,807400201,1,0,0,558.03,5,889105.76,9,2,6,2,True
8540049,135,2,451,2396,807400201,1,0,0,557.84,7,888547.92,18,3,3,2,True
8658087,235,4,25,8632,807400201,1,0,0,557.93,8,887989.99,26,5,4,3,False
8678177,1473,4,451,5682,807400201,1,0,0,558.02,7,887431.97,24,5,19,3,True
8694498,68,0,10,1261,807400201,1,0,0,558.02,6,887989.99,20,0,17,3,True
8701069,327,0,25,8657,807400201,1,0,0,558.08,8,887431.91,11,0,23,4,True
8979790,135,2,25,4487,807400201,1,0,0,557.86,8,886874.05,18,3,10,4,True
8997486,360,0,-1,6751,807400201,1,1,0,557.85,4,886874.05,24,4,8,4,True
9119724,1434,0,10,1261,807400201,1,0,0,558.13,0,887432.18,24,5,9,4,True
9127266,1473,4,451,6751,807400201,1,0,0,558.05,7,886874.13,24,1,3,6,True
9217701,512,0,10,8632,807400201,1,0,0,558.03,6,887432.16,12,2,15,8,False
9271198,360,0,451,5682,807400201,1,0,0,557.93,7,886874.23,24,4,9,8,True
9345977,327,0,451,7777,807400201,1,0,0,557.69,7,886316.54,11,4,13,9,True
9464368,327,0,451,5783,807400201,1,0,0,558.17,7,885758.37,11,4,17,10,True
9708134,267,0,10,5842,807400201,1,0,0,557.84,0,886316.21,6,0,8,10,True
9830782,360,0,-1,7777,807400201,1,1,0,558.15,1,886316.21,24,4,0,10,True
9913086,1473,4,-1,8632,807400201,1,2,0,557.84,4,886316.21,24,5,10,10,True
1019131,1035,0,20,8965,951062689,0,0,0,785.15,5,453168.85,11,0,16,1,True
1415960,865,0,10,7390,951062689,0,0,0,785.13,6,453953.98,24,2,18,1,True
2087991,208,0,20,7592,951062689,0,0,0,784.91,5,453169.07,9,4,23,3,True
2329369,1108,1,10,7558,951062689,0,0,0,785.05,0,453954.12,0,1,5,4,True
2462727,776,3,30,4827,951062689,0,0,0,785.08,8,453169.04,14,5,7,4,True
2536851,557,1,-1,5800,951062689,0,1,0,784.94,4,453169.04,17,0,4,4,True
2607987,622,4,451,2699,951062689,0,0,0,784.96,7,452384.08,11,2,22,4,True
2886635,716,0,10,2699,951062689,0,0,0,784.83,6,453168.91,18,0,17,5,True
3028685,1425,0,20,6744,951062689,0,0,0,785.12,5,452383.79,24,0,21,5,True
3197562,605,0,20,7630,951062689,0,0,0,784.85,5,451598.94,24,6,4,6,True
3223042,1311,2,451,7558,951062689,0,0,0,785.12,7,450813.82,5,0,15,6,True
3252598,309,0,30,2952,951062689,0,0,0,785.12,8,450028.7,4,4,16,7,True
3415002,557,1,25,2955,951062689,0,0,0,785.16,8,449243.54,17,6,22,7,True
3439243,309,0,451,2952,951062689,0,0,0,785.03,7,448458.51,4,3,22,7,True
3571262,182,1,10,2952,951062689,0,0,0,785.01,6,449243.52,18,4,8,8,True
3752134,776,3,25,6744,951062689,0,0,0,784.75,8,448458.77,14,4,14,9,True
4008719,129,0,20,3897,951062689,0,0,0,785.15,3,447673.62,18,1,22,9,True
4092620,1311,2,451,2699,951062689,0,0,0,784.91,7,446888.71,5,5,1,11,True
4125123,309,0,451,4346,951062689,0,0,0,785.25,7,446103.46,4,6,4,12,False
4348601,622,4,451,7630,951062689,0,0,0,785.16,7,445318.3,11,2,9,2,True
4476817,557,1,-1,4827,951062689,0,1,0,785.27,4,445318.3,17,5,19,3,True
4628411,1304,0,10,6744,951062689,0,0,0,785.06,6,446103.36,5,2,2,3,True
4632441,1311,2,451,2760,951062689,0,0,0,784.98,7,445318.38,5,5,15,3,True
4771416,557,1,451,6744,951062689,0,0,0,785.2,7,444533.18,17,1,17,5,True
4893519,1311,2,-1,8915,951062689,0,1,0,784.73,1,444533.18,5,5,14,5,True
5074422,249,0,20,7592,951062689,0,0,0,784.81,5,443748.37,6,0,1,6,True
5090735,1488,0,20,7592,951062689,0,0,0,784.98,5,442963.39,24,5,23,6,True
5234045,776,3,451,3395,951062689,0,0,0,784.82,7,442178.57,14,4,10,6,True
5263126,309,0,30,2952,951062689,0,0,0,785.04,8,441393.53,4,0,19,7,True
5313245,309,0,451,2952,951062689,0,0,0,784.76,7,440608.77,4,3,10,7,True
5659899,776,3,-1,2955,951062689,0,1,0,784.89,1,440608.77,14,4,17,8,True
5709629,1311,2,25,7592,951062689,0,0,0,784.94,8,439823.83,5,5,7,8,True
5709651,376,0,25,4346,951062689,0,0,0,784.78,8,439039.05,25,1,4,8,True
5712876,622,4,25,8080,951062689,0,0,0,784.81,8,438254.24,11,3,21,10,True
6136304,1311,2,451,3395,951062689,0,0,0,784.98,7,437469.26,5,6,5,10,True
6180682,1170,0,20,7558,951062689,0,0,0,784.96,3,436684.3,24,1,13,11,True
6220696,376,0,-1,2699,951062689,0,1,0,785.18,4,436684.3,25,4,14,12,True
6277153,557,1,25,2699,951062689,0,0,0,785.12,8,435899.18,17,5,3,12,True
6517434,557,1,25,6744,951062689,0,0,0,785.32,8,435113.86,17,2,20,12,True
6549013,309,0,451,5626,951062689,0,0,0,785.15,7,434328.71,4,5,16,1,True
6558896,1000,0,20,4532,951062689,0,0,0,784.93,5,433543.78,26,5,17,1,True
7106146,309,0,451,8344,951062689,0,0,0,784.94,7,432758.84,4,4,4,2,True
7160487,309,0,451,7390,951062689,0,0,0,784.88,7,431973.96,4,0,15,2,True
7165216,406,1,10,8915,951062689,0,0,0,784.93,6,432758.89,10,3,5,2,True
7211603,622,4,30,7630,951062689,0,0,0,785.02,8,431973.87,11,4,3,4,True
7279559,1311,2,25,7592,951062689,0,0,0,784.78,8,431189.09,5,4,22,4,True
7369002,1035,0,10,7630,951062689,0,0,0,784.94,6,431974.03,11,5,13,5,True
7591247,309,0,30,8344,951062689,0,0,0,784.87,8,431189.16,4,5,14,5,True
7980760,1139,3,-1,2302,951062689,0,1,0,785.08,4,431189.16,15,4,19,6,True
8035371,1210,0,20,3897,951062689,0,0,0,785.2,5,430403.96,24,3,18,7,True
8146524,376,0,451,7558,951062689,0,0,0,784.97,7,429618.99,25,3,5,8,True
8372102,309,0,25,2760,951062689,0,0,0,785.2,8,428833.79,4,4,17,8,True
8612120,1311,2,30,2699,951062689,0,0,0,785.18,8,428048.61,5,1,6,9,True
8814788,990,0,20,3395,951062689,0,0,0,784.91,5,427263.7,22,0,18,9,True
8868051,1139,3,25,5800,951062689,0,0,0,784.97,8,426478.73,15,0,22,9,True
9061268,376,0,451,6744,951062689,0,0,0,784.79,7,425693.94,25,4,13,9,True
9630267,652,0,10,8965,951062689,0,0,0,784.74,0,426478.68,24,3,21,10,True
9632541,776,3,451,7592,951062689,0,0,0,785.22,7,425693.46,14,5,22,11,True
9641663,309,0,451,2302,951062689,0,0,0,785.01,7,424908.45,4,6,6,11,True
1016657,199,0,10,2289,581175235,1,0,0,777.97,6,608153.97,18,0,11,3,True
1154488,597,4,25,6797,581175235,1,0,0,778.01,8,607375.96,24,6,3,4,True
1293523,579,0,20,3888,581175235,1,0,0,778.11,5,606597.85,11,5,19,4,True
1562869,1072,0,20,2289,581175235,1,0,0,778.0,5,605819.85,18,1,5,4,True
1755006,202,4,25,1083,581175235,1,0,0,777.93,8,605041.92,9,1,13,4,True
1796041,597,4,-1,9070,581175235,1,1,0,777.84,4,605041.92,24,6,1,5,True
1987572,25,3,451,9070,581175235,1,0,0,778.01,7,604263.91,11,0,14,6,True
2046226,202,4,451,9178,581175235,1,0,0,778.1,7,603485.81,9,1,12,7,True
2141192,597,4,451,8891,581175235,1,0,0,778.13,7,602707.68,24,1,11,8,False
2231858,448,0,30,7070,581175235,1,0,0,778.32,8,601929.36,13,1,8,9,True
2294986,670,0,20,8708,581175235,1,0,0,777.87,3,601151.49,18,3,8,10,True
2645212,529,2,451,1083,581175235,1,0,0,778.13,7,600373.36,18,4,18,10,True
2829571,25,3,451,7780,581175235,1,0,0,778.07,7,599595.29,11,6,18,12,True
3002815,25,3,451,3888,581175235,1,0,0,777.86,7,598817.43,11,1,2,1,True
3138861,529,2,30,2703,581175235,1,0,0,778.05,8,598039.38,18,5,17,1,True
3603628,529,2,30,1175,581175235,1,0,0,777.96,8,597261.42,18,0,14,4,True
4063716,346,0,20,8708,581175235,1,0,0,777.94,5,596483.48,24,1,17,5,True
4495462,25,3,25,1412,581175235,1,0,0,778.01,8,595705.47,11,0,1,5,True
5166933,398,0,10,4548,581175235,1,0,0,778.17,6,596483.64,10,0,2,6,True
5543935,25,3,30,5915,581175235,1,0,0,778.03,8,595705.61,11,6,13,6,True
5646519,785,0,20,9070,581175235,1,0,0,778.1,3,594927.51,14,1,16,7,True
5989949,1436,0,20,7589,581175235,1,0,0,778.07,3,594149.44,24,0,8,8,True
6095089,448,0,30,5915,581175235,1,0,0,778.04,8,593371.4,13,5,16,8,True
6241251,564,0,10,2014,581175235,1,0,0,777.8,6,594149.2,17,0,22,10,True
6375303,25,3,25,5182,581175235,1,0,0,777.93,8,593371.27,11,2,12,12,True
6652273,597,4,25,1412,581175235,1,0,0,778.0,8,592593.27,24,3,23,1,True
6858918,529,2,451,2703,581175235,1,0,0,777.84,7,591815.43,18,3,10,1,True
7242825,195,1,10,7070,581175235,1,0,0,777.86,0,592593.29,18,4,0,1,True
7336745,597,4,-1,9070,581175235,1,1,0,778.03,4,592593.29,24,6,13,2,True
7424277,597,4,451,1083,581175235,1,0,0,777.84,7,591815.45,24,4,16,3,True
7960303,448,0,30,7057,581175235,1,0,0,778.12,8,591037.33,13,0,19,3,True
8217989,597,4,25,5825,581175235,1,0,0,777.95,8,590259.38,24,2,23,4,True
8296854,448,0,-1,2703,581175235,1,1,0,778.13,1,590259.38,13,4,8,4,True
8329992,228,0,10,7780,581175235,1,0,0,777.97,6,591037.35,26,6,23,4,True
8414292,597,4,30,7780,581175235,1,0,0,777.93,8,590259.42,24,5,17,5,True
8499656,597,4,-1,7589,581175235,1,1,0,777.77,4,590259.42,24,4,10,5,True
8516076,1428,1,10,5182,581175235,1,0,0,777.73,0,591037.15,24,1,10,7,True
8549836,597,4,-1,2289,581175235,1,1,0,777.86,1,591037.15,24,3,13,7,True
8682704,448,0,-1,1412,581175235,1,2,0,778.1,4,591037.15,13,0,12,7,True
8711953,202,4,451,5182,581175235,1,0,0,778.4,7,590258.75,9,1,7,7,True
8998909,448,0,451,1175,581175235,1,0,0,777.96,7,589480.79,13,2,11,8,True
9102065,597,4,451,7057,581175235,1,0,0,778.02,7,588702.77,24,4,23,8,True
9222748,448,0,30,5915,581175235,1,0,0,778.03,8,587924.74,13,6,9,9,True
9339888,448,0,25,8702,581175235,1,0,0,777.84,8,587146.9,13,2,17,9,True
9352541,25,3,451,7057,581175235,1,0,0,777.99,7,586368.91,11,3,5,10,True
9455957,25,3,25,6797,581175235,1,0,0,778.19,8,585590.72,11,2,13,10,True
9461338,448,0,30,7070,581175235,1,0,0,777.96,8,584812.76,13,4,9,11,True
9580558,202,4,30,1083,581175235,1,0,0,778.06,8,584034.7,9,4,22,11,True
9692180,529,2,451,4952,581175235,1,0,0,777.77,7,583256.93,18,2,21,11,True
9985959,1164,0,20,6539,581175235,1,0,0,777.78,5,582479.15,24,3,8,11,True
1149750,410,4,30,2445,588156384,1,0,0,899.17,8,882353.83,18,2,21,1,False
1201213,1475,3,25,7458,588156384,1,0,0,898.95,8,881454.88,24,6,10,2,True
1349934,1110,0,10,6349,588156384,1,0,0,898.68,6,882353.56,0,3,3,2,True
1473140,1066,4,-1,1679,588156384,1,1,0,898.87,4,882353.56,11,1,12,4,True
1942820,1313,4,25,7458,588156384,1,0,0,899.09,8,881454.47,5,2,9,5,True
2147747,1475,3,-1,4985,588156384,1,1,0,898.92,1,881454.47,24,4,12,6,True
2582471,1066,4,-1,7819,588156384,1,2,0,899.08,4,881454.47,11,4,5,6,True
2670038,916,0,20,7458,588156384,1,0,0,899.08,3,880555.39,18,6,21,6,True
2909195,1044,0,10,5140,588156384,1,0,0,899.05,6,881454.44,11,4,2,7,True
3466031,342,0,20,8000,588156384,1,0,0,899.23,3,880555.21,24,4,20,7,True
3640620,343,1,25,1187,588156384,1,0,0,898.96,8,879656.25,24,5,18,7,True
4304257,1066,4,451,8721,588156384,1,0,0,899.07,7,878757.18,11,2,4,8,True
4459488,343,1,30,4565,588156384,1,0,0,898.96,8,877858.22,24,1,0,8,True
4730685,1066,4,30,5126,588156384,1,0,0,898.67,8,876959.55,11,0,16,9,True
5022140,28,1,10,8721,588156384,1,0,0,898.79,0,877858.34,11,2,14,9,True
5149008,343,1,30,6289,588156384,1,0,0,899.06,8,876959.28,24,6,0,10,True
5199781,1066,4,451,8421,588156384,1,0,0,899.04,7,876060.24,11,4,1,11,True
5385491,343,1,30,5881,588156384,1,0,0,899.05,8,875161.19,24,0,0,11,True
5428619,1066,4,25,2445,588156384,1,0,0,898.84,8,874262.35,11,1,12,11,True
6006612,848,2,20,7458,588156384,1,0,0,899.23,5,873363.12,5,2,17,12,True
6300499,580,0,20,8000,588156384,1,0,0,898.81,5,872464.31,11,3,11,1,True
6412974,278,1,25,8000,588156384,1,0,0,899.05,8,871565.26,24,1,3,2,True
6565498,1313,4,30,1217,588156384,1,0,0,898.99,8,870666.27,5,0,8,2,True
6613716,1276,4,-1,7169,588156384,1,1,0,898.85,4,870666.27,24,2,12,3,True
6995911,1336,2,20,5126,588156384,1,0,0,898.94,5,869767.33,18,3,0,4,True
7001595,1475,3,25,8000,588156384,1,0,0,899.07,8,868868.26,24,1,19,5,True
7098487,1338,0,10,1051,588156384,1,0,0,899.21,6,869767.47,18,0,17,5,True
7126624,286,1,10,1217,588156384,1,0,0,898.9,6,870666.37,24,2,1,5,True
7224192,929,0,10,5126,588156384,1,0,0,898.96,6,871565.33,18,3,14,6,True
7244049,1066,4,451,5140,588156384,1,0,0,899.17,7,870666.16,11,5,7,9,True
7332515,343,1,30,1187,588156384,1,0,0,898.9,8,869767.26,24,5,13,9,True
7449038,1066,4,451,4985,588156384,1,0,0,899.02,7,868868.24,11,1,8,11,True
7458742,1276,4,451,6349,588156384,1,0,0,899.22,7,867969.02,24,4,7,11,True
7538964,1314,2,20,1217,588156384,1,0,0,899.12,3,867069.9,5,6,7,1,True
7543777,278,1,25,5881,588156384,1,0,0,899.2,8,866170.7,24,0,4,1,True
7603561,1411,0,10,8201,588156384,1,0,0,899.08,0,867069.78,24,6,0,2,False
7624505,1124,0,20,1051,588156384,1,0,0,899.02,3,866170.76,24,6,14,4,True
7659250,1475,3,451,8421,588156384,1,0,0,899.06,7,865271.7,24,6,14,4,True
7705971,58,2,20,7819,588156384,1,0,0,899.18,5,864372.52,20,3,4,4,True
7712069,278,1,451,4359,588156384,1,0,0,898.88,7,863473.64,24,0,20,5,True
8762227,278,1,-1,8330,588156384,1,1,0,899.19,4,863473.64,24,2,13,5,False
8764576,1313,4,-1,7169,588156384,1,2,0,898.7,1,863473.64,5,2,17,5,True
8815226,1448,4,451,8721,588156384,1,0,0,899.16,7,862574.48,11,4,0,5,True
8862976,1276,4,451,4985,588156384,1,0,0,898.92,7,861675.56,24,4,15,7,True
8911905,498,0,20,7819,588156384,1,0,0,898.8,3,860776.76,12,1,12,8,True
8934813,1475,3,25,1217,588156384,1,0,0,898.85,8,859877.91,24,4,12,8,True
9081496,1475,3,-1,9805,588156384,1,1,0,898.95,1,859877.91,24,0,23,8,True
9431926,603,0,20,8421,588156384,1,0,0,899.13,5,858978.78,24,0,8,9,True
9445432,410,4,451,1679,588156384,1,0,0,899.15,7,858079.63,18,0,7,9,True
9562473,1066,4,451,4565,588156384,1,0,0,898.79,7,857180.84,11,2,7,10,True
9573960,410,4,451,4565,588156384,1,0,0,898.99,7,856281.85,18,0,23,10,True
9763564,410,4,451,6349,588156384,1,0,0,898.87,7,855382.98,18,0,5,11,True
9880134,1066,4,451,1217,588156384,1,0,0,898.79,7,854484.19,11,3,2,11,False
1091206,1350,4,-1,8478,521229176,0,1,0,239.96,4,575858.0,24,0,2,1,True
1453780,81,0,20,8478,521229176,0,0,0,240.29,3,575617.71,1,0,4,1,True
1475138,1120,4,-1,3978,521229176,0,1,0,240.06,4,575617.71,24,6,17,2,False
1629802,172,4,451,7014,521229176,0,0,0,240.05,7,575377.66,24,2,8,3,True
1747748,29,0,10,7014,521229176,0,0,0,239.79,6,575617.45,11,5,1,5,True
1864757,1364,0,451,8478,521229176,0,0,0,239.83,7,575377.62,16,4,3,5,False
1975547,1063,0,10,3978,521229176,0,0,0,239.78,0,575617.4,11,5,22,5,True
2017767,34,1,25,9436,521229176,0,0,0,240.12,8,575377.28,11,0,23,6,True
2455661,1105,2,20,5553,521229176,0,0,0,240.09,5,575137.19,0,0,1,6,True
2547715,1426,1,10,4392,521229176,0,0,0,240.11,6,575377.3,24,0,0,7,True
2549780,603,0,10,6657,521229176,0,0,0,240.19,6,575617.49,24,1,9,7,False
2764102,639,4,30,2430,521229176,0,0,0,239.91,8,575377.58,24,4,5,7,False
2789573,579,0,20,9300,521229176,0,0,0,240.37,3,575137.21,11,1,18,10,True
3145401,1120,4,30,3978,521229176,0,0,0,239.89,8,574897.32,24,0,1,10,True
3279569,1364,0,451,3464,521229176,0,0,0,239.95,7,574657.37,16,1,5,11,True
3397891,1364,0,-1,1940,521229176,0,1,0,239.92,1,574657.37,16,4,1,12,True
3665478,350,0,25,9494,521229176,0,0,0,240.05,8,574417.32,24,5,10,12,False
3843996,1350,4,25,7014,521229176,0,0,0,239.84,8,574177.48,24,2,9,2,True
4063384,1256,2,451,5094,521229176,0,0,0,239.78,7,573937.7,23,1,6,3,True
4120703,988,3,25,8429,521229176,0,0,0,239.85,8,573697.85,22,6,17,4,True
4249676,172,4,451,6657,521229176,0,0,0,240.03,7,573457.82,24,2,18,4,True
4892220,1120,4,30,9493,521229176,0,0,0,240.25,8,573217.57,24,6,12,4,True
4961293,1120,4,25,7014,521229176,0,0,0,240.18,8,572977.39,24,5,18,5,True
5039579,172,4,451,4182,521229176,0,0,0,239.96,7,572737.43,24,1,9,5,True
5438485,988,3,-1,8618,521229176,0,1,0,239.73,4,572737.43,22,5,18,8,True
5734251,1273,0,10,3464,521229176,0,0,0,239.89,6,572977.32,24,6,23,8,True
5742834,1350,4,451,7014,521229176,0,0,0,240.2,7,572737.12,24,0,12,9,True
5755661,1364,0,30,8478,521229176,0,0,0,239.76,8,572497.36,16,6,16,9,True
5936160,1256,2,30,4392,521229176,0,0,0,239.91,8,572257.45,23,5,1,9,True
5951999,1256,2,451,4392,521229176,0,0,0,239.65,7,572017.8,23,4,2,10,True
6172564,350,0,25,9494,521229176,0,0,0,240.08,8,571777.72,24,3,3,10,True
6604475,558,0,10,8478,521229176,0,0,0,239.98,6,572017.7,17,5,13,11,True
6645269,639,4,451,5094,521229176,0,0,0,240.02,7,571777.68,24,6,2,11,True
6870896,727,0,10,4182,521229176,0,0,0,240.18,6,572017.86,11,0,7,1,True
7328718,287,0,20,9436,521229176,0,0,0,239.88,3,571777.98,24,1,15,2,True
7423370,639,4,25,3464,521229176,0,0,0,239.92,8,571538.06,24,0,20,3,True
7467949,269,0,20,2898,521229176,0,0,0,239.85,5,571298.21,24,4,8,3,True
7516514,1256,2,451,7014,521229176,0,0,0,239.77,7,571058.44,23,2,11,3,True
7765053,1164,0,20,1955,521229176,0,0,0,240.05,5,570818.39,24,4,15,3,True
7809620,350,0,30,9300,521229176,0,0,0,240.0,8,570578.39,24,6,0,3,True
7853384,1364,0,-1,5450,521229176,0,1,0,239.78,1,570578.39,16,0,0,5,True
7875517,1364,0,-1,4392,521229176,0,2,0,239.96,1,570578.39,16,6,14,6,True
7894845,1350,4,25,2898,521229176,0,0,0,239.83,8,570338.56,24,1,22,7,True
7931046,1364,0,451,3978,521229176,0,0,0,239.95,7,570098.61,16,1,7,7,True
7956300,988,3,25,3978,521229176,0,0,0,240.12,8,569858.49,22,3,22,7,True
8087220,1256,2,-1,5450,521229176,0,1,0,240.02,4,569858.49,23,4,14,8,True
8178312,58,2,20,6657,521229176,0,0,0,240.02,3,569618.47,20,6,13,9,True
8386154,342,0,20,9493,521229176,0,0,0,239.97,3,569378.5,24,2,14,9,False
8952205,34,1,30,2430,521229176,0,0,0,239.79,8,569138.71,11,3,15,9,True
9316764,639,4,30,5094,521229176,0,0,0,239.97,8,568898.74,24,0,23,9,True
9334973,1278,0,20,9436,521229176,0,0,0,239.98,5,568658.76,24,5,8,9,True
9376852,34,1,-1,4182,521229176,0,1,0,240.03,4,568658.76,11,3,0,10,True
9853886,297,0,20,8429,521229176,0,0,0,240.27,3,568418.49,4,1,1,11,True
9959739,1364,0,451,5553,521229176,0,0,0,240.15,7,568178.34,16,0,22,11,True
1067600,475,4,451,1036,400417528,0,0,0,469.87,7,989258.13,5,2,21,1,True
1466929,184,0,20,1710,400417528,0,0,0,470.38,3,988787.75,18,1,9,2,True
1839503,475,4,451,2942,400417528,0,0,0,469.94,7,988317.81,5,2,9,2,True
1897219,259,4,25,3936,400417528,0,0,0,469.99,8,987847.82,6,6,16,3,True
1973929,1304,0,451,4849,400417528,0,0,0,470.07,7,987377.75,5,6,16,3,False
2579096,498,0,20,2869,400417528,0,0,0,470.12,5,986907.63,12,2,8,7,True
2684939,259,4,30,8621,400417528,0,0,0,470.07,8,986437.56,6,1,0,7,True
2756260,475,4,-1,2502,400417528,0,1,0,469.75,4,986437.56,5,2,5,7,True
2908434,448,0,10,1036,400417528,0,0,0,469.52,0,986907.08,13,0,10,7,True
2923570,1181,2,451,1523,400417528,0,0,0,470.31,7,986436.77,24,0,10,7,True
2936798,1304,0,451,1523,400417528,0,0,0,469.99,7,985966.78,5,1,2,8,True
2980586,1304,0,25,4849,400417528,0,0,0,469.94,8,985496.84,5,3,6,8,True
3123187,415,4,30,7485,400417528,0,0,0,469.9,8,985026.94,18,2,23,8,True
3146138,415,4,25,7485,400417528,0,0,0,470.0,8,984556.94,18,6,20,9,True
3562250,1410,1,10,2502,400417528,0,0,0,469.99,6,985026.93,24,2,9,9,True
3638001,415,4,451,7646,400417528,0,0,0,469.84,7,984557.09,18,0,2,10,True
3937754,259,4,25,6108,400417528,0,0,0,469.84,8,984087.25,6,4,18,10,True
4046540,475,4,30,2502,400417528,0,0,0,470.09,8,983617.16,5,5,22,12,True
4234788,1181,2,451,1710,400417528,0,0,0,469.89,7,983147.27,24,1,18,12,True
4278776,942,0,10,5697,400417528,0,0,0,470.12,0,983617.39,24,1,22,12,True
4772419,1304,0,25,8466,400417528,0,0,0,470.23,8,983147.16,5,6,9,12,True
5048130,259,4,25,2120,400417528,0,0,0,469.86,8,982677.3,6,3,0,12,True
5498446,1181,2,451,3661,400417528,0,0,0,469.99,7,982207.31,24,0,12,2,True
5509773,415,4,451,3661,400417528,0,0,0,470.31,7,981737.0,18,2,8,3,True
5577845,348,0,20,5697,400417528,0,0,0,470.04,5,981266.96,24,0,14,5,True
5758850,129,0,20,2120,400417528,0,0,0,469.74,3,980797.22,18,4,20,5,True
5855935,475,4,25,2704,400417528,0,0,0,469.9,8,980327.32,5,0,23,6,True
5901278,1304,0,25,1710,400417528,0,0,0,470.24,8,979857.08,5,2,3,6,True
6188787,1181,2,25,4849,400417528,0,0,0,469.76,8,979387.32,24,3,3,7,True
6310080,465,0,20,2869,400417528,0,0,0,469.76,5,978917.56,13,3,0,8,True
6886764,1007,2,20,1523,400417528,0,0,0,470.04,5,978447.52,26,5,9,8,True
7122028,1041,0,10,2502,400417528,0,0,0,469.93,0,978917.45,11,0,22,9,True
7322887,475,4,25,1036,400417528,0,0,0,469.92,8,978447.53,5,2,9,10,True
7469879,415,4,30,8586,400417528,0,0,0,470.11,8,977977.42,18,5,13,10,True
7756663,1181,2,30,3936,400417528,0,0,0,470.08,8,977507.34,24,0,1,12,True
8060587,1304,0,-1,7485,400417528,0,1,0,469.85,4,977507.34,5,0,15,12,True
8176741,1181,2,30,2704,400417528,0,0,0,470.02,8,977037.32,24,2,4,12,True
8237336,415,4,451,3936,400417528,0,0,0,469.83,7,976567.49,18,3,22,1,True
8467646,130,0,10,1036,400417528,0,0,0,469.82,0,977037.31,18,2,4,1,True
8659835,415,4,25,1036,400417528,0,0,0,469.87,8,976567.44,18,5,9,1,True
8759409,1471,0,10,7646,400417528,0,0,0,470.0,6,977037.44,24,0,13,2,True
8776517,929,0,10,7646,400417528,0,0,0,469.98,6,977507.42,18,4,18,3,True
8927595,993,0,10,2942,400417528,0,0,0,469.99,6,977977.41,22,5,5,5,True
9266059,1181,2,451,5697,400417528,0,0,0,469.95,7,977507.46,24,0,15,6,True
9439445,1181,2,30,5455,400417528,0,0,0,469.78,8,977037.68,24,6,0,7,True
9524006,219,0,20,8621,400417528,0,0,0,470.01,5,976567.67,9,1,20,7,True
9688358,628,0,10,3936,400417528,0,0,0,470.13,6,977037.8,11,2,20,9,False
9860543,1181,2,-1,6108,400417528,0,1,0,470.14,1,977037.8,24,4,8,10,True
9904314,415,4,-1,4849,400417528,0,2,0,470.19,1,977037.8,18,4,18,10,True
9996513,1304,0,30,2704,400417528,0,0,0,470.04,8,976567.76,5,3,11,11,True
9999729,259,4,30,1523,400417528,0,0,0,469.93,8,976097.83,6,1,22,11,True
1323233,1391,2,20,3434,417914526,0,0,0,177.11,3,310088.89,24,5,18,1,True
1547409,952,0,451,1343,417914526,0,0,0,177.1,7,309911.79,13,2,21,3,True
1833329,952,0,25,6095,417914526,0,0,0,176.8,8,309734.99,13,2,16,4,True
2066158,952,0,451,3453,417914526,0,0,0,176.87,7,309558.12,13,3,10,5,True
2313563,233,4,25,4689,417914526,0,0,0,177.04,8,309381.08,26,6,17,5,True
3070387,1256,2,20,3434,417914526,0,0,0,177.14,5,309203.94,23,5,14,7,True
3134087,1456,4,451,4689,417914526,0,0,0,177.03,7,309026.91,11,4,15,7,True
3150117,952,0,-1,4689,417914526,0,1,0,176.9,4,309026.91,13,5,20,7,True
3217619,1364,0,25,1576,417914526,0,0,0,176.97,8,308849.94,16,5,19,9,True
3366101,610,0,20,2962,417914526,0,0,0,176.85,5,308673.09,11,4,23,10,True
3712401,328,0,10,4238,417914526,0,0,0,177.1,6,308850.19,11,2,1,10,True
3912743,1393,3,451,2279,417914526,0,0,0,177.11,7,308673.08,24,4,9,11,True
3999149,355,1,10,1343,417914526,0,0,0,177.02,6,308850.1,24,1,22,11,True
4028675,427,2,30,4238,417914526,0,0,0,176.87,8,308673.23,18,2,22,1,True
4220532,1456,4,25,1576,417914526,0,0,0,177.03,8,308496.2,11,1,3,1,True
4640104,1364,0,30,5980,417914526,0,0,0,177.11,8,308319.09,16,1,1,1,True
4743819,233,4,-1,3434,417914526,0,1,0,177.24,4,308319.09,26,3,0,3,True
4746001,952,0,30,9353,417914526,0,0,0,177.34,8,308141.75,13,3,12,3,True
4759918,835,4,25,5980,417914526,0,0,0,177.08,8,307964.67,5,5,12,3,True
5522865,835,4,451,2279,417914526,0,0,0,177.07,7,307787.6,5,4,6,3,True
5581508,218,0,20,5989,417914526,0,0,0,176.97,3,307610.63,9,4,1,4,True
5697668,540,4,451,4238,417914526,0,0,0,176.9,7,307433.73,17,1,16,5,True
5828613,1364,0,451,4689,417914526,0,0,0,177.0,7,307256.73,16,1,18,5,True
5934481,540,4,30,3434,417914526,0,0,0,177.05,8,307079.68,17,2,9,5,True
6091636,1393,3,25,1620,417914526,0,0,0,177.01,8,306902.67,24,2,21,5,True
6243646,610,0,20,2962,417914526,0,0,0,176.93,3,306725.74,11,6,14,6,True
6355261,835,4,451,5980,417914526,0,0,0,176.93,7,306548.81,5,4,21,6,True
6373701,540,4,25,4238,417914526,0,0,0,177.0,8,306371.81,17,1,4,7,True
6532831,1456,4,-1,4976,417914526,0,1,0,176.38,4,306371.81,11,6,13,7,True
6652021,952,0,-1,2962,417914526,0,2,0,177.27,1,306371.81,13,4,2,10,True
6688927,628,0,10,5989,417914526,0,0,0,177.0,6,306548.81,11,5,16,10,True
6895966,540,4,30,2113,417914526,0,0,0,177.15,8,306371.66,17,1,14,10,True
6931937,304,0,10,5989,417914526,0,0,0,177.1,6,306548.76,4,3,19,11,True
6945516,233,4,451,1576,417914526,0,0,0,176.94,7,306371.82,26,0,17,11,True
7011376,1364,0,30,9478,417914526,0,0,0,176.83,8,306194.99,16,4,10,11,True
7792980,895,0,20,4768,417914526,0,0,0,176.82,5,306018.17,24,3,23,1,True
7808162,1456,4,25,1343,417914526,0,0,0,176.8,8,305841.37,11,0,14,4,True
8306574,156,4,451,9197,417914526,0,0,0,177.1,7,305664.27,18,1,13,4,True
8631605,835,4,25,8732,417914526,0,0,0,177.11,8,305487.16,5,2,2,4,True
8646933,233,4,-1,5498,417914526,0,1,0,176.86,1,305487.16,26,2,4,5,True
8653114,835,4,451,2962,417914526,0,0,0,177.02,7,305310.14,5,4,18,5,True
8694649,233,4,30,1343,417914526,0,0,0,177.18,8,305132.96,26,6,2,5,True
8696257,603,0,20,2113,417914526,0,0,0,177.17,5,304955.79,24,0,1,5,True
8856506,156,4,451,1343,417914526,0,0,0,177.19,7,304778.6,18,1,19,6,True
8884426,1399,0,10,9197,417914526,0,0,0,177.1,6,304955.7,24,3,18,7,True
8971529,200,0,20,2962,417914526,0,0,0,177.32,3,304778.38,9,4,17,8,True
8986271,1284,2,20,5498,417914526,0,0,0,177.26,5,304601.12,24,1,20,8,True
9005670,228,0,10,3453,417914526,0,0,0,176.88,6,304778.0,26,3,20,9,True
9427498,1456,4,451,4976,417914526,0,0,0,176.75,7,304601.25,11,3,22,9,True
9521432,1000,0,10,4238,417914526,0,0,0,177.03,6,304778.28,26,3,17,10,True
9684486,233,4,-1,7920,417914526,0,1,0,177.06,4,304778.28,26,1,21,10,True
9820229,427,2,30,2962,417914526,0,0,0,176.93,8,304601.35,18,4,6,11,True
1201052,997,3,-1,5685,156921566,0,1,0,764.89,4,302332.0,26,5,18,1,True
1368276,1053,1,25,1075,156921566,0,0,0,765.14,8,301566.86,11,0,2,3,True
1417399,1053,1,451,5534,156921566,0,0,0,765.0,7,300801.86,11,4,10,3,True
1624523,1468,1,-1,3535,156921566,0,1,0,765.12,4,300801.86,11,2,10,4,True
1870042,850,1,10,6901,156921566,0,0,0,765.12,0,301566.98,5,4,5,6,True
2109987,865,0,10,8601,156921566,0,0,0,765.09,6,302332.07,24,0,5,6,True
2360848,1053,1,25,8970,156921566,0,0,0,764.99,8,301567.08,11,4,11,7,True
3026661,1468,1,25,2595,156921566,0,0,0,765.02,8,300802.06,11,0,0,7,True
3246528,32,3,30,2595,156921566,0,0,0,765.16,8,300036.9,11,1,17,7,True
3263524,1470,4,451,8750,156921566,0,0,0,764.88,7,299272.02,11,1,4,8,True
3309071,1470,4,451,9876,156921566,0,0,0,764.91,7,298507.11,11,4,17,10,True
3332286,1023,2,20,4385,156921566,0,0,0,764.82,5,297742.29,11,1,16,10,True
3470035,1112,1,25,1534,156921566,0,0,0,764.76,8,296977.53,0,3,7,10,False
3475205,32,3,25,6432,156921566,0,0,0,764.93,8,296212.6,11,5,9,11,True
3624737,1180,1,10,1534,156921566,0,0,0,764.96,6,296977.56,24,2,1,12,True
3678826,1053,1,30,8750,156921566,0,0,0,765.12,8,296212.44,11,5,21,12,True
4266413,1053,1,451,8601,156921566,0,0,0,764.97,7,295447.47,11,6,14,1,True
4287291,1468,1,451,5685,156921566,0,0,0,765.14,7,294682.33,11,2,13,4,True
4399268,1468,1,30,4385,156921566,0,0,0,765.37,8,293916.96,11,0,21,4,True
4432357,32,3,451,6432,156921566,0,0,0,765.17,7,293151.79,11,6,9,5,True
4806065,1421,0,20,6432,156921566,0,0,0,765.26,5,292386.53,24,0,13,6,True
4978153,1470,4,451,4385,156921566,0,0,0,764.96,7,291621.57,11,4,16,6,True
5004057,1053,1,451,2595,156921566,0,0,0,764.92,7,290856.65,11,0,12,6,True
5226244,194,1,10,3535,156921566,0,0,0,764.79,6,291621.44,18,0,16,8,True
5353937,584,0,10,6095,156921566,0,0,0,764.91,0,292386.35,11,2,21,9,True
5447338,509,0,20,6095,156921566,0,0,0,765.05,5,291621.3,12,2,6,9,True
5511948,1112,1,451,6432,156921566,0,0,0,765.42,7,290855.88,0,0,2,10,True
5808472,1053,1,451,6432,156921566,0,0,0,764.89,7,290090.99,11,3,15,10,True
5859246,1238,0,10,6951,156921566,0,0,0,765.02,6,290856.01,18,5,10,11,True
6068096,32,3,451,6095,156921566,0,0,0,765.19,7,290090.82,11,2,2,12,True
6104548,997,3,25,4385,156921566,0,0,0,765.09,8,289325.73,26,2,16,12,True
6178574,1053,1,-1,6901,156921566,0,1,0,765.04,4,289325.73,11,5,7,1,True
6317533,997,3,451,1075,156921566,0,0,0,764.97,7,288560.76,26,2,14,2,True
6504527,1053,1,451,6901,156921566,0,0,0,765.12,7,287795.64,11,0,18,3,True
6560550,1053,1,451,5685,156921566,0,0,0,764.94,7,287030.7,11,2,23,4,True
6592956,1112,1,-1,6951,156921566,0,1,0,765.27,4,287030.7,0,3,0,4,True
6755952,275,0,10,6095,156921566,0,0,0,764.98,6,287795.68,24,2,15,5,True
6848185,32,3,25,4385,156921566,0,0,0,765.18,8,287030.5,11,1,21,5,True
7249870,1112,1,451,1075,156921566,0,0,0,765.1,7,286265.4,0,1,17,5,True
7275627,997,3,-1,6095,156921566,0,1,0,764.84,4,286265.4,26,6,20,5,True
7307276,729,0,20,9876,156921566,0,0,0,764.97,3,285500.43,11,6,11,5,True
7455044,1156,1,10,4385,156921566,0,0,0,764.88,6,286265.31,15,1,18,6,True
7643155,560,2,20,6432,156921566,0,0,0,765.16,5,285500.15,17,3,14,6,True
7922558,1053,1,451,8970,156921566,0,0,0,765.15,7,284735.0,11,1,18,6,True
8383703,1053,1,25,6951,156921566,0,0,0,765.19,8,283969.81,11,3,3,7,True
8617622,1053,1,25,8601,156921566,0,0,0,764.89,8,283204.92,11,3,16,8,True
8723217,32,3,30,5534,156921566,0,0,0,765.13,8,282439.79,11,5,13,8,True
9038597,1470,4,25,6432,156921566,0,0,0,764.77,8,281675.02,11,0,17,9,True
9185331,1112,1,30,4385,156921566,0,0,0,764.84,8,280910.18,0,0,3,10,True
9225712,1053,1,25,8601,156921566,0,0,0,764.83,8,280145.35,11,2,9,10,True
9549766,869,2,20,8970,156921566,0,0,0,764.8,5,279380.55,24,0,22,11,True
9592768,32,3,451,6095,156921566,0,0,0,765.14,7,278615.41,11,3,11,11,True
1067841,1068,2,20,7977,854575575,0,0,0,703.1,5,486717.9,18,0,2,1,True
1311515,988,3,451,4037,854575575,0,0,0,703.07,7,486014.83,22,4,13,3,True
1516120,1429,0,25,7419,854575575,0,0,0,703.01,8,485311.82,24,2,18,12,True
1523521,988,3,451,6231,854575575,0,0,0,703.0,7,484608.82,22,1,12,2,True
1586533,988,3,451,7697,854575575,0,0,0,702.97,7,483905.85,22,2,1,7,True
2330425,127,1,25,7419,854575575,0,0,0,703.06,8,483202.79,18,5,13,7,True
2563385,127,1,451,7120,854575575,0,0,0,703.03,7,482499.76,18,3,6,1,True
2664477,1495,3,-1,5168,854575575,0,1,0,702.93,1,482499.76,24,6,12,2,True
2807671,370,4,451,7120,854575575,0,0,0,703.29,7,481796.47,25,0,3,6,True
2899872,127,1,-1,3576,854575575,0,1,0,703.07,4,481796.47,18,1,5,7,True
2929876,1495,3,-1,3222,854575575,0,2,0,702.99,1,481796.47,24,1,18,9,True
2959930,1495,3,-1,5168,854575575,0,3,1,702.84,4,0.0,24,2,10,11,True
1022625,889,0,451,4816,683184176,1,0,0,1147.08,7,962892.92,27,1,18,3,True
1532921,269,0,20,4226,683184176,1,0,0,1146.71,5,961746.21,24,6,20,6,True
1659115,1439,4,-1,7959,683184176,1,1,0,1147.21,4,961746.21,24,5,18,7,False
1756935,577,0,10,3211,683184176,1,0,0,1147.15,6,962893.36,11,4,7,9,True
1804452,1220,3,451,4252,683184176,1,0,0,1146.91,7,961746.45,24,0,8,1,True
1860866,425,4,25,5718,683184176,1,0,0,1147.26,8,960599.19,18,1,13,2,False
1861434,71,1,451,4224,683184176,1,0,0,1147.04,7,959452.15,20,6,20,2,True
1885398,71,1,-1,5185,683184176,1,1,0,1146.83,4,959452.15,20,2,2,6,True
2043097,187,4,30,4226,683184176,1,0,0,1147.03,8,958305.12,18,2,19,6,True
2512439,398,0,20,8953,683184176,1,0,0,1146.75,5,957158.37,10,3,6,11,True
2549072,1201,0,10,6622,683184176,1,0,0,1147.04,0,958305.41,24,3,16,1,True
2790858,425,4,-1,9019,683184176,1,1,0,1147.14,1,958305.41,18,3,4,2,True
2800373,1220,3,451,8953,683184176,1,0,0,1146.89,7,957158.52,24,2,14,3,True
3023761,611,0,10,4438,683184176,1,0,0,1147.06,0,958305.58,11,5,0,4,True
3198193,1471,0,20,6501,683184176,1,0,0,1146.77,3,957158.81,24,4,19,5,True
3505169,1439,4,25,6622,683184176,1,0,0,1146.84,8,956011.97,24,5,2,5,True
3693123,425,4,25,5709,683184176,1,0,0,1146.83,8,954865.14,18,6,2,6,True
3929017,1439,4,-1,4252,683184176,1,1,0,1147.01,4,954865.14,24,0,17,6,True
3972237,71,1,-1,3678,683184176,1,2,0,1147.13,4,954865.14,20,4,5,7,True
4035345,1439,4,-1,6501,683184176,1,3,1,1146.88,4,954865.14,24,5,0,10,True
1017264,703,0,30,7825,320794190,1,0,0,1184.0,8,336891.0,18,5,5,1,True
1100173,123,0,10,9674,320794190,1,0,0,1183.89,0,338074.89,18,5,23,5,True
1534098,820,1,10,4267,320794190,1,0,0,1183.92,6,339258.81,18,2,4,6,True
1607520,192,2,30,9328,320794190,1,0,0,1184.1,8,338074.71,18,6,10,7,True
1638915,628,0,451,4859,320794190,1,0,0,1183.95,7,336890.76,11,1,6,7,True
1657500,1385,4,30,4859,320794190,1,0,0,1184.07,8,335706.69,24,0,4,7,True
2128067,628,0,451,5899,320794190,1,0,0,1183.99,7,334522.7,11,1,18,8,True
2433436,376,0,20,4746,320794190,1,0,0,1184.04,5,333338.66,25,3,8,8,True
2467252,703,0,25,5324,320794190,1,0,0,1183.69,8,332154.97,18,5,1,8,True
2652812,703,0,25,4859,320794190,1,0,0,1184.22,8,330970.75,18,6,7,9,True
2891367,192,2,25,9328,320794190,1,0,0,1183.96,8,329786.79,18,5,14,10,True
3062467,557,1,30,2924,320794190,1,0,0,1184.33,8,328602.46,17,4,1,10,True
3764474,557,1,30,4859,320794190,1,0,0,1184.06,8,327418.4,17,2,0,11,True
3842489,557,1,451,5306,320794190,1,0,0,1184.01,7,326234.39,17,4,2,11,True
3912445,192,2,30,9991,320794190,1,0,0,1183.86,8,325050.53,18,0,15,11,True
4045982,628,0,-1,3571,320794190,1,1,0,1184.29,4,325050.53,11,5,0,12,True
4576195,767,0,10,5306,320794190,1,0,0,1183.7,6,326234.23,14,2,15,12,True
4795500,1467,0,10,4267,320794190,1,0,0,1183.95,6,327418.18,11,3,0,1,False
4980745,557,1,451,6848,320794190,1,0,0,1184.14,7,326234.04,17,1,12,1,True
5105497,1246,0,10,9674,320794190,1,0,0,1184.24,6,327418.28,23,0,11,3,True
5130459,1385,4,30,9328,320794190,1,0,0,1184.0,8,326234.28,24,1,13,4,True
5154114,628,0,25,9300,320794190,1,0,0,1183.99,8,325050.29,11,0,9,4,True
5192016,703,0,451,8305,320794190,1,0,0,1184.14,7,323866.15,18,3,14,5,True
5426771,628,0,30,2810,320794190,1,0,0,1184.09,8,322682.06,11,4,0,5,True
5498871,1385,4,451,8305,320794190,1,0,0,1184.09,7,321497.97,24,0,15,6,True
5641677,557,1,451,8911,320794190,1,0,0,1183.95,7,320314.02,17,4,2,6,True
5742466,628,0,451,6621,320794190,1,0,0,1184.28,7,319129.74,11,4,7,6,True
5889640,34,1,10,9991,320794190,1,0,0,1184.03,6,320313.77,11,1,16,7,True
6075683,557,1,25,9674,320794190,1,0,0,1183.99,8,319129.78,17,5,0,9,True
6647266,703,0,-1,2491,320794190,1,1,0,1183.89,4,319129.78,18,6,12,9,True
6806446,1385,4,-1,1904,320794190,1,2,0,1184.13,4,319129.78,24,1,17,10,True
6894793,703,0,451,2810,320794190,1,0,0,1183.88,7,317945.9,18,6,9,10,True
6914852,628,0,30,6848,320794190,1,0,0,1184.01,8,316761.89,11,3,12,10,True
6917674,192,2,-1,5306,320794190,1,1,0,1183.75,4,316761.89,18,1,7,10,True
6991775,1322,2,20,7599,320794190,1,0,0,1184.26,5,315577.63,18,3,8,11,True
7030133,1451,1,10,8426,320794190,1,0,0,1183.88,6,316761.51,11,4,11,11,False
7182551,1385,4,-1,8426,320794190,1,1,0,1183.87,4,316761.51,24,4,19,11,True
7215579,703,0,-1,7825,320794190,1,2,0,1183.8,4,316761.51,18,0,9,12,False
7308685,628,0,451,5324,320794190,1,0,0,1184.09,7,315577.42,11,3,8,1,True
7395162,628,0,451,5899,320794190,1,0,0,1183.9,7,314393.52,11,5,17,2,True
7506378,557,1,25,6848,320794190,1,0,0,1184.16,8,313209.36,17,4,18,3,False
7598873,1385,4,30,8292,320794190,1,0,0,1183.82,8,312025.54,24,1,20,3,True
7698409,628,0,451,3788,320794190,1,0,0,1184.0,7,310841.54,11,0,9,3,True
7886841,703,0,-1,4267,320794190,1,1,0,1183.91,1,310841.54,18,1,8,3,True
7931335,192,2,451,6659,320794190,1,0,0,1184.08,7,309657.46,18,6,18,3,True
8067021,774,2,20,8292,320794190,1,0,0,1183.64,5,308473.82,14,2,14,3,True
8195069,1385,4,451,7028,320794190,1,0,0,1183.96,7,307289.86,24,2,10,4,True
8503952,703,0,451,9328,320794190,1,0,0,1183.76,7,306106.1,18,6,4,4,True
8583726,1303,0,10,7517,320794190,1,0,0,1183.91,6,307290.01,5,2,23,4,True
8662622,557,1,30,9991,320794190,1,0,0,1183.97,8,306106.04,17,6,6,4,True
8688495,628,0,-1,1904,320794190,1,1,0,1184.17,4,306106.04,11,4,19,5,True
8991457,550,0,10,4859,320794190,1,0,0,1184.08,0,307290.12,17,5,2,5,True
9053458,557,1,25,7599,320794190,1,0,0,1184.02,8,306106.1,17,0,8,5,True
9369509,713,0,10,8305,320794190,1,0,0,1183.64,6,307289.74,18,3,18,5,True
9401138,192,2,30,4170,320794190,1,0,0,1184.28,8,306105.46,18,2,12,6,True
9586293,628,0,451,3788,320794190,1,0,0,1183.96,7,304921.5,11,0,4,9,True
9591069,1385,4,30,4170,320794190,1,0,0,1183.98,8,303737.52,24,3,2,9,True
9745023,557,1,451,5306,320794190,1,0,0,1184.09,7,302553.43,17,6,1,9,True
1113704,1047,3,-1,4959,441416548,1,1,0,486.87,4,420029.0,11,5,13,1,True
1316703,496,1,30,4959,441416548,1,0,0,486.91,8,419542.09,12,4,1,1,True
1482043,528,3,25,6471,441416548,1,0,0,486.92,8,419055.17,18,3,4,2,True
1510837,1364,0,10,6013,441416548,1,0,0,487.06,6,419542.23,16,1,7,3,True
1707489,1047,3,451,7853,441416548,1,0,0,487.01,7,419055.22,11,3,2,3,True
2504723,1366,4,-1,8965,441416548,1,1,0,486.63,1,419055.22,16,4,9,5,True
2693147,47,1,10,2260,441416548,1,0,0,487.01,6,419542.23,24,1,8,5,True
2712634,929,0,10,8899,441416548,1,0,0,487.07,0,420029.3,18,2,19,5,True
2728337,990,0,20,4557,441416548,1,0,0,487.08,5,419542.22,22,5,13,6,True
2794984,528,3,-1,3176,441416548,1,1,0,487.06,4,419542.22,18,3,5,6,True
3057598,496,1,451,2514,441416548,1,0,0,486.89,7,419055.33,12,1,16,7,True
3185055,1047,3,30,2260,441416548,1,0,0,486.86,8,418568.47,11,1,1,8,True
3198178,528,3,451,4705,441416548,1,0,0,487.1,7,418081.37,18,3,0,8,True
3265081,528,3,25,9365,441416548,1,0,0,486.87,8,417594.5,18,3,14,8,True
3290191,1318,0,10,3912,441416548,1,0,0,487.08,6,418081.58,18,4,23,8,True
3326147,68,0,10,3176,441416548,1,0,0,486.84,6,418568.42,20,6,22,9,True
3662791,523,2,20,4392,441416548,1,0,0,487.02,5,418081.4,18,3,19,9,True
3845586,223,2,20,3176,441416548,1,0,0,487.08,5,417594.32,26,1,7,10,True
3876416,528,3,30,6013,441416548,1,0,0,486.91,8,417107.41,18,5,6,10,True
3897307,399,2,20,4705,441416548,1,0,0,486.74,5,416620.67,10,6,22,11,True
4067835,1086,0,20,6013,441416548,1,0,0,487.08,5,416133.59,18,6,19,12,True
4221327,1366,4,30,9149,441416548,1,0,0,487.15,8,415646.44,16,2,17,2,True
4263198,528,3,451,9592,441416548,1,0,0,487.0,7,415159.44,18,0,16,3,True
4436491,842,2,25,7853,441416548,1,0,0,486.86,8,414672.58,5,0,2,5,True
4614508,1303,0,20,3912,441416548,1,0,0,487.19,5,414185.39,5,2,17,5,True
5050336,528,3,451,3912,441416548,1,0,0,487.02,7,413698.37,18,4,12,6,True
5401931,1047,3,30,4557,441416548,1,0,0,487.13,8,413211.24,11,0,9,7,True
5464723,1366,4,-1,9592,441416548,1,1,0,487.2,4,413211.24,16,2,13,7,False
5547913,394,0,10,4392,441416548,1,0,0,487.24,6,413698.48,10,1,2,7,True
6115682,842,2,451,1186,441416548,1,0,0,486.92,7,413211.56,5,2,6,7,True
6274094,496,1,451,9149,441416548,1,0,0,487.11,7,412724.45,12,2,2,8,True
6346603,1366,4,451,6471,441416548,1,0,0,486.71,7,412237.74,16,1,6,8,True
6400027,551,0,20,1186,441416548,1,0,0,487.11,3,411750.63,17,1,19,8,True
6747663,1047,3,25,6013,441416548,1,0,0,486.85,8,411263.78,11,0,0,9,True
6843851,917,0,20,6013,441416548,1,0,0,487.04,3,410776.74,18,1,7,10,False
7160369,528,3,451,8965,441416548,1,0,0,487.07,7,410289.67,18,6,15,10,True
7163849,842,2,30,3176,441416548,1,0,0,487.0,8,409802.67,5,1,7,10,True
7278029,1366,4,451,9592,441416548,1,0,0,486.92,7,409315.75,16,4,16,11,True
7518256,528,3,25,4959,441416548,1,0,0,486.99,8,408828.76,18,4,9,11,True
7575440,145,0,20,2514,441416548,1,0,0,486.84,5,408341.92,18,6,20,11,True
7739994,1366,4,25,3176,441416548,1,0,0,487.12,8,407854.8,16,3,1,12,True
7811213,1354,0,10,6471,441416548,1,0,0,486.85,6,408341.65,24,3,2,12,True
7811444,1366,4,30,4255,441416548,1,0,0,486.74,8,407854.91,16,0,9,1,True
7852236,591,0,20,8899,441416548,1,0,0,486.96,3,407367.95,24,1,11,1,True
7924445,528,3,25,8648,441416548,1,0,0,487.3,8,406880.65,18,5,10,2,True
8145651,167,2,20,5951,441416548,1,0,0,486.98,5,406393.67,24,6,12,3,True
8171989,842,2,30,2260,441416548,1,0,0,486.93,8,405906.74,5,1,10,4,True
8220113,1262,0,20,4959,441416548,1,0,0,486.86,5,405419.88,23,4,8,4,False
8283230,665,2,20,4959,441416548,1,0,0,486.96,5,404932.92,18,1,1,5,True
8326616,528,3,451,4392,441416548,1,0,0,487.01,7,404445.91,18,1,17,6,True
8419277,958,2,20,2260,441416548,1,0,0,487.03,5,403958.88,13,6,20,6,True
8628119,496,1,25,4392,441416548,1,0,0,486.92,8,403471.96,12,0,4,7,True
8731337,842,2,25,7853,441416548,1,0,0,487.05,8,402984.91,5,3,13,7,True
9110036,1366,4,30,4255,441416548,1,0,0,487.23,8,402497.68,16,2,18,7,True
9220641,842,2,451,3912,441416548,1,0,0,486.85,7,402010.83,5,5,1,8,True
9550185,1366,4,-1,4255,441416548,1,1,0,486.94,1,402010.83,16,6,21,8,True
9677789,1047,3,451,9149,441416548,1,0,0,487.16,7,401523.67,11,1,21,9,True
9690474,735,1,10,2514,441416548,1,0,0,486.87,0,402010.54,11,0,10,11,True
1092643,1068,2,20,3423,180567478,0,0,0,325.75,5,530722.25,18,5,23,1,True
1199563,86,4,25,2926,180567478,0,0,0,325.82,8,530396.43,1,2,4,3,True
1573829,613,4,-1,1736,180567478,0,1,0,326.03,4,530396.43,11,3,7,3,True
1640795,613,4,30,2714,180567478,0,0,0,325.93,8,530070.5,11,5,23,4,True
1709084,613,4,-1,1831,180567478,0,1,0,325.91,4,530070.5,11,2,21,4,True
1798678,889,0,451,4405,180567478,0,0,0,326.18,7,529744.32,27,4,6,4,True
1813327,177,4,451,6471,180567478,0,0,0,325.95,7,529418.37,24,3,1,5,True
2016521,947,2,-1,2130,180567478,0,1,0,326.1,4,529418.37,24,1,23,6,True
2112814,444,2,20,4405,180567478,0,0,0,326.27,3,529092.1,24,0,22,7,True
2603829,177,4,451,9040,180567478,0,0,0,325.96,7,528766.14,24,1,3,7,True
2652971,177,4,-1,6715,180567478,0,1,0,326.27,4,528766.14,24,5,14,7,True
2821426,1428,1,451,9853,180567478,0,0,0,326.13,7,528440.01,24,4,4,11,True
3317623,199,0,-1,6715,180567478,0,1,0,326.04,4,528440.01,18,2,11,12,True
3410384,1321,0,10,4052,180567478,0,0,0,325.79,6,528765.8,18,2,14,12,True
3941024,199,0,30,9853,180567478,0,0,0,325.91,8,528439.89,18,3,2,12,True
3957157,177,4,25,2857,180567478,0,0,0,326.06,8,528113.83,24,5,4,2,True
4208613,1483,0,20,7981,180567478,0,0,0,326.07,5,527787.76,24,4,16,2,True
4482767,605,0,10,4275,180567478,0,0,0,326.07,6,528113.83,24,1,16,2,True
4658021,1419,1,10,2857,180567478,0,0,0,325.94,6,528439.77,24,2,0,3,True
4805161,1233,0,20,1696,180567478,0,0,0,326.06,3,528113.71,18,4,6,3,True
4980778,177,4,451,4700,180567478,0,0,0,325.95,7,527787.76,24,5,20,4,True
5273000,947,2,-1,8249,180567478,0,1,0,325.94,1,527787.76,24,4,2,4,True
5463321,613,4,25,3693,180567478,0,0,0,325.94,8,527461.82,11,1,11,6,True
5694651,177,4,451,1736,180567478,0,0,0,325.99,7,527135.83,24,1,20,6,True
5710857,1428,1,-1,4405,180567478,0,1,0,326.14,1,527135.83,24,6,16,7,True
5891563,1064,0,20,7981,180567478,0,0,0,326.29,5,526809.54,11,1,14,7,True
5955835,889,0,25,2714,180567478,0,0,0,325.92,8,526483.62,27,2,21,8,True
6063675,1413,0,10,3075,180567478,0,0,0,325.89,6,526809.51,24,2,21,8,True
6160255,177,4,451,5080,180567478,0,0,0,326.21,7,526483.3,24,4,1,8,True
6479802,1428,1,30,4960,180567478,0,0,0,326.0,8,526157.3,24,3,19,8,True
6554552,177,4,-1,2926,180567478,0,1,0,326.16,4,526157.3,24,0,15,9,False
6586985,1428,1,30,7473,180567478,0,0,0,325.88,8,525831.42,24,4,12,9,True
6822650,445,0,10,7747,180567478,0,0,0,326.12,0,526157.54,13,6,23,10,False
7074336,476,1,10,6715,180567478,0,0,0,326.09,6,526483.63,5,6,11,11,False
7113253,889,0,25,4700,180567478,0,0,0,326.0,8,526157.63,27,0,4,11,False
7163348,199,0,30,3492,180567478,0,0,0,326.23,8,525831.4,18,1,4,11,True
7250705,889,0,451,9853,180567478,0,0,0,326.02,7,525505.38,27,0,8,11,True
7338908,947,2,25,3693,180567478,0,0,0,325.88,8,525179.5,24,0,20,11,True
7506120,205,0,20,4052,180567478,0,0,0,325.85,5,524853.65,9,1,16,12,True
7728302,947,2,30,3075,180567478,0,0,0,326.13,8,524527.52,24,2,7,12,True
7949742,177,4,451,4052,180567478,0,0,0,326.27,7,524201.25,24,6,7,2,True
8211354,947,2,30,9040,180567478,0,0,0,326.22,8,523875.03,24,3,5,3,True
8499245,889,0,-1,3423,180567478,0,1,0,325.89,4,523875.03,27,2,5,4,True
8616800,613,4,30,9040,180567478,0,0,0,326.0,8,523549.03,11,0,17,4,True
8625757,889,0,451,2926,180567478,0,0,0,326.19,7,523222.84,27,4,4,5,True
8675151,1428,1,-1,6241,180567478,0,1,0,326.0,4,523222.84,24,3,6,5,True
8780963,613,4,451,3746,180567478,0,0,0,325.93,7,522896.91,11,3,9,6,True
8807860,177,4,451,3075,180567478,0,0,0,326.07,7,522570.84,24,0,3,7,True
9111595,512,0,10,8249,180567478,0,0,0,325.98,0,522896.82,12,3,11,7,True
9118043,86,4,30,4405,180567478,0,0,0,325.9,8,522570.92,1,0,5,7,True
9133722,86,4,-1,4700,180567478,0,1,0,326.23,1,522570.92,1,2,23,8,True
9472012,591,0,10,2130,180567478,0,0,0,326.04,6,522896.96,24,3,19,8,False
9521938,86,4,25,4700,180567478,0,0,0,326.14,8,522570.82,1,6,23,9,True
9592416,1428,1,-1,2857,180567478,0,1,0,326.14,4,522570.82,24,3,18,10,True
9706475,641,0,20,1736,180567478,0,0,0,325.96,5,522244.86,24,1,12,10,True
9730387,177,4,451,3693,180567478,0,0,0,325.9,7,521918.96,24,5,21,10,True
1104934,1370,4,30,4779,323237454,0,0,0,419.85,8,735134.15,16,2,21,1,True
1322456,1370,4,-1,5729,323237454,0,1,0,419.92,4,735134.15,16,5,15,1,True
1429676,631,3,25,1088,323237454,0,0,0,420.08,8,734714.07,11,6,14,2,True
1493889,228,0,451,5729,323237454,0,0,0,420.1,7,734293.97,26,1,23,3,True
1678409,123,0,-1,7857,323237454,0,1,0,420.07,4,734293.97,18,4,3,4,True
1758045,958,2,20,7857,323237454,0,0,0,419.86,5,733874.11,13,4,2,5,True
2108622,1370,4,30,8388,323237454,0,0,0,420.08,8,733454.03,16,3,5,6,True
2531793,1025,1,10,8388,323237454,0,0,0,420.23,6,733874.26,11,0,5,8,True
2668757,806,1,10,1070,323237454,0,0,0,419.9,0,734294.16,11,5,22,8,True
2840905,631,3,-1,8388,323237454,0,1,0,420.01,4,734294.16,11,4,17,9,True
2842769,48,4,25,8683,323237454,0,0,0,420.11,8,733874.05,24,1,11,10,True
3033455,1370,4,25,2098,323237454,0,0,0,420.06,8,733453.99,16,6,14,10,True
3228214,631,3,30,5729,323237454,0,0,0,419.78,8,733034.21,11,3,7,11,True
3281032,1152,0,10,5729,323237454,0,0,0,420.1,6,733454.31,15,4,6,12,True
3399317,890,4,30,5729,323237454,0,0,0,420.12,8,733034.19,24,4,21,1,True
3433849,228,0,25,7857,323237454,0,0,0,419.85,8,732614.34,26,6,21,1,True
3623246,1463,2,30,4779,323237454,0,0,0,420.01,8,732194.33,11,1,1,2,True
3992461,228,0,-1,3292,323237454,0,1,0,419.84,4,732194.33,26,4,11,2,True
4007576,123,0,451,2098,323237454,0,0,0,420.06,7,731774.27,18,5,2,2,True
4195908,631,3,451,3292,323237454,0,0,0,420.05,7,731354.22,11,6,3,2,True
5006542,174,3,451,1070,323237454,0,0,0,420.06,7,730934.16,24,5,0,2,False
5610555,665,2,20,7857,323237454,0,0,0,420.13,5,730514.03,18,0,0,3,True
5980797,956,1,10,1070,323237454,0,0,0,419.95,0,730933.98,13,1,21,3,True
6085652,1463,2,30,3292,323237454,0,0,0,419.91,8,730514.07,11,6,7,3,True
6153359,890,4,25,3693,323237454,0,0,0,419.84,8,730094.23,24,3,12,3,True
6235582,1463,2,-1,9752,323237454,0,1,0,419.89,4,730094.23,11,6,14,5,True
6307366,174,3,451,8388,323237454,0,0,0,420.09,7,729674.14,24,6,3,5,True
6521654,485,1,10,7723,323237454,0,0,0,419.99,6,730094.13,5,6,9,5,True
6568011,1476,0,20,1088,323237454,0,0,0,419.88,5,729674.25,24,1,6,5,True
6630497,631,3,451,8388,323237454,0,0,0,420.09,7,729254.16,11,5,23,5,True
6777968,631,3,-1,7857,323237454,0,1,0,420.0,4,729254.16,11,6,7,6,True
6941007,631,3,30,8683,323237454,0,0,0,420.17,8,728833.99,11,6,14,6,True
7010325,890,4,30,1079,323237454,0,0,0,419.95,8,728414.04,24,4,5,7,True
7031415,1463,2,451,2469,323237454,0,0,0,420.08,7,727993.96,11,0,18,9,True
7255362,48,4,25,8388,323237454,0,0,0,419.6,8,727574.36,24,4,1,11,True
7274275,1370,4,-1,4779,323237454,0,1,0,420.12,4,727574.36,16,3,1,11,True
7416729,228,0,25,1079,323237454,0,0,0,420.19,8,727154.17,26,0,8,11,True
7522306,1370,4,30,1002,323237454,0,0,0,419.72,8,726734.45,16,5,0,12,True
7811729,48,4,30,5568,323237454,0,0,0,419.8,8,726314.65,24,2,12,12,False
7859175,831,1,30,1088,323237454,0,0,0,419.98,8,725894.67,5,2,2,1,True
7897043,228,0,25,9752,323237454,0,0,0,419.86,8,725474.81,26,6,16,2,True
8057970,1463,2,-1,2469,323237454,0,1,0,419.82,1,725474.81,11,0,1,3,True
8107345,1370,4,25,5729,323237454,0,0,0,420.09,8,725054.72,16,1,3,4,False
8388811,694,2,20,3292,323237454,0,0,0,420.01,5,724634.71,24,0,14,6,True
8963163,631,3,30,1079,323237454,0,0,0,419.97,8,724214.74,11,4,8,8,True
9363579,470,1,10,7857,323237454,0,0,0,420.08,6,724634.82,5,3,3,9,True
9533269,20,0,10,1002,323237454,0,0,0,419.9,6,725054.72,24,6,20,9,True
9636365,228,0,451,3292,323237454,0,0,0,420.02,7,724634.7,26,4,7,10,True
9669044,1463,2,30,1002,323237454,0,0,0,419.8,8,724214.9,11,3,3,10,True
9760285,890,4,451,1088,323237454,0,0,0,420.05,7,723794.85,24,0,21,10,True
9822533,228,0,30,3292,323237454,0,0,0,420.4,8,723374.45,26,6,2,11,True
1118182,993,0,451,3559,760910214,1,0,0,387.88,7,528282.12,22,6,0,1,True
1175108,395,4,-1,7864,760910214,1,1,0,388.13,1,528282.12,10,3,8,1,True
1285336,903,3,451,9474,760910214,1,0,0,387.88,7,527894.24,2,3,22,2,True
1541461,1260,0,25,7515,760910214,1,0,0,387.94,8,527506.3,23,3,11,3,True
1703807,1347,4,25,2356,760910214,1,0,0,387.85,8,527118.45,24,5,3,4,True
1758799,537,0,451,7582,760910214,1,0,0,387.91,7,526730.54,18,0,22,5,True
1956391,98,0,451,6612,760910214,1,0,0,387.72,7,526342.82,3,5,4,5,True
2162678,1349,3,-1,2916,760910214,1,1,0,387.86,4,526342.82,24,4,11,6,True
2238971,1231,2,20,8060,760910214,1,0,0,388.1,5,525954.72,18,6,8,7,True
2422408,1087,4,451,6048,760910214,1,0,0,387.81,7,525566.91,18,2,12,7,True
2441801,993,0,451,3559,760910214,1,0,0,387.96,7,525178.95,22,1,15,8,True
2505239,312,0,10,7429,760910214,1,0,0,388.04,0,525566.99,4,1,13,8,True
3614233,804,0,20,6245,760910214,1,0,0,387.76,5,525179.23,11,2,8,10,True
3834096,1347,4,25,3451,760910214,1,0,0,388.18,8,524791.05,24,6,2,10,True
4200975,1260,0,451,3974,760910214,1,0,0,388.24,7,524402.81,23,6,2,11,False
4299403,27,0,20,3091,760910214,1,0,0,387.97,3,524014.84,11,0,13,11,True
4530328,903,3,-1,3559,760910214,1,1,0,388.26,4,524014.84,2,3,5,11,True
4839229,1260,0,451,9722,760910214,1,0,0,388.02,7,523626.82,23,6,12,12,True
5037427,395,4,-1,7269,760910214,1,1,0,387.81,4,523626.82,10,3,2,12,True
5104909,993,0,451,2916,760910214,1,0,0,388.05,7,523238.77,22,5,10,1,True
5254471,1087,4,451,3749,760910214,1,0,0,387.92,7,522850.85,18,4,19,1,True
6721985,537,0,20,3451,760910214,1,0,0,387.9,5,522462.95,18,0,2,2,True
6761424,395,4,-1,7313,760910214,1,1,0,387.9,1,522462.95,10,6,19,3,True
6836332,395,4,451,4400,760910214,1,0,0,387.66,7,522075.29,10,5,4,3,True
7129189,993,0,25,3451,760910214,1,0,0,388.06,8,521687.23,22,5,19,3,True
7271127,395,4,30,7515,760910214,1,0,0,388.36,8,521298.87,10,2,13,4,True
7275030,1467,0,20,9474,760910214,1,0,0,388.02,3,520910.85,11,4,1,4,True
7321937,1446,1,10,6048,760910214,1,0,0,387.97,6,521298.82,24,4,8,4,True
7352750,1382,0,10,9722,760910214,1,0,0,387.95,0,521686.77,16,0,0,5,True
7378303,1260,0,451,3974,760910214,1,0,0,388.04,7,521298.73,23,1,17,5,True
7439262,993,0,-1,7864,760910214,1,1,0,387.62,4,521298.73,22,4,13,6,False
7447983,1094,0,10,8043,760910214,1,0,0,387.91,6,521686.64,0,0,22,6,True
7572477,1307,0,10,9683,760910214,1,0,0,388.07,0,522074.71,5,1,11,7,True
7604239,903,3,451,3749,760910214,1,0,0,388.34,7,521686.37,2,3,13,8,True
7647752,1347,4,25,7313,760910214,1,0,0,388.34,8,521298.03,24,2,11,8,True
7914475,1347,4,451,4400,760910214,1,0,0,387.98,7,520910.05,24,4,7,10,True
8070442,537,0,451,3749,760910214,1,0,0,388.01,7,520522.04,18,1,4,11,True
8254251,1116,0,20,7269,760910214,1,0,0,387.94,5,520134.1,24,5,23,11,False
8291567,98,0,451,9683,760910214,1,0,0,387.91,7,519746.19,3,6,8,12,True
8294460,537,0,451,8060,760910214,1,0,0,387.99,7,519358.2,18,0,11,1,True
8549024,1349,3,-1,7429,760910214,1,1,0,387.99,4,519358.2,24,5,13,1,True
8593253,1260,0,451,7864,760910214,1,0,0,388.05,7,518970.15,23,5,19,3,True
8880993,993,0,25,3559,760910214,1,0,0,388.23,8,518581.92,22,5,14,4,True
9001460,98,0,30,4564,760910214,1,0,0,387.88,8,518194.04,3,4,17,6,True
9048969,1429,0,20,3091,760910214,1,0,0,388.01,5,517806.03,24,2,10,7,True
9145201,76,0,10,9624,760910214,1,0,0,388.13,0,518194.16,20,5,1,9,True
9545829,1152,0,20,1459,760910214,1,0,0,387.93,5,517806.23,15,5,10,9,True
9613602,1488,0,10,9624,760910214,1,0,0,388.13,6,518194.36,24,0,23,9,True
9685842,903,3,30,3974,760910214,1,0,0,387.8,8,517806.56,2,4,9,10,True
9802420,395,4,-1,3451,760910214,1,1,0,388.23,4,517806.56,10,6,13,10,True
9928838,395,4,451,9474,760910214,1,0,0,388.14,7,517418.42,10,6,22,11,True
1039016,616,1,30,7294,728575156,1,0,0,113.88,8,126893.12,11,2,8,1,True
1314881,184,0,10,7080,728575156,1,0,0,114.09,6,127007.21,18,4,17,1,True
1540800,1319,1,10,7603,728575156,1,0,0,113.99,6,127121.2,18,0,2,1,True
1560053,360,0,10,9681,728575156,1,0,0,114.17,6,127235.37,24,4,1,2,True
1992901,342,0,20,6261,728575156,1,0,0,113.77,5,127121.6,24,6,23,2,True
2036994,250,4,30,7363,728575156,1,0,0,113.75,8,127007.85,6,4,8,5,True
2159165,1390,0,10,1573,728575156,1,0,0,114.15,6,127122.0,24,6,17,6,True
2260562,250,4,451,2319,728575156,1,0,0,113.99,7,127008.01,6,1,7,7,True
2333417,859,2,20,9940,728575156,1,0,0,113.86,5,126894.15,24,6,8,8,True
2358968,250,4,451,5611,728575156,1,0,0,114.1,7,126780.05,6,3,13,9,True
2401672,1339,2,20,4352,728575156,1,0,0,114.05,3,126666.0,18,5,18,10,True
2419641,198,0,20,6911,728575156,1,0,0,113.79,5,126552.21,18,5,10,10,True
2863957,943,4,451,4352,728575156,1,0,0,113.99,7,126438.22,24,4,3,12,True
2960187,1270,1,10,4352,728575156,1,0,0,113.97,0,126552.19,23,3,21,1,True
3312611,250,4,25,6435,728575156,1,0,0,113.92,8,126438.27,6,6,15,2,True
3328737,145,0,451,7582,728575156,1,0,0,113.94,7,126324.33,18,1,9,2,True
3957378,1353,4,451,1573,728575156,1,0,0,114.0,7,126210.33,24,5,15,2,True
4017007,616,1,25,8414,728575156,1,0,0,114.17,8,126096.16,11,3,23,3,True
4117140,214,4,30,7363,728575156,1,0,0,114.18,8,125981.98,9,6,22,3,False
4223834,1000,0,10,5611,728575156,1,0,0,113.93,0,126095.91,26,1,13,3,True
4463037,734,0,-1,2319,728575156,1,1,0,114.23,1,126095.91,11,2,23,3,True
4617123,747,1,10,6842,728575156,1,0,0,113.81,6,126209.72,24,6,9,3,True
4910492,943,4,451,4352,728575156,1,0,0,114.16,7,126095.56,24,3,22,4,False
4967247,943,4,451,8393,728575156,1,0,0,113.91,7,125981.65,24,1,23,4,True
5014499,734,0,25,5611,728575156,1,0,0,113.77,8,125867.88,11,4,16,4,True
5095715,214,4,451,7482,728575156,1,0,0,114.19,7,125753.69,9,5,23,4,True
5177212,250,4,30,4975,728575156,1,0,0,113.89,8,125639.8,6,1,6,5,True
5400430,145,0,451,6435,728575156,1,0,0,114.23,7,125525.57,18,2,22,6,True
5446434,1353,4,451,7363,728575156,1,0,0,114.28,7,125411.29,24,3,10,6,True
5507483,553,1,10,2272,728575156,1,0,0,114.09,0,125525.38,17,2,10,7,True
5638262,1273,0,10,7363,728575156,1,0,0,113.94,0,125639.32,24,3,10,7,True
5694910,929,0,20,4975,728575156,1,0,0,113.76,5,125525.56,18,0,23,7,True
5792040,849,1,10,5555,728575156,1,0,0,114.09,6,125639.65,5,5,23,7,True
5803270,214,4,25,7080,728575156,1,0,0,113.84,8,125525.81,9,6,0,7,True
6115006,734,0,451,6261,728575156,1,0,0,113.98,7,125411.83,11,2,18,8,True
6166938,1025,1,10,4352,728575156,1,0,0,113.9,6,125525.73,11,0,2,9,True
6212005,943,4,30,2615,728575156,1,0,0,113.88,8,125411.85,24,3,11,10,True
6213199,145,0,25,7226,728575156,1,0,0,114.08,8,125297.77,18,1,11,11,True
6295050,759,0,20,8393,728575156,1,0,0,113.9,3,125183.87,24,4,10,11,True
6359000,729,0,20,7363,728575156,1,0,0,114.21,5,125069.66,11,0,9,11,True
6425934,943,4,25,6842,728575156,1,0,0,113.85,8,124955.81,24,6,5,12,True
6502137,616,1,451,4975,728575156,1,0,0,114.04,7,124841.77,11,2,15,12,True
6787266,688,0,10,7363,728575156,1,0,0,113.99,6,124955.76,24,3,0,1,True
6945352,616,1,30,6911,728575156,1,0,0,114.03,8,124841.73,11,5,1,2,True
7116174,616,1,451,7363,728575156,1,0,0,113.78,7,124727.95,11,0,11,2,True
7277502,145,0,25,7363,728575156,1,0,0,113.84,8,124614.11,18,4,5,2,True
7328087,145,0,451,2759,728575156,1,0,0,113.89,7,124500.22,18,4,20,3,True
7535519,523,2,20,4352,728575156,1,0,0,113.92,5,124386.3,18,0,14,4,True
8309347,734,0,30,2615,728575156,1,0,0,114.09,8,124272.21,11,0,2,5,True
8341251,734,0,-1,2615,728575156,1,1,0,114.01,1,124272.21,11,5,23,6,True
8358329,616,1,451,9940,728575156,1,0,0,114.23,7,124157.98,11,6,0,6,True
8639053,943,4,-1,6435,728575156,1,1,0,114.08,1,124157.98,24,0,20,8,True
8713541,215,0,10,2615,728575156,1,0,0,113.88,6,124271.86,9,1,3,9,True
8722391,734,0,30,7603,728575156,1,0,0,114.1,8,124157.76,11,5,22,9,True
9015647,616,1,-1,5555,728575156,1,1,0,113.9,1,124157.76,11,3,4,10,True
9040235,59,0,10,7603,728575156,1,0,0,114.1,6,124271.86,20,5,5,11,True
9078098,616,1,451,9681,728575156,1,0,0,114.15,7,124157.71,11,1,14,11,True
1011914,1483,0,10,4638,225348021,1,0,0,985.1,6,372056.1,24,4,5,1,True
1303875,149,2,20,5574,225348021,1,0,0,984.84,3,371071.26,18,2,20,1,True
1570730,1032,4,30,4333,225348021,1,0,0,984.98,8,370086.28,11,2,19,1,True
1747676,798,4,451,3009,225348021,1,0,0,985.24,7,369101.04,11,3,6,2,True
1902426,147,0,10,4638,225348021,1,0,0,985.04,6,370086.08,18,4,12,3,True
1975935,820,1,10,6472,225348021,1,0,0,985.3,6,371071.38,18,4,0,3,True
1976055,1032,4,451,8428,225348021,1,0,0,984.93,7,370086.45,11,0,2,4,True
2218012,752,0,451,5574,225348021,1,0,0,985.08,7,369101.37,24,2,13,4,True
2269636,1122,1,10,4333,225348021,1,0,0,984.82,6,370086.19,24,3,22,5,True
2447427,1075,0,451,9119,225348021,1,0,0,984.91,7,369101.28,18,0,14,5,True
2538225,798,4,25,4458,225348021,1,0,0,985.17,8,368116.11,11,1,11,6,True
2625818,1032,4,451,6472,225348021,1,0,0,984.92,7,367131.19,11,0,11,9,True
2919683,780,0,20,5574,225348021,1,0,0,985.01,5,366146.18,14,3,2,9,True
3503324,1032,4,25,3175,225348021,1,0,0,984.93,8,365161.25,11,4,15,9,True
4003261,1218,4,-1,3283,225348021,1,1,0,985.16,1,365161.25,24,0,12,11,True
4015470,798,4,-1,9104,225348021,1,2,0,984.99,4,365161.25,11,4,1,12,True
4064705,1032,4,451,1422,225348021,1,0,0,984.79,7,364176.46,11,3,5,12,True
4279899,798,4,451,8428,225348021,1,0,0,985.03,7,363191.43,11,1,15,12,True
4391646,98,0,25,6472,225348021,1,0,0,984.97,8,362206.46,3,1,15,12,True
4568253,366,0,20,5565,225348021,1,0,0,984.9,5,361221.56,25,0,20,1,True
4790877,522,0,-1,6580,225348021,1,1,0,984.87,4,361221.56,18,3,2,1,True
5320214,752,0,25,7688,225348021,1,0,0,985.09,8,360236.47,24,4,14,1,True
5333905,1075,0,30,4638,225348021,1,0,0,984.9,8,359251.57,18,4,15,2,True
5536177,865,0,-1,3009,225348021,1,1,0,984.99,4,359251.57,24,0,4,2,True
5558815,1218,4,451,5565,225348021,1,0,0,985.21,7,358266.36,24,4,9,3,True
5983414,1075,0,451,3009,225348021,1,0,0,984.85,7,357281.51,18,1,20,3,True
6010037,522,0,25,5574,225348021,1,0,0,985.15,8,356296.36,18,2,22,3,True
6049920,594,0,20,3175,225348021,1,0,0,985.27,5,355311.09,24,3,20,5,True
6204318,1260,0,20,3009,225348021,1,0,0,984.89,3,354326.2,23,3,6,5,True
6285414,1032,4,451,8591,225348021,1,0,0,984.81,7,353341.39,11,0,14,5,True
6477681,98,0,25,7142,225348021,1,0,0,985.0,8,352356.39,3,2,8,5,True
6584937,1075,0,30,9104,225348021,1,0,0,984.99,8,351371.4,18,3,1,6,True
7162884,522,0,30,1422,225348021,1,0,0,984.96,8,350386.44,18,5,8,7,True
7476220,1000,0,10,7142,225348021,1,0,0,984.93,0,351371.37,26,1,2,7,True
7569544,1218,4,-1,3009,225348021,1,1,0,985.03,4,351371.37,24,3,18,8,True
7628876,865,0,25,1422,225348021,1,0,0,985.11,8,350386.26,24,1,4,10,True
7853817,752,0,451,4807,225348021,1,0,0,985.19,7,349401.07,24,2,1,10,True
7863094,652,0,20,1305,225348021,1,0,0,985.02,3,348416.05,24,4,0,10,True
7880270,752,0,30,7142,225348021,1,0,0,984.95,8,347431.1,24,5,9,10,True
8030116,798,4,451,6472,225348021,1,0,0,985.1,7,346446.0,11,0,4,11,True
8144328,798,4,25,3283,225348021,1,0,0,985.0,8,345461.0,11,0,22,2,True
8391328,98,0,-1,1675,225348021,1,1,0,985.01,1,345461.0,3,5,7,2,True
8449048,1032,4,451,3197,225348021,1,0,0,985.1,7,344475.9,11,6,9,3,True
8481346,51,0,10,7142,225348021,1,0,0,984.92,6,345460.82,20,0,16,3,True
8624996,98,0,-1,8591,225348021,1,1,0,985.22,4,345460.82,3,4,0,3,True
8788629,1467,0,10,1422,225348021,1,0,0,984.71,6,346445.53,11,5,20,3,True
8987310,98,0,25,4333,225348021,1,0,0,984.99,8,345460.54,3,0,12,4,True
9043550,522,0,25,4333,225348021,1,0,0,984.99,8,344475.55,18,6,11,6,True
9183866,1218,4,25,2835,225348021,1,0,0,985.13,8,343490.42,24,4,8,7,True
9203073,424,1,10,9104,225348021,1,0,0,984.92,6,344475.34,18,0,18,8,True
9212349,752,0,30,4807,225348021,1,0,0,985.18,8,343490.16,24,3,14,8,True
9234624,180,0,10,2835,225348021,1,0,0,984.94,0,344475.1,18,6,8,9,True
9334614,28,1,10,5574,225348021,1,0,0,985.23,0,345460.33,11,3,15,10,True
9341739,1032,4,25,4333,225348021,1,0,0,985.04,8,344475.29,11,6,22,11,True
9713810,1123,2,20,3009,225348021,1,0,0,984.88,5,343490.41,24,6,19,11,True
1079288,626,2,20,2164,556929405,1,0,0,971.01,3,686982.99,11,3,23,1,True
1185166,1434,0,20,1183,556929405,1,0,0,970.93,5,686012.06,24,4,6,1,True
1295818,664,2,25,9899,556929405,1,0,0,971.07,8,685040.99,18,6,3,2,True
1393662,484,0,20,7277,556929405,1,0,0,971.01,5,684069.98,5,5,2,3,True
1435295,1127,0,20,3809,556929405,1,0,0,971.0,5,683098.98,24,2,3,3,True
1468326,628,0,10,7748,556929405,1,0,0,970.96,6,684069.94,11,1,17,3,True
2282237,664,2,451,4349,556929405,1,0,0,970.94,7,683099.0,18,1,10,7,True
2844602,799,2,20,2164,556929405,1,0,0,971.14,5,682127.86,11,2,4,7,True
2858144,664,2,25,2164,556929405,1,0,0,970.88,8,681156.98,18,5,8,7,True
3053072,664,2,451,3573,556929405,1,0,0,971.06,7,680185.92,18,0,13,8,True
3319764,378,0,451,9589,556929405,1,0,0,970.95,7,679214.97,25,3,2,8,True
3450444,1311,2,451,4618,556929405,1,0,0,970.73,7,678244.24,5,3,19,8,True
3562725,378,0,451,4349,556929405,1,0,0,971.05,7,677273.19,25,0,20,8,True
3780922,128,0,20,1183,556929405,1,0,0,971.16,3,676302.03,18,0,12,9,True
3916092,653,1,30,5792,556929405,1,0,0,971.23,8,675330.8,24,6,3,10,True
4216121,790,0,20,2164,556929405,1,0,0,970.7,5,674360.1,11,2,19,11,True
4408078,664,2,451,2308,556929405,1,0,0,970.91,7,673389.19,18,1,15,11,True
4485893,378,0,25,2164,556929405,1,0,0,971.2,8,672417.99,25,5,4,3,True
4579901,1311,2,-1,4005,556929405,1,1,0,970.78,4,672417.99,5,0,9,3,True
4626147,664,2,451,4005,556929405,1,0,0,971.26,7,671446.73,18,3,22,3,True
4747590,664,2,451,4349,556929405,1,0,0,970.99,7,670475.74,18,0,12,4,True
4774902,378,0,451,3809,556929405,1,0,0,971.07,7,669504.67,25,6,5,6,True
4939250,653,1,451,4226,556929405,1,0,0,971.1,7,668533.57,24,0,3,6,True
5108674,664,2,25,3809,556929405,1,0,0,971.09,8,667562.48,18,5,11,6,True
5281174,267,0,20,1182,556929405,1,0,0,971.24,3,666591.24,6,2,13,7,True
5468592,951,0,10,4226,556929405,1,0,0,970.93,0,667562.17,24,1,4,7,True
5597100,653,1,451,5792,556929405,1,0,0,970.77,7,666591.4,24,6,6,9,True
5618727,378,0,451,2164,556929405,1,0,0,970.95,7,665620.45,25,5,5,10,True
5960712,653,1,25,4226,556929405,1,0,0,971.15,8,664649.3,24,1,15,11,True
6004020,1311,2,25,4005,556929405,1,0,0,970.98,8,663678.32,5,3,5,11,True
6106595,653,1,-1,2164,556929405,1,1,0,971.08,4,663678.32,24,5,11,12,True
6209016,215,0,20,2164,556929405,1,0,0,971.17,5,662707.15,9,2,8,12,True
6234940,653,1,451,7748,556929405,1,0,0,971.11,7,661736.04,24,3,16,2,True
6289504,1311,2,25,9899,556929405,1,0,0,971.14,8,660764.9,5,0,6,3,True
6661068,378,0,25,3809,556929405,1,0,0,970.97,8,659793.93,25,0,18,3,True
6766119,653,1,-1,3573,556929405,1,1,0,970.83,1,659793.93,24,2,6,4,False
6851636,1311,2,25,3809,556929405,1,0,0,971.31,8,658822.62,5,5,21,5,True
6919789,653,1,451,3809,556929405,1,0,0,970.91,7,657851.71,24,0,5,5,False
6923622,1303,0,20,7748,556929405,1,0,0,971.09,3,656880.62,5,0,5,6,True
7470753,228,0,20,1910,556929405,1,0,0,971.13,5,655909.49,26,4,11,6,True
7616418,416,2,20,1910,556929405,1,0,0,971.0,3,654938.49,18,3,19,7,True
7673958,394,0,20,9899,556929405,1,0,0,971.32,3,653967.17,10,5,16,7,True
7772792,664,2,451,3365,556929405,1,0,0,971.06,7,652996.11,18,0,23,9,True
8278372,653,1,451,2308,556929405,1,0,0,970.94,7,652025.17,24,6,22,9,False
8542860,378,0,451,3573,556929405,1,0,0,970.95,7,651054.22,25,1,10,10,True
9284552,378,0,451,7748,556929405,1,0,0,970.96,7,650083.26,25,4,14,10,True
9296836,168,0,20,4877,556929405,1,0,0,970.97,5,649112.29,24,4,15,10,True
9387166,664,2,451,3365,556929405,1,0,0,971.11,7,648141.18,18,2,13,10,True
9645199,653,1,30,4618,556929405,1,0,0,970.8,8,647170.38,24,4,19,10,True
9742610,1311,2,30,2164,556929405,1,0,0,970.88,8,646199.5,5,1,12,11,True
9853657,653,1,-1,7748,556929405,1,1,0,971.01,4,646199.5,24,5,5,11,True
1031767,420,4,30,1654,277371852,1,0,0,395.91,8,138126.09,18,5,5,1,True
1094472,858,1,25,3246,277371852,1,0,0,395.91,8,137730.18,24,4,21,1,True
1166174,647,4,25,3845,277371852,1,0,0,395.74,8,137334.44,24,1,22,2,True
1245211,975,4,-1,3845,277371852,1,1,0,395.97,1,137334.44,22,1,14,2,True
1282596,975,4,25,5736,277371852,1,0,0,396.04,8,136938.4,22,6,22,3,True
1319520,1142,2,20,4031,277371852,1,0,0,395.78,3,136542.62,15,3,4,3,True
1685039,1485,0,20,4706,277371852,1,0,0,395.89,5,136146.73,24,6,7,4,True
1685156,420,4,25,7730,277371852,1,0,0,395.81,8,135750.92,18,6,23,5,True
1720626,858,1,25,3508,277371852,1,0,0,395.92,8,135355.0,24,1,4,7,True
1904887,145,0,10,3845,277371852,1,0,0,396.06,0,135751.06,18,4,6,8,True
2114101,975,4,-1,7730,277371852,1,1,0,395.98,4,135751.06,22,2,4,8,True
2193066,1235,1,10,4706,277371852,1,0,0,395.99,6,136147.05,18,5,4,8,True
2394845,647,4,30,1101,277371852,1,0,0,396.05,8,135751.0,24,1,12,8,True
2911323,627,0,10,3845,277371852,1,0,0,395.92,6,136146.92,11,3,0,9,True
3080018,975,4,451,3845,277371852,1,0,0,395.85,7,135751.07,22,1,13,10,True
3139294,975,4,25,1654,277371852,1,0,0,396.02,8,135355.05,22,3,12,10,True
3157941,975,4,-1,2491,277371852,1,1,0,395.84,1,135355.05,22,3,15,10,True
3434729,975,4,25,1101,277371852,1,0,0,395.85,8,134959.2,22,4,21,11,True
3451446,647,4,451,3246,277371852,1,0,0,396.21,7,134562.99,24,5,15,12,True
3907887,464,1,10,1654,277371852,1,0,0,395.97,6,134958.96,13,6,18,1,True
3975609,1387,1,10,4031,277371852,1,0,0,396.05,0,135355.01,24,4,10,1,True
3987293,203,0,20,3629,277371852,1,0,0,396.15,5,134958.86,9,6,18,1,True
4038818,342,0,20,3387,277371852,1,0,0,395.83,5,134563.03,24,4,0,3,True
4077316,1399,0,20,3387,277371852,1,0,0,395.88,5,134167.15,24,4,10,3,True
4090321,858,1,451,1415,277371852,1,0,0,395.9,7,133771.25,24,0,1,3,True
4137238,1276,4,-1,7730,277371852,1,1,0,395.91,1,133771.25,24,3,22,6,True
4231037,1276,4,30,2491,277371852,1,0,0,395.99,8,133375.26,24,3,20,6,True
4696706,834,0,20,3246,277371852,1,0,0,396.28,5,132978.98,5,4,3,8,True
4759048,858,1,30,8921,277371852,1,0,0,396.06,8,132582.92,24,6,17,8,True
4995315,68,0,10,3629,277371852,1,0,0,396.08,6,132979.0,20,4,23,9,True
5022356,603,0,10,8921,277371852,1,0,0,395.99,0,133374.99,24,2,20,9,True
5375091,975,4,25,8921,277371852,1,0,0,395.83,8,132979.16,22,5,1,10,True
5414527,1276,4,451,1415,277371852,1,0,0,396.21,7,132582.95,24,5,8,11,True
5544653,1380,0,20,4706,277371852,1,0,0,395.77,5,132187.18,16,0,20,11,True
5545896,858,1,-1,1101,277371852,1,1,0,396.3,1,132187.18,24,6,1,1,True
5605718,688,0,10,1101,277371852,1,0,0,396.01,6,132583.19,24,2,19,1,True
5620811,647,4,25,7730,277371852,1,0,0,395.95,8,132187.24,24,3,16,2,True
6240631,1276,4,30,8921,277371852,1,0,0,396.18,8,131791.06,24,0,10,2,True
6512841,647,4,30,7730,277371852,1,0,0,395.8,8,131395.26,24,5,22,4,True
6664158,975,4,25,3629,277371852,1,0,0,395.86,8,130999.4,22,5,22,4,True
6696138,420,4,-1,1654,277371852,1,1,0,396.29,4,130999.4,18,6,12,4,True
6825864,420,4,30,1654,277371852,1,0,0,396.14,8,130603.26,18,0,21,4,True
7030581,687,0,10,3508,277371852,1,0,0,395.91,0,130999.17,24,2,18,6,True
7058725,591,0,20,4138,277371852,1,0,0,396.13,5,130603.04,24,2,7,7,True
7294941,1276,4,-1,7985,277371852,1,1,0,395.98,1,130603.04,24,4,0,7,True
7646248,647,4,451,1101,277371852,1,0,0,395.79,7,130207.25,24,4,10,7,True
7887287,975,4,451,7985,277371852,1,0,0,395.79,7,129811.46,22,5,22,7,False
8617516,975,4,30,3387,277371852,1,0,0,395.78,8,129415.68,22,4,14,8,True
8711685,1255,0,10,7730,277371852,1,0,0,395.95,6,129811.63,23,3,13,8,True
8788140,858,1,-1,3629,277371852,1,1,0,396.03,4,129811.63,24,0,3,8,True
8789913,530,0,10,2491,277371852,1,0,0,395.83,6,130207.46,18,2,0,10,True
9197994,734,0,10,1101,277371852,1,0,0,396.27,0,130603.73,11,3,15,10,True
9609681,647,4,30,3508,277371852,1,0,0,396.05,8,130207.68,24,2,14,11,True
9733344,647,4,451,4138,277371852,1,0,0,395.78,7,129811.9,24,4,20,11,True
1167693,1224,4,30,2244,242748823,1,0,0,570.98,8,852106.02,24,4,22,1,True
1199746,1264,0,-1,5331,242748823,1,1,0,570.84,1,852106.02,23,1,8,3,True
1521575,375,4,451,6309,242748823,1,0,0,571.15,7,851534.87,25,0,5,3,True
1608844,255,2,-1,9176,242748823,1,1,0,571.26,4,851534.87,6,6,14,4,True
1797748,812,0,20,3697,242748823,1,0,0,571.04,5,850963.83,18,3,20,6,True
1994379,1488,0,-1,2244,242748823,1,1,0,570.71,4,850963.83,24,6,15,6,True
2006458,81,0,10,6030,242748823,1,0,0,571.13,6,851534.96,1,2,6,7,True
2053472,687,0,10,8674,242748823,1,0,0,570.72,0,852105.68,24,2,1,7,True
2544959,255,2,451,8781,242748823,1,0,0,571.1,7,851534.58,6,0,22,7,True
2587060,1224,4,451,3697,242748823,1,0,0,570.74,7,850963.84,24,5,16,8,True
2888965,1429,0,20,6309,242748823,1,0,0,571.01,3,850392.83,24,6,8,8,True
3113344,255,2,451,2654,242748823,1,0,0,570.92,7,849821.91,6,1,10,11,True
3442871,364,4,-1,9176,242748823,1,1,0,571.39,4,849821.91,25,1,11,11,True
3718023,1264,0,25,9597,242748823,1,0,0,570.88,8,849251.03,23,0,13,12,True
3828772,375,4,25,6468,242748823,1,0,0,571.15,8,848679.88,25,6,17,12,True
3869123,1488,0,451,6468,242748823,1,0,0,570.74,7,848109.14,24,4,10,1,True
4304142,1401,1,10,6309,242748823,1,0,0,570.85,6,848679.99,24,3,22,2,True
4323355,572,0,20,9386,242748823,1,0,0,570.95,5,848109.04,11,3,22,3,True
4657919,255,2,25,3697,242748823,1,0,0,570.96,8,847538.08,6,6,13,3,True
4821452,332,4,451,6468,242748823,1,0,0,570.85,7,846967.23,11,5,2,4,True
4869118,889,0,20,7310,242748823,1,0,0,571.04,5,846396.19,27,6,2,4,True
5010159,319,0,10,4216,242748823,1,0,0,571.07,0,846967.26,11,5,19,5,True
5096905,1450,4,-1,4404,242748823,1,1,0,570.88,1,846967.26,11,1,10,5,True
5517269,332,4,451,6030,242748823,1,0,0,571.06,7,846396.2,11,3,7,6,True
5573015,364,4,30,4216,242748823,1,0,0,570.96,8,845825.24,25,4,2,6,True
5653588,1271,0,10,5830,242748823,1,0,0,571.04,6,846396.28,23,4,18,6,True
5978964,1450,4,451,6030,242748823,1,0,0,571.03,7,845825.25,11,1,4,6,True
6517346,1488,0,30,6683,242748823,1,0,0,570.72,8,845254.53,24,2,21,6,True
6899349,1488,0,25,4902,242748823,1,0,0,571.0,8,844683.53,24,4,23,7,True
7030314,364,4,30,3697,242748823,1,0,0,571.05,8,844112.48,25,0,0,7,True
7246996,883,0,20,9386,242748823,1,0,0,571.12,3,843541.36,24,2,0,7,True
7336691,1297,0,20,5830,242748823,1,0,0,571.1,5,842970.26,5,4,2,7,True
7429401,1304,0,10,3697,242748823,1,0,0,571.08,6,843541.34,5,2,18,7,True
7533257,375,4,-1,6030,242748823,1,1,0,570.81,1,843541.34,25,2,17,8,True
7744076,255,2,451,8674,242748823,1,0,0,571.24,7,842970.1,6,1,13,9,True
7780601,255,2,30,5374,242748823,1,0,0,571.02,8,842399.08,6,6,5,9,True
7836161,364,4,451,4404,242748823,1,0,0,571.23,7,841827.85,25,0,11,10,True
7926401,457,0,20,4902,242748823,1,0,0,570.92,5,841256.93,13,1,6,12,True
8107399,255,2,451,9176,242748823,1,0,0,570.55,7,840686.38,6,4,11,1,True
8212084,332,4,25,3697,242748823,1,0,0,571.15,8,840115.23,11,0,0,1,True
8292327,1471,0,20,5510,242748823,1,0,0,571.0,5,839544.23,24,6,5,1,True
8491368,1450,4,25,4363,242748823,1,0,0,571.3,8,838972.93,11,0,8,2,True
8498683,1264,0,-1,2244,242748823,1,1,0,571.17,4,838972.93,23,0,20,4,True
8740294,332,4,-1,5830,242748823,1,2,0,570.96,4,838972.93,11,5,23,5,True
8760789,403,0,10,4404,242748823,1,0,0,571.06,6,839543.99,10,4,16,5,True
8783510,375,4,451,5374,242748823,1,0,0,571.07,7,838972.92,25,3,1,5,True
9453129,375,4,25,2244,242748823,1,0,0,571.12,8,838401.8,25,2,13,6,True
9484589,375,4,25,6762,242748823,1,0,0,570.67,8,837831.13,25,2,9,7,False
9523080,1450,4,451,8781,242748823,1,0,0,570.89,7,837260.24,11,1,2,8,True
9577289,1488,0,451,9386,242748823,1,0,0,571.2,7,836689.04,24,6,10,9,True
9658187,1224,4,451,9386,242748823,1,0,0,571.24,7,836117.8,24,6,2,9,True
9884199,1488,0,30,3697,242748823,1,0,0,570.95,8,835546.85,24,4,3,10,True
9945926,332,4,30,5374,242748823,1,0,0,571.27,8,834975.58,11,6,22,11,True
1076367,1488,0,20,9638,306208038,1,0,0,247.91,5,834007.09,24,2,7,1,True
1189978,859,2,30,3596,306208038,1,0,0,247.88,8,833759.21,24,3,0,1,True
1569721,1163,4,30,1343,306208038,1,0,0,247.91,8,833511.3,24,3,22,2,True
1665172,1164,0,451,7610,306208038,1,0,0,247.89,7,833263.41,24,3,1,2,True
1873644,1163,4,451,9772,306208038,1,0,0,248.15,7,833015.26,24,4,8,2,True
1885993,64,0,20,1343,306208038,1,0,0,247.94,5,832767.32,20,5,11,2,True
2004252,1053,1,10,4735,306208038,1,0,0,247.96,6,833015.28,11,5,2,3,False
2010147,755,3,25,1379,306208038,1,0,0,248.0,8,832767.28,24,1,4,3,True
2194522,231,4,451,9772,306208038,1,0,0,248.1,7,832519.18,26,6,1,3,True
2241954,755,3,25,5501,306208038,1,0,0,248.1,8,832271.08,24,1,8,4,True
2348169,755,3,25,9638,306208038,1,0,0,247.91,8,832023.17,24,4,22,4,True
2827222,859,2,30,1538,306208038,1,0,0,247.92,8,831775.25,24,2,2,6,True
3067894,1163,4,451,8296,306208038,1,0,0,247.79,7,831527.46,24,6,21,6,True
3091428,1164,0,451,4735,306208038,1,0,0,247.98,7,831279.48,24,3,7,6,True
3103015,268,2,20,9772,306208038,1,0,0,248.16,5,831031.32,24,2,8,9,True
3192073,755,3,451,5501,306208038,1,0,0,248.25,7,830783.07,24,6,16,9,True
3414289,755,3,451,5501,306208038,1,0,0,247.96,7,830535.11,24,3,6,10,True
3561595,239,1,10,7610,306208038,1,0,0,247.86,6,830782.97,26,1,14,11,True
3638518,1163,4,451,8296,306208038,1,0,0,247.94,7,830535.03,24,0,2,12,True
3773503,1163,4,25,6973,306208038,1,0,0,248.13,8,830286.9,24,6,23,2,True
3929563,1164,0,25,5275,306208038,1,0,0,248.08,8,830038.82,24,5,19,2,True
4064129,1303,0,20,5275,306208038,1,0,0,248.04,3,829790.78,5,0,19,2,True
4085228,1163,4,30,4735,306208038,1,0,0,248.05,8,829542.73,24,1,5,2,True
4088263,1163,4,451,7610,306208038,1,0,0,248.18,7,829294.55,24,0,3,3,True
4402468,1163,4,30,7610,306208038,1,0,0,248.17,8,829046.38,24,3,17,4,True
4668844,231,4,-1,1193,306208038,1,1,0,248.05,4,829046.38,26,5,14,5,True
4783996,859,2,30,9638,306208038,1,0,0,247.81,8,828798.57,24,4,5,5,True
4905264,1163,4,30,5275,306208038,1,0,0,247.96,8,828550.61,24,6,16,5,True
5265894,1164,0,25,1419,306208038,1,0,0,248.0,8,828302.61,24,5,22,6,True
5528976,1163,4,451,7610,306208038,1,0,0,248.07,7,828054.54,24,5,22,7,True
5636695,231,4,-1,8296,306208038,1,1,0,248.01,4,828054.54,26,0,1,7,True
5702600,231,4,25,1343,306208038,1,0,0,247.82,8,827806.72,26,2,9,7,True
5790661,411,2,20,9638,306208038,1,0,0,248.05,5,827558.67,18,6,1,7,True
5960888,1163,4,30,8296,306208038,1,0,0,248.25,8,827310.42,24,1,7,8,True
6089050,29,0,20,9638,306208038,1,0,0,248.11,3,827062.31,11,5,10,9,True
6292987,937,0,10,5275,306208038,1,0,0,247.98,6,827310.29,24,4,5,10,True
6359127,755,3,451,1699,306208038,1,0,0,248.03,7,827062.26,24,1,16,10,True
6481191,1163,4,451,1419,306208038,1,0,0,247.79,7,826814.47,24,6,0,11,True
6570230,1119,0,10,1419,306208038,1,0,0,248.01,6,827062.48,24,3,2,11,True
6635676,708,2,20,1193,306208038,1,0,0,247.96,3,826814.52,18,6,1,12,True
6837166,859,2,30,1343,306208038,1,0,0,248.04,8,826566.48,24,3,21,1,True
6869423,1298,0,10,5501,306208038,1,0,0,248.0,6,826814.48,5,5,0,1,True
7147139,231,4,30,4735,306208038,1,0,0,248.07,8,826566.41,26,5,12,1,True
7175811,859,2,451,1379,306208038,1,0,0,247.92,7,826318.49,24,6,7,2,True
7222891,1163,4,451,5275,306208038,1,0,0,248.12,7,826070.37,24,2,17,2,True
7291199,343,1,10,1379,306208038,1,0,0,247.89,6,826318.26,24,4,20,2,True
8137957,1412,2,20,6029,306208038,1,0,0,247.94,5,826070.32,24,5,17,2,True
8197077,755,3,-1,8296,306208038,1,1,0,248.2,1,826070.32,24,5,0,4,True
8234628,859,2,451,7610,306208038,1,0,0,248.33,7,825821.99,24,5,21,5,True
8277978,1164,0,25,3596,306208038,1,0,0,247.66,8,825574.33,24,1,10,6,True
8615490,755,3,25,2500,306208038,1,0,0,248.27,8,825326.06,24,4,1,6,True
8813652,231,4,25,6973,306208038,1,0,0,248.13,8,825077.93,26,2,16,7,False
8888022,1163,4,451,1379,306208038,1,0,0,248.06,7,824829.87,24,1,18,8,True
9044847,755,3,-1,1379,306208038,1,1,0,247.9,1,824829.87,24,5,5,9,True
9335825,1037,0,10,9638,306208038,1,0,0,247.95,6,825077.82,11,4,4,9,True
9559661,755,3,25,2500,306208038,1,0,0,247.97,8,824829.85,24,1,16,10,True
9647689,755,3,25,1699,306208038,1,0,0,248.17,8,824581.68,24,6,18,11,True
9684355,1163,4,25,1538,306208038,1,0,0,248.25,8,824333.43,24,6,20,11,True
9933040,995,1,10,1343,306208038,1,0,0,248.05,6,824581.48,22,3,18,11,True
1022982,425,4,30,7020,438391984,0,0,0,458.87,8,565563.13,18,5,6,1,True
1200058,1247,0,20,4742,438391984,0,0,0,458.88,5,565104.25,23,5,20,1,True
1257323,882,0,20,2874,438391984,0,0,0,458.99,3,564645.26,27,3,17,2,True
1460925,215,0,20,5502,438391984,0,0,0,459.14,5,564186.12,9,3,11,2,True
1562417,550,0,20,7363,438391984,0,0,0,458.89,5,563727.23,17,1,21,3,True
1700631,1413,0,30,4347,438391984,0,0,0,458.79,8,563268.44,24,4,22,3,True
2026867,696,2,451,5502,438391984,0,0,0,459.0,7,562809.44,24,3,3,4,True
2143090,108,2,20,5989,438391984,0,0,0,458.87,3,562350.57,3,2,14,4,True
2866484,811,0,20,5989,438391984,0,0,0,458.89,5,561891.68,18,0,21,4,True
2967945,433,4,30,2834,438391984,0,0,0,458.96,8,561432.72,24,6,3,4,True
3186149,454,1,10,4347,438391984,0,0,0,458.98,0,561891.7,13,3,9,5,True
3251396,1297,0,30,7020,438391984,0,0,0,459.03,8,561432.67,5,5,19,5,True
3289783,433,4,30,2900,438391984,0,0,0,459.1,8,560973.57,24,5,3,6,True
3363832,378,0,10,4742,438391984,0,0,0,459.1,0,561432.67,25,6,12,7,True
3885428,1413,0,30,7020,438391984,0,0,0,458.95,8,560973.72,24,2,16,8,True
3967559,1297,0,-1,7020,438391984,0,1,0,458.92,4,560973.72,5,1,16,9,True
4112053,1413,0,30,2834,438391984,0,0,0,458.87,8,560514.85,24,5,15,9,True
4213771,1297,0,451,2308,438391984,0,0,0,458.86,7,560055.99,5,0,12,10,True
4452274,1413,0,25,6143,438391984,0,0,0,459.14,8,559596.85,24,6,3,10,True
4845341,335,4,451,2834,438391984,0,0,0,458.89,7,559137.96,11,1,1,11,True
4895345,287,0,20,9865,438391984,0,0,0,458.87,5,558679.09,24,0,4,12,True
4910480,425,4,451,5875,438391984,0,0,0,458.99,7,558220.1,18,2,2,1,True
4941550,335,4,25,1839,438391984,0,0,0,459.08,8,557761.02,11,6,18,4,True
5074555,372,0,10,1183,438391984,0,0,0,458.88,0,558219.9,25,1,18,4,True
5088341,433,4,451,2343,438391984,0,0,0,458.92,7,557760.98,24,1,18,4,True
5229053,696,2,451,9865,438391984,0,0,0,459.11,7,557301.87,24,1,2,5,True
5259500,360,0,10,7020,438391984,0,0,0,458.8,0,557760.67,24,0,12,5,True
5424529,1488,0,10,4347,438391984,0,0,0,458.88,0,558219.55,24,1,7,6,True
5592399,425,4,451,4463,438391984,0,0,0,459.11,7,557760.44,18,5,18,7,True
5607944,1413,0,30,8602,438391984,0,0,0,458.82,8,557301.62,24,3,19,8,True
5796428,425,4,-1,5989,438391984,0,1,0,458.86,1,557301.62,18,0,23,8,True
5894737,1413,0,25,1183,438391984,0,0,0,458.97,8,556842.65,24,1,17,8,True
6382785,335,4,30,2834,438391984,0,0,0,458.81,8,556383.84,11,2,16,8,True
6435306,1297,0,25,6484,438391984,0,0,0,459.22,8,555924.62,5,3,5,8,True
6457205,425,4,25,2834,438391984,0,0,0,459.12,8,555465.5,18,5,9,8,True
6503703,1227,0,20,3925,438391984,0,0,0,459.08,5,555006.42,18,5,15,9,True
6573167,518,2,20,1709,438391984,0,0,0,459.13,5,554547.29,18,6,0,10,True
6962962,696,2,25,4742,438391984,0,0,0,459.02,8,554088.27,24,4,22,10,True
6985507,1232,1,10,4347,438391984,0,0,0,458.72,6,554546.99,18,2,23,11,True
6995261,1037,0,10,2900,438391984,0,0,0,459.26,6,555006.25,11,2,8,12,True
7067250,1297,0,451,7363,438391984,0,0,0,459.16,7,554547.09,5,5,23,12,True
7184247,1297,0,451,6143,438391984,0,0,0,459.18,7,554087.91,5,0,12,2,True
7769173,1311,2,20,2023,438391984,0,0,0,458.97,5,553628.94,5,6,5,2,True
7807439,716,0,20,4463,438391984,0,0,0,459.16,5,553169.78,18,2,16,2,True
7877105,1297,0,30,3505,438391984,0,0,0,458.84,8,552710.94,5,0,22,2,True
8046429,1413,0,30,4463,438391984,0,0,0,458.88,8,552252.06,24,2,21,4,True
8134043,341,0,20,9865,438391984,0,0,0,458.91,5,551793.15,24,0,17,5,True
8606625,1297,0,25,1183,438391984,0,0,0,458.68,8,551334.47,5,2,1,5,True
8735033,696,2,25,7020,438391984,0,0,0,458.83,8,550875.64,24,0,8,6,True
9071179,1124,0,20,3505,438391984,0,0,0,459.28,5,550416.36,24,0,10,7,False
9111757,1297,0,451,2834,438391984,0,0,0,459.03,7,549957.33,5,0,1,8,True
9327965,425,4,30,4347,438391984,0,0,0,458.9,8,549498.43,18,2,7,8,True
9348568,696,2,451,3858,438391984,0,0,0,458.9,7,549039.53,24,0,21,9,True
9509524,696,2,451,2900,438391984,0,0,0,459.23,7,548580.3,24,6,4,9,True
9524320,335,4,25,4243,438391984,0,0,0,458.86,8,548121.44,11,3,15,10,True
9780564,1210,0,20,2874,438391984,0,0,0,458.96,5,547662.48,24,2,2,10,True
1246749,353,1,451,8330,654636970,1,0,0,502.17,7,866548.83,24,5,2,3,True
1293897,996,0,25,2301,654636970,1,0,0,502.04,8,866046.79,26,5,16,4,True
1342139,353,1,451,3949,654636970,1,0,0,502.03,7,865544.76,24,5,0,4,True
1350623,35,2,-1,5906,654636970,1,1,0,502.13,1,865544.76,11,6,10,5,True
1632171,108,2,20,8330,654636970,1,0,0,502.06,5,865042.7,3,1,1,7,True
1663103,257,1,10,9081,654636970,1,0,0,501.97,6,865544.67,6,4,10,8,True
2123490,995,1,10,7236,654636970,1,0,0,501.68,6,866046.35,22,0,21,10,False
2152661,35,2,30,4110,654636970,1,0,0,501.82,8,865544.53,11,2,22,10,True
2166948,353,1,30,8820,654636970,1,0,0,502.08,8,865042.45,24,2,10,11,True
2206248,744,4,451,2301,654636970,1,0,0,501.84,7,864540.61,24,1,9,12,True
2273874,962,0,20,7209,654636970,1,0,0,502.07,5,864038.54,13,0,3,1,True
2409492,198,0,10,7236,654636970,1,0,0,501.79,6,864540.33,18,0,13,2,True
2486340,744,4,25,4912,654636970,1,0,0,501.93,8,864038.4,24,1,12,2,True
2625557,716,0,10,1289,654636970,1,0,0,502.06,6,864540.46,18,4,1,3,True
2667593,1061,2,25,7209,654636970,1,0,0,501.98,8,864038.48,11,2,5,5,True
3092664,353,1,25,4500,654636970,1,0,0,502.24,8,863536.24,24,6,17,7,True
3224027,744,4,25,8820,654636970,1,0,0,501.85,8,863034.39,24,2,7,8,True
3378883,121,4,-1,7114,654636970,1,1,0,502.13,1,863034.39,18,0,14,10,True
3759198,1061,2,-1,2605,654636970,1,2,0,501.96,4,863034.39,11,3,15,4,True
4261503,744,4,-1,7236,654636970,1,3,1,502.02,4,863034.39,24,6,17,8,True
1244024,719,4,25,5069,998717557,0,0,0,613.02,8,865042.98,11,0,11,1,True
1388564,1159,0,20,8114,998717557,0,0,0,613.07,5,864429.91,15,3,2,1,True
1479186,645,0,20,1471,998717557,0,0,0,613.16,5,863816.75,24,6,22,2,False
1481316,1366,4,30,1955,998717557,0,0,0,612.87,8,863203.88,16,3,11,2,True
1553305,1377,0,30,1369,998717557,0,0,0,613.16,8,862590.72,16,4,20,2,True
1578391,1377,0,30,1955,998717557,0,0,0,613.07,8,861977.65,16,5,23,2,True
1759055,882,0,451,1983,998717557,0,0,0,613.17,7,861364.48,27,3,17,3,True
2071376,1366,4,451,5068,998717557,0,0,0,613.19,7,860751.29,16,6,16,4,True
2182659,393,1,10,1945,998717557,0,0,0,613.01,0,861364.3,10,1,8,4,True
2650904,135,2,20,5282,998717557,0,0,0,612.99,5,860751.31,18,6,8,5,True
2804299,971,4,-1,1955,998717557,0,1,0,612.88,4,860751.31,13,0,0,5,True
2899044,882,0,25,6357,998717557,0,0,0,613.02,8,860138.29,27,4,6,5,True
3059705,1366,4,30,8114,998717557,0,0,0,612.81,8,859525.48,16,0,4,8,True
3382290,1377,0,-1,9080,998717557,0,1,0,612.77,1,859525.48,16,6,16,8,True
3797742,742,4,-1,7751,998717557,0,2,0,613.11,1,859525.48,24,4,22,9,True
3870435,811,0,10,1955,998717557,0,0,0,612.95,6,860138.43,18,6,12,9,True
4240690,71,1,10,2080,998717557,0,0,0,613.14,6,860751.57,20,2,17,9,True
4987393,1377,0,25,6275,998717557,0,0,0,612.72,8,860138.85,16,3,2,10,True
5178218,503,0,20,8032,998717557,0,0,0,612.92,3,859525.93,12,2,20,11,True
5238468,1377,0,-1,4319,998717557,0,1,0,613.16,4,859525.93,16,0,6,11,True
5498836,1377,0,30,1983,998717557,0,0,0,612.8,8,858913.13,16,1,4,11,True
5646958,1150,0,10,1471,998717557,0,0,0,613.05,0,859526.18,15,3,13,12,True
5670898,465,0,30,8032,998717557,0,0,0,612.76,8,858913.42,13,3,22,1,True
6108276,1377,0,30,2080,998717557,0,0,0,612.92,8,858300.5,16,6,23,1,True
6171490,1298,0,20,4475,998717557,0,0,0,613.01,3,857687.49,5,1,16,1,True
6415642,1305,2,20,5069,998717557,0,0,0,613.0,3,857074.49,5,6,0,1,True
6478966,1366,4,25,9515,998717557,0,0,0,613.15,8,856461.34,16,4,9,2,True
6532093,1377,0,451,5068,998717557,0,0,0,612.94,7,855848.4,16,1,12,2,True
6591094,677,0,10,2080,998717557,0,0,0,612.78,6,856461.18,24,6,21,3,True
6701503,1377,0,25,4475,998717557,0,0,0,612.97,8,855848.21,16,3,21,4,True
6805615,641,0,20,2415,998717557,0,0,0,613.01,5,855235.2,24,2,15,5,True
6892006,719,4,-1,2415,998717557,0,1,0,613.12,4,855235.2,11,4,11,7,True
7066850,742,4,451,8032,998717557,0,0,0,613.2,7,854622.0,24,2,1,8,True
7349107,742,4,30,6515,998717557,0,0,0,613.3,8,854008.7,24,4,16,9,True
7404805,742,4,25,4319,998717557,0,0,0,612.87,8,853395.83,24,1,20,9,True
7428263,1366,4,30,1955,998717557,0,0,0,612.94,8,852782.89,16,0,17,10,True
7797981,882,0,-1,5068,998717557,0,1,0,613.0,1,852782.89,27,4,8,11,True
7937527,550,0,20,5282,998717557,0,0,0,613.16,5,852169.73,17,1,4,12,True
8156755,719,4,30,1945,998717557,0,0,0,613.01,8,851556.72,11,2,22,12,True
8266694,882,0,30,4475,998717557,0,0,0,613.04,8,850943.68,27,2,14,1,True
8367275,523,2,20,8114,998717557,0,0,0,613.02,5,850330.66,18,1,6,3,True
8446829,882,0,451,5068,998717557,0,0,0,613.47,7,849717.19,27,1,15,4,True
8515449,882,0,451,1983,998717557,0,0,0,613.12,7,849104.07,27,5,1,4,True
8706601,465,0,30,5068,998717557,0,0,0,612.87,8,848491.2,13,6,16,4,True
8807171,1377,0,-1,5069,998717557,0,1,0,613.06,4,848491.2,16,0,7,5,True
8866856,889,0,20,6515,998717557,0,0,0,612.72,3,847878.48,27,3,20,7,True
8916703,742,4,451,1471,998717557,0,0,0,612.96,7,847265.52,24,2,22,8,True
8972398,525,0,10,1955,998717557,0,0,0,613.01,6,847878.53,18,3,22,8,True
9163766,1366,4,30,1700,998717557,0,0,0,612.88,8,847265.65,16,6,2,8,True
9267331,882,0,25,9515,998717557,0,0,0,612.86,8,846652.79,27,3,3,9,True
9681099,871,0,10,6275,998717557,0,0,0,612.87,6,847265.66,24,3,8,10,True
9722624,1377,0,451,5282,998717557,0,0,0,613.31,7,846652.35,16,4,17,11,True
9959209,1366,4,-1,9515,998717557,0,1,0,613.35,4,846652.35,16,2,8,11,True
1049059,304,0,451,2165,410328814,1,0,0,1108.09,7,308965.91,4,6,18,3,True
1108605,304,0,30,1406,410328814,1,0,0,1107.8,8,307858.11,4,0,0,3,False
1174255,223,2,20,8406,410328814,1,0,0,1108.03,5,306750.08,26,2,15,3,False
1281132,183,1,10,8494,410328814,1,0,0,1108.01,0,307858.09,18,6,10,4,True
1577930,681,2,25,5769,410328814,1,0,0,1108.0,8,306750.09,24,0,13,4,True
1714467,1122,1,451,5183,410328814,1,0,0,1107.86,7,305642.23,24,3,23,4,True
1750002,1122,1,25,1626,410328814,1,0,0,1108.03,8,304534.2,24,4,22,5,True
1958446,890,4,-1,8406,410328814,1,1,0,1107.98,1,304534.2,24,1,4,5,True
2250698,400,4,30,3099,410328814,1,0,0,1108.03,8,303426.17,10,4,13,6,True
2507631,487,4,25,8802,410328814,1,0,0,1108.11,8,302318.06,12,0,10,6,True
2821784,634,1,10,1215,410328814,1,0,0,1107.9,0,303425.96,24,3,16,6,True
2931776,531,0,10,1406,410328814,1,0,0,1108.1,6,304534.06,18,0,14,8,True
3336242,238,0,20,8802,410328814,1,0,0,1107.9,5,303426.16,26,3,12,9,True
3551748,122,3,25,7672,410328814,1,0,0,1108.11,8,302318.05,18,0,0,9,True
3574480,890,4,451,7672,410328814,1,0,0,1108.08,7,301209.97,24,5,19,10,True
3811755,304,0,-1,2242,410328814,1,1,0,1107.93,1,301209.97,4,2,19,10,True
3846251,664,2,20,1215,410328814,1,0,0,1107.91,3,300102.06,18,0,13,10,True
4072640,1122,1,30,1626,410328814,1,0,0,1107.83,8,298994.23,24,2,13,12,True
4217714,645,0,10,8406,410328814,1,0,0,1107.94,6,300102.17,24,6,3,12,True
4468565,1122,1,451,1215,410328814,1,0,0,1107.9,7,298994.27,24,0,5,12,False
4621265,144,1,10,7496,410328814,1,0,0,1108.07,6,300102.34,18,3,17,12,True
4651234,122,3,451,1406,410328814,1,0,0,1107.88,7,298994.46,18,0,7,1,True
4832343,890,4,30,8494,410328814,1,0,0,1107.92,8,297886.54,24,4,19,1,True
5050495,428,0,20,8681,410328814,1,0,0,1108.11,3,296778.43,18,4,2,2,True
5572189,890,4,-1,1215,410328814,1,1,0,1108.03,1,296778.43,24,6,4,2,True
5868844,917,0,10,2165,410328814,1,0,0,1107.8,6,297886.23,18,3,10,3,True
6022407,1122,1,451,7496,410328814,1,0,0,1107.99,7,296778.24,24,5,13,6,True
6293400,681,2,30,2242,410328814,1,0,0,1108.02,8,295670.22,24,4,19,6,True
6432156,479,2,20,1419,410328814,1,0,0,1108.56,5,294561.66,5,3,12,8,True
6488881,304,0,25,2029,410328814,1,0,0,1108.04,8,293453.62,4,4,2,8,True
6674871,215,0,10,5769,410328814,1,0,0,1108.05,6,294561.67,9,0,16,10,True
6714552,681,2,30,3678,410328814,1,0,0,1107.86,8,293453.81,24,3,7,10,True
6962294,1122,1,25,3099,410328814,1,0,0,1107.86,8,292345.95,24,6,14,10,True
7046173,122,3,451,3099,410328814,1,0,0,1108.06,7,291237.89,18,6,15,1,True
7175960,400,4,-1,5769,410328814,1,1,0,1108.34,4,291237.89,10,6,5,1,True
7332066,400,4,30,5183,410328814,1,0,0,1108.13,8,290129.76,10,3,19,2,True
7378985,781,1,10,8681,410328814,1,0,0,1108.17,6,291237.93,14,1,13,2,True
7938708,304,0,451,5837,410328814,1,0,0,1107.93,7,290130.0,4,0,16,3,True
8010541,400,4,-1,7672,410328814,1,1,0,1108.04,4,290130.0,10,4,18,3,True
8348462,487,4,-1,3099,410328814,1,2,0,1108.2,4,290130.0,12,4,0,4,True
8544158,890,4,451,3678,410328814,1,0,0,1108.21,7,289021.79,24,1,18,4,True
8553092,1210,0,10,7204,410328814,1,0,0,1108.13,0,290129.92,24,6,12,5,True
8968017,282,2,20,7672,410328814,1,0,0,1108.09,3,289021.83,24,1,1,5,True
9137644,122,3,30,1215,410328814,1,0,0,1107.98,8,287913.85,18,6,0,6,True
9282217,304,0,25,1626,410328814,1,0,0,1107.84,8,286806.01,4,1,15,6,True
9629413,487,4,-1,8802,410328814,1,1,0,1107.77,4,286806.01,12,5,14,6,True
9762634,400,4,30,3099,410328814,1,0,0,1108.04,8,285697.97,10,5,6,6,True
9773478,304,0,451,1406,410328814,1,0,0,1107.82,7,284590.15,4,5,7,7,True
9968999,205,0,20,2165,410328814,1,0,0,1107.9,3,283482.25,9,5,1,7,True
9975992,122,3,25,1419,410328814,1,0,0,1107.99,8,282374.26,18,2,0,11,True
1240329,1325,0,20,4869,216807235,1,0,0,902.08,5,680833.92,18,6,13,2,True
1459286,942,0,451,1327,216807235,1,0,0,901.67,7,679932.25,24,3,18,4,True
1510668,1270,1,10,8586,216807235,1,0,0,901.84,6,680834.09,23,3,14,10,True
1644171,1032,4,-1,9246,216807235,1,1,0,901.91,4,680834.09,11,1,15,10,True
1739190,1226,2,30,1689,216807235,1,0,0,902.07,8,679932.02,18,3,20,1,True
1793028,1357,3,30,3992,216807235,1,0,0,901.98,8,679030.04,24,4,0,3,True
1807220,942,0,30,2206,216807235,1,0,0,902.03,8,678128.01,24,3,22,9,True
2014582,300,0,20,3992,216807235,1,0,0,902.1,5,677225.91,4,6,11,9,True
2129449,945,1,10,5653,216807235,1,0,0,901.99,6,678127.9,24,3,15,11,True
2166850,549,1,-1,2699,216807235,1,1,0,901.76,1,678127.9,17,4,17,3,True
2263918,877,2,-1,3992,216807235,1,2,0,901.97,4,678127.9,24,1,12,3,True
2502212,1060,1,-1,2531,216807235,1,3,1,901.8,1,678127.9,11,6,23,4,True
1112345,29,0,20,2107,852995547,1,0,0,1173.01,5,655888.99,11,2,0,2,True
1173131,393,1,30,5240,852995547,1,0,0,1172.75,8,654716.24,10,1,6,5,True
1378706,739,1,10,3853,852995547,1,0,0,1172.94,0,655889.18,24,2,9,5,True
1447075,200,0,10,5240,852995547,1,0,0,1173.23,0,657062.41,9,2,22,5,True
1458099,306,4,30,2233,852995547,1,0,0,1172.91,8,655889.5,4,1,22,5,False
1723856,406,1,10,1658,852995547,1,0,0,1172.74,0,657062.24,10,4,7,6,True
1765634,1173,1,10,4505,852995547,1,0,0,1172.94,0,658235.18,24,0,18,6,True
1784429,1186,2,20,2107,852995547,1,0,0,1173.08,5,657062.1,24,3,1,8,True
2180632,1201,0,-1,4342,852995547,1,1,0,1172.84,4,657062.1,24,1,8,12,True
2414349,393,1,451,4342,852995547,1,0,0,1172.85,7,655889.25,10,6,14,12,True
2441420,71,1,10,1658,852995547,1,0,0,1173.06,0,657062.31,20,4,4,12,True
2519287,1201,0,25,4505,852995547,1,0,0,1172.92,8,655889.39,24,1,9,1,True
2799494,1201,0,30,3847,852995547,1,0,0,1172.94,8,654716.45,24,0,0,1,True
3080404,446,1,10,4480,852995547,1,0,0,1172.81,6,655889.26,13,3,15,2,True
3090264,306,4,30,4342,852995547,1,0,0,1172.82,8,654716.44,4,6,5,2,False
3228387,1093,0,451,4820,852995547,1,0,0,1172.91,7,653543.53,18,1,14,3,True
3466136,1093,0,30,9972,852995547,1,0,0,1172.9,8,652370.63,18,4,3,4,True
3663418,1201,0,451,2233,852995547,1,0,0,1172.86,7,651197.77,24,5,16,4,True
3697960,1137,1,25,4133,852995547,1,0,0,1172.98,8,650024.79,24,6,15,4,True
3843706,1137,1,-1,2233,852995547,1,1,0,1172.93,1,650024.79,24,4,19,4,True
4165559,169,4,451,2233,852995547,1,0,0,1173.18,7,648851.61,24,5,22,6,True
4189478,1093,0,25,9972,852995547,1,0,0,1173.22,8,647678.39,18,3,17,6,False
4409102,1137,1,451,4480,852995547,1,0,0,1172.75,7,646505.64,24,0,19,6,True
4564147,792,1,25,2107,852995547,1,0,0,1172.87,8,645332.77,11,5,23,7,True
4888222,1137,1,30,3847,852995547,1,0,0,1173.28,8,644159.49,24,6,10,7,True
5024928,1201,0,451,4133,852995547,1,0,0,1172.97,7,642986.52,24,5,22,12,True
5139641,705,1,10,4133,852995547,1,0,0,1173.02,0,644159.54,18,3,12,12,True
5349930,1093,0,451,3544,852995547,1,0,0,1172.94,7,642986.6,18,3,19,2,True
5366178,642,0,20,1980,852995547,1,0,0,1173.2,5,641813.4,24,4,13,3,True
5604208,1093,0,25,3544,852995547,1,0,0,1172.82,8,640640.58,18,3,7,4,True
5731947,306,4,451,3544,852995547,1,0,0,1172.77,7,639467.81,4,0,3,4,True
5941762,949,4,-1,2233,852995547,1,1,0,1172.95,1,639467.81,24,0,2,5,True
6057053,949,4,-1,5240,852995547,1,2,0,1172.96,1,639467.81,24,1,17,5,True
6158157,792,1,30,3847,852995547,1,0,0,1173.09,8,638294.72,11,4,8,6,True
6344587,1485,0,10,4133,852995547,1,0,0,1173.24,0,639467.96,24,4,14,8,True
6458101,949,4,451,5240,852995547,1,0,0,1173.03,7,638294.93,24,1,9,8,True
6587424,1201,0,-1,4820,852995547,1,1,0,1172.95,1,638294.93,24,0,21,9,True
6671423,1137,1,-1,1980,852995547,1,2,0,1173.01,4,638294.93,24,2,20,11,True
6920687,949,4,-1,4342,852995547,1,3,1,1173.01,4,638294.93,24,2,17,11,True
1021164,482,1,451,3441,314372290,1,0,0,131.17,7,231684.83,5,4,0,2,True
1568533,1179,0,-1,7358,314372290,1,1,0,130.89,1,231684.83,24,5,21,2,True
1573080,774,2,20,6621,314372290,1,0,0,131.13,5,231553.7,14,1,18,3,True
1909409,471,0,10,7541,314372290,1,0,0,131.18,6,231684.88,5,1,1,7,True
1978907,1150,0,-1,7541,314372290,1,1,0,131.04,4,231684.88,15,2,13,7,True
2057041,482,1,25,3492,314372290,1,0,0,131.09,8,231553.79,5,6,22,8,True
2430141,482,1,-1,7654,314372290,1,1,0,131.01,1,231553.79,5,0,20,10,True
2563577,1150,0,25,7654,314372290,1,0,0,131.2,8,231422.59,15,1,22,10,True
2606686,20,0,10,4783,314372290,1,0,0,131.18,6,231553.77,24,1,23,10,True
2656330,1061,2,20,2864,314372290,1,0,0,131.06,5,231422.71,11,0,3,10,True
2758307,832,3,-1,2864,314372290,1,1,0,130.87,4,231422.71,5,2,15,3,True
2777986,1205,0,10,7071,314372290,1,0,0,130.95,6,231553.66,24,6,4,4,True
2778881,369,1,10,5750,314372290,1,0,0,130.95,0,231684.61,25,5,7,8,True
2934264,1179,0,451,7071,314372290,1,0,0,131.08,7,231553.53,24,6,10,12,True
2962784,937,0,20,9285,314372290,1,0,0,130.86,5,231422.67,24,4,2,3,True
3361594,502,0,30,6621,314372290,1,0,0,130.89,8,231291.78,12,4,13,5,True
3527791,302,1,10,7358,314372290,1,0,0,131.12,6,231422.9,4,2,13,7,True
3991315,482,1,-1,9307,314372290,1,1,0,131.15,1,231422.9,5,4,8,9,True
4009911,1150,0,-1,8025,314372290,1,2,0,131.17,1,231422.9,15,1,17,10,True
4043142,1179,0,-1,5750,314372290,1,3,1,130.72,1,231422.9,24,5,9,11,True
1155920,599,0,10,1545,572375593,1,0,0,1156.84,6,163431.84,24,4,6,1,True
1262788,294,3,-1,5645,572375593,1,1,0,1156.86,1,163431.84,4,2,2,1,True
1274123,294,3,25,1035,572375593,1,0,0,1157.1,8,162274.74,4,0,1,1,True
1341701,995,1,30,1035,572375593,1,0,0,1156.73,8,161118.01,22,0,5,2,True
1645149,1278,0,20,7669,572375593,1,0,0,1157.08,3,159960.93,24,4,0,3,True
1704020,529,2,20,5645,572375593,1,0,0,1157.21,3,158803.72,18,5,19,5,True
1731257,1028,4,30,1035,572375593,1,0,0,1156.89,8,157646.83,11,1,19,5,True
1788453,1143,4,30,8742,572375593,1,0,0,1157.12,8,156489.71,15,1,16,5,True
1982406,1140,0,20,3835,572375593,1,0,0,1156.66,5,155333.05,15,2,1,6,True
2401399,568,1,10,7669,572375593,1,0,0,1156.67,6,156489.72,11,3,21,6,True
2570748,950,0,451,9759,572375593,1,0,0,1157.14,7,155332.58,24,1,19,6,True
2643340,995,1,30,5645,572375593,1,0,0,1157.01,8,154175.57,22,3,4,6,True
2894211,346,0,20,3835,572375593,1,0,0,1157.25,3,153018.32,24,4,9,7,True
2899097,1391,2,20,5127,572375593,1,0,0,1156.73,5,151861.59,24,6,18,7,True
3234624,294,3,451,4320,572375593,1,0,0,1157.1,7,150704.49,4,4,21,7,True
3279787,201,1,30,4894,572375593,1,0,0,1157.01,8,149547.48,9,5,1,8,True
3345884,1319,1,10,3934,572375593,1,0,0,1156.79,0,150704.27,18,6,16,9,True
3414052,1143,4,-1,4370,572375593,1,1,0,1157.1,4,150704.27,15,4,15,10,True
3445035,1429,0,10,9969,572375593,1,0,0,1157.16,6,151861.43,24,1,16,11,True
3841898,448,0,10,2775,572375593,1,0,0,1156.97,6,153018.4,13,2,19,12,True
4137974,294,3,451,5645,572375593,1,0,0,1157.09,7,151861.31,4,1,21,1,True
4213781,950,0,451,8940,572375593,1,0,0,1156.79,7,150704.52,24,3,0,2,True
4224527,201,1,451,2775,572375593,1,0,0,1156.85,7,149547.67,9,1,11,2,True
4463078,631,3,451,4370,572375593,1,0,0,1157.01,7,148390.66,11,3,3,2,True
4570789,260,0,10,3934,572375593,1,0,0,1156.81,0,149547.47,6,0,13,3,True
4977283,995,1,25,5127,572375593,1,0,0,1156.87,8,148390.6,22,3,5,3,True
5159106,1143,4,-1,8940,572375593,1,1,0,1157.04,4,148390.6,15,6,23,3,True
5185502,294,3,-1,3934,572375593,1,2,0,1157.17,4,148390.6,4,3,14,4,True
5200646,1028,4,30,1545,572375593,1,0,0,1156.83,8,147233.77,11,5,7,4,True
5396566,1015,0,10,6890,572375593,1,0,0,1156.92,6,148390.69,26,1,9,5,True
5451985,1028,4,-1,3835,572375593,1,1,0,1156.85,4,148390.69,11,1,5,6,True
5557393,294,3,25,7669,572375593,1,0,0,1156.82,8,147233.87,4,3,22,7,True
5731090,1238,0,10,7114,572375593,1,0,0,1157.01,6,148390.88,18,5,2,7,True
5766585,631,3,451,8742,572375593,1,0,0,1157.38,7,147233.5,11,1,17,8,True
5822080,1143,4,25,7432,572375593,1,0,0,1157.09,8,146076.41,15,6,16,8,True
5867401,1028,4,25,5645,572375593,1,0,0,1156.88,8,144919.53,11,5,10,8,False
6142137,1028,4,451,6890,572375593,1,0,0,1156.84,7,143762.69,11,0,16,9,True
6179362,1028,4,30,3835,572375593,1,0,0,1156.95,8,142605.74,11,2,14,9,True
6461874,713,0,20,3934,572375593,1,0,0,1157.22,5,141448.52,18,3,16,9,False
6615469,1028,4,-1,1545,572375593,1,1,0,1157.26,4,141448.52,11,1,15,9,True
6634643,294,3,451,9785,572375593,1,0,0,1157.05,7,140291.47,4,4,17,10,True
6751064,353,1,10,3934,572375593,1,0,0,1157.14,0,141448.61,24,1,13,11,True
6765570,995,1,-1,8940,572375593,1,1,0,1157.11,1,141448.61,22,2,12,1,True
6971709,950,0,-1,3934,572375593,1,2,0,1156.97,1,141448.61,24,2,15,2,True
6994391,1364,0,10,4370,572375593,1,0,0,1157.02,6,142605.63,16,3,8,3,True
7091705,1449,0,10,9477,572375593,1,0,0,1156.6,0,143762.23,11,6,13,4,True
7282603,294,3,451,1545,572375593,1,0,0,1156.91,7,142605.32,4,2,5,6,True
7486715,585,2,20,4370,572375593,1,0,0,1156.97,5,141448.35,11,6,7,7,True
7777360,645,0,10,9759,572375593,1,0,0,1157.12,0,142605.47,24,1,15,8,True
7993281,1249,2,20,8742,572375593,1,0,0,1157.04,5,141448.43,23,0,18,9,True
8044637,677,0,20,2775,572375593,1,0,0,1156.97,3,140291.46,24,1,17,9,True
8072352,995,1,-1,4894,572375593,1,1,0,1157.08,4,140291.46,22,3,0,9,True
8303623,1143,4,25,5645,572375593,1,0,0,1157.26,8,139134.2,15,1,5,9,True
9297422,294,3,25,4894,572375593,1,0,0,1157.17,8,137977.03,4,3,11,10,True
9306184,294,3,451,4370,572375593,1,0,0,1156.92,7,136820.11,4,0,3,10,True
9740484,937,0,10,4894,572375593,1,0,0,1157.11,6,137977.22,24,3,23,11,True
9923792,950,0,451,1327,572375593,1,0,0,1157.01,7,136820.21,24,3,2,11,True
1225223,314,0,30,1708,954571357,1,0,0,972.87,8,380152.13,4,5,17,2,True
1460912,1409,1,30,8929,954571357,1,0,0,972.88,8,379179.25,24,2,15,3,True
1986140,695,2,20,1708,954571357,1,0,0,973.02,5,378206.23,24,4,9,3,True
2108455,1436,0,20,2507,954571357,1,0,0,972.9,5,377233.33,24,6,5,5,True
2238364,1179,0,20,8929,954571357,1,0,0,972.76,3,376260.57,24,3,5,5,True
2482362,1179,0,20,4259,954571357,1,0,0,972.87,5,375287.7,24,4,1,5,True
2897396,1409,1,451,8222,954571357,1,0,0,973.03,7,374314.67,24,5,6,6,True
3133044,1403,4,25,2752,954571357,1,0,0,972.98,8,373341.69,24,5,3,6,True
3153022,701,2,20,5841,954571357,1,0,0,972.9,3,372368.79,18,3,7,7,True
3176494,314,0,451,9272,954571357,1,0,0,972.91,7,371395.88,4,5,9,9,True
3353118,866,0,20,3679,954571357,1,0,0,972.95,5,370422.93,24,0,18,9,True
3355384,1160,0,10,9272,954571357,1,0,0,972.95,6,371395.88,15,1,8,10,True
3364453,1403,4,-1,9272,954571357,1,1,0,973.02,1,371395.88,24,1,21,10,True
3552304,314,0,25,2266,954571357,1,0,0,972.89,8,370422.99,4,6,10,1,True
3679991,1010,0,10,8368,954571357,1,0,0,973.32,6,371396.31,26,4,15,2,True
3756881,1409,1,25,5841,954571357,1,0,0,972.99,8,370423.32,24,5,5,2,True
3828126,869,2,451,6546,954571357,1,0,0,972.95,7,369450.37,24,1,20,2,True
3866849,1010,0,20,5449,954571357,1,0,0,973.09,5,368477.28,26,1,20,3,True
4045969,1416,4,451,9634,954571357,1,0,0,973.07,7,367504.21,24,3,21,3,True
4089974,577,0,10,2507,954571357,1,0,0,972.8,6,368477.01,11,5,15,4,True
4293989,1271,0,10,2185,954571357,1,0,0,972.89,0,369449.9,23,1,1,4,True
4301738,300,0,451,3257,954571357,1,0,0,972.76,7,368477.14,4,3,22,5,True
4310389,1416,4,-1,2507,954571357,1,1,0,973.0,4,368477.14,24,2,11,6,True
4430182,993,0,10,8368,954571357,1,0,0,972.96,6,369450.1,22,4,21,6,True
4590090,314,0,451,9634,954571357,1,0,0,973.06,7,368477.04,4,3,6,6,True
4627552,314,0,451,2752,954571357,1,0,0,972.91,7,367504.13,4,5,18,7,True
5224128,314,0,-1,2266,954571357,1,1,0,972.9,4,367504.13,4,1,18,8,True
5747026,1359,2,20,9582,954571357,1,0,0,973.17,5,366530.96,24,5,4,9,True
6080629,869,2,30,9634,954571357,1,0,0,973.27,8,365557.69,24,3,1,9,True
6138934,1416,4,30,8589,954571357,1,0,0,972.77,8,364584.92,24,1,20,9,True
6299046,1273,0,451,7445,954571357,1,0,0,972.98,7,363611.94,24,2,1,10,True
6384436,1416,4,-1,7445,954571357,1,1,0,972.98,1,363611.94,24,5,18,11,False
6566362,880,1,10,9634,954571357,1,0,0,973.06,6,364585.0,27,5,3,11,True
6623712,1356,2,20,9754,954571357,1,0,0,973.1,3,363611.9,24,6,14,12,True
6647769,300,0,-1,5035,954571357,1,1,0,972.93,1,363611.9,4,4,17,1,True
6777156,385,1,30,2266,954571357,1,0,0,973.04,8,362638.86,25,3,9,1,True
7109220,1140,0,20,9397,954571357,1,0,0,972.99,5,361665.87,15,4,2,1,True
7202216,1361,2,20,9272,954571357,1,0,0,972.92,5,360692.95,16,4,10,1,True
7246874,931,0,20,9441,954571357,1,0,0,973.11,3,359719.84,24,0,18,2,True
7249514,1273,0,25,2266,954571357,1,0,0,973.09,8,358746.75,24,6,0,2,True
7311572,314,0,-1,7445,954571357,1,1,0,972.95,1,358746.75,4,2,9,3,False
7325243,869,2,30,8368,954571357,1,0,0,972.84,8,357773.91,24,2,2,4,False
7331487,1416,4,30,9754,954571357,1,0,0,973.29,8,356800.62,24,4,2,4,True
7845256,869,2,25,9754,954571357,1,0,0,972.96,8,355827.66,24,0,7,5,True
7971583,1403,4,451,3375,954571357,1,0,0,973.07,7,354854.59,24,1,10,5,True
7991704,1303,0,10,2185,954571357,1,0,0,973.08,6,355827.67,5,2,6,5,True
8802035,869,2,30,6546,954571357,1,0,0,972.92,8,354854.75,24,0,1,7,True
8893802,1403,4,30,7445,954571357,1,0,0,973.07,8,353881.68,24,6,22,8,True
8941414,314,0,451,9754,954571357,1,0,0,972.88,7,352908.8,4,4,16,8,True
8998048,385,1,30,2216,954571357,1,0,0,972.97,8,351935.83,25,0,16,9,True
9021745,996,0,20,3679,954571357,1,0,0,972.9,5,350962.93,26,1,14,10,True
9033998,1264,0,10,6546,954571357,1,0,0,972.79,6,351935.72,23,5,20,10,True
9154154,314,0,10,6546,954571357,1,0,0,972.91,6,352908.63,4,1,0,10,True
1299645,94,3,25,8965,722863944,0,0,0,1037.15,8,993890.85,1,1,16,2,True
1481534,1109,4,451,5675,722863944,0,0,0,1037.05,7,992853.8,0,6,21,3,True
1531528,174,3,451,6978,722863944,0,0,0,1036.95,7,991816.85,24,4,22,4,True
1640425,1089,0,10,1409,722863944,0,0,0,1036.86,6,992853.71,18,4,22,4,True
1822270,343,1,10,4810,722863944,0,0,0,1037.16,0,993890.87,24,6,6,4,True
2037261,676,4,451,5784,722863944,0,0,0,1036.74,7,992854.13,24,4,1,4,True
2241881,231,4,451,5784,722863944,0,0,0,1036.93,7,991817.2,26,0,22,4,True
2247922,1109,4,30,6978,722863944,0,0,0,1036.66,8,990780.54,0,2,2,4,True
2664814,231,4,451,8918,722863944,0,0,0,1037.1,7,989743.44,26,1,1,5,True
3084488,1109,4,25,6978,722863944,0,0,0,1037.1,8,988706.34,0,5,4,6,True
3178704,444,2,20,5675,722863944,0,0,0,1037.0,3,987669.34,24,2,0,7,True
3314118,231,4,451,3484,722863944,0,0,0,1037.11,7,986632.23,26,6,10,8,True
3385759,231,4,451,6423,722863944,0,0,0,1036.86,7,985595.37,26,4,16,10,True
3716001,603,0,10,8965,722863944,0,0,0,1037.05,0,986632.42,24,5,14,10,True
3761080,1109,4,451,5691,722863944,0,0,0,1036.82,7,985595.6,0,1,4,10,True
3802578,1349,3,-1,5331,722863944,0,1,0,1037.07,4,985595.6,24,1,7,1,True
3847315,1175,2,20,5675,722863944,0,0,0,1037.06,5,984558.54,24,2,21,2,True
3968955,94,3,30,5784,722863944,0,0,0,1036.93,8,983521.61,1,0,4,2,True
4237965,1109,4,25,5331,722863944,0,0,0,1037.08,8,982484.53,0,3,4,2,True
4980659,59,0,20,6978,722863944,0,0,0,1037.11,5,981447.42,20,6,9,4,True
5245049,174,3,25,5784,722863944,0,0,0,1037.06,8,980410.36,24,3,22,4,True
5262129,231,4,451,4810,722863944,0,0,0,1036.9,7,979373.46,26,3,1,6,True
5294347,231,4,25,7239,722863944,0,0,0,1036.84,8,978336.62,26,2,16,8,True
5356720,231,4,-1,6282,722863944,0,1,0,1037.12,1,978336.62,26,1,17,8,True
5505399,676,4,25,4810,722863944,0,0,0,1036.94,8,977299.68,24,4,15,9,True
5517171,299,1,10,1835,722863944,0,0,0,1036.87,6,978336.55,4,4,16,9,True
5868919,231,4,451,5331,722863944,0,0,0,1036.91,7,977299.64,26,4,16,10,True
5900585,1314,2,20,2025,722863944,0,0,0,1037.03,5,976262.61,5,6,3,10,True
6410793,1349,3,-1,6776,722863944,0,1,0,1037.01,4,976262.61,24,2,11,11,True
6481342,1349,3,-1,1549,722863944,0,2,0,1037.35,1,976262.61,24,2,18,11,True
7220276,558,0,20,1409,722863944,0,0,0,1036.94,5,975225.67,17,5,11,12,True
7560713,676,4,25,6776,722863944,0,0,0,1036.84,8,974188.83,24,3,6,12,True
7745486,1349,3,25,6282,722863944,0,0,0,1036.98,8,973151.85,24,6,20,12,True
8093622,910,0,10,4810,722863944,0,0,0,1037.02,6,974188.87,18,6,20,2,True
8320161,467,0,10,7027,722863944,0,0,0,1036.96,6,975225.83,5,4,2,3,True
8564734,1036,1,10,6776,722863944,0,0,0,1037.05,0,976262.88,11,6,10,3,True
8679310,1109,4,451,8417,722863944,0,0,0,1037.0,7,975225.88,0,4,6,3,True
8692601,94,3,30,1835,722863944,0,0,0,1037.2,8,974188.68,1,6,9,3,True
8906414,1109,4,25,9086,722863944,0,0,0,1037.06,8,973151.62,0,1,14,4,True
9107227,1109,4,451,5718,722863944,0,0,0,1037.12,7,972114.5,0,4,17,4,True
9110527,231,4,25,2025,722863944,0,0,0,1037.05,8,971077.45,26,6,0,4,True
9198639,1349,3,25,7239,722863944,0,0,0,1037.14,8,970040.31,24,2,16,4,True
9454733,1349,3,30,6776,722863944,0,0,0,1036.92,8,969003.39,24,4,3,5,True
9562437,94,3,30,7027,722863944,0,0,0,1037.26,8,967966.13,1,4,8,8,True
9607378,676,4,-1,6776,722863944,0,1,0,1037.12,1,967966.13,24,5,5,9,True
9664722,1109,4,-1,5675,722863944,0,2,0,1036.62,4,967966.13,0,4,7,9,True
9708967,676,4,451,6978,722863944,0,0,0,1036.88,7,966929.25,24,1,15,9,True
9815767,1109,4,30,8965,722863944,0,0,0,1036.97,8,965892.28,0,5,1,10,True
9830164,1109,4,451,5675,722863944,0,0,0,1037.32,7,964854.96,0,1,9,10,True
9876511,1311,2,20,2025,722863944,0,0,0,1036.66,3,963818.3,5,0,1,11,True
9973661,1349,3,30,9086,722863944,0,0,0,1037.0,8,962781.3,24,0,10,11,False
1060733,376,0,20,6446,113138243,1,0,0,249.92,3,391081.08,25,5,16,2,True
1100779,1338,0,20,6705,113138243,1,0,0,249.95,5,390831.13,18,5,23,2,True
1433593,1140,0,10,7999,113138243,1,0,0,250.23,6,391081.36,15,4,9,4,True
1861902,1035,0,10,7944,113138243,1,0,0,250.14,6,391331.5,11,5,9,4,True
2038575,1419,1,30,5177,113138243,1,0,0,250.12,8,391081.38,24,0,10,5,True
2192886,743,4,30,1411,113138243,1,0,0,249.81,8,390831.57,24,6,14,6,True
2432778,1399,0,20,1587,113138243,1,0,0,249.97,5,390581.6,24,5,21,6,True
2634973,743,4,451,1823,113138243,1,0,0,250.08,7,390331.52,24,4,3,7,True
2800687,334,0,20,1655,113138243,1,0,0,249.99,5,390081.53,11,5,17,7,True
2814638,1119,0,10,2715,113138243,1,0,0,250.1,0,390331.63,24,6,8,7,True
2845058,794,2,20,3326,113138243,1,0,0,250.03,3,390081.6,11,3,6,8,True
3020131,443,2,30,1823,113138243,1,0,0,249.92,8,389831.68,24,0,3,8,True
3211623,320,1,25,1655,113138243,1,0,0,250.1,8,389581.58,11,1,11,9,True
3494147,184,0,10,3326,113138243,1,0,0,250.07,0,389831.65,18,4,21,9,True
3597344,205,0,20,9475,113138243,1,0,0,250.17,5,389581.48,9,0,9,9,True
3665845,1296,4,-1,9865,113138243,1,1,0,250.06,4,389581.48,5,5,8,10,True
3823396,947,2,20,2928,113138243,1,0,0,250.04,3,389331.44,24,0,16,10,True
3870353,320,1,451,1411,113138243,1,0,0,250.0,7,389081.44,11,5,0,11,True
3873121,1177,4,451,6705,113138243,1,0,0,249.83,7,388831.61,24,6,6,11,True
4042199,1296,4,30,2928,113138243,1,0,0,250.12,8,388581.49,5,0,17,11,True
4057547,320,1,30,1536,113138243,1,0,0,249.84,8,388331.65,11,6,6,12,True
4073513,670,0,10,2386,113138243,1,0,0,250.15,6,388581.8,18,4,8,2,True
4096563,939,0,20,7999,113138243,1,0,0,249.89,5,388331.91,24,6,6,3,True
4346829,443,2,25,6705,113138243,1,0,0,250.16,8,388081.75,24,4,7,3,True
4551564,743,4,451,6705,113138243,1,0,0,250.01,7,387831.74,24,5,3,3,True
4662855,982,4,25,7999,113138243,1,0,0,249.96,8,387581.78,22,2,8,3,True
4691221,443,2,451,6446,113138243,1,0,0,250.09,7,387331.69,24,6,5,3,True
4992458,467,0,20,6705,113138243,1,0,0,249.9,3,387081.79,5,2,11,5,True
5447385,304,0,10,7705,113138243,1,0,0,249.99,0,387331.78,4,2,22,7,True
5461834,1277,2,20,2715,113138243,1,0,0,249.98,5,387081.8,24,4,9,9,True
5506626,804,0,10,2715,113138243,1,0,0,249.82,0,387331.62,11,5,5,10,True
5645802,1296,4,451,9782,113138243,1,0,0,249.92,7,387081.7,5,6,8,12,True
5705397,1297,0,10,7944,113138243,1,0,0,249.97,6,387331.67,5,0,23,12,True
5762697,996,0,-1,5177,113138243,1,1,0,250.1,4,387331.67,26,6,13,12,False
5992654,867,0,20,2386,113138243,1,0,0,249.8,5,387081.87,24,6,14,1,True
7032996,1177,4,-1,1411,113138243,1,1,0,250.05,1,387081.87,24,2,18,1,True
7137335,812,0,20,2386,113138243,1,0,0,250.05,5,386831.82,18,3,23,2,True
7177769,743,4,25,7705,113138243,1,0,0,249.99,8,386581.83,24,6,15,2,True
7192254,982,4,25,1411,113138243,1,0,0,250.0,8,386331.83,22,2,10,3,True
7310292,570,2,20,7944,113138243,1,0,0,249.95,5,386081.88,11,5,15,3,True
7478826,1177,4,25,5177,113138243,1,0,0,250.13,8,385831.75,24,5,18,5,True
7740407,320,1,451,7999,113138243,1,0,0,250.09,7,385581.66,11,4,15,5,True
7827200,320,1,451,1655,113138243,1,0,0,250.0,7,385331.66,11,6,21,6,True
8190147,1474,0,10,7999,113138243,1,0,0,249.88,6,385581.54,24,6,19,7,True
8754521,1296,4,25,7999,113138243,1,0,0,250.09,8,385331.45,5,4,19,7,True
8828565,831,1,10,4396,113138243,1,0,0,250.17,6,385581.62,5,6,18,8,True
9117355,287,0,20,2928,113138243,1,0,0,249.81,3,385331.81,24,1,22,8,True
9706758,320,1,25,7999,113138243,1,0,0,249.99,8,385081.82,11,5,16,8,True
9735772,1296,4,30,2715,113138243,1,0,0,250.11,8,384831.71,5,3,11,10,True
9850547,1177,4,25,2715,113138243,1,0,0,249.94,8,384581.77,24,0,7,11,True
9873200,645,0,20,2163,113138243,1,0,0,249.74,5,384332.03,24,3,7,11,True
1835400,1434,0,10,8769,459383836,0,0,0,547.94,0,338795.94,24,6,5,1,True
1847411,319,0,30,9334,459383836,0,0,0,547.79,8,338248.15,11,5,13,1,True
1853953,32,3,25,5449,459383836,0,0,0,548.17,8,337699.98,11,5,14,1,True
1908183,218,0,-1,7338,459383836,0,1,0,547.96,4,337699.98,9,3,16,1,True
2132268,218,0,30,9846,459383836,0,0,0,548.26,8,337151.72,9,3,0,2,True
2293142,249,0,10,8769,459383836,0,0,0,547.98,0,337699.7,6,0,16,2,True
2591386,1322,2,20,8514,459383836,0,0,0,547.93,5,337151.77,18,0,0,3,True
2776679,32,3,451,8540,459383836,0,0,0,548.04,7,336603.73,11,6,0,4,True
2851995,218,0,451,5449,459383836,0,0,0,548.2,7,336055.53,9,3,20,4,True
2874592,319,0,-1,7338,459383836,0,1,0,547.83,4,336055.53,11,3,19,5,True
2976751,1305,2,20,4300,459383836,0,0,0,547.86,5,335507.67,5,6,17,5,True
3013817,319,0,451,8769,459383836,0,0,0,547.9,7,334959.77,11,1,21,6,True
3062462,694,2,20,9334,459383836,0,0,0,548.0,5,334411.77,24,1,8,8,True
3190700,1153,3,25,5480,459383836,0,0,0,548.04,8,333863.73,15,6,6,8,True
3320996,1153,3,25,5480,459383836,0,0,0,548.16,8,333315.57,15,1,14,8,True
3401722,1153,3,-1,3920,459383836,0,1,0,547.94,4,333315.57,15,4,22,10,True
3511523,218,0,30,2109,459383836,0,0,0,548.15,8,332767.42,9,1,12,11,True
3531339,1153,3,25,9258,459383836,0,0,0,547.91,8,332219.51,15,3,13,11,True
3773038,1153,3,30,7161,459383836,0,0,0,547.95,8,331671.56,15,5,10,11,True
4161180,1153,3,30,9334,459383836,0,0,0,547.8,8,331123.76,15,1,9,11,True
4170434,32,3,-1,2109,459383836,0,1,0,547.92,4,331123.76,11,2,12,11,True
4353379,319,0,451,9334,459383836,0,0,0,547.88,7,330575.88,11,3,19,12,True
4393263,1153,3,451,9846,459383836,0,0,0,548.19,7,330027.69,15,4,1,12,True
4732445,319,0,30,9334,459383836,0,0,0,547.9,8,329479.79,11,2,15,12,True
4732642,577,0,451,9258,459383836,0,0,0,548.1,7,328931.69,11,3,19,1,True
4885299,218,0,30,8514,459383836,0,0,0,548.02,8,328383.67,9,0,17,2,True
5128901,32,3,30,6204,459383836,0,0,0,548.12,8,327835.55,11,2,7,3,True
5389433,205,0,10,9258,459383836,0,0,0,547.8,0,328383.35,9,5,6,3,True
5611856,371,3,451,4058,459383836,0,0,0,548.14,7,327835.21,25,3,11,3,True
5914347,371,3,451,8540,459383836,0,0,0,548.19,7,327287.02,25,1,16,4,True
6251623,371,3,451,3920,459383836,0,0,0,547.86,7,326739.16,25,5,10,4,True
6330979,577,0,451,8769,459383836,0,0,0,547.94,7,326191.22,11,0,14,5,True
6430662,319,0,451,7338,459383836,0,0,0,548.03,7,325643.19,11,3,5,5,True
6643236,1153,3,25,5480,459383836,0,0,0,548.08,8,325095.11,15,5,6,6,True
6877394,371,3,25,7161,459383836,0,0,0,547.99,8,324547.12,25,1,20,7,True
6906985,218,0,451,8769,459383836,0,0,0,548.32,7,323998.8,9,3,17,7,True
7073479,688,0,20,8769,459383836,0,0,0,548.11,3,323450.69,24,2,16,8,False
7237566,228,0,10,8514,459383836,0,0,0,548.02,6,323998.71,26,6,17,8,True
7329236,371,3,30,8540,459383836,0,0,0,547.94,8,323450.77,25,5,21,9,True
7415425,577,0,25,5449,459383836,0,0,0,547.97,8,322902.8,11,1,19,11,True
7548758,1153,3,-1,8769,459383836,0,1,0,547.83,1,322902.8,15,4,11,12,True
7610938,1206,0,10,4300,459383836,0,0,0,548.21,0,323451.01,24,0,22,12,True
7857453,341,0,10,4058,459383836,0,0,0,548.05,6,323999.06,24,1,6,12,True
7974043,577,0,-1,9846,459383836,0,1,0,548.03,4,323999.06,11,2,0,12,True
8016065,371,3,30,3920,459383836,0,0,0,547.96,8,323451.1,25,2,6,1,True
8128238,1153,3,451,4058,459383836,0,0,0,548.08,7,322903.02,15,3,3,2,True
8491839,300,0,20,5480,459383836,0,0,0,548.18,5,322354.84,4,2,7,3,True
8583295,319,0,30,7338,459383836,0,0,0,547.99,8,321806.85,11,2,14,3,True
8983508,931,0,20,8769,459383836,0,0,0,548.04,5,321258.81,24,6,22,3,True
9136070,218,0,451,8540,459383836,0,0,0,547.89,7,320710.92,9,4,16,5,True
9155848,1075,0,20,7338,459383836,0,0,0,547.63,5,320163.29,18,1,11,6,True
9246162,208,0,10,5449,459383836,0,0,0,547.93,6,320711.22,9,2,22,6,True
9246281,371,3,-1,7338,459383836,0,1,0,547.95,1,320711.22,25,6,11,7,True
9712316,1010,0,10,8540,459383836,0,0,0,547.99,6,321259.21,26,3,10,8,True
9741470,577,0,451,3920,459383836,0,0,0,548.04,7,320711.17,11,5,11,9,True
9746270,880,1,10,8769,459383836,0,0,0,548.03,0,321259.2,27,3,15,10,False
9783198,577,0,10,4058,459383836,0,0,0,547.91,0,321807.11,11,1,3,10,True
1105718,952,0,-1,7832,542488442,1,1,0,811.13,4,514763.0,13,4,1,1,True
1215789,517,4,30,2660,542488442,1,0,0,810.83,8,513952.17,12,2,23,2,True
1221569,1124,0,10,7832,542488442,1,0,0,810.95,0,514763.12,24,4,4,2,True
1229483,1111,0,20,8533,542488442,1,0,0,810.72,5,513952.4,0,0,21,2,True
1371638,377,4,451,6946,542488442,1,0,0,810.83,7,513141.57,25,0,6,2,True
1741191,952,0,25,7835,542488442,1,0,0,810.97,8,512330.6,13,5,17,3,True
1746412,517,4,451,3655,542488442,1,0,0,811.06,7,511519.54,12,5,13,4,False
1780334,952,0,25,2522,542488442,1,0,0,810.97,8,510708.57,13,6,7,4,True
1929080,377,4,451,6923,542488442,1,0,0,810.93,7,509897.64,25,4,19,5,True
2061547,531,0,451,7167,542488442,1,0,0,810.92,7,509086.72,18,1,10,5,True
2161967,377,4,30,3655,542488442,1,0,0,810.79,8,508275.93,25,4,6,6,True
2198281,611,0,10,3655,542488442,1,0,0,811.11,0,509087.04,11,0,20,8,True
2246047,952,0,-1,7339,542488442,1,1,0,810.89,1,509087.04,13,0,3,10,False
2304063,1012,0,20,4807,542488442,1,0,0,810.94,3,508276.1,26,4,12,12,True
2701997,35,2,-1,2522,542488442,1,1,0,811.06,4,508276.1,11,4,10,12,True
2942704,924,4,30,7314,542488442,1,0,0,811.11,8,507464.99,18,4,20,12,True
3077125,1318,0,25,3211,542488442,1,0,0,810.94,8,506654.05,18,5,19,1,True
3099371,1406,0,10,4807,542488442,1,0,0,810.97,6,507465.02,24,1,15,1,True
3217731,727,0,20,2660,542488442,1,0,0,810.98,5,506654.04,11,4,0,3,True
3223993,1426,1,10,2522,542488442,1,0,0,810.91,0,507464.95,24,5,6,4,True
3262987,996,0,20,4807,542488442,1,0,0,811.27,3,506653.68,26,0,2,4,True
3607545,1318,0,451,3211,542488442,1,0,0,810.82,7,505842.86,18,3,16,5,True
3664828,249,0,10,3655,542488442,1,0,0,811.25,0,506654.11,6,4,12,7,True
3920432,517,4,451,7972,542488442,1,0,0,811.07,7,505843.04,12,0,1,7,True
4007967,68,0,20,6264,542488442,1,0,0,811.33,5,505031.71,20,3,20,8,True
4142063,525,0,10,2384,542488442,1,0,0,811.08,6,505842.79,18,5,2,8,True
4198119,1025,1,10,3211,542488442,1,0,0,810.82,0,506653.61,11,1,12,8,True
4296687,952,0,30,7167,542488442,1,0,0,810.93,8,505842.68,13,0,6,8,True
4307923,35,2,451,3211,542488442,1,0,0,810.93,7,505031.75,11,0,7,8,True
4406109,887,2,20,6264,542488442,1,0,0,810.97,5,504220.78,27,4,9,8,True
4719282,1429,0,10,3211,542488442,1,0,0,811.1,6,505031.88,24,5,14,9,True
4821468,35,2,451,7972,542488442,1,0,0,811.08,7,504220.8,11,2,19,11,True
4984044,471,0,10,3655,542488442,1,0,0,810.98,6,505031.78,5,4,6,12,True
5104985,1318,0,-1,4807,542488442,1,1,0,811.16,4,505031.78,18,1,7,1,True
5242809,377,4,25,7832,542488442,1,0,0,811.06,8,504220.72,25,3,16,1,True
5512543,531,0,10,7972,542488442,1,0,0,811.02,6,505031.74,18,2,5,2,True
5525809,377,4,451,7832,542488442,1,0,0,811.17,7,504220.57,25,1,23,3,True
5652044,952,0,451,7832,542488442,1,0,0,811.04,7,503409.53,13,5,13,3,True
5674986,1318,0,-1,7167,542488442,1,1,0,811.17,4,503409.53,18,2,11,3,True
5757706,1318,0,451,2384,542488442,1,0,0,811.02,7,502598.51,18,4,18,3,True
5821128,531,0,451,3211,542488442,1,0,0,810.76,7,501787.75,18,1,14,4,True
6016412,35,2,451,7339,542488442,1,0,0,810.66,7,500977.09,11,6,23,5,True
6249867,562,1,10,4346,542488442,1,0,0,810.85,6,501787.94,17,3,13,6,True
6734248,900,1,10,6264,542488442,1,0,0,810.87,6,502598.81,24,3,23,6,True
7285718,531,0,451,4807,542488442,1,0,0,810.79,7,501788.02,18,6,23,7,True
7657235,924,4,25,6264,542488442,1,0,0,811.1,8,500976.92,18,5,20,8,False
7700983,35,2,30,6923,542488442,1,0,0,811.19,8,500165.73,11,2,9,8,True
8242898,517,4,-1,7835,542488442,1,1,0,811.02,4,500165.73,12,2,11,8,True
8254873,35,2,30,8284,542488442,1,0,0,811.04,8,499354.69,11,5,14,9,True
8719803,952,0,-1,7339,542488442,1,1,0,811.2,4,499354.69,13,6,3,10,True
9018617,531,0,451,2522,542488442,1,0,0,810.96,7,498543.73,18,3,16,10,True
9241307,377,4,451,2660,542488442,1,0,0,810.71,7,497733.02,25,0,9,11,True
9339659,531,0,30,3655,542488442,1,0,0,811.05,8,496921.97,18,0,0,11,True
9753741,1318,0,-1,7339,542488442,1,1,0,810.95,1,496921.97,18,4,2,11,True
1141832,114,0,25,7351,124638020,1,0,0,743.02,8,734078.98,3,2,9,2,True
1934654,1325,0,-1,7810,124638020,1,1,0,743.03,4,734078.98,18,4,5,2,True
2329900,297,0,451,8043,124638020,1,0,0,743.07,7,733335.91,4,3,15,3,True
2578146,260,0,-1,1002,124638020,1,1,0,742.9,4,733335.91,6,3,19,3,True
2634242,757,0,10,3639,124638020,1,0,0,742.95,6,734078.86,24,0,7,5,True
2804397,1380,0,20,7351,124638020,1,0,0,742.97,5,733335.89,16,6,13,5,True
3100895,665,2,451,5055,124638020,1,0,0,742.83,7,732593.06,18,0,3,5,True
3180197,219,0,10,9854,124638020,1,0,0,743.03,0,733336.09,9,5,22,5,True
4066966,376,0,20,7905,124638020,1,0,0,742.73,5,732593.36,25,4,21,8,True
4086532,1321,0,20,7810,124638020,1,0,0,742.98,5,731850.38,18,5,2,8,True
4098387,268,2,30,8839,124638020,1,0,0,743.09,8,731107.29,24,0,5,8,True
4167551,962,0,20,2346,124638020,1,0,0,743.03,5,730364.26,13,2,7,8,True
4198760,114,0,-1,3639,124638020,1,1,0,742.72,4,730364.26,3,6,1,9,True
4240912,1192,2,20,1773,124638020,1,0,0,743.22,5,729621.04,24,6,10,9,True
4282275,1127,0,20,2346,124638020,1,0,0,743.07,5,728877.97,24,6,17,10,True
4299036,268,2,30,7351,124638020,1,0,0,743.15,8,728134.82,24,6,23,10,True
4383474,297,0,-1,3047,124638020,1,1,0,743.08,4,728134.82,4,3,12,11,True
4493297,260,0,-1,3601,124638020,1,2,0,743.04,1,728134.82,6,1,21,11,True
4781876,804,0,20,7905,124638020,1,0,0,742.85,5,727391.97,11,3,22,11,True
5164140,1086,0,20,5055,124638020,1,0,0,743.07,3,726648.9,18,4,3,12,True
5195711,114,0,-1,8839,124638020,1,1,0,742.88,4,726648.9,3,0,13,12,True
5402728,665,2,30,3639,124638020,1,0,0,742.79,8,725906.11,18,4,8,1,True
5601889,699,4,451,1488,124638020,1,0,0,743.24,7,725162.87,18,6,19,2,True
5672495,268,2,30,1773,124638020,1,0,0,743.12,8,724419.75,24,5,1,2,True
5677826,665,2,25,7019,124638020,1,0,0,743.22,8,723676.53,18,2,14,4,True
6217671,699,4,451,3639,124638020,1,0,0,742.87,7,722933.66,18,5,4,4,True
6256188,393,1,25,4129,124638020,1,0,0,743.18,8,722190.48,10,2,12,5,True
6352926,1325,0,30,5055,124638020,1,0,0,743.3,8,721447.18,18,6,15,5,True
6434904,114,0,451,1002,124638020,1,0,0,742.85,7,720704.33,3,4,17,6,True
6462909,268,2,25,7351,124638020,1,0,0,743.13,8,719961.2,24,0,5,6,True
6513370,268,2,30,7019,124638020,1,0,0,743.21,8,719217.99,24,3,2,6,True
6604078,1179,0,10,3061,124638020,1,0,0,743.24,6,719961.23,24,3,13,7,True
6705460,297,0,-1,4473,124638020,1,1,0,742.68,1,719961.23,4,5,19,7,True
6902287,268,2,25,7905,124638020,1,0,0,743.02,8,719218.21,24,2,1,8,True
7344335,254,0,20,9854,124638020,1,0,0,743.05,5,718475.16,6,0,8,9,True
7441325,393,1,30,1777,124638020,1,0,0,743.1,8,717732.06,10,2,8,9,True
7452780,459,1,10,7361,124638020,1,0,0,743.02,0,718475.08,13,0,3,9,True
7509788,297,0,25,1488,124638020,1,0,0,742.92,8,717732.16,4,3,23,11,True
7591418,297,0,30,5055,124638020,1,0,0,743.17,8,716988.99,4,4,15,11,True
7654298,599,0,20,4129,124638020,1,0,0,742.95,3,716246.04,24,5,0,12,True
7861751,260,0,30,3601,124638020,1,0,0,742.95,8,715503.09,6,5,23,12,True
7889902,268,2,-1,6688,124638020,1,1,0,743.03,1,715503.09,24,6,17,12,True
7990799,728,1,10,6004,124638020,1,0,0,743.18,6,716246.27,11,2,0,1,True
8033528,1112,1,10,3601,124638020,1,0,0,743.11,6,716989.38,0,1,13,2,True
8047970,325,0,20,1773,124638020,1,0,0,742.99,5,716246.39,11,3,0,2,True
8279377,1477,2,20,1002,124638020,1,0,0,742.78,3,715503.61,24,1,2,3,True
8778312,1325,0,30,1777,124638020,1,0,0,743.04,8,714760.57,18,4,20,4,True
8932923,665,2,25,6004,124638020,1,0,0,742.82,8,714017.75,18,3,4,5,True
9177649,126,1,10,9854,124638020,1,0,0,742.81,0,714760.56,18,3,9,5,True
9256993,350,0,10,1777,124638020,1,0,0,743.02,6,715503.58,24,5,22,5,True
9356457,260,0,30,3061,124638020,1,0,0,743.16,8,714760.42,6,1,11,9,True
9440943,297,0,25,5055,124638020,1,0,0,743.03,8,714017.39,4,5,6,9,True
9445339,114,0,25,7361,124638020,1,0,0,742.96,8,713274.43,3,0,2,9,True
9474753,699,4,25,7905,124638020,1,0,0,743.04,8,712531.39,18,3,9,10,True
9801314,297,0,451,7905,124638020,1,0,0,742.85,7,711788.54,4,1,19,10,True
9976060,393,1,30,7019,124638020,1,0,0,743.12,8,711045.42,10,2,19,11,True
1086708,341,0,30,2760,493677673,1,0,0,712.05,8,636292.95,24,6,20,1,True
1087795,1166,2,20,6143,493677673,1,0,0,712.3,5,635580.65,24,0,5,1,True
1125429,860,1,25,9545,493677673,1,0,0,712.0,8,634868.65,24,0,5,1,True
1147497,369,1,30,4867,493677673,1,0,0,711.83,8,634156.82,25,1,20,2,True
1178705,341,0,25,5690,493677673,1,0,0,712.04,8,633444.78,24,5,11,3,True
1216494,857,1,10,4284,493677673,1,0,0,711.98,6,634156.76,24,2,12,4,True
1347860,369,1,451,6143,493677673,1,0,0,711.72,7,633445.04,25,4,6,4,True
1367909,369,1,30,9545,493677673,1,0,0,711.89,8,632733.15,25,4,5,9,True
1376388,1495,3,451,5449,493677673,1,0,0,712.05,7,632021.1,24,5,4,11,True
1386245,346,0,10,7233,493677673,1,0,0,711.81,6,632732.91,24,1,3,12,True
1569071,749,4,451,5690,493677673,1,0,0,711.98,7,632020.93,24,3,11,12,True
1714008,154,4,25,1941,493677673,1,0,0,711.95,8,631308.98,18,5,10,1,True
1799228,665,2,20,8367,493677673,1,0,0,711.9,3,630597.08,18,0,4,2,True
2081256,749,4,25,4284,493677673,1,0,0,711.76,8,629885.32,24,0,7,3,True
2163984,1010,0,10,5690,493677673,1,0,0,712.21,6,630597.53,26,1,19,4,True
2257396,341,0,-1,8367,493677673,1,1,0,712.06,1,630597.53,24,1,0,4,True
2598479,1495,3,451,3233,493677673,1,0,0,712.43,7,629885.1,24,4,13,5,True
2679586,341,0,10,8954,493677673,1,0,0,711.93,0,630597.03,24,5,14,5,True
2794065,154,4,-1,9545,493677673,1,1,0,711.95,4,630597.03,18,0,18,6,True
2890803,749,4,451,7233,493677673,1,0,0,711.92,7,629885.11,24,1,16,7,True
2914666,659,4,30,3233,493677673,1,0,0,711.96,8,629173.15,18,5,21,10,True
3060056,858,1,10,3233,493677673,1,0,0,712.0,6,629885.15,24,6,12,10,True
3070718,1035,0,20,4867,493677673,1,0,0,711.98,5,629173.17,11,0,2,12,True
3081400,550,0,20,3233,493677673,1,0,0,711.82,3,628461.35,17,5,2,1,True
3089655,154,4,451,4867,493677673,1,0,0,712.05,7,627749.3,18,4,9,1,True
3315161,749,4,451,4867,493677673,1,0,0,712.1,7,627037.2,24,0,12,4,True
3342659,1303,0,20,1173,493677673,1,0,0,711.84,5,626325.36,5,0,5,4,True
3666845,787,0,20,7487,493677673,1,0,0,712.06,5,625613.3,14,1,17,4,True
3713215,749,4,451,6143,493677673,1,0,0,711.69,7,624901.61,24,6,2,6,True
3725658,748,1,10,3252,493677673,1,0,0,712.12,6,625613.73,24,1,12,8,True
3855117,341,0,-1,1622,493677673,1,1,0,711.93,4,625613.73,24,0,13,9,True
4191410,341,0,-1,1941,493677673,1,2,0,711.93,4,625613.73,24,2,7,10,True
4557581,158,2,-1,6143,493677673,1,3,1,712.01,4,625613.73,24,1,20,10,True
1079150,529,2,30,3994,666044189,0,0,0,845.19,8,254339.81,18,4,21,1,False
1171072,1483,0,10,6328,666044189,0,0,0,844.91,6,255184.72,24,6,22,1,True
1188010,1480,4,25,9382,666044189,0,0,0,845.2,8,254339.52,24,0,2,1,True
1432128,1119,0,20,5987,666044189,0,0,0,844.99,3,253494.53,24,2,19,3,False
1986736,757,0,20,5987,666044189,0,0,0,844.84,5,252649.69,24,3,12,3,True
2058306,177,4,451,9382,666044189,0,0,0,844.91,7,251804.78,24,3,4,4,True
2068210,1044,0,10,6106,666044189,0,0,0,845.05,6,252649.83,11,2,8,4,True
2207813,1243,2,20,5572,666044189,0,0,0,845.08,5,251804.75,18,1,18,4,True
2622714,177,4,25,9458,666044189,0,0,0,844.82,8,250959.93,24,0,4,4,True
2968006,790,0,10,5572,666044189,0,0,0,845.13,6,251805.06,11,3,18,5,True
3031941,841,1,-1,9066,666044189,0,1,0,845.27,4,251805.06,5,3,17,7,True
3035494,1480,4,30,9756,666044189,0,0,0,844.89,8,250960.17,24,5,20,8,True
3041875,84,4,451,5572,666044189,0,0,0,845.14,7,250115.03,1,2,13,8,True
3135412,917,0,10,3478,666044189,0,0,0,845.39,0,250960.42,18,3,15,9,True
3157056,84,4,25,9458,666044189,0,0,0,844.71,8,250115.71,1,5,18,11,False
3178591,1195,1,451,5572,666044189,0,0,0,844.69,7,249271.02,24,1,21,11,True
3303885,1195,1,25,4715,666044189,0,0,0,845.11,8,248425.91,24,6,17,12,True
3656590,471,0,10,3008,666044189,0,0,0,845.01,6,249270.92,5,0,11,1,False
3708332,177,4,-1,4715,666044189,0,1,0,844.84,1,249270.92,24,3,18,2,True
3895363,1480,4,451,2535,666044189,0,0,0,845.0,7,248425.92,24,3,11,3,True
3956007,1217,0,10,5987,666044189,0,0,0,845.09,0,249271.01,24,3,23,5,True
4373627,84,4,451,8006,666044189,0,0,0,844.94,7,248426.07,1,2,7,5,True
4401253,1090,0,10,9382,666044189,0,0,0,845.05,6,249271.12,18,5,7,7,True
4474484,529,2,-1,3008,666044189,0,1,0,845.01,4,249271.12,18,1,18,7,True
4479718,529,2,451,9756,666044189,0,0,0,845.01,7,248426.11,18,3,6,7,True
4719638,177,4,451,9066,666044189,0,0,0,844.8,7,247581.31,24,4,15,8,True
4766297,841,1,30,1213,666044189,0,0,0,845.07,8,246736.24,5,4,21,9,True
4839935,841,1,25,3478,666044189,0,0,0,845.01,8,245891.23,5,2,15,9,True
4857975,1195,1,25,2590,666044189,0,0,0,844.92,8,245046.31,24,0,12,9,True
4882696,806,1,10,6328,666044189,0,0,0,844.85,6,245891.16,11,1,13,9,True
4979431,841,1,30,3008,666044189,0,0,0,844.96,8,245046.2,5,4,7,9,True
5349122,84,4,25,6328,666044189,0,0,0,845.04,8,244201.16,1,5,5,10,True
5419763,84,4,451,8006,666044189,0,0,0,844.83,7,243356.33,1,1,16,11,True
5484592,1480,4,451,5987,666044189,0,0,0,845.11,7,242511.22,24,4,19,12,True
5493769,841,1,10,8006,666044189,0,0,0,844.99,6,243356.21,5,5,12,12,True
6119816,267,0,20,6106,666044189,0,0,0,845.22,5,242510.99,6,4,18,1,True
6354254,841,1,25,3994,666044189,0,0,0,844.83,8,241666.16,5,1,15,1,True
6754270,84,4,451,9756,666044189,0,0,0,845.22,7,240820.94,1,2,3,1,True
6877590,841,1,451,9756,666044189,0,0,0,845.08,7,239975.86,5,0,19,2,True
6933068,1195,1,25,5572,666044189,0,0,0,845.2,8,239130.66,24,3,3,2,True
7435872,841,1,30,6106,666044189,0,0,0,845.05,8,238285.61,5,5,7,2,True
7476524,1480,4,30,1716,666044189,0,0,0,844.93,8,237440.68,24,6,10,3,True
7614903,599,0,10,3008,666044189,0,0,0,845.14,6,238285.82,24,0,19,3,True
8474220,1195,1,25,9458,666044189,0,0,0,844.84,8,237440.98,24,6,10,3,True
8535660,84,4,451,2535,666044189,0,0,0,845.23,7,236595.75,1,1,10,5,True
8760573,670,0,10,8006,666044189,0,0,0,845.06,0,237440.81,18,6,2,5,True
9101599,84,4,25,3008,666044189,0,0,0,844.85,8,236595.96,1,2,19,5,True
9109792,84,4,30,3478,666044189,0,0,0,845.23,8,235750.73,1,4,3,6,True
9318702,1480,4,30,1293,666044189,0,0,0,844.8,8,234905.93,24,4,3,6,True
9378043,1273,0,20,2535,666044189,0,0,0,844.76,3,234061.17,24,4,12,7,True
9533417,523,2,20,4715,666044189,0,0,0,845.21,3,233215.96,18,4,0,8,True
9573932,907,0,10,9756,666044189,0,0,0,844.89,6,234060.85,2,4,18,9,True
9695643,1311,2,20,5922,666044189,0,0,0,845.01,5,233215.84,5,1,17,10,True
9731266,1195,1,30,1293,666044189,0,0,0,845.1,8,232370.74,24,3,3,10,True
9809438,529,2,25,4715,666044189,0,0,0,845.06,8,231525.68,18,3,7,11,True
1055552,349,2,-1,8854,493853809,0,1,0,449.87,4,119938.0,24,4,2,1,True
1138378,663,4,451,6257,493853809,0,0,0,450.26,7,119487.74,18,6,14,1,True
1146316,916,0,20,9737,493853809,0,0,0,450.12,3,119037.62,18,6,15,2,True
1181613,663,4,-1,9303,493853809,0,1,0,449.83,4,119037.62,18,0,12,2,True
1458311,56,4,451,6519,493853809,0,0,0,450.03,7,118587.59,20,3,7,4,True
1542936,567,1,25,1583,493853809,0,0,0,449.83,8,118137.76,11,2,6,4,True
1619234,846,3,25,9737,493853809,0,0,0,450.01,8,117687.75,5,6,3,5,False
1659808,51,0,25,5395,493853809,0,0,0,449.92,8,117237.83,20,5,3,6,True
1809968,846,3,30,9930,493853809,0,0,0,449.88,8,116787.95,5,3,9,6,True
2155481,567,1,30,2568,493853809,0,0,0,449.98,8,116337.97,11,5,1,6,True
2359384,56,4,451,7771,493853809,0,0,0,450.04,7,115887.93,20,1,2,8,True
2722913,51,0,25,7823,493853809,0,0,0,450.28,8,115437.65,20,1,6,10,True
2756511,663,4,30,3410,493853809,0,0,0,449.91,8,114987.74,18,1,4,12,True
2797026,567,1,30,6228,493853809,0,0,0,449.81,8,114537.93,11,4,4,12,True
2798693,1227,0,10,5395,493853809,0,0,0,449.75,6,114987.68,18,6,15,1,True
2901258,51,0,25,3911,493853809,0,0,0,450.16,8,114537.52,20,0,15,1,True
2901600,567,1,25,7823,493853809,0,0,0,450.12,8,114087.4,11,4,4,2,True
3268314,846,3,451,5555,493853809,0,0,0,450.22,7,113637.18,5,4,5,2,False
3307661,286,1,10,6257,493853809,0,0,0,449.75,6,114086.93,24,2,5,3,True
3484041,51,0,25,3399,493853809,0,0,0,450.16,8,113636.77,20,6,7,3,True
3506425,349,2,30,5395,493853809,0,0,0,450.26,8,113186.51,24,2,15,3,True
3536870,349,2,30,7823,493853809,0,0,0,450.08,8,112736.43,24,4,0,3,True
3542372,51,0,451,9930,493853809,0,0,0,449.77,7,112286.66,20,4,21,3,True
3593398,663,4,451,9453,493853809,0,0,0,449.83,7,111836.83,18,4,7,4,True
4248888,663,4,25,7773,493853809,0,0,0,450.19,8,111386.64,18,6,23,5,True
4281161,567,1,451,9930,493853809,0,0,0,450.07,7,110936.57,11,0,3,5,True
4288277,349,2,25,3410,493853809,0,0,0,450.03,8,110486.54,24,2,16,5,True
4330143,567,1,25,7823,493853809,0,0,0,450.05,8,110036.49,11,1,7,6,True
4434174,56,4,451,9453,493853809,0,0,0,450.19,7,109586.3,20,2,6,6,True
4644340,51,0,30,5508,493853809,0,0,0,449.85,8,109136.45,20,5,13,8,True
4716664,51,0,451,6228,493853809,0,0,0,449.94,7,108686.51,20,2,13,8,True
4767904,783,0,10,9930,493853809,0,0,0,450.2,6,109136.71,14,2,6,8,True
5288538,205,0,20,3399,493853809,0,0,0,450.06,5,108686.65,9,0,8,9,True
6272032,567,1,30,6228,493853809,0,0,0,450.05,8,108236.6,11,2,22,11,True
6393426,51,0,-1,7773,493853809,0,1,0,449.92,1,108236.6,20,4,16,11,True
6407879,567,1,451,5133,493853809,0,0,0,449.85,7,107786.75,11,5,10,12,True
6438823,649,0,10,9369,493853809,0,0,0,450.09,0,108236.84,24,0,0,1,True
6441798,1356,2,20,6228,493853809,0,0,0,450.2,3,107786.64,24,6,22,1,True
6626257,594,0,10,8036,493853809,0,0,0,450.0,0,108236.64,24,5,11,2,True
6902500,56,4,451,5437,493853809,0,0,0,449.81,7,107786.83,20,3,22,2,True
7201413,567,1,451,6257,493853809,0,0,0,450.39,7,107336.44,11,1,21,2,True
7311045,663,4,451,5508,493853809,0,0,0,450.04,7,106886.4,18,2,9,3,True
7456490,663,4,451,5395,493853809,0,0,0,450.01,7,106436.39,18,6,1,6,True
7778251,663,4,-1,9369,493853809,0,1,0,449.88,4,106436.39,18,6,1,6,False
7961553,320,1,10,9737,493853809,0,0,0,450.14,6,106886.53,11,2,23,6,True
8348820,349,2,25,5437,493853809,0,0,0,450.05,8,106436.48,24,3,1,8,True
8477381,1476,0,10,5395,493853809,0,0,0,449.8,6,106886.28,24,1,16,8,True
8726716,56,4,-1,3410,493853809,0,1,0,449.77,1,106886.28,20,6,22,8,True
8769397,846,3,451,3410,493853809,0,0,0,449.84,7,106436.44,5,5,7,8,True
8778251,68,0,20,9737,493853809,0,0,0,449.94,5,105986.5,20,4,0,9,True
8823215,663,4,451,7823,493853809,0,0,0,450.07,7,105536.43,18,4,15,9,True
8920974,56,4,451,6228,493853809,0,0,0,449.91,7,105086.52,20,0,10,10,True
9075261,56,4,451,5571,493853809,0,0,0,450.17,7,104636.35,20,5,6,10,True
9154327,349,2,30,9737,493853809,0,0,0,450.06,8,104186.29,24,5,11,10,True
9547652,349,2,451,8773,493853809,0,0,0,449.83,7,103736.46,24,5,9,11,True
1238567,375,4,30,2420,582752937,0,0,0,1096.12,8,893661.88,25,1,1,2,True
1512633,123,0,451,8702,582752937,0,0,0,1096.13,7,892565.75,18,5,0,2,True
1573823,203,0,10,5968,582752937,0,0,0,1095.81,6,893661.56,9,1,5,3,True
1598329,375,4,-1,3854,582752937,0,1,0,1095.82,4,893661.56,25,3,13,3,True
1732013,375,4,30,5462,582752937,0,0,0,1096.06,8,892565.5,25,1,21,4,True
1844756,560,2,451,1084,582752937,0,0,0,1095.95,7,891469.55,17,3,18,4,True
2003767,799,2,20,7617,582752937,0,0,0,1096.04,5,890373.51,11,6,12,5,True
2058246,560,2,30,4803,582752937,0,0,0,1095.99,8,889277.52,17,1,13,5,True
2375979,1363,0,10,9439,582752937,0,0,0,1096.02,6,890373.54,16,4,3,6,True
2776763,160,0,20,8702,582752937,0,0,0,1095.73,3,889277.81,24,2,19,6,True
2958290,1041,0,20,4091,582752937,0,0,0,1095.72,5,888182.09,11,5,15,7,True
2981360,203,0,20,2686,582752937,0,0,0,1095.75,3,887086.34,9,6,14,7,True
3006982,1124,0,20,1935,582752937,0,0,0,1096.07,3,885990.27,24,2,20,7,True
3176377,1324,4,30,1090,582752937,0,0,0,1095.96,8,884894.31,18,4,14,9,True
3207976,647,4,451,7617,582752937,0,0,0,1095.85,7,883798.46,24,6,4,9,True
3258518,1324,4,-1,5462,582752937,0,1,0,1095.97,4,883798.46,18,1,12,9,True
3516553,560,2,451,4091,582752937,0,0,0,1095.97,7,882702.49,17,4,21,10,False
3598951,560,2,-1,5968,582752937,0,1,0,1095.97,4,882702.49,17,5,3,11,True
3713965,216,4,451,5812,582752937,0,0,0,1096.42,7,881606.07,9,0,19,12,True
4684554,216,4,25,1047,582752937,0,0,0,1096.17,8,880509.9,9,1,6,12,False
5176159,560,2,451,4585,582752937,0,0,0,1095.79,7,879414.11,17,3,22,1,True
5222195,123,0,451,5968,582752937,0,0,0,1096.17,7,878317.94,18,2,4,1,True
5252610,123,0,451,9439,582752937,0,0,0,1096.04,7,877221.9,18,4,18,1,True
5512891,123,0,451,2120,582752937,0,0,0,1096.06,7,876125.84,18,0,19,3,True
5789291,560,2,-1,2120,582752937,0,1,0,1096.05,1,876125.84,17,1,14,3,True
5887856,424,1,10,9439,582752937,0,0,0,1095.83,0,877221.67,18,4,7,4,True
6041692,509,0,10,1744,582752937,0,0,0,1095.84,6,878317.51,12,1,7,5,True
6090485,811,0,10,5812,582752937,0,0,0,1096.04,6,879413.55,18,2,13,6,True
6090911,375,4,451,1744,582752937,0,0,0,1096.02,7,878317.53,25,0,19,6,True
6304151,199,0,20,8744,582752937,0,0,0,1096.05,5,877221.48,18,5,12,6,True
6306831,1324,4,30,3281,582752937,0,0,0,1096.21,8,876125.27,18,0,6,7,True
6353812,1324,4,25,2684,582752937,0,0,0,1095.7,8,875029.57,18,4,6,8,True
6694962,1238,0,10,8702,582752937,0,0,0,1096.01,0,876125.58,18,0,4,8,True
6732282,375,4,451,6595,582752937,0,0,0,1095.84,7,875029.74,25,6,7,9,True
6769472,375,4,-1,2686,582752937,0,1,0,1095.94,1,875029.74,25,1,6,9,True
6878043,1111,0,10,4803,582752937,0,0,0,1095.96,6,876125.7,0,4,6,9,True
7095256,216,4,451,1744,582752937,0,0,0,1096.01,7,875029.69,9,1,0,10,True
7116529,375,4,-1,8702,582752937,0,1,0,1096.23,4,875029.69,25,2,21,10,True
7135278,560,2,-1,7617,582752937,0,2,0,1095.97,1,875029.69,17,3,2,11,True
7220420,216,4,25,4091,582752937,0,0,0,1095.55,8,873934.14,9,6,12,11,True
7291427,687,0,10,6595,582752937,0,0,0,1096.2,0,875030.34,24,1,2,12,True
7356062,375,4,451,2420,582752937,0,0,0,1096.03,7,873934.31,25,0,8,1,True
7385942,1324,4,-1,2339,582752937,0,1,0,1096.1,1,873934.31,18,2,19,1,True
7805868,759,0,20,4091,582752937,0,0,0,1095.98,5,872838.33,24,6,12,2,True
8072698,1256,2,20,8702,582752937,0,0,0,1095.85,3,871742.48,23,2,1,3,True
8337949,647,4,-1,3854,582752937,0,1,0,1096.11,4,871742.48,24,6,19,4,True
8338299,647,4,30,3810,582752937,0,0,0,1095.91,8,870646.57,24,1,10,6,True
8498392,123,0,30,5462,582752937,0,0,0,1095.95,8,869550.62,18,0,11,6,True
8528485,1324,4,-1,7617,582752937,0,1,0,1096.33,4,869550.62,18,5,0,8,True
8867396,123,0,25,3810,582752937,0,0,0,1096.05,8,868454.57,18,6,15,8,True
8902050,560,2,451,6595,582752937,0,0,0,1096.05,7,867358.52,17,3,5,8,True
9040993,375,4,30,2684,582752937,0,0,0,1096.13,8,866262.39,25,6,22,9,True
9121192,375,4,-1,1047,582752937,0,1,0,1096.11,1,866262.39,25,6,16,9,True
9165862,303,0,20,3854,582752937,0,0,0,1096.11,3,865166.28,4,6,9,9,True
9386862,341,0,10,3854,582752937,0,0,0,1096.01,6,866262.29,24,5,18,9,True
9418304,123,0,-1,4091,582752937,0,1,0,1095.93,1,866262.29,18,3,22,10,True
9485714,123,0,-1,7617,582752937,0,2,0,1096.12,1,866262.29,18,2,13,10,True
9505854,647,4,30,3810,582752937,0,0,0,1096.13,8,865166.16,24,3,21,10,True
1395771,787,0,451,6148,945037981,0,0,0,818.77,7,499084.23,14,4,23,2,True
1537108,402,3,25,2245,945037981,0,0,0,818.98,8,498265.25,10,4,7,3,True
1571503,286,1,30,1937,945037981,0,0,0,819.22,8,497446.03,24,3,14,4,True
1614389,1159,0,451,4028,945037981,0,0,0,819.27,7,496626.76,15,3,7,6,False
1688795,785,0,10,7917,945037981,0,0,0,818.87,6,497445.63,14,2,6,6,True
1715901,1000,0,20,5958,945037981,0,0,0,818.89,5,496626.74,26,6,17,7,True
1832678,1166,2,20,2775,945037981,0,0,0,819.15,5,495807.59,24,2,4,7,True
2301344,349,2,451,9786,945037981,0,0,0,819.32,7,494988.27,24,3,9,7,True
2317452,1011,4,451,6148,945037981,0,0,0,818.79,7,494169.48,26,3,8,8,True
2346228,1011,4,451,4520,945037981,0,0,0,818.91,7,493350.57,26,0,4,8,True
2360411,802,2,451,2041,945037981,0,0,0,819.05,7,492531.52,11,5,5,9,True
3054227,1011,4,451,1937,945037981,0,0,0,819.05,7,491712.47,26,5,15,9,False
3055248,702,4,30,2323,945037981,0,0,0,819.02,8,490893.45,18,4,12,9,True
3659243,1037,0,20,2323,945037981,0,0,0,818.87,5,490074.58,11,6,16,10,True
3709455,702,4,30,8852,945037981,0,0,0,818.95,8,489255.63,18,5,11,10,False
3824581,286,1,30,6103,945037981,0,0,0,819.01,8,488436.62,24,0,6,11,True
3855600,802,2,25,2041,945037981,0,0,0,818.69,8,487617.93,11,0,22,11,False
4034096,1399,0,20,4520,945037981,0,0,0,819.0,5,486798.93,24,1,10,12,True
4380680,1159,0,25,4520,945037981,0,0,0,818.98,8,485979.95,15,1,23,12,True
4823252,402,3,-1,7917,945037981,0,1,0,819.29,1,485979.95,10,2,22,1,True
4858531,1159,0,25,5283,945037981,0,0,0,819.07,8,485160.88,15,6,7,1,True
5322375,1027,0,20,6148,945037981,0,0,0,819.14,3,484341.74,11,4,11,2,True
5408169,649,0,20,2323,945037981,0,0,0,818.92,5,483522.82,24,6,22,4,True
5581933,841,1,10,4520,945037981,0,0,0,819.04,6,484341.86,5,1,9,5,True
5683775,349,2,30,5283,945037981,0,0,0,818.73,8,483523.13,24,0,1,6,True
5836407,802,2,451,5283,945037981,0,0,0,819.02,7,482704.11,11,3,5,7,True
6120173,502,0,10,2041,945037981,0,0,0,819.01,6,483523.12,12,3,11,8,True
6168056,1011,4,30,8732,945037981,0,0,0,819.22,8,482703.9,26,3,11,8,True
6838104,349,2,-1,8732,945037981,0,1,0,819.01,1,482703.9,24,6,18,9,True
7106100,1000,0,20,1937,945037981,0,0,0,818.93,5,481884.97,26,0,21,9,True
7217124,802,2,451,4028,945037981,0,0,0,819.29,7,481065.68,11,1,19,11,True
7707909,1011,4,451,7917,945037981,0,0,0,819.07,7,480246.61,26,5,8,11,True
8125091,748,1,-1,2323,945037981,0,1,0,819.21,4,480246.61,24,6,6,11,True
8280816,525,0,10,4520,945037981,0,0,0,819.27,6,481065.88,18,6,17,12,True
8464293,1159,0,451,4520,945037981,0,0,0,818.84,7,480247.04,15,1,7,12,True
8567493,802,2,-1,6148,945037981,0,1,0,819.0,4,480247.04,11,5,13,12,True
8722966,286,1,25,5283,945037981,0,0,0,819.08,8,479427.96,24,4,4,2,True
8723180,349,2,30,2323,945037981,0,0,0,818.82,8,478609.14,24,4,17,2,True
9071921,748,1,451,2041,945037981,0,0,0,818.97,7,477790.17,24,5,12,3,True
9096784,497,0,20,9786,945037981,0,0,0,819.08,5,476971.09,12,5,15,4,True
9121762,702,4,30,4028,945037981,0,0,0,818.67,8,476152.42,18,3,14,5,True
9186094,402,3,25,5958,945037981,0,0,0,819.27,8,475333.15,10,4,3,5,True
9213892,1436,0,20,2775,945037981,0,0,0,819.09,5,474514.06,24,6,17,6,True
9271555,1011,4,-1,4520,945037981,0,1,0,818.91,4,474514.06,26,5,1,6,True
9406246,802,2,30,6148,945037981,0,0,0,819.0,8,473695.06,11,2,15,7,True
9462564,402,3,25,4520,945037981,0,0,0,818.95,8,472876.11,10,2,0,9,True
9511474,702,4,451,4520,945037981,0,0,0,818.97,7,472057.14,18,5,6,9,True
9684884,1011,4,451,4028,945037981,0,0,0,819.14,7,471238.0,26,6,13,9,True
9728427,1339,2,20,7917,945037981,0,0,0,819.11,5,470418.89,18,5,19,10,True
9991925,328,0,10,6148,945037981,0,0,0,819.0,0,471237.89,11,2,10,10,True
1108318,525,0,-1,9161,880902812,1,1,0,237.0,1,871196.0,18,2,0,2,True
1243197,874,4,30,5977,880902812,1,0,0,237.05,8,870958.95,24,2,16,3,True
1313820,656,2,20,9132,880902812,1,0,0,237.11,5,870721.84,18,5,2,3,True
1370462,525,0,451,2042,880902812,1,0,0,236.92,7,870484.92,18,4,7,4,True
1405557,178,4,30,4696,880902812,1,0,0,236.69,8,870248.23,24,5,23,4,True
1540903,1272,0,10,4877,880902812,1,0,0,236.91,6,870485.14,24,5,7,4,True
1959027,525,0,25,3421,880902812,1,0,0,237.19,8,870247.95,18,2,13,5,True
2084505,457,0,25,7908,880902812,1,0,0,237.06,8,870010.89,13,2,18,6,True
2508786,457,0,25,1670,880902812,1,0,0,237.08,8,869773.81,13,3,14,6,True
2663512,457,0,25,4877,880902812,1,0,0,236.95,8,869536.86,13,1,17,7,True
2747992,584,0,451,5208,880902812,1,0,0,237.04,7,869299.82,11,1,12,7,True
2863648,178,4,451,7908,880902812,1,0,0,236.85,7,869062.97,24,3,23,8,False
3405381,584,0,25,4696,880902812,1,0,0,236.79,8,868826.18,11,4,19,8,True
3458686,584,0,451,5977,880902812,1,0,0,236.89,7,868589.29,11,1,15,8,True
3499625,1039,1,10,8191,880902812,1,0,0,237.07,0,868826.36,11,6,14,9,True
3562087,874,4,30,7022,880902812,1,0,0,237.08,8,868589.28,24,4,5,9,True
3589352,329,1,10,9126,880902812,1,0,0,237.27,0,868826.55,11,4,2,9,True
3899158,445,0,10,7257,880902812,1,0,0,237.11,6,869063.66,13,6,8,10,True
4057024,584,0,-1,9419,880902812,1,1,0,236.82,1,869063.66,11,1,21,11,True
4394704,178,4,25,2810,880902812,1,0,0,236.92,8,868826.74,24,4,12,11,True
4563993,647,4,451,8679,880902812,1,0,0,237.26,7,868589.48,24,3,16,12,True
4952487,346,0,20,8679,880902812,1,0,0,237.06,3,868352.42,24,4,16,2,True
5025551,1206,0,10,7908,880902812,1,0,0,237.19,6,868589.61,24,0,19,2,True
5265328,457,0,25,7257,880902812,1,0,0,237.16,8,868352.45,13,4,4,3,True
5496793,568,1,10,2810,880902812,1,0,0,236.78,0,868589.23,11,6,3,4,True
5693580,343,1,10,8381,880902812,1,0,0,236.89,0,868826.12,24,4,7,8,False
5745499,727,0,20,9126,880902812,1,0,0,237.17,3,868588.95,11,1,7,8,True
5793563,457,0,-1,5860,880902812,1,1,0,236.93,4,868588.95,13,2,15,8,True
6053498,178,4,451,5977,880902812,1,0,0,236.92,7,868352.03,24,0,14,8,True
6255689,525,0,451,4681,880902812,1,0,0,237.03,7,868115.0,18,3,0,8,True
6466294,647,4,451,8266,880902812,1,0,0,237.06,7,867877.94,24,5,9,9,True
6835011,584,0,451,2042,880902812,1,0,0,236.86,7,867641.08,11,6,2,9,False
6893633,647,4,25,9161,880902812,1,0,0,236.9,8,867404.18,24,0,4,9,False
7418633,457,0,30,2042,880902812,1,0,0,237.01,8,867167.17,13,3,0,10,True
7529736,457,0,451,2901,880902812,1,0,0,237.16,7,866930.01,13,6,18,10,False
7584307,457,0,451,5208,880902812,1,0,0,236.97,7,866693.04,13,1,17,10,True
7616806,996,0,10,9132,880902812,1,0,0,237.07,6,866930.11,26,4,16,12,True
7713602,1015,0,20,8266,880902812,1,0,0,236.94,5,866693.17,26,3,9,12,True
7758148,584,0,30,9132,880902812,1,0,0,237.27,8,866455.9,11,5,3,3,True
7766395,457,0,-1,2810,880902812,1,1,0,237.06,1,866455.9,13,2,20,3,True
7794311,525,0,451,8679,880902812,1,0,0,237.2,7,866218.7,18,2,10,4,True
7903743,647,4,30,7896,880902812,1,0,0,236.79,8,865981.91,24,3,14,4,True
8060877,874,4,30,3421,880902812,1,0,0,237.28,8,865744.63,24,4,22,4,True
8128581,498,0,20,9161,880902812,1,0,0,236.76,3,865507.87,12,4,20,4,True
8519668,457,0,451,5208,880902812,1,0,0,237.1,7,865270.77,13,6,20,4,True
8526422,874,4,451,9126,880902812,1,0,0,236.57,7,865034.2,24,0,22,5,True
8592013,457,0,451,8679,880902812,1,0,0,236.98,7,864797.22,13,4,9,5,True
8792727,457,0,-1,2901,880902812,1,1,0,237.16,4,864797.22,13,2,2,6,True
8971275,874,4,25,7257,880902812,1,0,0,236.86,8,864560.36,24,3,10,6,True
9055741,525,0,25,2810,880902812,1,0,0,236.71,8,864323.65,18,6,4,6,True
9126644,874,4,25,9126,880902812,1,0,0,236.93,8,864086.72,24,2,19,7,True
9195541,411,2,20,1783,880902812,1,0,0,237.0,5,863849.72,18,4,1,8,True
9643119,1179,0,10,5624,880902812,1,0,0,236.91,6,864086.63,24,3,0,8,True
9660411,178,4,-1,2263,880902812,1,1,0,237.35,4,864086.63,24,2,5,8,True
9940758,457,0,30,5208,880902812,1,0,0,237.02,8,863849.61,13,1,5,9,True
1013374,428,0,30,2112,847854782,0,0,0,1121.84,8,354333.16,18,2,9,1,True
1129215,689,0,451,9908,847854782,0,0,0,1122.06,7,353211.1,24,3,2,1,True
1652892,123,0,10,9908,847854782,0,0,0,1121.97,0,354333.07,18,3,13,1,True
1708148,420,4,451,2873,847854782,0,0,0,1122.1,7,353210.97,18,5,16,1,True
1832207,641,0,10,9868,847854782,0,0,0,1122.03,6,354333.0,24,1,23,2,True
2137665,485,1,10,9147,847854782,0,0,0,1121.93,0,355454.93,5,4,16,3,True
2322858,1173,1,451,6106,847854782,0,0,0,1121.87,7,354333.06,24,6,12,3,True
2512288,1353,4,451,2112,847854782,0,0,0,1122.25,7,353210.81,24,5,17,5,True
2599925,689,0,30,7775,847854782,0,0,0,1122.17,8,352088.64,24,1,12,7,True
2836801,420,4,30,1419,847854782,0,0,0,1122.2,8,350966.44,18,4,3,7,True
2879578,359,2,451,8653,847854782,0,0,0,1121.89,7,349844.55,24,4,9,7,True
3087032,359,2,451,2112,847854782,0,0,0,1122.01,7,348722.54,24,3,12,8,True
3094312,1353,4,25,7775,847854782,0,0,0,1122.03,8,347600.51,24,1,5,9,True
3510793,689,0,-1,9908,847854782,0,1,0,1122.03,4,347600.51,24,2,19,10,True
3519036,689,0,451,9868,847854782,0,0,0,1122.23,7,346478.28,24,5,4,10,True
3531789,359,2,-1,2873,847854782,0,1,0,1121.79,4,346478.28,24,2,7,11,True
3565325,1187,4,451,1419,847854782,0,0,0,1121.94,7,345356.34,24,2,19,12,True
3580146,752,0,30,3536,847854782,0,0,0,1122.17,8,344234.17,24,4,15,12,True
3895554,420,4,-1,3619,847854782,0,1,0,1121.98,4,344234.17,18,4,6,12,True
4257492,359,2,451,9908,847854782,0,0,0,1121.8,7,343112.37,24,6,5,1,True
4351270,1173,1,-1,9147,847854782,0,1,0,1121.79,4,343112.37,24,2,0,2,True
4351908,420,4,25,9926,847854782,0,0,0,1121.9,8,341990.47,18,4,19,3,True
4470717,497,0,10,2873,847854782,0,0,0,1121.76,6,343112.23,12,5,7,3,True
4788068,420,4,451,9926,847854782,0,0,0,1121.93,7,341990.3,18,0,3,3,True
4819314,689,0,451,2112,847854782,0,0,0,1121.65,7,340868.65,24,6,11,4,True
5090556,359,2,25,1419,847854782,0,0,0,1122.0,8,339746.65,24,0,16,4,True
5125335,210,4,30,5043,847854782,0,0,0,1122.03,8,338624.62,9,1,17,5,True
5186463,184,0,20,9908,847854782,0,0,0,1122.08,5,337502.54,18,1,4,5,True
5214596,260,0,20,8527,847854782,0,0,0,1122.07,5,336380.47,6,4,16,6,True
5229492,359,2,25,8653,847854782,0,0,0,1121.98,8,335258.49,24,4,0,6,True
5904476,428,0,451,6106,847854782,0,0,0,1122.01,7,334136.48,18,1,8,6,True
6168001,359,2,451,1047,847854782,0,0,0,1121.96,7,333014.52,24,1,0,7,True
6199848,1353,4,25,8653,847854782,0,0,0,1122.08,8,331892.44,24,3,4,8,True
6282769,752,0,451,2873,847854782,0,0,0,1122.01,7,330770.43,24,6,9,8,True
6421762,689,0,25,3536,847854782,0,0,0,1122.02,8,329648.41,24,1,16,10,True
6629213,752,0,451,9926,847854782,0,0,0,1122.13,7,328526.28,24,6,20,11,True
6842869,1233,0,10,1047,847854782,0,0,0,1121.99,6,329648.27,18,4,4,1,True
6929400,35,2,20,1419,847854782,0,0,0,1122.05,5,328526.22,11,0,6,1,True
7070323,420,4,25,1419,847854782,0,0,0,1121.83,8,327404.39,18,3,3,2,True
7109308,1187,4,30,3619,847854782,0,0,0,1121.9,8,326282.49,24,2,4,2,True
7114011,420,4,25,7775,847854782,0,0,0,1122.16,8,325160.33,18,1,6,2,True
7335621,428,0,451,1419,847854782,0,0,0,1121.81,7,324038.52,18,4,15,3,True
7613255,689,0,30,8653,847854782,0,0,0,1121.81,8,322916.71,24,5,23,4,True
7918154,27,0,10,9871,847854782,0,0,0,1122.08,6,324038.79,11,6,14,4,True
8005651,180,0,10,2873,847854782,0,0,0,1121.68,6,325160.47,18,3,19,4,True
8322758,1353,4,-1,3536,847854782,0,1,0,1121.7,1,325160.47,24,6,21,5,True
8605150,1353,4,25,5043,847854782,0,0,0,1122.03,8,324038.44,24,4,14,5,True
8642477,359,2,30,7775,847854782,0,0,0,1122.09,8,322916.35,24,6,6,6,True
8786082,34,1,10,1047,847854782,0,0,0,1121.79,0,324038.14,11,5,23,6,False
9197798,129,0,10,5043,847854782,0,0,0,1121.94,6,325160.08,18,5,11,6,True
9247156,1187,4,451,9926,847854782,0,0,0,1121.91,7,324038.17,24,6,0,6,True
9420937,752,0,30,2112,847854782,0,0,0,1122.0,8,322916.17,24,4,22,6,True
9530436,199,0,10,7775,847854782,0,0,0,1121.94,0,324038.11,18,6,13,6,True
9619224,1173,1,451,2873,847854782,0,0,0,1121.86,7,322916.25,24,2,3,7,True
9624550,1353,4,451,6204,847854782,0,0,0,1122.0,7,321794.25,24,4,10,8,True
9925323,689,0,451,6204,847854782,0,0,0,1121.98,7,320672.27,24,1,0,10,True
9989781,76,0,10,6204,847854782,0,0,0,1121.91,0,321794.18,20,6,21,10,True
9996236,1187,4,25,3536,847854782,0,0,0,1121.93,8,320672.25,24,1,21,10,True
1162967,317,4,25,1001,657293615,1,0,0,187.15,8,870306.85,4,2,20,1,True
1217014,663,4,25,1001,657293615,1,0,0,186.66,8,870120.19,18,0,8,1,True
1297685,572,0,451,1001,657293615,1,0,0,186.99,7,869933.2,11,2,0,2,True
1315127,907,0,30,8298,657293615,1,0,0,187.04,8,869746.16,2,4,12,3,True
1492394,599,0,451,9633,657293615,1,0,0,187.03,7,869559.13,24,5,11,3,True
1956449,266,2,20,1001,657293615,1,0,0,186.95,5,869372.18,6,1,9,4,True
1994715,907,0,30,6861,657293615,1,0,0,186.98,8,869185.2,2,2,16,4,True
2194737,599,0,-1,7668,657293615,1,1,0,186.77,1,869185.2,24,6,5,5,True
2234809,907,0,451,6296,657293615,1,0,0,186.94,7,868998.26,2,2,4,6,True
2473218,572,0,30,7986,657293615,1,0,0,186.83,8,868811.43,11,3,20,6,True
2594317,796,2,20,7423,657293615,1,0,0,187.04,3,868624.39,11,5,10,6,True
2767489,317,4,25,7668,657293615,1,0,0,187.09,8,868437.3,4,6,6,7,True
3195431,147,0,25,8284,657293615,1,0,0,186.83,8,868250.47,18,4,18,9,True
3409772,317,4,-1,1002,657293615,1,1,0,186.88,4,868250.47,4,6,12,11,True
3414464,572,0,451,1927,657293615,1,0,0,186.91,7,868063.56,11,0,22,12,True
3550806,907,0,25,7986,657293615,1,0,0,187.3,8,867876.26,2,1,3,1,True
4006706,663,4,451,2747,657293615,1,0,0,187.04,7,867689.22,18,0,22,2,True
4015402,907,0,30,7668,657293615,1,0,0,187.14,8,867502.08,2,3,16,2,True
4027357,599,0,451,1002,657293615,1,0,0,187.04,7,867315.04,24,5,10,3,True
4216172,907,0,-1,4950,657293615,1,1,0,187.05,4,867315.04,2,6,14,4,True
4286855,663,4,30,2747,657293615,1,0,0,186.87,8,867128.17,18,2,17,6,True
4656922,147,0,451,8234,657293615,1,0,0,186.96,7,866941.21,18,6,12,9,True
4812685,572,0,25,4950,657293615,1,0,0,186.94,8,866754.27,11,2,11,11,True
4815061,129,0,20,7668,657293615,1,0,0,186.63,5,866567.64,18,5,6,11,True
5116771,317,4,-1,9633,657293615,1,1,0,187.08,1,866567.64,4,5,11,12,True
5139114,317,4,451,8234,657293615,1,0,0,186.82,7,866380.82,4,3,19,12,True
5669045,572,0,451,8234,657293615,1,0,0,187.03,7,866193.79,11,4,22,1,True
5678578,572,0,30,3606,657293615,1,0,0,187.13,8,866006.66,11,6,5,2,True
5783444,627,0,10,7423,657293615,1,0,0,187.01,6,866193.67,11,5,23,3,True
5833006,907,0,25,3606,657293615,1,0,0,187.02,8,866006.65,2,5,7,3,True
6002075,1255,0,20,2747,657293615,1,0,0,187.02,3,865819.63,23,4,15,4,True
6319815,858,1,10,3606,657293615,1,0,0,186.79,0,866006.42,24,0,19,4,True
6424333,317,4,30,3606,657293615,1,0,0,187.01,8,865819.41,4,1,1,5,True
6439092,317,4,-1,1002,657293615,1,1,0,186.86,1,865819.41,4,3,16,5,True
6494716,599,0,451,8234,657293615,1,0,0,187.05,7,865632.36,24,0,1,6,True
6647761,663,4,451,1927,657293615,1,0,0,187.1,7,865445.26,18,6,5,7,True
6664819,428,0,20,9732,657293615,1,0,0,186.8,3,865258.46,18,2,1,8,True
6709835,1243,2,20,1927,657293615,1,0,0,187.15,5,865071.31,18,3,8,9,True
6720133,907,0,451,1002,657293615,1,0,0,186.94,7,864884.37,2,5,6,10,True
7254030,663,4,30,7668,657293615,1,0,0,187.12,8,864697.25,18,0,4,10,True
7261453,663,4,-1,2342,657293615,1,1,0,187.19,4,864697.25,18,0,22,10,True
7367042,663,4,-1,1001,657293615,1,2,0,187.07,4,864697.25,18,0,14,10,True
7386289,663,4,-1,7986,657293615,1,3,1,187.0,1,864697.25,18,5,23,10,False
1155810,110,4,-1,2967,143660501,0,1,0,687.26,1,310188.0,3,6,3,1,True
1734433,880,1,10,6087,143660501,0,0,0,687.14,6,310875.14,27,6,11,1,True
1767694,1474,0,10,1539,143660501,0,0,0,686.77,0,311561.91,24,3,8,2,True
1836042,1195,1,10,1111,143660501,0,0,0,686.95,6,312248.86,24,0,17,3,False
1938569,732,0,20,9871,143660501,0,0,0,686.98,5,311561.88,11,6,20,3,True
2148788,467,0,20,2720,143660501,0,0,0,686.96,5,310874.92,5,3,12,4,True
2320963,557,1,-1,3318,143660501,0,1,0,686.93,4,310874.92,17,1,14,5,True
2355620,557,1,30,9704,143660501,0,0,0,686.73,8,310188.19,17,0,17,6,True
2465597,857,1,10,6598,143660501,0,0,0,687.02,6,310875.21,24,2,21,6,True
2466859,262,2,20,9704,143660501,0,0,0,686.92,5,310188.29,6,6,16,6,True
2496348,424,1,10,9366,143660501,0,0,0,687.1,6,310875.39,18,2,17,6,True
2639485,110,4,25,4622,143660501,0,0,0,686.94,8,310188.45,3,2,17,7,True
2685184,319,0,10,2084,143660501,0,0,0,687.05,6,310875.5,11,1,0,8,True
2810183,574,2,20,1539,143660501,0,0,0,686.74,5,310188.76,11,2,20,8,True
2914437,1063,0,30,2420,143660501,0,0,0,687.03,8,309501.73,11,5,7,9,True
3359766,1063,0,30,6087,143660501,0,0,0,687.05,8,308814.68,11,1,20,9,True
3602948,614,4,30,1111,143660501,0,0,0,687.4,8,308127.28,11,2,11,11,True
3953118,1289,1,10,3439,143660501,0,0,0,686.72,0,308814.0,24,6,10,11,True
4005885,1319,1,10,6628,143660501,0,0,0,686.97,6,309500.97,18,1,8,11,True
4171262,1114,1,25,4232,143660501,0,0,0,686.8,8,308814.17,0,4,16,12,True
4423750,1041,0,10,9871,143660501,0,0,0,687.01,0,309501.18,11,0,1,1,True
4481699,557,1,25,6598,143660501,0,0,0,686.94,8,308814.24,17,1,3,1,True
4576044,695,2,-1,9704,143660501,0,1,0,687.13,4,308814.24,24,6,19,3,True
4635305,1226,2,25,9366,143660501,0,0,0,686.92,8,308127.32,18,4,2,4,True
4693725,155,1,-1,1111,143660501,0,1,0,686.78,4,308127.32,18,6,3,4,True
4878778,1114,1,-1,2967,143660501,0,2,0,687.01,4,308127.32,0,0,4,5,True
4993251,1226,2,451,2875,143660501,0,0,0,686.9,7,307440.42,18,4,21,5,True
5051101,155,1,30,2720,143660501,0,0,0,686.84,8,306753.58,18,3,19,5,True
5227353,1063,0,25,2875,143660501,0,0,0,686.99,8,306066.59,11,4,9,6,True
5340683,614,4,451,6628,143660501,0,0,0,686.96,7,305379.63,11,4,3,6,True
5385686,337,1,30,2867,143660501,0,0,0,687.19,8,304692.44,11,1,9,7,True
5486845,1271,0,20,5371,143660501,0,0,0,686.99,3,304005.45,23,3,19,7,True
5570766,695,2,451,9704,143660501,0,0,0,686.82,7,303318.63,24,2,16,8,True
5575720,337,1,30,5068,143660501,0,0,0,686.77,8,302631.86,11,0,0,8,True
6688877,858,1,10,3318,143660501,0,0,0,686.87,0,303318.73,24,6,11,10,True
6724914,1009,0,10,4232,143660501,0,0,0,687.08,6,304005.81,26,3,7,10,True
7176755,337,1,451,6628,143660501,0,0,0,687.16,7,303318.65,11,1,10,10,True
7441607,811,0,20,1539,143660501,0,0,0,687.06,5,302631.59,18,6,13,11,True
7508573,850,1,10,6598,143660501,0,0,0,686.72,6,303318.31,5,4,5,1,True
7910544,695,2,-1,8977,143660501,0,1,0,686.84,1,303318.31,24,0,8,1,True
7953776,337,1,25,9871,143660501,0,0,0,687.04,8,302631.27,11,0,18,1,True
8034006,110,4,30,1539,143660501,0,0,0,686.95,8,301944.32,3,0,17,4,True
8180771,1226,2,-1,2967,143660501,0,1,0,687.1,1,301944.32,18,1,21,4,True
8187188,614,4,-1,1111,143660501,0,2,0,687.04,4,301944.32,11,2,5,5,True
8273137,1345,2,20,6628,143660501,0,0,0,686.93,5,301257.39,24,3,19,5,True
8365944,110,4,451,6929,143660501,0,0,0,687.1,7,300570.29,3,5,0,5,True
8937468,155,1,-1,5867,143660501,0,1,0,687.29,4,300570.29,18,5,6,6,True
9094168,1063,0,-1,3488,143660501,0,2,0,687.11,4,300570.29,11,6,19,6,True
9110399,47,1,10,1111,143660501,0,0,0,687.18,0,301257.47,24,5,7,6,True
9110840,110,4,451,9704,143660501,0,0,0,686.79,7,300570.68,3,0,20,7,True
9114817,695,2,30,2967,143660501,0,0,0,687.05,8,299883.63,24,4,19,8,True
9214363,1063,0,30,2084,143660501,0,0,0,687.13,8,299196.5,11,4,21,8,True
9498510,110,4,25,9287,143660501,0,0,0,686.88,8,298509.62,3,3,15,8,True
9537231,883,0,20,6598,143660501,0,0,0,686.71,3,297822.91,24,5,12,8,False
9552132,557,1,451,2720,143660501,0,0,0,686.81,7,297136.1,17,1,3,9,True
9755007,695,2,30,6598,143660501,0,0,0,686.67,8,296449.43,24,6,4,10,True
9830703,1449,0,10,7305,143660501,0,0,0,686.97,6,297136.4,11,1,7,10,True
1409385,32,3,451,2255,863733647,0,0,0,696.84,7,797148.16,11,3,11,1,True
1465711,967,1,25,7015,863733647,0,0,0,697.06,8,796451.1,13,3,20,1,True
1573432,1089,0,20,3207,863733647,0,0,0,697.11,5,795753.99,18,4,23,3,True
2041595,1425,0,10,3207,863733647,0,0,0,696.84,6,796450.83,24,5,10,3,True
2163411,32,3,-1,3118,863733647,0,1,0,696.97,1,796450.83,11,1,5,4,True
2412055,744,4,30,7015,863733647,0,0,0,697.12,8,795753.71,24,2,23,5,True
2563935,860,1,10,3118,863733647,0,0,0,696.91,6,796450.62,24,0,22,5,True
2840470,137,2,-1,8074,863733647,0,1,0,696.91,1,796450.62,18,6,19,5,True
3207100,806,1,451,3207,863733647,0,0,0,697.05,7,795753.57,11,0,22,5,True
3265417,511,1,10,5206,863733647,0,0,0,696.94,0,796450.51,12,2,17,6,True
3300525,848,2,30,7793,863733647,0,0,0,696.89,8,795753.62,5,3,22,6,True
3436838,806,1,30,2255,863733647,0,0,0,697.08,8,795056.54,11,6,15,9,True
3473897,806,1,451,1509,863733647,0,0,0,697.31,7,794359.23,11,4,18,10,True
3496368,137,2,-1,7793,863733647,0,1,0,697.16,4,794359.23,18,4,20,10,True
3554967,341,0,10,4533,863733647,0,0,0,696.84,0,795056.07,24,5,21,11,True
3734297,848,2,451,3207,863733647,0,0,0,697.09,7,794358.98,5,6,3,2,True
3760054,137,2,25,3413,863733647,0,0,0,696.98,8,793662.0,18,6,14,2,True
3963738,1413,0,10,3207,863733647,0,0,0,696.9,6,794358.9,24,1,9,2,True
4016807,267,0,10,1509,863733647,0,0,0,696.82,0,795055.72,6,4,5,2,True
4161295,484,0,20,9471,863733647,0,0,0,697.03,3,794358.69,5,6,8,4,True
4229541,137,2,30,2255,863733647,0,0,0,697.08,8,793661.61,18,6,0,4,True
4255874,744,4,-1,8074,863733647,0,1,0,697.2,1,793661.61,24,1,9,5,True
4470122,32,3,25,5206,863733647,0,0,0,696.97,8,792964.64,11,3,21,7,True
4540855,32,3,451,6157,863733647,0,0,0,697.18,7,792267.46,11,5,23,8,True
4813071,529,2,20,6879,863733647,0,0,0,697.07,3,791570.39,18,6,22,8,True
5402456,328,0,10,3413,863733647,0,0,0,697.31,6,792267.7,11,6,12,9,True
5464670,266,2,20,2255,863733647,0,0,0,696.99,3,791570.71,6,6,5,12,True
5504235,848,2,25,9471,863733647,0,0,0,696.9,8,790873.81,5,6,12,12,True
5715488,848,2,451,6157,863733647,0,0,0,697.02,7,790176.79,5,1,22,12,True
6199759,848,2,25,4533,863733647,0,0,0,696.68,8,789480.11,5,3,7,2,True
6214138,967,1,451,4533,863733647,0,0,0,697.11,7,788783.0,13,0,7,2,True
6311985,748,1,10,7793,863733647,0,0,0,697.27,6,789480.27,24,2,6,2,True
6386654,1272,0,20,7788,863733647,0,0,0,697.21,3,788783.06,24,3,6,2,True
6415836,314,0,20,1164,863733647,0,0,0,696.98,5,788086.08,4,6,0,2,True
6436077,744,4,451,6157,863733647,0,0,0,697.24,7,787388.84,24,0,19,2,True
6569489,744,4,451,8074,863733647,0,0,0,696.96,7,786691.88,24,1,21,3,True
6667955,744,4,25,6157,863733647,0,0,0,696.94,8,785994.94,24,0,1,3,True
6971165,137,2,-1,8074,863733647,0,1,0,697.04,4,785994.94,18,4,15,4,True
7346981,137,2,25,1965,863733647,0,0,0,696.79,8,785298.15,18,2,13,5,True
7725542,137,2,451,6157,863733647,0,0,0,696.85,7,784601.3,18,6,5,5,True
7975560,681,2,20,3207,863733647,0,0,0,697.07,5,783904.23,24,2,2,6,True
8121562,689,0,10,6157,863733647,0,0,0,696.99,6,784601.22,24,4,23,7,True
8170019,1278,0,10,7793,863733647,0,0,0,696.7,6,785297.92,24,1,20,8,True
8277172,32,3,25,7015,863733647,0,0,0,697.1,8,784600.82,11,2,7,8,True
8468937,32,3,451,5206,863733647,0,0,0,697.07,7,783903.75,11,5,12,8,True
9369572,967,1,25,3118,863733647,0,0,0,696.93,8,783206.82,13,5,12,8,True
9439229,848,2,25,7015,863733647,0,0,0,696.96,8,782509.86,5,3,9,8,True
9553958,20,0,20,1164,863733647,0,0,0,697.05,3,781812.81,24,1,0,9,True
9624149,1206,0,20,7788,863733647,0,0,0,696.94,3,781115.87,24,3,9,10,False
9757290,848,2,451,3207,863733647,0,0,0,697.02,7,780418.85,5,0,0,10,True
9873966,137,2,25,9471,863733647,0,0,0,697.12,8,779721.73,18,6,21,11,True
9916409,806,1,-1,2255,863733647,0,1,0,696.99,1,779721.73,11,3,9,11,True
1117474,182,1,451,6520,671446374,1,0,0,1020.06,7,321656.94,18,5,15,1,True
1212784,250,4,-1,1582,671446374,1,1,0,1020.08,4,321656.94,6,4,6,9,True
1214909,1041,0,10,5597,671446374,1,0,0,1019.68,6,322676.62,11,3,0,11,True
1350663,859,2,20,7424,671446374,1,0,0,1019.88,3,321656.74,24,6,20,1,True
1405554,1408,1,10,1883,671446374,1,0,0,1020.05,6,322676.79,24,5,5,2,True
2125013,937,0,-1,5527,671446374,1,1,0,1019.96,4,322676.79,24,3,6,6,True
2359487,16,4,-1,2378,671446374,1,2,0,1020.13,4,322676.79,24,5,5,5,True
2468204,117,1,-1,7543,671446374,1,3,1,1019.82,4,322676.79,18,6,3,6,True
1012429,44,4,30,8279,105878057,1,0,0,1048.99,8,464787.01,24,0,21,1,True
1180825,935,1,10,7011,105878057,1,0,0,1049.1,6,465836.11,24,6,2,3,True
1591027,44,4,451,6458,105878057,1,0,0,1049.05,7,464787.06,24,0,22,4,True
1742632,942,0,30,5955,105878057,1,0,0,1048.96,8,463738.1,24,4,11,6,True
2136430,974,3,-1,5955,105878057,1,1,0,1048.96,4,463738.1,22,0,17,7,True
2172945,350,0,10,8704,105878057,1,0,0,1049.1,6,464787.2,24,2,13,8,True
2544871,1101,2,25,6532,105878057,1,0,0,1049.22,8,463737.98,0,2,11,8,True
2550806,524,1,-1,4518,105878057,1,1,0,1048.85,1,463737.98,18,4,12,8,True
2758183,1004,4,-1,8482,105878057,1,2,0,1048.92,4,463737.98,26,4,13,10,True
2892332,437,4,30,5821,105878057,1,0,0,1049.05,8,462688.93,24,1,19,12,False
3060584,1061,2,20,3976,105878057,1,0,0,1049.15,5,461639.78,11,4,1,12,True
3145928,1283,2,20,7011,105878057,1,0,0,1048.91,3,460590.87,24,3,10,1,True
3322645,1101,2,25,4518,105878057,1,0,0,1048.83,8,459542.04,0,2,14,1,False
3384279,942,0,30,7167,105878057,1,0,0,1049.15,8,458492.89,24,2,12,2,True
3481356,1004,4,451,2360,105878057,1,0,0,1049.05,7,457443.84,26,1,0,2,False
3563439,669,2,20,9265,105878057,1,0,0,1048.7,5,456395.14,18,0,8,2,False
3673547,974,3,451,6555,105878057,1,0,0,1048.87,7,455346.27,22,1,15,2,True
3808080,1206,0,20,3976,105878057,1,0,0,1049.03,3,454297.24,24,4,7,3,True
4116943,1101,2,451,8279,105878057,1,0,0,1048.73,7,453248.51,0,5,9,4,True
4281005,748,1,10,7167,105878057,1,0,0,1049.23,6,454297.74,24,3,13,5,True
4677628,1004,4,30,5112,105878057,1,0,0,1049.13,8,453248.61,26,6,16,5,True
4987201,661,4,30,4518,105878057,1,0,0,1049.22,8,452199.39,18,1,23,5,True
5127964,437,4,451,8704,105878057,1,0,0,1048.97,7,451150.42,24,0,10,6,True
5228899,278,1,10,9366,105878057,1,0,0,1049.06,6,452199.48,24,4,19,6,True
5360219,44,4,-1,8292,105878057,1,1,0,1049.38,4,452199.48,24,0,23,7,True
5388167,820,1,10,9294,105878057,1,0,0,1049.08,6,453248.56,18,3,8,7,True
5632655,661,4,451,8482,105878057,1,0,0,1049.24,7,452199.32,18,6,22,8,True
5706476,437,4,25,4518,105878057,1,0,0,1049.26,8,451150.06,24,1,1,8,True
5711422,180,0,20,9366,105878057,1,0,0,1048.98,5,450101.08,18,3,8,8,True
5860893,661,4,451,6532,105878057,1,0,0,1049.19,7,449051.89,18,2,4,8,True
5911947,1474,0,10,6555,105878057,1,0,0,1049.01,6,450100.9,24,5,10,9,True
5960683,882,0,10,6458,105878057,1,0,0,1049.4,0,451150.3,27,6,6,9,True
5973011,1411,0,10,9884,105878057,1,0,0,1048.96,0,452199.26,24,1,21,9,True
6196956,1436,0,20,9366,105878057,1,0,0,1049.04,5,451150.22,24,4,9,9,True
6275421,974,3,451,9884,105878057,1,0,0,1049.01,7,450101.21,22,3,0,10,True
6804349,44,4,30,2361,105878057,1,0,0,1048.83,8,449052.38,24,1,9,10,True
7077893,44,4,30,6458,105878057,1,0,0,1049.05,8,448003.33,24,1,21,10,True
7097604,895,0,20,5112,105878057,1,0,0,1049.0,5,446954.33,24,5,21,12,True
7536926,1101,2,451,5955,105878057,1,0,0,1048.85,7,445905.48,0,0,10,12,True
7757325,907,0,20,5821,105878057,1,0,0,1049.0,5,444856.48,2,1,13,12,True
7902210,1004,4,-1,4518,105878057,1,1,0,1048.7,4,444856.48,26,0,5,2,True
7941947,130,0,20,5955,105878057,1,0,0,1048.89,5,443807.59,18,5,23,4,True
7946390,1101,2,-1,9884,105878057,1,1,0,1049.07,1,443807.59,0,2,15,5,True
8240322,46,1,10,8772,105878057,1,0,0,1049.09,0,444856.68,24,6,18,5,True
8612188,1101,2,-1,5112,105878057,1,1,0,1048.63,4,444856.68,0,5,9,6,True
8958468,974,3,451,5821,105878057,1,0,0,1049.04,7,443807.64,22,1,12,6,True
8962586,1101,2,451,2360,105878057,1,0,0,1048.86,7,442758.78,0,1,14,7,True
8997337,558,0,20,4518,105878057,1,0,0,1048.91,5,441709.87,17,1,4,8,True
9275192,44,4,451,6458,105878057,1,0,0,1049.03,7,440660.84,24,0,22,9,True
9316009,1170,0,10,6828,105878057,1,0,0,1048.99,6,441709.83,24,3,5,9,True
9685752,661,4,451,6828,105878057,1,0,0,1048.88,7,440660.95,18,6,19,10,False
1061985,303,0,20,1942,147078192,0,0,0,490.05,5,201558.95,4,1,11,1,True
1159158,1072,0,451,7562,147078192,0,0,0,489.95,7,201069.0,18,1,10,1,True
1613360,1471,0,10,7109,147078192,0,0,0,489.99,6,201558.99,24,6,5,1,True
1739900,997,3,451,9959,147078192,0,0,0,490.11,7,201068.88,26,3,19,4,True
2055528,1072,0,30,7916,147078192,0,0,0,490.03,8,200578.85,18,3,23,6,True
2066662,851,1,30,7462,147078192,0,0,0,489.89,8,200088.96,5,4,17,7,True
2166852,1363,0,10,7598,147078192,0,0,0,489.91,6,200578.87,16,1,20,7,True
2174443,1067,4,451,1796,147078192,0,0,0,490.04,7,200088.83,11,6,0,7,False
2537816,594,0,10,7902,147078192,0,0,0,489.96,6,200578.79,24,4,0,7,True
2630330,269,0,20,8134,147078192,0,0,0,489.91,5,200088.88,24,6,3,8,True
2766828,497,0,20,9006,147078192,0,0,0,490.17,3,199598.71,12,6,11,9,True
2862831,1353,4,451,7109,147078192,0,0,0,490.31,7,199108.4,24,1,0,9,True
2897462,1025,1,-1,2999,147078192,0,1,0,490.19,4,199108.4,11,6,2,10,True
3026573,641,0,30,7109,147078192,0,0,0,489.83,8,198618.57,24,2,9,12,True
3278263,1353,4,-1,9377,147078192,0,1,0,489.72,1,198618.57,24,5,23,12,True
3541828,634,1,451,4039,147078192,0,0,0,490.2,7,198128.37,24,4,18,12,True
3601023,634,1,-1,9959,147078192,0,1,0,490.16,4,198128.37,24,3,23,3,True
3901454,787,0,20,7462,147078192,0,0,0,489.89,3,197638.48,14,2,23,3,True
3931843,851,1,-1,1942,147078192,0,1,0,489.88,4,197638.48,5,1,20,3,True
4217001,851,1,-1,7916,147078192,0,2,0,490.01,4,197638.48,5,6,5,5,True
4263052,1072,0,25,1796,147078192,0,0,0,490.04,8,197148.44,18,6,21,5,True
4302281,1353,4,-1,9093,147078192,0,1,0,490.17,4,197148.44,24,2,9,6,True
4361082,997,3,30,1942,147078192,0,0,0,490.08,8,196658.36,26,4,2,6,True
4470437,1025,1,-1,1796,147078192,0,1,0,489.97,1,196658.36,11,3,1,7,True
4505959,634,1,-1,9291,147078192,0,2,0,490.23,1,196658.36,24,6,5,7,True
4534741,641,0,30,8134,147078192,0,0,0,490.29,8,196168.07,24,5,5,8,True
4700119,997,3,25,1092,147078192,0,0,0,489.88,8,195678.19,26,1,0,9,True
4799194,1067,4,451,7562,147078192,0,0,0,490.2,7,195187.99,11,2,1,9,True
4861063,429,0,10,9377,147078192,0,0,0,489.68,6,195677.67,24,3,13,9,True
4912746,1072,0,25,8033,147078192,0,0,0,490.09,8,195187.58,18,5,18,11,True
5042388,441,4,30,4039,147078192,0,0,0,489.87,8,194697.71,24,6,13,11,True
5744256,441,4,-1,7916,147078192,0,1,0,490.06,1,194697.71,24,1,22,12,True
6129621,350,0,20,7562,147078192,0,0,0,489.93,3,194207.78,24,5,17,1,True
6223284,1067,4,25,7902,147078192,0,0,0,489.95,8,193717.83,11,1,20,1,True
6312329,634,1,30,9482,147078192,0,0,0,489.87,8,193227.96,24,0,21,2,True
6354293,997,3,451,9959,147078192,0,0,0,490.33,7,192737.63,26,5,17,2,True
6563756,441,4,451,7562,147078192,0,0,0,489.86,7,192247.77,24,0,0,3,True
6577292,1072,0,30,1942,147078192,0,0,0,490.28,8,191757.49,18,1,13,3,True
7185282,1067,4,25,7462,147078192,0,0,0,489.57,8,191267.92,11,2,22,3,True
7359336,1067,4,25,8134,147078192,0,0,0,489.87,8,190778.05,11,2,20,4,True
7652093,641,0,25,9959,147078192,0,0,0,489.99,8,190288.06,24,2,9,5,True
8185296,641,0,-1,8033,147078192,0,1,0,489.93,1,190288.06,24,5,7,5,True
8371660,641,0,451,9482,147078192,0,0,0,490.04,7,189798.02,24,5,1,5,True
8447655,851,1,30,9482,147078192,0,0,0,490.14,8,189307.88,5,5,5,6,True
8549474,634,1,451,1796,147078192,0,0,0,489.81,7,188818.07,24,4,6,6,True
8808904,1029,0,10,8134,147078192,0,0,0,490.03,0,189308.1,11,0,20,7,True
8891368,1353,4,30,7902,147078192,0,0,0,489.89,8,188818.21,24,2,11,7,True
8959862,851,1,30,7902,147078192,0,0,0,490.12,8,188328.09,5,1,7,8,True
9035211,1353,4,30,4473,147078192,0,0,0,490.07,8,187838.02,24,6,13,10,True
9338092,1067,4,25,5007,147078192,0,0,0,490.04,8,187347.98,11,4,15,11,True
1458364,564,0,10,6809,171586193,0,0,0,379.12,0,851992.12,17,5,5,1,False
1522444,577,0,-1,5638,171586193,0,1,0,379.06,4,851992.12,11,4,9,1,True
1724764,774,2,20,7469,171586193,0,0,0,378.9,5,851613.22,14,5,19,1,True
1807927,131,4,30,8219,171586193,0,0,0,378.98,8,851234.24,18,1,16,1,True
1860861,49,3,451,3448,171586193,0,0,0,379.04,7,850855.2,20,6,22,1,True
1910812,1036,1,25,9306,171586193,0,0,0,378.9,8,850476.3,11,2,12,2,True
2086269,367,1,10,3448,171586193,0,0,0,378.92,6,850855.22,25,6,17,3,True
2331391,577,0,451,8253,171586193,0,0,0,378.72,7,850476.5,11,0,21,3,True
2538733,998,0,10,4851,171586193,0,0,0,378.81,0,850855.31,26,2,11,4,True
2593903,1388,1,10,9306,171586193,0,0,0,378.86,0,851234.17,24,5,6,5,True
2741322,577,0,-1,9306,171586193,0,1,0,378.98,4,851234.17,11,5,17,7,True
2917355,1004,4,-1,8219,171586193,0,2,0,378.89,1,851234.17,26,1,17,7,True
3172656,1053,1,10,8219,171586193,0,0,0,379.03,6,851613.2,11,4,17,7,False
3428080,1036,1,451,8213,171586193,0,0,0,379.14,7,851234.06,11,5,1,8,True
3536021,1451,1,10,7469,171586193,0,0,0,378.79,6,851612.85,11,6,12,8,False
3686822,1480,4,451,3762,171586193,0,0,0,379.13,7,851233.72,24,4,8,9,True
3741080,1144,2,20,7433,171586193,0,0,0,379.1,5,850854.62,15,3,15,9,True
3950269,49,3,451,8165,171586193,0,0,0,378.86,7,850475.76,20,2,11,9,True
3999162,1065,0,20,1715,171586193,0,0,0,378.84,5,850096.92,11,4,2,10,True
4109703,577,0,451,7038,171586193,0,0,0,378.66,7,849718.26,11,6,4,10,True
4366523,701,2,25,3481,171586193,0,0,0,378.78,8,849339.48,18,5,4,11,True
4752496,131,4,30,2432,171586193,0,0,0,378.88,8,848960.6,18,6,10,11,True
4988437,49,3,451,5874,171586193,0,0,0,379.02,7,848581.58,20,3,10,12,True
5055268,1112,1,10,6809,171586193,0,0,0,378.99,0,848960.57,0,6,14,1,True
6130938,1480,4,451,4501,171586193,0,0,0,379.14,7,848581.43,24,4,21,2,True
6368227,701,2,25,4851,171586193,0,0,0,378.81,8,848202.62,18,2,12,2,True
6550354,1036,1,-1,8213,171586193,0,1,0,378.95,4,848202.62,11,2,1,4,True
6621553,701,2,451,6809,171586193,0,0,0,378.97,7,847823.65,18,1,12,4,True
6735560,427,2,20,3481,171586193,0,0,0,378.99,3,847444.66,18,3,20,5,True
6771624,1480,4,451,7813,171586193,0,0,0,379.19,7,847065.47,24,6,15,6,True
6780825,701,2,30,2837,171586193,0,0,0,379.02,8,846686.45,18,2,16,6,True
6885853,1036,1,451,3990,171586193,0,0,0,379.3,7,846307.15,11,5,1,6,True
6908657,1036,1,451,8253,171586193,0,0,0,379.18,7,845927.97,11,2,10,6,True
6969791,785,0,10,1715,171586193,0,0,0,379.04,0,846307.01,14,3,2,7,True
7081644,1480,4,30,3560,171586193,0,0,0,378.91,8,845928.1,24,0,7,10,True
7117972,585,2,20,3481,171586193,0,0,0,379.0,5,845549.1,11,2,8,11,True
7515006,1404,2,20,7221,171586193,0,0,0,378.9,5,845170.2,24,3,2,12,True
7576591,577,0,25,4501,171586193,0,0,0,378.99,8,844791.21,11,0,19,12,True
7668069,1210,0,20,5638,171586193,0,0,0,379.06,5,844412.15,24,5,1,1,True
7793171,287,0,10,4501,171586193,0,0,0,378.73,6,844790.88,24,0,4,3,True
7965339,1036,1,25,8165,171586193,0,0,0,378.79,8,844412.09,11,5,5,3,True
8190006,130,0,20,8219,171586193,0,0,0,379.33,5,844032.76,18,4,3,4,True
8687108,49,3,30,7813,171586193,0,0,0,379.03,8,843653.73,20,3,9,5,False
8890106,131,4,-1,7469,171586193,0,1,0,379.19,1,843653.73,18,6,21,6,False
8928256,131,4,30,8213,171586193,0,0,0,379.17,8,843274.56,18,6,13,6,True
8958926,701,2,30,3481,171586193,0,0,0,378.6,8,842895.96,18,4,6,6,True
8965724,131,4,30,2837,171586193,0,0,0,378.73,8,842517.23,18,6,22,8,True
8994215,314,0,20,5227,171586193,0,0,0,378.81,5,842138.42,4,4,5,8,True
9147686,1480,4,30,8165,171586193,0,0,0,378.91,8,841759.51,24,5,17,10,True
9447023,1354,0,20,4675,171586193,0,0,0,379.08,5,841380.43,24,2,3,10,True
9573052,1140,0,20,7433,171586193,0,0,0,378.92,5,841001.51,15,0,12,11,True
9893715,1480,4,30,4501,171586193,0,0,0,379.25,8,840622.26,24,2,4,11,True
9898528,1480,4,-1,6809,171586193,0,1,0,378.78,1,840622.26,24,5,12,11,True
1086027,220,0,20,2226,971886936,1,0,0,1060.1,3,67817.9,26,4,3,1,True
1467000,811,0,20,8937,971886936,1,0,0,1060.2,5,66757.7,18,6,9,3,True
1492278,22,3,-1,2671,971886936,1,1,0,1060.08,1,66757.7,11,4,13,4,True
1657798,802,2,20,4323,971886936,1,0,0,1060.13,5,65697.57,11,0,22,4,True
1995479,1272,0,20,6919,971886936,1,0,0,1060.27,3,64637.3,24,1,11,4,True
2052172,366,0,-1,2466,971886936,1,1,0,1059.92,4,64637.3,25,4,12,5,True
2302526,39,3,-1,4323,971886936,1,2,0,1059.93,1,64637.3,11,0,14,5,True
2361103,366,0,451,2591,971886936,1,0,0,1059.6,7,63577.7,25,3,15,6,True
2408245,22,3,451,8661,971886936,1,0,0,1060.03,7,62517.67,11,5,18,6,True
2500612,630,0,10,8661,971886936,1,0,0,1060.13,6,63577.8,11,1,5,6,True
2691355,531,0,25,6919,971886936,1,0,0,1060.02,8,62517.78,18,0,21,7,True
3052455,251,4,25,8714,971886936,1,0,0,1059.77,8,61458.01,6,5,1,8,True
3083677,1082,3,25,4925,971886936,1,0,0,1060.0,8,60398.01,18,0,1,8,True
3162229,531,0,451,2466,971886936,1,0,0,1059.67,7,59338.34,18,6,18,8,True
3213768,22,3,-1,1376,971886936,1,1,0,1059.97,1,59338.34,11,0,8,9,True
3400557,562,1,10,2226,971886936,1,0,0,1060.01,6,60398.35,17,6,14,11,True
3444334,584,0,20,6570,971886936,1,0,0,1059.98,3,59338.37,11,1,8,1,False
3493360,366,0,451,2466,971886936,1,0,0,1059.91,7,58278.46,25,6,6,2,True
3992929,653,1,10,1211,971886936,1,0,0,1059.83,6,59338.29,24,6,18,3,True
4095328,996,0,20,4323,971886936,1,0,0,1060.09,5,58278.2,26,1,15,6,True
4505332,251,4,451,4961,971886936,1,0,0,1059.98,7,57218.22,6,3,23,6,True
4608123,22,3,451,1376,971886936,1,0,0,1059.96,7,56158.26,11,2,6,7,True
4886343,549,1,10,1376,971886936,1,0,0,1060.15,6,57218.41,17,6,3,9,True
4985284,366,0,30,2226,971886936,1,0,0,1059.91,8,56158.5,25,2,21,9,True
5052245,531,0,30,4323,971886936,1,0,0,1060.02,8,55098.48,18,4,19,9,True
5647105,39,3,-1,1376,971886936,1,1,0,1059.8,4,55098.48,11,2,23,10,True
5706480,147,0,10,2226,971886936,1,0,0,1060.13,6,56158.61,18,6,13,10,True
5945755,1082,3,451,2466,971886936,1,0,0,1059.83,7,55098.78,18,4,19,10,False
6099679,39,3,-1,8661,971886936,1,1,0,1059.9,1,55098.78,11,4,5,11,True
6426648,951,0,20,8671,971886936,1,0,0,1060.47,3,54038.31,24,3,19,11,True
6599493,39,3,-1,2466,971886936,1,1,0,1060.07,4,54038.31,11,4,1,11,True
6624273,1082,3,-1,4961,971886936,1,2,0,1060.03,4,54038.31,18,4,7,1,True
6640663,251,4,451,6919,971886936,1,0,0,1060.17,7,52978.14,6,0,17,1,True
6771180,931,0,10,8719,971886936,1,0,0,1059.84,0,54037.98,24,4,9,3,True
6807506,22,3,30,5631,971886936,1,0,0,1059.69,8,52978.29,11,0,11,4,True
7146247,64,0,10,2226,971886936,1,0,0,1060.3,6,54038.59,20,2,2,4,True
7637850,1082,3,30,8671,971886936,1,0,0,1059.89,8,52978.7,18,4,0,5,True
7664022,39,3,451,8714,971886936,1,0,0,1060.1,7,51918.6,11,0,7,5,True
8339562,39,3,30,2671,971886936,1,0,0,1060.45,8,50858.15,11,1,10,5,True
8406084,1082,3,25,2226,971886936,1,0,0,1059.82,8,49798.33,18,4,10,5,True
8966724,1483,0,20,6919,971886936,1,0,0,1059.66,5,48738.67,24,4,1,6,True
8988492,990,0,10,6570,971886936,1,0,0,1059.75,6,49798.42,22,4,18,7,True
9159629,22,3,30,5631,971886936,1,0,0,1059.99,8,48738.43,11,2,8,7,True
9224634,22,3,30,8671,971886936,1,0,0,1059.85,8,47678.58,11,3,16,8,True
9239263,1082,3,25,4961,971886936,1,0,0,1059.85,8,46618.73,18,2,8,9,True
9356103,129,0,20,4323,971886936,1,0,0,1060.22,5,45558.51,18,0,7,9,True
9419026,653,1,10,2466,971886936,1,0,0,1059.91,6,46618.42,24,4,20,9,True
9550860,1483,0,10,8719,971886936,1,0,0,1059.85,6,47678.27,24,4,16,11,True
9774253,39,3,25,8719,971886936,1,0,0,1059.95,8,46618.32,11,2,5,11,True
9972783,39,3,451,4925,971886936,1,0,0,1059.84,7,45558.48,11,2,13,11,True
1107763,259,4,-1,6359,394801746,1,1,0,534.88,4,960055.0,6,4,21,1,True
1337605,591,0,10,5003,394801746,1,0,0,534.93,6,960589.93,24,6,9,2,True
1423245,259,4,-1,7198,394801746,1,1,0,535.18,4,960589.93,6,1,17,3,True
1892524,987,4,-1,5003,394801746,1,2,0,535.15,1,960589.93,22,2,14,3,True
1960787,987,4,451,3036,394801746,1,0,0,535.15,7,960054.78,22,4,7,4,True
2108239,259,4,451,5629,394801746,1,0,0,534.88,7,959519.9,6,0,0,4,True
2193690,282,2,30,7263,394801746,1,0,0,535.03,8,958984.87,24,6,13,4,True
2369701,662,1,30,8868,394801746,1,0,0,535.1,8,958449.77,18,1,18,4,True
2611160,947,2,20,3276,394801746,1,0,0,535.02,5,957914.75,24,0,18,5,True
2816621,662,1,30,3276,394801746,1,0,0,535.01,8,957379.74,18,2,6,6,True
2940352,448,0,20,2198,394801746,1,0,0,535.15,3,956844.59,13,6,2,6,True
2948456,662,1,30,3036,394801746,1,0,0,534.88,8,956309.71,18,5,19,7,True
3028934,734,0,10,3801,394801746,1,0,0,535.22,6,956844.93,11,2,3,8,True
3416655,662,1,451,5629,394801746,1,0,0,535.17,7,956309.76,18,1,12,8,True
3745516,377,4,25,6474,394801746,1,0,0,535.02,8,955774.74,25,0,17,9,True
3875832,1030,4,-1,3036,394801746,1,1,0,534.93,4,955774.74,11,6,21,9,True
3941834,662,1,30,6512,394801746,1,0,0,535.13,8,955239.61,18,6,2,10,True
3987325,1030,4,451,8868,394801746,1,0,0,534.79,7,954704.82,11,3,22,10,True
4188716,58,2,20,7263,394801746,1,0,0,534.76,5,954170.06,20,2,14,11,True
4293152,282,2,451,6130,394801746,1,0,0,534.97,7,953635.09,24,1,6,1,True
4518050,1030,4,25,4997,394801746,1,0,0,534.91,8,953100.18,11,3,6,1,True
4580520,987,4,30,3036,394801746,1,0,0,534.67,8,952565.51,22,0,5,5,True
4603063,282,2,-1,6508,394801746,1,1,0,534.88,4,952565.51,24,2,9,5,True
4751731,341,0,30,3722,394801746,1,0,0,535.06,8,952030.45,24,0,10,6,True
4758599,1030,4,451,3722,394801746,1,0,0,534.72,7,951495.73,11,2,3,7,True
4828814,987,4,451,9492,394801746,1,0,0,534.91,7,950960.82,22,6,13,8,True
5360614,398,0,20,3276,394801746,1,0,0,535.07,5,950425.75,10,1,5,8,True
5950160,662,1,451,5003,394801746,1,0,0,535.1,7,949890.65,18,3,10,8,True
6328964,1030,4,451,7263,394801746,1,0,0,535.08,7,949355.57,11,0,8,9,True
6369215,757,0,10,5588,394801746,1,0,0,534.8,6,949890.37,24,5,14,9,True
6407631,1314,2,20,6820,394801746,1,0,0,535.03,5,949355.34,5,6,12,10,True
6552391,1030,4,451,9492,394801746,1,0,0,534.92,7,948820.42,11,3,4,10,True
6940595,34,1,10,7990,394801746,1,0,0,535.09,0,949355.51,11,1,21,10,True
7112619,1314,2,20,6820,394801746,1,0,0,534.87,5,948820.64,5,4,20,10,True
7252565,574,2,20,3036,394801746,1,0,0,535.27,5,948285.37,11,6,5,12,True
7385806,1030,4,25,7990,394801746,1,0,0,534.85,8,947750.52,11,2,13,12,True
7392429,1012,0,10,5359,394801746,1,0,0,534.77,6,948285.29,26,0,20,1,True
7698140,282,2,451,6512,394801746,1,0,0,535.09,7,947750.2,24,1,21,1,True
7833161,987,4,30,6359,394801746,1,0,0,534.91,8,947215.29,22,2,19,1,True
8076430,282,2,25,8868,394801746,1,0,0,535.26,8,946680.03,24,6,10,2,True
8259984,867,0,20,1973,394801746,1,0,0,534.99,3,946145.04,24,1,15,2,True
8503864,355,1,10,7014,394801746,1,0,0,534.94,6,946679.98,24,4,2,4,True
8600027,662,1,451,3722,394801746,1,0,0,534.91,7,946145.07,18,6,23,4,False
8725160,662,1,25,5801,394801746,1,0,0,534.89,8,945610.18,18,5,15,4,True
8784026,987,4,25,6512,394801746,1,0,0,535.03,8,945075.15,22,5,21,5,True
8829614,987,4,30,7198,394801746,1,0,0,535.03,8,944540.12,22,0,10,7,True
8888773,341,0,-1,8206,394801746,1,1,0,534.84,4,944540.12,24,1,10,7,True
8999585,377,4,30,5801,394801746,1,0,0,535.01,8,944005.11,25,1,10,7,True
9002547,640,4,451,2050,394801746,1,0,0,534.89,7,943470.22,24,4,5,8,True
9410836,341,0,25,1973,394801746,1,0,0,534.82,8,942935.4,24,6,12,9,True
9564325,377,4,30,5359,394801746,1,0,0,534.8,8,942400.6,25,0,12,9,True
9847179,377,4,-1,5359,394801746,1,1,0,535.04,1,942400.6,25,6,2,11,True
1069052,484,0,451,6617,724547962,1,0,0,310.39,7,802604.61,5,4,23,1,True
1187980,410,4,451,4192,724547962,1,0,0,310.21,7,802294.4,18,5,12,1,True
1227293,410,4,451,4068,724547962,1,0,0,309.88,7,801984.52,18,4,3,1,True
1234158,1333,4,25,1222,724547962,1,0,0,310.16,8,801674.36,18,0,5,2,True
1461596,484,0,451,9776,724547962,1,0,0,310.02,7,801364.34,5,1,17,3,False
1754960,874,4,-1,7950,724547962,1,1,0,309.89,4,801364.34,24,3,23,4,True
1932889,549,1,10,6907,724547962,1,0,0,310.09,6,801674.43,17,2,4,5,True
2080905,191,3,30,5884,724547962,1,0,0,310.06,8,801364.37,18,5,11,5,True
2119350,465,0,10,1864,724547962,1,0,0,310.17,6,801674.54,13,3,1,6,True
2239469,191,3,25,5884,724547962,1,0,0,309.79,8,801364.75,18,3,15,6,True
2257766,994,4,451,8572,724547962,1,0,0,309.96,7,801054.79,22,0,13,7,True
2414217,319,0,20,1864,724547962,1,0,0,309.84,5,800744.95,11,5,7,9,True
2742163,410,4,25,8036,724547962,1,0,0,309.68,8,800435.27,18,6,2,11,True
2840807,130,0,-1,1073,724547962,1,1,0,310.4,1,800435.27,18,6,3,11,True
3042697,410,4,451,6300,724547962,1,0,0,309.89,7,800125.38,18,5,9,12,True
3145355,484,0,30,5884,724547962,1,0,0,309.7,8,799815.68,5,2,9,12,True
3228604,218,0,20,9724,724547962,1,0,0,310.09,5,799505.59,9,3,6,12,True
3537548,130,0,-1,1222,724547962,1,1,0,309.63,1,799505.59,18,4,2,1,True
3637047,220,0,20,6907,724547962,1,0,0,309.93,5,799195.66,26,1,8,1,True
3776702,694,2,20,5884,724547962,1,0,0,309.93,3,798885.73,24,3,10,2,True
3914387,1315,0,20,9724,724547962,1,0,0,309.56,5,798576.17,5,6,18,3,True
3967376,420,4,451,6300,724547962,1,0,0,309.97,7,798266.2,18,1,18,3,True
4291797,410,4,-1,1073,724547962,1,1,0,310.09,1,798266.2,18,3,7,4,True
4512577,994,4,30,7950,724547962,1,0,0,310.0,8,797956.2,22,5,14,4,True
4534792,1179,0,20,9724,724547962,1,0,0,309.94,3,797646.26,24,4,4,6,True
4552205,589,1,10,7950,724547962,1,0,0,309.97,0,797956.23,24,2,10,6,True
4815650,349,2,20,4068,724547962,1,0,0,309.9,5,797646.33,24,2,1,7,True
4885686,444,2,20,7530,724547962,1,0,0,310.04,5,797336.29,24,6,2,7,True
4926406,410,4,30,1073,724547962,1,0,0,309.88,8,797026.41,18,5,2,7,True
5191285,191,3,-1,5204,724547962,1,1,0,310.07,4,797026.41,18,1,3,8,True
5191290,994,4,451,5884,724547962,1,0,0,309.78,7,796716.63,22,3,17,8,True
5409274,874,4,25,2707,724547962,1,0,0,310.21,8,796406.42,24,6,19,9,True
5544898,484,0,25,2707,724547962,1,0,0,309.99,8,796096.43,5,6,10,10,True
5556971,300,0,10,5204,724547962,1,0,0,309.94,6,796406.37,4,6,5,10,True
5846641,1333,4,451,8036,724547962,1,0,0,309.96,7,796096.41,18,1,2,11,True
6178640,1333,4,451,8850,724547962,1,0,0,309.89,7,795786.52,18,2,2,11,True
6276574,484,0,451,4192,724547962,1,0,0,310.16,7,795476.36,5,1,9,12,True
6696012,191,3,-1,2707,724547962,1,1,0,310.0,4,795476.36,18,2,18,12,False
6743518,410,4,-1,8323,724547962,1,2,0,309.57,4,795476.36,18,6,2,1,True
6849433,994,4,30,1898,724547962,1,0,0,310.22,8,795166.14,22,0,16,1,True
6962961,404,1,10,1973,724547962,1,0,0,309.85,6,795475.99,10,4,22,2,True
7254083,874,4,30,4684,724547962,1,0,0,309.84,8,795166.15,24,1,0,3,True
7377819,484,0,451,8572,724547962,1,0,0,310.26,7,794855.89,5,2,0,3,True
7609267,130,0,451,4449,724547962,1,0,0,309.82,7,794546.07,18,0,16,3,True
7680940,1436,0,10,5884,724547962,1,0,0,310.0,6,794856.07,24,2,10,4,True
7698981,677,0,20,1864,724547962,1,0,0,310.02,5,794546.05,24,0,13,4,True
7857386,191,3,25,7950,724547962,1,0,0,310.07,8,794235.98,18,5,20,5,True
7947120,130,0,-1,4684,724547962,1,1,0,310.03,4,794235.98,18,0,22,5,True
8221931,525,0,20,1864,724547962,1,0,0,310.13,3,793925.85,18,5,15,5,True
8240717,191,3,25,5204,724547962,1,0,0,309.96,8,793615.89,18,0,9,5,True
8489850,130,0,30,9271,724547962,1,0,0,309.78,8,793306.11,18,2,0,6,True
8859076,484,0,-1,8850,724547962,1,1,0,310.16,4,793306.11,5,1,3,6,True
8931415,994,4,451,1898,724547962,1,0,0,309.86,7,792996.25,22,4,7,7,True
9144336,819,2,20,8036,724547962,1,0,0,309.99,5,792686.26,18,3,13,8,True
9449731,410,4,451,1973,724547962,1,0,0,310.03,7,792376.23,18,5,0,8,True
9462071,550,0,20,9724,724547962,1,0,0,310.23,5,792066.0,17,4,3,8,True
9606808,410,4,451,1864,724547962,1,0,0,310.01,7,791755.99,18,1,1,10,True
9885472,1333,4,451,6907,724547962,1,0,0,309.76,7,791446.23,18,6,4,10,True
9937678,410,4,-1,4449,724547962,1,1,0,309.95,1,791446.23,18,6,10,11,True
1020002,1426,1,10,7240,932383991,0,0,0,910.03,6,802683.03,24,3,0,1,True
1296654,1320,3,-1,2805,932383991,0,1,0,909.77,4,802683.03,18,3,16,3,True
1428190,378,0,30,2805,932383991,0,0,0,910.11,8,801772.92,25,4,14,6,True
1711360,1320,3,451,6782,932383991,0,0,0,909.83,7,800863.09,18,4,15,7,True
1793557,551,0,451,3639,932383991,0,0,0,910.09,7,799953.0,17,2,18,7,True
2093070,560,2,30,1911,932383991,0,0,0,910.02,8,799042.98,17,1,21,9,True
2152334,378,0,451,8486,932383991,0,0,0,910.03,7,798132.95,25,0,11,10,True
2230623,560,2,25,2805,932383991,0,0,0,910.01,8,797222.94,17,5,2,11,True
2241640,929,0,10,4484,932383991,0,0,0,910.0,6,798132.94,18,1,19,12,True
2413431,1089,0,20,8983,932383991,0,0,0,910.16,5,797222.78,18,2,3,12,True
2826956,560,2,25,7436,932383991,0,0,0,910.22,8,796312.56,17,2,18,12,True
2890567,378,0,30,9171,932383991,0,0,0,910.05,8,795402.51,25,2,19,12,True
2901501,834,0,10,3170,932383991,0,0,0,910.24,6,796312.75,5,6,21,1,True
3063073,560,2,-1,2562,932383991,0,1,0,910.11,1,796312.75,17,5,16,1,True
3166096,219,0,10,4336,932383991,0,0,0,910.17,6,797222.92,9,5,16,2,True
3729824,1439,4,25,8744,932383991,0,0,0,910.26,8,796312.66,24,1,9,2,False
3974165,130,0,10,2562,932383991,0,0,0,909.99,0,797222.65,18,2,3,3,True
4087357,931,0,20,6782,932383991,0,0,0,909.99,5,796312.66,24,3,1,3,False
4158360,51,0,20,5505,932383991,0,0,0,910.01,5,795402.65,20,0,2,3,True
4492655,205,0,10,1346,932383991,0,0,0,909.86,6,796312.51,9,2,1,4,True
4676786,560,2,25,1841,932383991,0,0,0,910.0,8,795402.51,17,2,15,4,True
4704815,1320,3,25,6782,932383991,0,0,0,909.79,8,794492.72,18,2,18,4,False
4874558,551,0,451,7240,932383991,0,0,0,910.25,7,793582.47,17,5,18,4,True
5019551,551,0,451,2805,932383991,0,0,0,909.88,7,792672.59,17,2,8,5,True
5471281,670,0,10,2805,932383991,0,0,0,909.84,6,793582.43,18,3,6,6,True
5650814,378,0,-1,3170,932383991,0,1,0,909.94,1,793582.43,25,1,4,7,True
5806035,1439,4,25,4362,932383991,0,0,0,910.07,8,792672.36,24,2,10,7,False
5874329,378,0,30,8734,932383991,0,0,0,910.05,8,791762.31,25,0,5,9,True
6160675,1439,4,25,4362,932383991,0,0,0,909.84,8,790852.47,24,0,12,9,True
6526913,1325,0,20,7240,932383991,0,0,0,909.76,3,789942.71,18,3,5,10,True
6593448,1162,2,20,6440,932383991,0,0,0,909.93,5,789032.78,24,6,16,11,True
6670861,378,0,25,4484,932383991,0,0,0,910.21,8,788122.57,25,4,12,11,True
6880611,1320,3,-1,3170,932383991,0,1,0,909.94,4,788122.57,18,3,0,12,True
7143216,560,2,451,5505,932383991,0,0,0,910.12,7,787212.45,17,5,22,12,True
7146535,203,0,20,3368,932383991,0,0,0,910.16,3,786302.29,9,6,2,12,True
7203091,560,2,30,6440,932383991,0,0,0,909.97,8,785392.32,17,0,23,1,True
7225636,551,0,30,1911,932383991,0,0,0,909.98,8,784482.34,17,4,6,1,True
7391838,560,2,30,1841,932383991,0,0,0,909.94,8,783572.4,17,6,0,1,True
7836608,871,0,20,9171,932383991,0,0,0,910.14,5,782662.26,24,5,18,2,True
7869982,551,0,25,4362,932383991,0,0,0,910.14,8,781752.12,17,4,1,3,True
7904332,560,2,25,5505,932383991,0,0,0,910.07,8,780842.05,17,3,23,3,True
7949481,551,0,451,8744,932383991,0,0,0,910.08,7,779931.97,17,6,0,3,True
8263922,560,2,25,1346,932383991,0,0,0,909.84,8,779022.13,17,4,16,5,True
8538329,551,0,30,4484,932383991,0,0,0,910.16,8,778111.97,17,3,4,6,True
8676839,560,2,451,1841,932383991,0,0,0,910.1,7,777201.87,17,1,23,7,True
8742704,1439,4,30,5505,932383991,0,0,0,910.02,8,776291.85,24,3,18,7,True
8842982,796,2,20,9171,932383991,0,0,0,909.96,3,775381.89,11,5,19,8,True
9218868,560,2,451,1346,932383991,0,0,0,910.14,7,774471.75,17,3,8,9,True
9307918,81,0,10,9662,932383991,0,0,0,910.02,6,775381.77,1,3,13,9,True
9769888,1439,4,25,8744,932383991,0,0,0,910.17,8,774471.6,24,4,10,10,True
9794885,1320,3,30,9662,932383991,0,0,0,910.17,8,773561.43,18,0,13,10,True
9845293,378,0,25,8744,932383991,0,0,0,909.98,8,772651.45,25,4,1,11,True
1000642,1045,4,25,2755,182676943,1,0,0,597.8,8,874365.2,11,6,21,1,True
1072007,1471,0,20,8803,182676943,1,0,0,597.85,3,873767.35,24,0,15,2,False
1088543,1307,0,25,5167,182676943,1,0,0,597.8,8,873169.55,5,3,21,2,True
1497367,260,0,20,2755,182676943,1,0,0,597.84,3,872571.71,6,6,12,3,True
1738722,1045,4,451,7344,182676943,1,0,0,598.17,7,871973.54,11,4,16,4,True
1846736,30,4,25,2568,182676943,1,0,0,597.94,8,871375.6,11,5,13,4,True
1877637,1007,2,20,5962,182676943,1,0,0,597.86,3,870777.74,26,2,15,5,True
1902550,1045,4,-1,5165,182676943,1,1,0,597.97,4,870777.74,11,6,14,6,True
2298265,1140,0,20,2568,182676943,1,0,0,597.91,5,870179.83,15,0,6,6,True
2313457,520,4,451,2568,182676943,1,0,0,598.34,7,869581.49,18,2,8,8,True
2635292,480,0,10,7619,182676943,1,0,0,597.85,6,870179.34,5,6,2,9,True
3004758,370,4,451,8803,182676943,1,0,0,597.77,7,869581.57,25,5,11,11,True
3253912,148,1,10,9513,182676943,1,0,0,598.13,0,870179.7,18,1,9,11,True
4053942,939,0,30,2430,182676943,1,0,0,598.24,8,869581.46,24,1,5,1,True
4552149,30,4,30,6365,182676943,1,0,0,597.86,8,868983.6,11,5,3,1,True
4874400,1045,4,451,9513,182676943,1,0,0,598.12,7,868385.48,11,6,9,2,False
4896701,319,0,20,6497,182676943,1,0,0,597.83,3,867787.65,11,0,15,2,True
4896978,825,2,20,7344,182676943,1,0,0,598.04,5,867189.61,18,3,19,3,True
5393916,735,1,10,2755,182676943,1,0,0,598.0,0,867787.61,11,1,11,4,True
5452734,916,0,451,6868,182676943,1,0,0,598.29,7,867189.32,18,1,2,5,True
5618933,1045,4,30,6497,182676943,1,0,0,597.71,8,866591.61,11,6,20,7,True
5627800,882,0,10,6868,182676943,1,0,0,598.05,6,867189.66,27,1,1,7,True
5633468,916,0,451,4880,182676943,1,0,0,597.92,7,866591.74,18,5,3,7,True
5803984,370,4,451,2096,182676943,1,0,0,598.09,7,865993.65,25,2,1,8,True
5819551,939,0,30,8037,182676943,1,0,0,597.95,8,865395.7,24,6,7,10,True
5826995,630,0,20,8037,182676943,1,0,0,598.01,3,864797.69,11,4,12,11,True
6469858,893,4,-1,4178,182676943,1,1,0,597.81,4,864797.69,24,5,13,11,True
6784139,1454,1,10,2712,182676943,1,0,0,598.18,6,865395.87,11,2,23,11,True
6807812,895,0,20,7619,182676943,1,0,0,598.04,5,864797.83,24,4,1,12,True
6854322,370,4,-1,2712,182676943,1,1,0,598.07,4,864797.83,25,5,0,12,True
7298849,219,0,20,2712,182676943,1,0,0,598.01,3,864199.82,9,2,3,1,True
7393578,370,4,451,2755,182676943,1,0,0,597.94,7,863601.88,25,0,20,1,True
7576182,907,0,20,2430,182676943,1,0,0,598.04,5,863003.84,2,5,10,1,True
7598295,1045,4,30,7344,182676943,1,0,0,597.95,8,862405.89,11,5,21,2,True
7667134,916,0,-1,3105,182676943,1,1,0,598.0,1,862405.89,18,4,8,3,True
7672015,98,0,10,8037,182676943,1,0,0,597.88,6,863003.77,3,3,3,3,True
7718989,1093,0,20,7344,182676943,1,0,0,598.11,5,862405.66,18,6,22,3,False
7746964,893,4,30,5962,182676943,1,0,0,598.0,8,861807.66,24,6,19,5,True
7809904,30,4,-1,5962,182676943,1,1,0,597.71,4,861807.66,11,3,12,5,False
7855764,1307,0,451,2568,182676943,1,0,0,597.97,7,861209.69,5,6,20,6,True
7898505,30,4,451,7761,182676943,1,0,0,598.16,7,860611.53,11,2,17,6,True
7989901,520,4,30,7344,182676943,1,0,0,598.16,8,860013.37,18,3,14,7,True
8072524,1307,0,25,7619,182676943,1,0,0,597.75,8,859415.62,5,2,8,7,True
8430338,30,4,30,5163,182676943,1,0,0,598.04,8,858817.58,11,4,13,8,True
8464593,145,0,10,2430,182676943,1,0,0,597.73,0,859415.31,18,2,22,8,True
8510462,1044,0,20,5962,182676943,1,0,0,598.24,5,858817.07,11,3,16,8,True
8511726,370,4,451,7761,182676943,1,0,0,597.98,7,858219.09,25,4,12,9,True
8564264,1321,0,20,8037,182676943,1,0,0,598.14,5,857620.95,18,0,6,10,True
8686770,918,2,20,2430,182676943,1,0,0,598.0,3,857022.95,18,1,16,10,True
8695990,893,4,30,8037,182676943,1,0,0,598.05,8,856424.9,24,4,19,11,True
9282787,370,4,25,1632,182676943,1,0,0,598.07,8,855826.83,25,5,2,11,True
9399238,1045,4,-1,4178,182676943,1,1,0,597.53,4,855826.83,11,5,6,11,True
9473402,1045,4,30,6497,182676943,1,0,0,597.82,8,855229.01,11,0,19,11,True
9556884,893,4,-1,5962,182676943,1,1,0,597.71,1,855229.01,24,5,12,11,False
1006948,938,4,-1,2932,598582551,0,1,0,146.94,4,368526.0,24,0,14,1,True
1044003,1175,2,30,3256,598582551,0,0,0,146.87,8,368379.13,24,6,21,2,True
1055566,714,2,451,2615,598582551,0,0,0,147.04,7,368232.09,18,0,4,2,False
1122591,1434,0,20,3256,598582551,0,0,0,146.87,3,368085.22,24,0,22,2,True
1157676,938,4,451,2004,598582551,0,0,0,147.07,7,367938.15,24,0,5,3,False
1325874,597,4,25,4618,598582551,0,0,0,147.04,8,367791.11,24,4,2,4,False
1621015,739,1,25,7529,598582551,0,0,0,146.89,8,367644.22,24,5,3,4,True
1778416,358,4,-1,2583,598582551,0,1,0,146.95,4,367644.22,24,0,9,4,True
1978655,1227,0,10,8054,598582551,0,0,0,147.02,0,367791.24,18,6,1,5,True
2502429,23,0,20,5248,598582551,0,0,0,147.21,5,367644.03,11,0,7,6,True
2731414,739,1,-1,7529,598582551,0,1,0,146.93,1,367644.03,24,2,9,6,True
3117813,597,4,-1,8054,598582551,0,2,0,146.93,4,367644.03,24,3,6,6,True
3136142,1380,0,20,7529,598582551,0,0,0,147.04,5,367496.99,16,6,21,7,True
3144793,597,4,451,9181,598582551,0,0,0,146.9,7,367350.09,24,2,17,7,True
3285627,667,4,-1,6359,598582551,0,1,0,146.94,4,367350.09,18,3,15,10,True
3473567,938,4,451,1283,598582551,0,0,0,146.93,7,367203.16,24,4,13,10,True
3664799,714,2,25,7333,598582551,0,0,0,146.93,8,367056.23,18,1,9,11,True
3722967,95,2,20,8054,598582551,0,0,0,146.92,5,366909.31,1,6,16,12,True
3757247,940,1,10,7529,598582551,0,0,0,146.79,6,367056.1,24,1,19,12,True
4072139,309,0,-1,2583,598582551,0,1,0,147.13,1,367056.1,4,3,0,1,True
4163651,309,0,30,7529,598582551,0,0,0,147.15,8,366908.95,4,2,5,1,True
4206087,558,0,10,9658,598582551,0,0,0,147.08,6,367056.03,17,0,8,2,True
4508764,998,0,20,6359,598582551,0,0,0,147.2,5,366908.83,26,6,2,3,True
4555454,597,4,-1,7529,598582551,0,1,0,146.93,4,366908.83,24,0,9,3,True
4647469,667,4,-1,6359,598582551,0,2,0,146.96,4,366908.83,18,2,1,4,True
4647755,1164,0,20,6893,598582551,0,0,0,146.99,3,366761.84,24,5,2,4,True
4825720,938,4,-1,6857,598582551,0,1,0,147.22,4,366761.84,24,5,19,6,True
5052229,309,0,30,2932,598582551,0,0,0,146.79,8,366615.05,4,5,12,7,True
5075664,714,2,25,8910,598582551,0,0,0,147.13,8,366467.92,18,6,9,7,True
5170829,860,1,10,7529,598582551,0,0,0,147.0,6,366614.92,24,4,15,7,True
5191215,714,2,30,2932,598582551,0,0,0,146.95,8,366467.97,18,5,17,7,True
5288817,358,4,25,2932,598582551,0,0,0,147.13,8,366320.84,24,2,0,8,True
5488447,667,4,451,7830,598582551,0,0,0,147.19,7,366173.65,18,3,3,8,True
5899563,597,4,451,3256,598582551,0,0,0,147.02,7,366026.63,24,3,10,8,True
5965809,309,0,30,6893,598582551,0,0,0,147.13,8,365879.5,4,3,8,10,True
6137630,358,4,25,9451,598582551,0,0,0,146.97,8,365732.53,24,4,22,10,True
6449051,309,0,-1,2932,598582551,0,1,0,147.34,1,365732.53,4,0,20,11,True
6696002,1304,0,10,3256,598582551,0,0,0,147.02,6,365879.55,5,4,0,11,True
6783778,1175,2,451,9658,598582551,0,0,0,147.22,7,365732.33,24,6,4,11,True
6836325,239,1,10,7529,598582551,0,0,0,147.02,6,365879.35,26,5,15,12,True
7139895,1175,2,30,6359,598582551,0,0,0,146.96,8,365732.39,24,1,20,12,True
7210386,215,0,10,9973,598582551,0,0,0,147.24,6,365879.63,9,2,1,2,True
7272301,597,4,25,2583,598582551,0,0,0,146.87,8,365732.76,24,0,1,2,True
7321766,938,4,25,8054,598582551,0,0,0,147.01,8,365585.75,24,0,3,3,True
7380917,1102,2,20,5248,598582551,0,0,0,146.95,5,365438.8,0,5,21,4,True
7395755,667,4,451,2417,598582551,0,0,0,146.81,7,365291.99,18,1,1,4,True
7593019,938,4,451,8910,598582551,0,0,0,147.03,7,365144.96,24,2,1,4,True
7746959,64,0,10,7529,598582551,0,0,0,146.96,6,365291.92,20,0,17,4,True
7784519,309,0,451,9181,598582551,0,0,0,147.08,7,365144.84,4,1,10,5,True
7838918,739,1,451,1283,598582551,0,0,0,146.98,7,364997.86,24,1,8,6,True
7877315,309,0,451,8910,598582551,0,0,0,146.96,7,364850.9,4,1,23,6,True
8460655,303,0,10,6857,598582551,0,0,0,147.12,6,364998.02,4,0,17,6,True
9206907,1217,0,10,2583,598582551,0,0,0,147.08,0,365145.1,24,6,17,8,True
9252855,316,2,20,6893,598582551,0,0,0,146.98,3,364998.12,4,1,12,8,True
9334176,714,2,25,6359,598582551,0,0,0,146.84,8,364851.28,18,4,7,8,True
9743676,667,4,30,3147,598582551,0,0,0,146.99,8,364704.29,18,0,9,8,True
9888025,309,0,30,9181,598582551,0,0,0,146.96,8,364557.33,4,1,12,8,True
9897286,1307,0,20,9181,598582551,0,0,0,146.85,5,364410.48,5,5,14,10,True
9935722,1175,2,451,6359,598582551,0,0,0,147.18,7,364263.3,24,3,5,11,True
1067845,247,4,25,2316,498719439,1,0,0,234.08,8,688885.92,6,2,15,1,True
1090731,719,4,451,3452,498719439,1,0,0,234.14,7,688651.78,11,5,20,1,True
1117601,917,0,10,3881,498719439,1,0,0,233.9,6,688885.68,18,4,0,2,True
1305644,1187,4,451,8100,498719439,1,0,0,234.17,7,688651.51,24,3,5,3,True
2323113,339,4,-1,2316,498719439,1,1,0,234.06,4,688651.51,11,3,2,5,True
2651816,1063,0,20,2106,498719439,1,0,0,234.17,3,688417.34,11,5,2,5,True
2671766,1187,4,-1,9666,498719439,1,1,0,234.07,1,688417.34,24,6,9,6,True
2755251,1187,4,25,6851,498719439,1,0,0,233.81,8,688183.53,24,0,8,7,True
3110358,1187,4,-1,3278,498719439,1,1,0,234.1,4,688183.53,24,4,3,8,True
3517747,719,4,25,2316,498719439,1,0,0,234.29,8,687949.24,11,2,17,8,True
3629738,705,1,10,1804,498719439,1,0,0,233.89,0,688183.13,18,2,15,9,True
3758677,1170,0,20,3035,498719439,1,0,0,234.15,5,687948.98,24,1,17,9,True
3930765,218,0,20,9666,498719439,1,0,0,234.2,3,687714.78,9,0,7,10,True
4238769,339,4,451,7363,498719439,1,0,0,233.8,7,687480.98,11,5,19,12,True
4312602,537,0,20,2106,498719439,1,0,0,233.91,5,687247.07,18,1,11,12,True
4539056,1053,1,10,2155,498719439,1,0,0,234.05,6,687481.12,11,0,7,5,True
4585260,1217,0,10,9222,498719439,1,0,0,233.82,6,687714.94,24,5,21,5,True
4599278,642,0,10,2774,498719439,1,0,0,233.86,6,687948.8,24,4,15,6,True
4628446,1272,0,20,9222,498719439,1,0,0,234.08,5,687714.72,24,4,23,6,True
4719258,1062,3,-1,7281,498719439,1,1,0,234.12,1,687714.72,11,2,7,6,True
4972631,503,0,20,7059,498719439,1,0,0,233.84,5,687480.88,12,2,17,7,True
5089707,247,4,30,3035,498719439,1,0,0,233.82,8,687247.06,6,6,3,7,True
5143692,1187,4,30,3881,498719439,1,0,0,233.92,8,687013.14,24,5,8,8,False
5386161,1354,0,-1,9222,498719439,1,1,0,234.04,4,687013.14,24,4,18,9,True
5408266,339,4,-1,3082,498719439,1,2,0,234.11,4,687013.14,11,5,5,10,True
5601391,1062,3,451,4504,498719439,1,0,0,234.1,7,686779.04,11,3,12,10,True
5657195,1312,0,20,9222,498719439,1,0,0,233.96,3,686545.08,5,5,1,11,True
5859211,1354,0,-1,3604,498719439,1,1,0,233.99,1,686545.08,24,0,3,11,True
6310939,1354,0,451,8100,498719439,1,0,0,233.83,7,686311.25,24,4,2,12,True
6577841,467,0,20,2316,498719439,1,0,0,234.03,3,686077.22,5,1,4,1,True
6923520,1354,0,451,7113,498719439,1,0,0,233.96,7,685843.26,24,1,8,1,True
6969039,1354,0,30,2316,498719439,1,0,0,233.86,8,685609.4,24,6,13,2,True
7135272,719,4,30,7184,498719439,1,0,0,233.98,8,685375.42,11,4,6,2,True
7918417,1354,0,25,2106,498719439,1,0,0,234.04,8,685141.38,24,6,10,3,True
8195631,339,4,30,3452,498719439,1,0,0,234.06,8,684907.32,11,0,14,3,False
8436126,1187,4,451,3881,498719439,1,0,0,234.05,7,684673.27,24,5,7,5,False
8619080,1062,3,30,1199,498719439,1,0,0,233.74,8,684439.53,11,2,5,5,True
8753533,719,4,30,7059,498719439,1,0,0,234.14,8,684205.39,11,1,1,5,True
8802134,339,4,451,7281,498719439,1,0,0,234.06,7,683971.33,11,2,7,5,True
8893333,1000,0,10,2316,498719439,1,0,0,234.14,6,684205.47,26,1,15,6,True
8947828,729,0,20,3881,498719439,1,0,0,233.94,5,683971.53,11,3,0,6,True
9065288,1449,0,10,3604,498719439,1,0,0,234.19,6,684205.72,11,4,1,6,True
9116235,979,0,10,7184,498719439,1,0,0,234.11,0,684439.83,22,3,7,8,True
9317613,1187,4,451,4504,498719439,1,0,0,234.23,7,684205.6,24,5,11,9,True
9399656,247,4,30,9177,498719439,1,0,0,234.13,8,683971.47,6,0,6,10,False
9421376,1089,0,20,7363,498719439,1,0,0,233.97,5,683737.5,18,5,2,10,False
9577254,247,4,25,3035,498719439,1,0,0,233.75,8,683503.75,6,3,15,11,True
9860005,719,4,451,3278,498719439,1,0,0,234.09,7,683269.66,11,5,11,11,True
9867833,1187,4,-1,3082,498719439,1,1,0,233.97,4,683269.66,24,0,14,11,True
9957265,247,4,451,1804,498719439,1,0,0,234.09,7,683035.57,6,4,11,11,True
1142452,640,4,30,9919,942296868,0,0,0,674.95,8,125612.05,24,0,9,1,True
1540095,522,0,10,2499,942296868,0,0,0,674.68,6,126286.73,18,4,7,1,True
1636799,605,0,-1,9575,942296868,0,1,0,675.15,1,126286.73,24,0,6,1,True
1766827,398,0,25,6281,942296868,0,0,0,675.06,8,125611.67,10,2,4,3,True
1767125,1000,0,20,3824,942296868,0,0,0,674.94,3,124936.73,26,4,23,3,True
2128484,1072,0,10,1791,942296868,0,0,0,675.06,6,125611.79,18,1,8,4,False
2770492,1488,0,-1,9575,942296868,0,1,0,674.83,4,125611.79,24,3,0,4,True
2793975,794,2,25,2015,942296868,0,0,0,675.04,8,124936.75,11,6,17,5,False
2959041,398,0,451,9575,942296868,0,0,0,675.01,7,124261.74,10,4,0,6,True
2974587,794,2,25,1872,942296868,0,0,0,674.92,8,123586.82,11,4,13,6,True
3137317,463,1,10,9453,942296868,0,0,0,674.87,6,124261.69,13,2,1,6,True
3339297,965,4,-1,6534,942296868,0,1,0,675.1,4,124261.69,13,4,3,7,True
3496282,1423,3,451,9919,942296868,0,0,0,674.96,7,123586.73,24,0,0,7,True
3625841,1123,2,20,5497,942296868,0,0,0,674.92,5,122911.81,24,1,16,7,True
3742516,965,4,451,1020,942296868,0,0,0,675.03,7,122236.78,13,2,2,8,True
3852248,640,4,451,9919,942296868,0,0,0,674.87,7,121561.91,24,3,8,8,True
3855604,1333,4,-1,6281,942296868,0,1,0,675.19,1,121561.91,18,1,6,8,True
4244854,965,4,451,1791,942296868,0,0,0,675.0,7,120886.91,13,4,10,9,True
4568879,605,0,451,9873,942296868,0,0,0,674.92,7,120211.99,24,5,11,10,True
4678554,1488,0,-1,9453,942296868,0,1,0,675.12,4,120211.99,24,5,13,10,True
5137720,605,0,-1,5497,942296868,0,2,0,675.2,4,120211.99,24,4,16,11,True
5142040,605,0,451,9873,942296868,0,0,0,675.21,7,119536.78,24,1,13,12,True
5239566,679,0,10,8160,942296868,0,0,0,675.01,0,120211.79,24,5,2,2,True
5399720,640,4,25,6281,942296868,0,0,0,674.71,8,119537.08,24,4,5,2,True
5584550,1271,0,10,2499,942296868,0,0,0,674.89,6,120211.97,23,5,2,3,True
5754561,366,0,20,3824,942296868,0,0,0,674.89,5,119537.08,25,4,13,6,True
5791708,965,4,-1,9453,942296868,0,1,0,675.3,1,119537.08,13,0,17,6,True
5868995,605,0,25,9873,942296868,0,0,0,675.04,8,118862.04,24,1,16,6,True
6020197,1388,1,10,6223,942296868,0,0,0,674.83,6,119536.87,24,6,14,8,True
6112738,640,4,30,6223,942296868,0,0,0,674.68,8,118862.19,24,6,11,9,True
6221603,1217,0,10,1791,942296868,0,0,0,675.0,6,119537.19,24,4,19,9,True
6431501,640,4,-1,9575,942296868,0,1,0,675.1,4,119537.19,24,2,6,9,True
6910880,794,2,451,1872,942296868,0,0,0,675.23,7,118861.96,11,3,21,10,True
6922363,794,2,451,5497,942296868,0,0,0,675.08,7,118186.88,11,5,2,10,True
7099294,1089,0,20,6534,942296868,0,0,0,674.78,3,117512.1,18,3,10,11,True
7118023,1423,3,451,2015,942296868,0,0,0,674.96,7,116837.14,24,4,4,11,True
7252568,605,0,30,6534,942296868,0,0,0,674.81,8,116162.33,24,2,10,11,True
7252617,1488,0,451,1020,942296868,0,0,0,675.15,7,115487.18,24,4,1,12,True
7313927,605,0,451,9575,942296868,0,0,0,674.74,7,114812.44,24,5,19,12,True
7361638,1423,3,30,9873,942296868,0,0,0,674.96,8,114137.48,24,6,10,1,True
7461196,1488,0,451,6534,942296868,0,0,0,674.92,7,113462.56,24,0,2,1,True
7466220,640,4,25,6281,942296868,0,0,0,674.96,8,112787.6,24,5,1,1,True
7487559,1423,3,451,5497,942296868,0,0,0,674.87,7,112112.73,24,4,5,2,True
7940113,464,1,10,1872,942296868,0,0,0,675.12,0,112787.85,13,2,11,2,True
8147768,640,4,-1,6281,942296868,0,1,0,675.14,1,112787.85,24,3,14,2,True
8396141,794,2,25,8284,942296868,0,0,0,674.77,8,112113.08,11,2,19,2,True
8510499,1128,2,20,6534,942296868,0,0,0,674.87,5,111438.21,24,0,19,3,True
8631477,1488,0,30,3824,942296868,0,0,0,675.05,8,110763.16,24,1,11,4,True
8635821,640,4,451,6281,942296868,0,0,0,674.98,7,110088.18,24,1,13,4,True
8868724,438,1,10,9873,942296868,0,0,0,674.98,0,110763.16,24,5,18,4,True
9104858,398,0,-1,1791,942296868,0,1,0,675.06,4,110763.16,10,3,21,5,True
9235807,1423,3,451,8284,942296868,0,0,0,674.91,7,110088.25,24,5,9,6,True
9384988,640,4,30,9873,942296868,0,0,0,675.2,8,109413.05,24,0,7,6,True
9393293,1333,4,451,2499,942296868,0,0,0,675.13,7,108737.92,18,2,4,6,True
9482498,570,2,20,8284,942296868,0,0,0,675.15,5,108062.77,11,3,23,9,True
9975141,1488,0,25,8160,942296868,0,0,0,675.01,8,107387.76,24,2,20,11,True
1410432,892,4,451,5612,961067216,1,0,0,151.81,7,529932.19,24,6,11,1,True
1900445,1383,4,451,9767,961067216,1,0,0,152.0,7,529780.19,16,3,21,1,True
1947042,1389,4,30,5043,961067216,1,0,0,151.92,8,529628.27,24,1,23,3,True
1967465,319,0,10,9767,961067216,1,0,0,152.18,0,529780.45,11,0,18,3,True
2152334,1407,4,-1,3199,961067216,1,1,0,151.78,4,529780.45,24,1,1,3,True
2212854,1407,4,-1,5043,961067216,1,2,0,151.91,4,529780.45,24,0,6,4,True
2545895,1389,4,25,9767,961067216,1,0,0,152.0,8,529628.45,24,1,16,5,True
2596142,394,0,10,8934,961067216,1,0,0,151.82,6,529780.27,10,0,21,6,True
2697734,1407,4,451,1253,961067216,1,0,0,151.82,7,529628.45,24,0,2,8,True
2821292,944,2,451,1074,961067216,1,0,0,152.06,7,529476.39,24,2,20,8,True
3138039,1383,4,30,9615,961067216,1,0,0,151.68,8,529324.71,16,4,6,8,True
3161483,944,2,451,8930,961067216,1,0,0,151.99,7,529172.72,24,2,4,8,True
3511888,892,4,451,5043,961067216,1,0,0,152.0,7,529020.72,24,0,3,9,True
3557074,892,4,451,8531,961067216,1,0,0,151.89,7,528868.83,24,1,1,10,True
3770773,1383,4,451,8531,961067216,1,0,0,151.79,7,528717.04,16,0,23,10,True
3854802,944,2,25,6831,961067216,1,0,0,152.01,8,528565.03,24,4,9,11,True
3929741,892,4,25,5612,961067216,1,0,0,151.95,8,528413.08,24,0,5,11,True
4013474,1108,1,10,7491,961067216,1,0,0,151.77,6,528564.85,0,5,7,12,True
4344443,1407,4,451,7674,961067216,1,0,0,151.96,7,528412.89,24,1,15,2,True
4508671,892,4,30,3199,961067216,1,0,0,151.77,8,528261.12,24,4,20,2,True
4960009,944,2,451,4176,961067216,1,0,0,152.03,7,528109.09,24,6,23,3,True
5186298,1407,4,-1,8531,961067216,1,1,0,152.06,1,528109.09,24,0,17,4,True
5377383,341,0,10,8937,961067216,1,0,0,152.11,0,528261.2,24,2,15,5,True
5554011,47,1,10,1525,961067216,1,0,0,152.08,6,528413.28,24,2,13,7,True
5647923,1407,4,25,8531,961067216,1,0,0,151.98,8,528261.3,24,1,6,7,True
5744697,1029,0,10,8545,961067216,1,0,0,152.08,6,528413.38,11,2,11,9,True
5778000,892,4,451,8934,961067216,1,0,0,151.75,7,528261.63,24,3,12,9,True
6082611,944,2,30,4176,961067216,1,0,0,152.42,8,528109.21,24,0,17,10,True
6353823,1407,4,451,6517,961067216,1,0,0,152.06,7,527957.15,24,2,14,11,True
6438131,653,1,10,1253,961067216,1,0,0,151.87,0,528109.02,24,5,5,11,True
6928691,944,2,25,8531,961067216,1,0,0,152.29,8,527956.73,24,3,10,11,True
6949953,1407,4,30,5043,961067216,1,0,0,151.94,8,527804.79,24,5,3,12,True
7372458,1389,4,25,8713,961067216,1,0,0,152.18,8,527652.61,24,2,19,1,True
7502582,1389,4,30,3199,961067216,1,0,0,152.07,8,527500.54,24,2,10,1,True
7620419,1407,4,451,1074,961067216,1,0,0,151.87,7,527348.67,24,3,13,2,True
7698774,944,2,25,1334,961067216,1,0,0,151.94,8,527196.73,24,4,15,2,True
7719312,1389,4,25,4176,961067216,1,0,0,152.22,8,527044.51,24,1,6,2,True
7795964,1389,4,-1,4532,961067216,1,1,0,151.88,1,527044.51,24,3,9,2,True
7829303,944,2,-1,8713,961067216,1,2,0,151.92,1,527044.51,24,3,5,2,True
8163184,958,2,20,1074,961067216,1,0,0,152.03,3,526892.48,13,6,3,3,True
8308671,1312,0,10,7491,961067216,1,0,0,151.94,6,527044.42,5,1,13,3,True
8474867,1407,4,-1,8930,961067216,1,1,0,152.02,1,527044.42,24,0,3,4,True
8516551,892,4,451,1253,961067216,1,0,0,151.72,7,526892.7,24,0,23,6,True
8687501,1389,4,451,4532,961067216,1,0,0,151.91,7,526740.79,24,2,22,7,True
8858142,1389,4,451,1074,961067216,1,0,0,152.11,7,526588.68,24,3,5,7,True
9089206,892,4,25,6517,961067216,1,0,0,151.96,8,526436.72,24,3,7,7,True
9815323,944,2,-1,1334,961067216,1,1,0,151.98,4,526436.72,24,4,10,8,True
9815818,1407,4,-1,8545,961067216,1,2,0,151.91,1,526436.72,24,5,22,9,True
9891274,993,0,10,5612,961067216,1,0,0,152.08,6,526588.8,22,0,19,11,True
9970258,180,0,10,8930,961067216,1,0,0,152.07,6,526740.87,18,0,19,11,True
1171749,96,0,10,2054,319941461,0,0,0,566.92,0,638376.92,1,2,20,1,True
1410624,325,0,20,2054,319941461,0,0,0,566.99,5,637809.93,11,6,16,1,True
1532699,589,1,25,4749,319941461,0,0,0,567.14,8,637242.79,24,4,16,2,True
1619289,282,2,20,4351,319941461,0,0,0,567.26,5,636675.53,24,6,0,3,True
1760993,1103,4,25,7076,319941461,0,0,0,567.05,8,636108.48,0,5,19,4,True
1842734,1103,4,25,8341,319941461,0,0,0,566.88,8,635541.6,0,4,1,4,True
1909329,1241,3,451,4335,319941461,0,0,0,566.93,7,634974.67,18,1,2,5,True
2195177,340,4,25,4048,319941461,0,0,0,566.96,8,634407.71,24,2,14,5,True
2383268,220,0,25,6123,319941461,0,0,0,566.77,8,633840.94,26,3,5,5,True
2553718,1155,0,-1,4335,319941461,0,1,0,567.05,4,633840.94,15,4,22,6,True
2971298,220,0,451,2215,319941461,0,0,0,567.12,7,633273.82,26,3,10,6,True
2981794,1103,4,30,3033,319941461,0,0,0,566.91,8,632706.91,0,6,5,8,True
3204592,340,4,30,4351,319941461,0,0,0,567.02,8,632139.89,24,3,5,9,True
3227613,96,0,20,2121,319941461,0,0,0,567.18,5,631572.71,1,5,6,10,True
3334607,1155,0,451,4048,319941461,0,0,0,567.02,7,631005.69,15,6,23,11,True
3339182,340,4,451,2121,319941461,0,0,0,567.3,7,630438.39,24,0,19,12,True
3429931,1001,4,451,7076,319941461,0,0,0,567.24,7,629871.15,26,2,22,12,True
3626385,1103,4,-1,4351,319941461,0,1,0,566.73,4,629871.15,0,1,0,12,True
3914753,220,0,30,4351,319941461,0,0,0,567.07,8,629304.08,26,5,3,1,True
4039093,220,0,-1,5396,319941461,0,1,0,567.03,1,629304.08,26,2,4,1,True
4063772,1179,0,20,4048,319941461,0,0,0,567.12,5,628736.96,24,5,10,2,True
4351193,442,3,25,5481,319941461,0,0,0,567.11,8,628169.85,24,4,7,2,True
4398116,340,4,451,6123,319941461,0,0,0,567.17,7,627602.68,24,1,12,2,True
4408112,220,0,25,5649,319941461,0,0,0,567.0,8,627035.68,26,0,17,3,True
4450158,1250,1,10,5481,319941461,0,0,0,567.05,0,627602.73,23,0,0,3,True
4515962,1001,4,-1,5396,319941461,0,1,0,566.84,4,627602.73,26,6,17,4,True
4772395,442,3,-1,4351,319941461,0,2,0,566.96,4,627602.73,24,2,2,5,True
4997107,1001,4,30,8341,319941461,0,0,0,566.91,8,627035.82,26,1,22,5,True
5577086,372,0,20,3992,319941461,0,0,0,566.93,5,626468.89,25,2,14,5,True
5647273,1155,0,451,5649,319941461,0,0,0,566.79,7,625902.1,15,4,7,7,True
5783221,220,0,451,3542,319941461,0,0,0,566.85,7,625335.25,26,2,14,7,True
6086289,1001,4,451,4048,319941461,0,0,0,566.83,7,624768.42,26,6,4,9,True
6145031,220,0,30,9591,319941461,0,0,0,566.9,8,624201.52,26,3,7,9,True
6216673,589,1,-1,5639,319941461,0,1,0,567.22,4,624201.52,24,5,12,9,True
6341437,1245,1,10,3094,319941461,0,0,0,566.82,6,624768.34,18,1,0,10,True
6736500,1241,3,-1,4351,319941461,0,1,0,567.06,4,624768.34,18,0,15,12,True
6813251,1241,3,451,4335,319941461,0,0,0,566.95,7,624201.39,18,1,18,12,True
7207543,1150,0,20,5639,319941461,0,0,0,566.94,5,623634.45,15,3,10,3,True
7325136,589,1,25,4351,319941461,0,0,0,566.74,8,623067.71,24,4,6,3,True
7840687,220,0,451,7076,319941461,0,0,0,567.09,7,622500.62,26,6,1,5,True
8190618,442,3,30,6123,319941461,0,0,0,567.03,8,621933.59,24,1,1,5,True
8260661,304,0,20,5649,319941461,0,0,0,566.55,5,621367.04,4,1,14,5,True
8431090,642,0,10,4335,319941461,0,0,0,566.75,6,621933.79,24,1,15,6,True
8433102,518,2,20,4351,319941461,0,0,0,567.16,5,621366.63,18,3,21,7,True
8763185,589,1,-1,4749,319941461,0,1,0,566.86,1,621366.63,24,0,16,7,True
8824688,1001,4,30,3542,319941461,0,0,0,567.12,8,620799.51,26,4,21,8,True
9264123,589,1,30,5481,319941461,0,0,0,567.11,8,620232.4,24,5,18,8,True
9282045,51,0,20,2121,319941461,0,0,0,566.94,5,619665.46,20,5,1,9,True
9637875,1115,1,10,9591,319941461,0,0,0,567.02,6,620232.48,0,5,0,10,False
9669361,220,0,451,4749,319941461,0,0,0,566.94,7,619665.54,26,6,3,10,False
9846725,1103,4,30,3992,319941461,0,0,0,567.01,8,619098.53,0,2,13,10,True
9883192,589,1,451,4474,319941461,0,0,0,566.87,7,618531.66,24,6,16,11,True
1033113,1208,4,451,2538,526745565,0,0,0,521.13,7,206235.87,24,6,13,1,True
1210780,1208,4,25,9842,526745565,0,0,0,521.15,8,205714.72,24,3,17,1,True
1235710,554,4,451,2956,526745565,0,0,0,521.15,7,205193.57,17,6,11,3,True
1400661,1208,4,-1,2438,526745565,0,1,0,520.82,1,205193.57,24,5,5,7,True
1416820,554,4,25,5194,526745565,0,0,0,521.26,8,204672.31,17,5,1,7,True
1551896,553,1,10,9599,526745565,0,0,0,520.99,6,205193.3,17,2,17,8,True
1711671,1139,3,451,1719,526745565,0,0,0,521.24,7,204672.06,15,3,22,8,True
2079952,346,0,20,9235,526745565,0,0,0,520.88,3,204151.18,24,4,5,9,True
2204886,1139,3,30,2968,526745565,0,0,0,521.03,8,203630.15,15,0,12,12,True
2295763,1139,3,451,2538,526745565,0,0,0,520.83,7,203109.32,15,6,6,12,True
2382219,1208,4,451,8547,526745565,0,0,0,521.3,7,202588.02,24,5,8,1,True
2958819,554,4,-1,5194,526745565,0,1,0,521.05,4,202588.02,17,2,21,1,True
3188496,1208,4,451,1719,526745565,0,0,0,520.97,7,202067.05,24,4,10,1,True
3550000,862,4,25,4372,526745565,0,0,0,521.04,8,201546.01,24,3,15,2,True
3724161,1139,3,30,9656,526745565,0,0,0,521.28,8,201024.73,15,2,10,2,True
3958763,1471,0,20,8295,526745565,0,0,0,521.08,5,200503.65,24,4,15,5,True
4085159,554,4,451,9656,526745565,0,0,0,521.01,7,199982.64,17,0,5,5,True
4330482,1305,2,20,1092,526745565,0,0,0,520.87,5,199461.77,5,0,14,5,True
4372900,554,4,30,9842,526745565,0,0,0,520.77,8,198941.0,17,2,21,5,True
4429543,913,0,-1,4372,526745565,0,1,0,520.85,1,198941.0,18,0,6,5,True
4430512,554,4,25,8547,526745565,0,0,0,521.31,8,198419.69,17,4,19,6,True
4719045,482,1,10,4372,526745565,0,0,0,521.08,6,198940.77,5,5,4,6,True
4743642,1208,4,25,9656,526745565,0,0,0,521.07,8,198419.7,24,5,6,6,True
5203656,1139,3,25,9235,526745565,0,0,0,520.75,8,197898.95,15,1,19,6,True
5356216,1232,1,10,9656,526745565,0,0,0,520.91,6,198419.86,18,6,11,7,True
5521983,1139,3,25,2956,526745565,0,0,0,521.19,8,197898.67,15,4,22,7,True
5553640,554,4,451,2398,526745565,0,0,0,521.1,7,197377.57,17,5,3,7,True
5824741,1208,4,-1,8295,526745565,0,1,0,521.01,1,197377.57,24,0,0,9,True
5912761,554,4,451,8318,526745565,0,0,0,521.19,7,196856.38,17,0,4,9,True
6386240,862,4,451,5435,526745565,0,0,0,520.93,7,196335.45,24,3,14,9,True
6469425,862,4,30,1719,526745565,0,0,0,521.23,8,195814.22,24,6,9,10,True
6545687,1208,4,30,9235,526745565,0,0,0,520.99,8,195293.23,24,6,20,11,True
6705777,862,4,25,2956,526745565,0,0,0,521.28,8,194771.95,24,2,1,1,False
6884791,1139,3,451,8547,526745565,0,0,0,520.87,7,194251.08,15,5,21,1,True
6918945,1208,4,25,4372,526745565,0,0,0,520.94,8,193730.14,24,6,4,2,True
6982874,562,1,10,2968,526745565,0,0,0,520.92,6,194251.06,17,0,6,3,True
7088380,913,0,451,9235,526745565,0,0,0,520.97,7,193730.09,18,5,15,3,True
7206270,267,0,20,9599,526745565,0,0,0,520.95,3,193209.14,6,6,9,3,True
7293975,1139,3,25,2438,526745565,0,0,0,521.04,8,192688.1,15,4,17,3,True
7440373,913,0,30,3193,526745565,0,0,0,521.05,8,192167.05,18,2,23,3,True
7546741,913,0,-1,5435,526745565,0,1,0,521.06,1,192167.05,18,0,16,4,False
7939090,913,0,25,1719,526745565,0,0,0,521.09,8,191645.96,18,4,4,4,True
7966438,1159,0,10,9235,526745565,0,0,0,521.04,0,192167.0,15,6,9,5,True
9003633,913,0,25,8547,526745565,0,0,0,520.92,8,191646.08,18,1,1,5,True
9241628,203,0,10,8295,526745565,0,0,0,521.0,0,192167.08,9,0,9,5,True
9335973,1208,4,451,5194,526745565,0,0,0,521.07,7,191646.01,24,4,4,5,True
9370856,14,2,20,2438,526745565,0,0,0,521.18,5,191124.83,24,2,12,6,True
9738515,554,4,25,5435,526745565,0,0,0,520.89,8,190603.94,17,3,7,6,True
9795835,1139,3,25,4372,526745565,0,0,0,521.01,8,190082.93,15,4,16,8,True
9797886,913,0,451,1728,526745565,0,0,0,521.03,7,189561.9,18,0,18,9,True
9909697,1023,2,20,2538,526745565,0,0,0,520.99,3,189040.91,11,3,7,10,True
9919603,1208,4,25,3193,526745565,0,0,0,521.37,8,188519.54,24,0,9,10,True
1741578,1476,0,20,9778,364757022,0,0,0,619.29,5,359184.71,24,6,2,1,True
1891229,741,3,30,5761,364757022,0,0,0,619.01,8,358565.7,24,1,12,1,True
2042091,741,3,451,3757,364757022,0,0,0,618.93,7,357946.77,24,1,10,2,False
2165040,741,3,-1,5841,364757022,0,1,0,619.14,4,357946.77,24,5,0,2,False
2193353,569,4,451,2746,364757022,0,0,0,619.18,7,357327.59,11,0,8,2,True
2665549,931,0,-1,9928,364757022,0,1,0,619.24,4,357327.59,24,0,21,3,True
2799694,1155,0,10,8183,364757022,0,0,0,619.06,0,357946.65,15,3,18,3,True
2825164,394,0,451,2887,364757022,0,0,0,619.23,7,357327.42,10,2,2,5,True
2880059,711,2,20,2264,364757022,0,0,0,619.06,5,356708.36,18,0,2,5,True
2965518,741,3,30,2519,364757022,0,0,0,618.85,8,356089.51,24,0,18,5,True
2985926,879,1,10,3757,364757022,0,0,0,618.95,6,356708.46,27,1,7,6,True
3149763,1179,0,10,3701,364757022,0,0,0,619.21,0,357327.67,24,5,2,7,True
3311973,741,3,451,5841,364757022,0,0,0,618.7,7,356708.97,24,4,8,8,True
3353335,931,0,451,2264,364757022,0,0,0,619.16,7,356089.81,24,2,16,10,True
3363208,741,3,30,2034,364757022,0,0,0,618.96,8,355470.85,24,2,18,10,True
3625404,741,3,30,8082,364757022,0,0,0,619.13,8,354851.72,24,1,22,11,False
3802271,394,0,30,8183,364757022,0,0,0,619.05,8,354232.67,10,1,23,1,True
3881932,713,0,10,2034,364757022,0,0,0,618.86,0,354851.53,18,6,9,2,True
4340684,1235,1,10,2746,364757022,0,0,0,618.95,6,355470.48,18,1,8,2,True
4424030,664,2,20,8397,364757022,0,0,0,618.95,5,354851.53,18,3,10,3,True
4491728,569,4,451,4966,364757022,0,0,0,619.14,7,354232.39,11,2,8,4,True
4578523,1474,0,10,6451,364757022,0,0,0,618.94,6,354851.33,24,0,6,4,True
4623189,931,0,451,8143,364757022,0,0,0,619.08,7,354232.25,24,4,5,4,True
4941221,394,0,30,7995,364757022,0,0,0,618.65,8,353613.6,10,1,20,6,True
5064002,1206,0,20,5761,364757022,0,0,0,619.02,3,352994.58,24,4,7,6,True
5256439,741,3,-1,2519,364757022,0,1,0,619.02,1,352994.58,24,0,7,7,True
5430652,569,4,25,8143,364757022,0,0,0,619.04,8,352375.54,11,6,9,7,True
5807784,569,4,30,2887,364757022,0,0,0,619.06,8,351756.48,11,4,6,8,True
5890315,1370,4,-1,6372,364757022,0,1,0,619.22,4,351756.48,16,6,10,8,True
5929856,995,1,10,4966,364757022,0,0,0,619.02,6,352375.5,22,6,2,9,True
5986407,195,1,10,8397,364757022,0,0,0,618.83,6,352994.33,18,3,12,9,True
6026952,569,4,451,8817,364757022,0,0,0,618.96,7,352375.37,11,6,1,9,True
6128200,518,2,20,2264,364757022,0,0,0,619.09,3,351756.28,18,4,20,9,True
6647976,509,0,10,7995,364757022,0,0,0,619.1,6,352375.38,12,4,11,10,True
6747203,659,4,25,9773,364757022,0,0,0,618.98,8,351756.4,18,3,9,11,True
6796183,664,2,20,7158,364757022,0,0,0,619.04,5,351137.36,18,6,4,11,True
6876277,394,0,451,4966,364757022,0,0,0,619.01,7,350518.35,10,3,12,12,True
7260694,569,4,451,3701,364757022,0,0,0,619.26,7,349899.09,11,0,12,1,True
7400806,659,4,451,7995,364757022,0,0,0,618.82,7,349280.27,18,5,14,1,True
7405941,738,2,20,9773,364757022,0,0,0,618.85,5,348661.42,11,3,4,1,True
7425139,1370,4,-1,5761,364757022,0,1,0,618.85,4,348661.42,16,1,3,2,True
7575980,741,3,-1,8240,364757022,0,2,0,618.85,1,348661.42,24,1,20,4,True
7600261,945,1,10,3701,364757022,0,0,0,619.11,6,349280.53,24,5,9,5,False
7952347,569,4,-1,8328,364757022,0,1,0,619.18,4,349280.53,11,1,2,5,True
8120409,1370,4,25,2519,364757022,0,0,0,619.16,8,348661.37,16,3,0,5,False
8251364,931,0,-1,2746,364757022,0,1,0,619.35,4,348661.37,24,0,18,6,True
8372565,1370,4,451,7158,364757022,0,0,0,619.0,7,348042.37,16,6,20,6,False
8400334,1370,4,30,4966,364757022,0,0,0,618.95,8,347423.42,16,2,11,6,True
8798745,931,0,-1,7158,364757022,0,1,0,619.2,4,347423.42,24,1,0,7,True
8968385,394,0,451,7158,364757022,0,0,0,619.08,7,346804.34,10,6,2,8,True
9117956,1370,4,451,6372,364757022,0,0,0,618.78,7,346185.56,16,1,11,8,True
9175043,1370,4,451,3757,364757022,0,0,0,619.09,7,345566.47,16,2,7,9,True
9420630,659,4,25,8143,364757022,0,0,0,619.13,8,344947.34,18,6,20,9,True
9494697,569,4,451,6451,364757022,0,0,0,619.04,7,344328.3,11,4,21,10,True
9782968,1246,0,20,5761,364757022,0,0,0,619.07,5,343709.23,23,0,23,10,True
9897446,1159,0,20,3757,364757022,0,0,0,619.01,3,343090.22,15,1,0,11,True
9902368,530,0,10,7071,364757022,0,0,0,618.99,0,343709.21,18,2,3,11,True
1000067,205,0,-1,3496,828308371,1,1,0,956.18,1,151521.0,9,5,4,1,True
1027267,1036,1,25,6446,828308371,1,0,0,956.31,8,150564.69,11,0,21,1,True
1050906,688,0,30,6446,828308371,1,0,0,956.31,8,149608.38,24,0,17,1,True
1133293,471,0,451,6446,828308371,1,0,0,956.07,7,148652.31,5,0,22,3,True
1135829,838,4,-1,8754,828308371,1,1,0,956.09,1,148652.31,5,0,4,3,True
1197788,1036,1,451,8573,828308371,1,0,0,955.66,7,147696.65,11,2,4,3,True
1361996,438,1,10,3686,828308371,1,0,0,956.09,6,148652.74,24,6,12,4,True
1384295,838,4,30,3496,828308371,1,0,0,956.19,8,147696.55,5,5,12,4,True
1791666,688,0,25,4594,828308371,1,0,0,956.33,8,146740.22,24,1,13,5,True
2120606,838,4,30,1719,828308371,1,0,0,956.29,8,145783.93,5,2,23,5,True
2643344,205,0,451,7959,828308371,1,0,0,955.99,7,144827.94,9,0,12,6,False
2756293,1036,1,25,5784,828308371,1,0,0,956.47,8,143871.47,11,2,1,6,True
3079740,695,2,20,3686,828308371,1,0,0,955.92,5,142915.55,24,4,1,6,True
3283493,205,0,-1,5784,828308371,1,1,0,955.9,4,142915.55,9,0,15,6,True
3426536,688,0,25,1719,828308371,1,0,0,956.12,8,141959.43,24,4,17,8,False
3498219,747,1,25,5873,828308371,1,0,0,956.0,8,141003.43,24,6,0,9,True
3565940,838,4,-1,5873,828308371,1,1,0,955.81,1,141003.43,5,3,11,9,True
3937702,394,0,20,6446,828308371,1,0,0,956.1,5,140047.33,10,0,9,9,True
4124073,1327,4,451,5784,828308371,1,0,0,955.98,7,139091.35,18,1,7,9,True
4145536,144,1,10,4319,828308371,1,0,0,956.06,6,140047.41,18,3,21,10,True
4211112,1036,1,30,5188,828308371,1,0,0,956.2,8,139091.21,11,4,14,10,True
4277140,471,0,-1,8420,828308371,1,1,0,956.29,1,139091.21,5,0,6,10,True
4374716,81,0,10,9054,828308371,1,0,0,956.09,6,140047.3,1,3,23,1,True
4539199,688,0,30,5188,828308371,1,0,0,955.75,8,139091.55,24,2,3,1,False
4646657,688,0,25,3496,828308371,1,0,0,955.64,8,138135.91,24,2,5,1,True
5078668,1361,2,20,9054,828308371,1,0,0,955.85,5,137180.06,16,0,21,2,True
5287715,471,0,-1,8754,828308371,1,1,0,955.91,1,137180.06,5,5,8,3,True
5290569,1322,2,20,4594,828308371,1,0,0,956.04,3,136224.02,18,3,14,3,True
5319047,688,0,451,4319,828308371,1,0,0,956.08,7,135267.94,24,3,10,4,True
5404510,1035,0,20,5188,828308371,1,0,0,956.14,5,134311.8,11,3,15,4,True
5432058,688,0,25,3686,828308371,1,0,0,956.14,8,133355.66,24,6,23,4,True
5556588,688,0,30,8573,828308371,1,0,0,955.62,8,132400.04,24,0,7,5,True
5627077,889,0,10,4594,828308371,1,0,0,955.93,6,133355.97,27,3,14,8,True
5685523,471,0,30,9054,828308371,1,0,0,956.03,8,132399.94,5,1,12,8,True
5765009,1189,2,20,7959,828308371,1,0,0,955.76,3,131444.18,24,6,0,9,True
5891525,688,0,451,4319,828308371,1,0,0,956.04,7,130488.14,24,4,23,9,True
5946527,205,0,30,4594,828308371,1,0,0,956.12,8,129532.02,9,2,12,10,True
6023381,838,4,-1,5873,828308371,1,1,0,955.96,4,129532.02,5,2,5,10,True
6198542,1327,4,-1,8573,828308371,1,2,0,956.12,4,129532.02,18,2,10,11,True
6227131,1044,0,10,9054,828308371,1,0,0,956.02,0,130488.04,11,0,19,12,True
6258575,1327,4,451,8814,828308371,1,0,0,955.94,7,129532.1,18,5,22,12,True
6395540,688,0,30,4319,828308371,1,0,0,955.97,8,128576.13,24,6,20,12,True
6470010,471,0,451,5784,828308371,1,0,0,955.91,7,127620.22,5,0,1,1,True
6607549,747,1,25,7959,828308371,1,0,0,956.09,8,126664.13,24,4,11,1,True
6609566,641,0,10,8754,828308371,1,0,0,956.07,6,127620.2,24,3,10,3,True
6713672,838,4,30,3496,828308371,1,0,0,955.84,8,126664.36,5,5,16,3,True
6749585,688,0,-1,8754,828308371,1,1,0,956.05,4,126664.36,24,1,14,5,True
6898055,688,0,25,8573,828308371,1,0,0,956.06,8,125708.3,24,3,12,6,True
7042706,1327,4,451,5873,828308371,1,0,0,955.76,7,124752.54,18,1,9,7,True
7319375,219,0,10,9054,828308371,1,0,0,956.32,6,125708.86,9,4,14,7,True
8274618,880,1,10,8573,828308371,1,0,0,955.95,0,126664.81,27,5,7,8,True
8420740,1327,4,30,9054,828308371,1,0,0,955.93,8,125708.88,18,3,8,9,True
8706177,838,4,30,4319,828308371,1,0,0,955.75,8,124753.13,5,6,2,9,True
8987647,68,0,10,4594,828308371,1,0,0,956.16,6,125709.29,20,2,17,9,True
9692057,838,4,451,3968,828308371,1,0,0,956.18,7,124753.11,5,6,2,10,True
9939025,1036,1,451,8420,828308371,1,0,0,956.02,7,123797.09,11,1,10,10,True
9939710,551,0,10,3686,828308371,1,0,0,956.15,6,124753.24,17,0,14,11,True
1285426,75,3,25,2784,191845802,0,0,0,1193.92,8,183353.08,20,1,22,2,True
1488692,479,2,30,3779,191845802,0,0,0,1193.86,8,182159.22,5,0,3,2,True
1569647,75,3,30,9267,191845802,0,0,0,1193.84,8,180965.38,20,3,20,2,True
1601284,479,2,451,2784,191845802,0,0,0,1193.98,7,179771.4,5,3,8,6,True
1875106,542,0,10,7925,191845802,0,0,0,1194.01,0,180965.41,17,6,19,7,False
1925327,292,1,10,2355,191845802,0,0,0,1194.14,6,182159.55,4,1,19,7,True
1939258,1265,4,451,5564,191845802,0,0,0,1193.91,7,180965.64,23,0,12,8,True
2020813,1265,4,-1,7602,191845802,0,1,0,1194.25,1,180965.64,23,2,2,11,True
2166351,1404,2,451,9267,191845802,0,0,0,1194.12,7,179771.52,24,6,2,11,True
2594861,1404,2,-1,2784,191845802,0,1,0,1194.12,1,179771.52,24,4,18,11,True
2810096,705,1,10,8456,191845802,0,0,0,1194.02,6,180965.54,18,2,5,12,True
2966038,869,2,30,1622,191845802,0,0,0,1194.05,8,179771.49,24,2,11,12,True
3133880,1404,2,451,1622,191845802,0,0,0,1194.08,7,178577.41,24,3,9,1,True
3531499,869,2,451,7602,191845802,0,0,0,1193.98,7,177383.43,24,5,7,1,True
3802750,1265,4,-1,2784,191845802,0,1,0,1194.01,4,177383.43,23,4,15,1,True
3885229,1265,4,-1,2357,191845802,0,2,0,1193.99,1,177383.43,23,4,20,2,True
4170538,522,0,451,2784,191845802,0,0,0,1194.02,7,176189.41,18,2,8,2,True
4206555,479,2,25,1481,191845802,0,0,0,1194.04,8,174995.37,5,6,11,2,True
4291830,1404,2,451,7925,191845802,0,0,0,1193.62,7,173801.75,24,5,23,3,True
4443528,75,3,-1,3892,191845802,0,1,0,1194.12,1,173801.75,20,0,18,3,True
4529023,1404,2,25,3892,191845802,0,0,0,1194.16,8,172607.59,24,0,21,3,True
5039722,75,3,451,8844,191845802,0,0,0,1194.04,7,171413.55,20,0,13,4,True
5173958,75,3,25,7925,191845802,0,0,0,1194.04,8,170219.51,20,1,5,7,True
5582193,479,2,-1,4651,191845802,0,1,0,1193.65,4,170219.51,5,0,22,7,True
5673230,1404,2,451,1622,191845802,0,0,0,1193.99,7,169025.52,24,2,14,8,True
5995260,869,2,30,2357,191845802,0,0,0,1194.14,8,167831.38,24,3,11,8,True
6270548,479,2,-1,3779,191845802,0,1,0,1194.04,4,167831.38,5,4,13,9,True
6314080,1404,2,451,7823,191845802,0,0,0,1194.16,7,166637.22,24,6,5,10,True
6464582,522,0,30,3779,191845802,0,0,0,1193.97,8,165443.25,18,3,5,10,True
6484408,1271,0,20,4066,191845802,0,0,0,1193.82,5,164249.43,23,4,4,10,True
6647040,1404,2,451,5564,191845802,0,0,0,1193.74,7,163055.69,24,3,23,10,True
6690862,869,2,451,7303,191845802,0,0,0,1194.07,7,161861.62,24,4,23,10,True
7010119,75,3,25,5856,191845802,0,0,0,1193.78,8,160667.84,20,5,18,10,True
7099400,75,3,-1,3630,191845802,0,1,0,1194.01,1,160667.84,20,6,11,11,True
7279876,804,0,10,7925,191845802,0,0,0,1193.89,6,161861.73,11,4,17,11,True
7443316,129,0,10,7925,191845802,0,0,0,1194.03,6,163055.76,18,3,19,11,True
7563730,522,0,-1,7602,191845802,0,1,0,1194.02,4,163055.76,18,5,10,11,True
7631369,75,3,451,1481,191845802,0,0,0,1193.82,7,161861.94,20,5,22,11,True
7713871,1404,2,30,5564,191845802,0,0,0,1194.06,8,160667.88,24,3,7,11,True
7745233,1238,0,20,2687,191845802,0,0,0,1194.18,5,159473.7,18,6,20,12,True
8090686,522,0,451,9097,191845802,0,0,0,1193.83,7,158279.87,18,1,11,1,True
8253622,522,0,30,9267,191845802,0,0,0,1193.78,8,157086.09,18,2,15,2,True
8321409,1265,4,25,7506,191845802,0,0,0,1193.99,8,155892.1,23,0,3,4,True
8471355,479,2,451,7823,191845802,0,0,0,1193.96,7,154698.14,5,6,22,5,True
8598055,869,2,30,7823,191845802,0,0,0,1193.99,8,153504.15,24,6,2,5,False
9077666,479,2,25,8844,191845802,0,0,0,1193.82,8,152310.33,5,0,9,6,True
9083393,522,0,451,7823,191845802,0,0,0,1193.87,7,151116.46,18,0,15,6,True
9246913,75,3,25,8844,191845802,0,0,0,1194.0,8,149922.46,20,6,19,6,True
9312049,479,2,30,7823,191845802,0,0,0,1194.09,8,148728.37,5,2,1,7,True
9416700,675,2,20,3779,191845802,0,0,0,1193.97,5,147534.4,24,2,21,9,True
9449191,869,2,30,8794,191845802,0,0,0,1194.1,8,146340.3,24,1,4,10,True
9471142,75,3,451,9267,191845802,0,0,0,1193.85,7,145146.45,20,0,0,10,True
9481465,479,2,451,5856,191845802,0,0,0,1194.23,7,143952.22,5,1,4,11,True
9516133,479,2,25,9329,191845802,0,0,0,1194.24,8,142757.98,5,4,10,11,True
9606915,1265,4,25,3172,191845802,0,0,0,1194.14,8,141563.84,23,4,6,11,True
9876312,1265,4,25,7602,191845802,0,0,0,1194.06,8,140369.78,23,5,22,11,True
1099889,897,0,20,2923,860457500,0,0,0,497.15,3,160910.85,24,5,23,1,True
1151687,222,2,-1,9049,860457500,0,1,0,496.94,1,160910.85,26,5,13,1,True
1216875,1218,4,-1,4163,860457500,0,2,0,496.67,4,160910.85,24,6,1,2,True
1464787,553,1,451,7493,860457500,0,0,0,497.04,7,160413.81,17,5,13,2,True
1669294,222,2,20,4757,860457500,0,0,0,497.24,5,159916.57,26,5,22,3,False
1676709,883,0,10,6431,860457500,0,0,0,497.07,6,160413.64,24,1,8,3,True
1820897,949,4,-1,7862,860457500,0,1,0,496.86,1,160413.64,24,2,11,3,True
2087704,819,2,20,7493,860457500,0,0,0,497.03,5,159916.61,18,5,4,3,True
2583281,445,0,30,9154,860457500,0,0,0,496.9,8,159419.71,13,6,9,4,True
2594821,553,1,30,7493,860457500,0,0,0,496.98,8,158922.73,17,3,17,5,True
2685045,664,2,25,3507,860457500,0,0,0,497.0,8,158425.73,18,5,21,6,False
2840336,860,1,10,7292,860457500,0,0,0,496.88,6,158922.61,24,0,23,7,True
3013080,137,2,20,6431,860457500,0,0,0,497.1,5,158425.51,18,3,6,7,True
3132969,445,0,25,5592,860457500,0,0,0,497.05,8,157928.46,13,3,21,7,True
3186006,1358,4,30,4667,860457500,0,0,0,497.11,8,157431.35,24,0,13,9,True
3761114,553,1,451,3491,860457500,0,0,0,497.02,7,156934.33,17,1,3,9,True
3959399,535,0,10,7941,860457500,0,0,0,497.0,0,157431.33,18,4,14,11,True
4237366,1358,4,451,5592,860457500,0,0,0,496.96,7,156934.37,24,2,13,11,True
4618706,664,2,451,1709,860457500,0,0,0,497.25,7,156437.12,18,3,20,12,True
4677195,445,0,451,3507,860457500,0,0,0,496.98,7,155940.14,13,6,3,1,True
4838138,222,2,-1,3507,860457500,0,1,0,497.13,4,155940.14,26,0,13,1,True
4907029,222,2,25,5856,860457500,0,0,0,497.27,8,155442.87,26,1,11,2,True
5237379,1218,4,30,7493,860457500,0,0,0,496.99,8,154945.88,24,0,21,4,True
5454478,949,4,-1,9049,860457500,0,1,0,496.77,4,154945.88,24,0,10,5,True
5753759,222,2,25,7941,860457500,0,0,0,497.06,8,154448.82,26,5,5,6,True
5872711,731,4,451,7493,860457500,0,0,0,497.0,7,153951.82,11,4,18,7,True
5887394,1358,4,25,2452,860457500,0,0,0,497.11,8,153454.71,24,4,14,8,True
6029493,1094,0,20,7292,860457500,0,0,0,496.95,5,152957.76,0,2,5,8,True
6181929,369,1,10,1709,860457500,0,0,0,497.22,6,153454.98,25,1,8,8,True
6895615,664,2,30,5953,860457500,0,0,0,496.95,8,152958.03,18,3,1,8,True
6907303,445,0,451,7941,860457500,0,0,0,496.83,7,152461.2,13,5,11,9,False
6950127,949,4,30,9154,860457500,0,0,0,496.93,8,151964.27,24,6,8,9,True
7020638,394,0,10,4320,860457500,0,0,0,497.02,6,152461.29,10,2,7,10,True
7054295,222,2,30,4163,860457500,0,0,0,496.91,8,151964.38,26,1,0,10,True
7252347,222,2,30,4966,860457500,0,0,0,496.86,8,151467.52,26,4,23,10,True
7350112,222,2,30,9049,860457500,0,0,0,497.26,8,150970.26,26,6,1,10,True
7512534,1303,0,20,4757,860457500,0,0,0,497.1,5,150473.16,5,4,3,12,True
7895945,664,2,30,2288,860457500,0,0,0,497.12,8,149976.04,18,4,6,1,True
7902993,53,0,20,5592,860457500,0,0,0,497.04,5,149479.0,20,2,9,2,True
8093502,1116,0,20,2452,860457500,0,0,0,497.08,3,148981.92,24,1,4,4,True
8190223,1312,0,10,1709,860457500,0,0,0,497.03,0,149478.95,5,4,5,4,True
8243714,731,4,451,9729,860457500,0,0,0,496.97,7,148981.98,11,6,19,4,False
8301423,220,0,25,1709,860457500,0,0,0,496.88,8,148485.1,26,0,3,4,True
8321070,359,2,20,4667,860457500,0,0,0,497.22,5,147987.88,24,4,5,6,True
8361382,806,1,10,1709,860457500,0,0,0,497.2,0,148485.08,11,2,18,6,True
8787744,553,1,-1,5856,860457500,0,1,0,497.22,4,148485.08,17,4,2,6,True
8878586,222,2,30,9729,860457500,0,0,0,496.95,8,147988.13,26,4,10,6,True
9076615,204,0,20,4966,860457500,0,0,0,497.04,5,147491.09,9,4,22,7,True
9214931,949,4,25,5953,860457500,0,0,0,497.03,8,146994.06,24,2,9,8,True
9432033,553,1,25,5863,860457500,0,0,0,496.73,8,146497.33,17,1,17,9,True
9757099,553,1,30,8719,860457500,0,0,0,496.9,8,146000.43,17,0,7,9,True
9791766,1471,0,20,9729,860457500,0,0,0,496.93,5,145503.5,24,3,17,11,True
9903446,624,0,10,7152,969838140,1,0,0,509.82,0,652965.06,13,4,5,8,True
9999484,1158,0,30,7855,198328433,1,0,0,332.13,8,906682.22,20,3,20,11,True
9843429,1330,0,451,9011,527729205,0,0,0,722.0,7,600833.19,24,6,5,11,True
9921632,1290,0,30,9494,298813281,0,0,0,624.9,8,244238.82,11,3,17,11,True
9864567,246,0,451,2030,443427305,1,0,0,172.25,7,637743.37,23,6,10,11,True
9841695,1472,0,10,7968,514552667,1,0,0,701.19,0,692129.12,24,5,18,9,True
9961927,241,0,25,3455,988406718,0,0,0,950.35,8,126042.07,8,3,17,10,True
9989562,432,0,451,8441,943042597,1,0,0,758.85,7,529703.2,11,6,9,11,True
9819582,432,0,10,9170,578559870,1,0,0,464.93,6,302541.69,11,3,2,10,True
9958641,272,0,25,6660,451238135,1,0,0,518.96,8,399395.5,24,1,4,11,True
9628471,1293,0,10,4551,168229833,0,0,0,1198.81,0,315797.09,7,6,21,11,True
9946946,1494,0,25,4575,459905582,1,0,0,934.04,8,590293.45,18,5,22,11,True
9701112,1042,0,25,6124,470045409,0,0,0,989.07,8,188485.85,24,3,10,11,True
9664650,1489,0,25,3498,645465549,0,0,0,451.16,8,964263.16,18,2,9,10,True
9956651,1293,0,30,5279,607040900,0,0,0,762.9,8,635844.44,7,2,20,11,True
9979690,617,0,30,2362,214082706,0,0,0,222.98,8,769305.89,24,6,21,11,True
9888672,1432,0,451,4891,260907808,0,0,0,161.98,7,620414.92,5,5,23,11,True
9513623,1042,0,10,7468,658283009,1,0,0,613.18,0,825290.68,24,0,21,11,True
9965011,1489,0,451,3742,131225348,1,0,0,421.01,7,907581.12,18,4,9,11,True
9498166,432,0,25,6397,229831613,1,0,0,628.26,8,328693.1,11,3,7,11,True
9794867,1330,0,-1,8556,305428527,1,1,0,859.88,4,374471.17,24,2,23,11,True
9609721,246,0,30,1330,420335531,1,0,0,710.93,8,746848.59,23,4,2,10,True
9925215,1158,0,30,6774,926691384,1,0,0,289.93,8,735727.51,20,2,14,11,True
9973638,1293,0,-1,1740,673168203,1,1,0,636.14,4,260154.14,7,5,21,11,True
9492690,272,0,-1,7655,991618345,0,1,0,118.02,4,152623.52,24,2,10,11,True
9625710,1432,0,20,4262,712762401,0,0,0,334.03,5,666956.46,5,2,20,11,True
9909992,932,0,25,1608,754271714,1,0,0,339.92,8,102119.15,28,3,12,10,True
9847719,407,0,30,3233,283474675,1,0,0,268.69,8,446538.01,19,3,15,11,True
9657629,932,0,-1,5130,302066811,1,1,0,320.99,4,250020.01,28,6,22,9,True
9908345,432,0,25,9352,856512306,0,0,0,898.21,8,811365.98,11,6,4,11,True
9808904,241,0,-1,9363,769945989,1,1,0,183.02,4,118451.24,8,5,7,11,True
9972171,1494,0,-1,8855,983146468,1,1,0,913.08,1,75632.09,18,1,1,11,True
9994969,617,0,451,8827,821481548,0,0,0,1186.02,7,672781.18,24,3,20,10,True
9784480,246,0,-1,9866,925471139,0,1,0,281.03,1,857771.13,23,5,21,11,True
9999813,1293,0,10,5822,378413987,0,0,0,180.13,6,165379.71,7,2,11,10,True
9688121,1158,0,25,5407,850222340,0,0,0,1069.88,8,203101.47,20,3,11,11,True
9947051,494,0,25,4384,393037692,0,0,0,555.27,8,83267.48,5,3,9,11,True
9747297,878,0,20,4909,465388842,0,0,0,123.0,5,599967.99,24,0,21,11,True
9649772,272,0,30,2242,224496248,1,0,0,336.31,8,286468.11,24,3,7,11,True
9832461,1494,0,30,8405,368567122,0,0,0,233.86,8,196664.66,18,5,15,9,True
9964275,241,0,451,6695,583470867,0,0,0,440.0,7,161500.28,8,5,18,11,True
9667600,932,0,25,8952,975299233,1,0,0,115.05,8,497786.68,28,1,19,11,True
9948378,624,0,-1,4809,219605123,0,1,0,1037.78,4,38896.19,13,2,14,11,True
9915563,1293,0,25,9784,224394340,1,0,0,194.37,8,571166.52,7,0,7,11,True
9904055,932,0,20,9109,492690255,1,0,0,957.21,5,723315.6,28,0,4,11,True
9821308,624,0,451,2477,955491217,1,0,0,671.02,7,627967.29,13,2,6,11,True
9914470,932,0,25,6050,149392052,1,0,0,156.88,8,765717.41,28,3,21,11,True
9939879,489,0,451,4339,737586578,0,0,0,993.01,7,145312.25,24,2,1,11,True
9954532,494,0,30,8422,461945067,1,0,0,811.18,8,92638.38,5,2,0,11,False
9519449,1432,0,10,5834,939995366,0,0,0,940.88,6,439913.88,5,5,18,11,True
9799707,407,0,25,5956,936914118,1,0,0,923.12,8,707731.72,19,0,6,11,True
9839539,494,0,30,5690,251702665,0,0,0,932.1,8,236230.14,5,5,15,11,True
9969299,932,0,-1,5494,229072155,1,1,0,1043.99,4,216230.3,28,0,23,10,False
9616640,1472,0,25,8777,615394396,0,0,0,1107.05,8,742655.61,24,3,12,11,True
9959762,494,0,451,9804,897084963,0,0,0,379.21,7,537709.66,5,0,21,11,True
9889217,1158,0,25,7289,424132168,0,0,0,1014.06,8,560439.85,20,3,2,11,True
9988112,1494,0,20,2818,581429430,0,0,0,670.98,3,660417.34,18,2,4,11,True
9939997,878,0,10,5503,667437938,1,0,0,755.92,6,632936.64,24,4,16,11,True
9974957,1489,0,-1,6547,175070237,1,1,0,909.24,1,793564.45,18,6,20,11,True
9984336,272,0,30,7529,545445024,1,0,0,957.96,8,893316.94,24,4,4,9,True
9984336,272,0,451,3948,545445024,1,0,0,957.71,7,892359.23,24,1,13,9,True
9752029,1158,0,25,1127,989594700,0,0,0,255.1,8,836037.88,20,3,5,11,True
9947227,1472,0,30,8080,591496222,1,0,0,301.16,8,851353.79,24,3,3,11,True
9983631,1158,0,30,8217,826098432,0,0,0,462.17,8,968734.06,20,0,3,11,True
9688331,624,0,451,8515,501887306,0,0,0,937.31,7,664003.56,13,2,5,11,True
9679545,878,0,30,1608,923992975,0,0,0,362.94,8,895794.86,24,2,12,11,True
9856221,1472,0,25,3076,494569529,1,0,0,165.95,8,794443.21,24,0,10,11,True
9964000,1472,0,25,9143,857900962,1,0,0,321.82,8,632530.69,24,0,5,10,True
9915790,1293,0,25,1390,281641519,1,0,0,935.84,8,729726.34,7,5,1,10,True
9897377,1330,0,20,7396,856715242,1,0,0,979.27,5,376665.22,24,1,6,11,True
9921123,1290,0,451,2714,772933233,1,0,0,534.84,7,394803.5,11,2,20,10,True
9640873,617,0,-1,4213,515840267,1,1,0,207.33,4,182554.84,24,6,9,11,True
9764030,617,0,30,7114,310131389,1,0,0,209.14,8,159617.61,24,0,18,11,False
9996903,1042,0,10,1840,905135745,1,0,0,646.14,6,844837.47,24,5,17,11,True
9753141,431,0,20,1432,714467275,0,0,0,166.22,5,74670.77,21,4,21,10,True
9949672,1290,0,10,7365,467548052,0,0,0,199.1,6,102077.28,11,6,6,8,True
9811538,1042,0,451,7939,319835686,0,0,0,454.91,7,408251.85,24,5,16,11,True
9830438,407,0,25,4362,399634036,1,0,0,197.77,8,86610.57,19,6,22,9,True
9667434,1290,0,20,7592,486166303,1,0,0,657.78,3,308037.27,11,0,16,11,True
9630622,624,0,30,3890,164812928,1,0,0,118.83,8,786034.19,13,0,4,11,True
9860478,878,0,30,6015,279145349,1,0,0,606.96,8,858354.89,24,5,2,11,True
9553280,1330,0,-1,6108,474184902,1,1,0,1099.97,4,95114.38,24,0,13,8,True
9981274,489,0,451,3839,134830786,0,0,0,815.86,7,918360.83,24,6,22,9,True
9998955,432,0,451,5925,780398344,1,0,0,1022.2,7,468854.46,11,5,13,11,True
9892846,1290,0,10,7761,654709929,1,0,0,203.23,6,609197.71,11,2,14,11,True
9769601,407,0,10,1164,429842896,0,0,0,364.1,6,259447.55,19,0,21,10,True
9782582,1290,0,20,3484,409070399,1,0,0,420.07,3,568117.74,11,0,18,10,True
9925713,1494,0,20,1016,157128422,0,0,0,922.85,5,405535.95,18,1,21,10,True
9885355,932,0,25,5497,812115634,1,0,0,214.06,8,955269.82,28,3,1,11,True
9811643,1494,0,30,4164,818202388,1,0,0,496.96,8,346515.56,18,5,17,11,True
9945327,932,0,451,3348,508181338,1,0,0,694.16,7,593182.73,28,0,6,11,True
9946698,1290,0,10,8243,826489252,1,0,0,208.14,6,143297.81,11,4,19,10,True
9905886,431,0,30,5170,323334099,0,0,0,367.79,8,69600.36,21,4,4,9,True
9940713,1330,0,451,4591,459293283,0,0,0,689.04,7,870366.35,24,0,3,11,True
9804225,1158,0,10,4293,671273475,0,0,0,1143.78,0,571697.43,20,0,21,11,True
9898972,432,0,25,7580,758283706,0,0,0,1179.88,8,238376.92,11,2,4,11,True
9870535,246,0,30,9392,167165799,1,0,0,141.3,8,514099.23,23,0,5,7,True
9996827,494,0,30,8866,968196121,1,0,0,242.14,8,642901.56,5,1,0,10,True
9860541,1472,0,30,4789,817600628,1,0,0,212.92,8,944727.85,24,5,12,11,True
9951385,1290,0,451,4356,281169539,1,0,0,755.02,7,387726.45,11,2,19,11,True
9873039,489,0,-1,8575,594143142,1,1,0,306.11,4,296451.14,24,0,22,11,True
9843689,241,0,451,5452,705241788,0,0,0,532.1,7,859466.57,8,3,23,11,True
9899946,1158,0,451,7890,179629363,0,0,0,893.88,7,906892.76,20,6,10,11,True
9978324,1432,0,451,8798,588992915,0,0,0,553.8,7,402826.1,5,3,7,11,True
9976380,1472,0,451,4257,947936095,1,0,0,914.82,7,261492.56,24,0,2,11,True
9196206,1293,0,10,2074,359051066,0,0,0,370.07,0,908730.97,7,3,19,11,True
9751058,272,0,451,3594,689776833,1,0,0,226.94,7,607267.42,24,3,17,11,True
9602582,246,0,25,3086,335869622,1,0,0,694.05,8,369616.65,23,0,20,10,True
9936611,624,0,20,5516,419690295,1,0,0,257.06,5,823133.33,13,5,14,10,True
9971566,1158,0,451,2042,101648380,0,0,0,506.14,7,781788.23,20,5,11,11,True
9987338,272,0,451,6839,673793436,0,0,0,1036.98,7,381531.01,24,4,11,11,True
9950905,272,0,10,3993,398537125,0,0,0,480.07,0,524167.26,24,1,23,11,True
9893885,1472,0,-1,1898,347085095,1,2,0,1190.07,1,608079.63,24,1,12,11,True
9992114,1293,0,30,1030,748595117,1,0,0,514.8,8,844149.54,7,3,15,11,True
9855515,1489,0,10,6742,514625615,0,0,0,460.13,6,602040.37,18,4,21,10,True
9761154,1489,0,30,6088,417752575,1,0,0,729.94,8,909111.23,18,3,6,10,True
9839727,272,0,451,1536,852977477,0,0,0,108.09,7,540682.0,24,5,13,11,True
9780721,246,0,-1,5022,684918605,0,1,0,1117.81,4,80078.73,23,1,22,11,True
9941249,241,0,451,2772,239679825,0,0,0,321.86,7,85531.52,8,2,8,11,True
9975525,1494,0,10,8470,665447769,0,0,0,1184.13,6,642441.26,18,2,4,9,True
9667479,1042,0,451,8141,182067586,0,0,0,232.3,7,306963.45,24,2,12,11,True
9919191,617,0,-1,5405,293824996,1,1,0,867.87,4,46066.97,24,2,4,11,True
9939175,489,0,10,5885,275721560,0,0,0,745.41,6,458838.52,24,3,18,11,True
9890354,1158,0,20,2351,444503121,0,0,0,939.02,3,321662.79,20,2,20,10,True
9953580,617,0,20,5119,582462393,1,0,0,789.94,5,61871.53,24,2,2,10,True
9871882,407,0,-1,1414,658752573,0,1,0,1066.03,4,40016.18,19,6,4,11,True
9738968,1432,0,451,9275,126726893,1,0,0,951.84,7,351820.42,5,2,7,11,True
9778964,407,0,30,5219,126186952,0,0,0,312.95,8,303197.0,19,1,19,9,True
9843165,407,0,451,5491,997093996,1,0,0,196.97,7,855836.0,19,6,22,11,True
9767425,272,0,20,6700,774581627,0,0,0,208.72,5,224043.6,24,1,12,9,True
9934840,407,0,30,9169,454204702,0,0,0,1002.19,8,52981.41,19,3,19,11,True
9873708,432,0,10,4607,511249153,1,0,0,385.23,0,584037.37,11,6,10,10,True
9946613,624,0,451,2796,742779127,1,0,0,408.93,7,401830.43,13,3,1,11,True
9866602,494,0,30,2783,481348272,0,0,0,183.09,8,630965.41,5,5,0,8,True
9866602,494,0,451,7006,481348272,0,0,0,182.8,7,630599.64,5,5,23,11,True
9638647,1330,0,10,2519,129575167,0,0,0,883.32,6,761222.57,24,2,10,11,True
9870374,1432,0,20,4971,108703643,0,0,0,322.96,5,943820.57,5,0,14,11,True
9811011,1293,0,25,9833,826647770,0,0,0,756.74,8,267122.73,7,1,7,11,True
9914495,617,0,30,6463,461642181,1,0,0,358.1,8,655041.61,24,6,17,11,True
9906114,1158,0,451,7292,485922618,0,0,0,993.19,7,575164.74,20,3,12,11,True
9747130,272,0,-1,6882,379947848,0,1,0,913.9,4,296283.27,24,0,23,11,True
9797083,1158,0,451,8847,336424105,1,0,0,191.14,7,802255.69,20,1,16,11,True
9917315,494,0,451,5167,864966934,0,0,0,1085.13,7,811281.79,5,2,22,11,True
9937979,407,0,30,5329,549295747,0,0,0,1072.98,8,766683.55,19,5,4,11,True
9864044,489,0,451,1898,921592575,0,0,0,488.95,7,558013.53,24,6,16,11,True
9944333,1472,0,30,8495,889260016,1,0,0,222.09,8,420196.48,24,4,11,10,True
9970092,494,0,451,1186,114796321,0,0,0,908.85,7,91844.12,5,1,5,10,True
9227823,1330,0,10,8591,833021140,1,0,0,446.25,6,426122.09,24,1,0,10,True
9934492,1290,0,20,9247,122842879,0,0,0,143.97,5,626463.01,11,5,13,11,True
9715208,489,0,25,3390,564490757,1,0,0,900.15,8,200035.57,24,6,3,11,True
9964896,1290,0,25,1724,874166633,1,0,0,1186.78,8,929018.04,11,3,3,11,True
9974940,272,0,25,4085,904764417,1,0,0,103.71,8,653178.35,24,0,14,10,True
9777841,1494,0,25,3111,417837639,0,0,0,1099.91,8,399817.98,18,4,19,11,True
9581491,624,0,20,3267,705038233,1,0,0,389.71,3,972251.72,13,2,21,9,True
9719392,1330,0,451,6206,554619072,1,0,0,881.91,7,474913.21,24,2,23,10,True
9901697,617,0,-1,4430,327555465,0,1,0,294.99,4,937566.09,24,1,3,11,True
9836702,432,0,20,2387,172741405,0,0,0,148.87,5,234037.87,11,6,0,11,True
9616871,1432,0,30,9138,472498628,1,0,0,884.27,8,490234.66,5,4,17,11,True
9922294,272,0,451,9501,748801252,0,0,0,765.06,7,586098.63,24,6,7,11,True
9918357,1494,0,10,4182,402579063,0,0,0,251.7,6,121902.39,18,3,0,11,True
9512054,1432,0,25,5686,149172592,1,0,0,755.27,8,291698.37,5,2,16,11,True
9416108,489,0,-1,5530,646547518,0,1,0,273.59,1,701667.99,24,2,13,10,True
9910073,624,0,-1,7081,790362642,1,1,0,679.19,4,686073.03,13,4,17,11,True
9792408,1042,0,20,5404,429080525,0,0,0,456.93,5,778700.96,24,6,9,11,True
9941208,494,0,451,7498,278959044,1,0,0,1034.98,7,236175.05,5,0,16,11,True
9958692,431,0,10,4664,473667839,0,0,0,925.11,6,255426.3,21,6,14,11,True
9819668,489,0,30,5780,438874167,1,0,0,456.89,8,224050.04,24,5,0,11,True
9874879,1489,0,-1,6889,966289747,0,1,0,178.13,1,397817.05,18,2,15,11,True
9862969,1158,0,-1,5780,727589376,0,1,0,748.05,1,551779.62,20,6,8,11,True
9900032,1158,0,20,4369,358512450,1,0,0,472.95,5,661509.67,20,2,12,11,True
9920890,1042,0,451,8770,381038574,0,0,0,654.67,7,683827.58,24,2,16,11,True
9832251,1494,0,20,3853,233704457,1,0,0,1155.93,5,590056.96,18,1,4,11,True
9945737,1158,0,451,9016,222063183,1,0,0,898.92,7,77599.53,20,2,20,11,True
9899808,494,0,10,2207,353992071,0,0,0,1181.13,6,238027.84,5,6,16,9,True
9904152,1158,0,20,6405,518291536,0,0,0,242.89,3,942671.65,20,5,9,11,True
9789693,1290,0,-1,2907,685094766,1,1,0,206.8,4,200850.74,11,5,12,11,True
9745483,432,0,10,7015,714847198,1,0,0,428.03,6,328095.42,11,3,16,11,True
9857496,1290,0,-1,4398,222759098,0,1,0,247.9,1,366177.02,11,2,5,11,True
9697987,1472,0,-1,5385,664222450,0,1,0,759.19,1,371388.35,24,0,22,11,True
9948314,1042,0,451,7316,506756228,0,0,0,1050.01,7,269772.74,24,5,11,11,True
9879406,432,0,25,4441,415567499,1,0,0,995.94,8,631703.91,11,2,3,11,True
9896751,1472,0,451,9201,580695204,0,0,0,187.0,7,638664.68,24,1,23,11,True
9691571,432,0,451,2427,246195060,1,0,0,714.87,7,733253.19,11,1,10,11,True
9993562,617,0,25,7075,921817490,0,0,0,109.89,8,126483.96,24,0,11,11,True
9936420,494,0,30,7286,821667067,0,0,0,278.96,8,494822.71,5,2,12,11,True
9881484,1330,0,451,4905,714860804,0,0,0,354.03,7,293049.64,24,1,21,11,True
9885353,241,0,30,9164,357467085,0,0,0,820.07,8,870653.2,8,5,12,11,True
9898244,1432,0,10,8686,301802952,0,0,0,778.85,6,390880.1,5,3,19,11,True
9681101,1489,0,25,8287,389084217,1,0,0,922.82,8,732383.01,18,1,23,11,True
9911757,1042,0,20,1439,399118971,1,0,0,391.91,5,964629.49,24,6,5,11,True
9882478,431,0,25,9577,551549191,0,0,0,529.94,8,832035.28,21,4,0,11,True
9784105,1330,0,20,8305,433907826,0,0,0,764.15,3,274880.79,24,1,7,11,True
9831799,932,0,-1,1305,636193227,0,1,0,938.61,1,200385.45,28,3,1,11,True
9874241,878,0,-1,7589,540169508,1,2,0,814.08,4,227912.44,24,1,20,11,True
9757311,241,0,10,5650,518011847,1,0,0,268.94,6,407986.28,8,4,15,11,True
9924238,494,0,25,2029,216648812,1,0,0,221.94,8,667202.49,5,2,5,11,True
9844397,932,0,30,7338,245293792,1,0,0,842.83,8,167384.26,28,2,21,11,True
9949235,1489,0,10,9319,761493620,1,0,0,624.98,0,972845.51,18,5,16,11,True
9904339,932,0,30,6683,183806470,1,0,0,918.07,8,727820.21,28,5,8,11,True
9856262,1158,0,10,9395,241086269,0,0,0,819.11,6,826990.89,20,3,23,11,True
9270824,494,0,20,9673,177533105,0,0,0,1165.05,5,301624.37,5,2,9,10,False
9973301,241,0,10,4646,395948405,1,0,0,368.02,0,186807.41,8,4,3,11,False
9323723,1489,0,25,3026,233100711,0,0,0,154.97,8,939362.88,18,4,21,10,True
9935915,624,0,30,9795,583469447,0,0,0,255.09,8,693198.82,13,4,2,11,True
9899806,624,0,10,6767,924149802,1,0,0,880.96,6,530592.83,13,0,17,11,True
9886255,1432,0,-1,1743,400263609,0,1,0,316.22,4,698891.55,5,2,4,11,True
9967089,1042,0,30,3754,453828531,0,0,0,1059.8,8,320557.11,24,3,21,10,True
9998492,431,0,30,7582,229673964,1,0,0,996.01,8,118489.6,21,2,6,11,True
9879885,1042,0,25,6177,299665877,1,0,0,213.9,8,319287.86,24,2,0,11,True
9990985,1042,0,30,2826,631514992,0,0,0,361.0,8,294127.7,24,1,23,9,True
9812530,407,0,25,8520,974924620,0,0,0,926.86,8,618006.67,19,2,14,11,True
9791731,1472,0,-1,9869,783349011,0,1,0,328.21,1,84246.75,24,3,10,11,True
9784128,432,0,451,2956,129256009,0,0,0,985.08,7,324005.72,11,0,22,10,True
9837153,272,0,10,2420,607625738,1,0,0,820.08,0,858438.25,24,3,18,11,True
9861593,617,0,-1,8861,837100551,0,2,0,169.18,4,469849.17,24,6,0,11,True
9876415,1293,0,20,7910,971038539,0,0,0,679.07,3,260656.29,7,0,7,11,True
9748835,1489,0,25,2522,530354089,0,0,0,890.79,8,94906.55,18,2,9,11,True
9677801,432,0,-1,9240,385881305,1,1,0,723.84,4,165815.28,11,5,20,11,True
9945255,489,0,-1,8927,188529373,0,1,0,392.19,4,828305.99,24,4,23,11,True
9830593,1158,0,-1,7934,255630552,0,1,0,971.12,1,851183.96,20,3,17,11,True
9768968,1293,0,30,1722,687312210,1,0,0,595.96,8,534503.2,7,5,15,11,False
9943608,494,0,451,2325,724006352,1,0,0,679.03,7,512261.46,5,0,20,10,True
9951225,1293,0,451,8016,317973552,1,0,0,1022.91,7,327350.58,7,6,22,11,True
9863046,407,0,30,5195,341462907,0,0,0,957.91,8,487865.34,19,2,13,11,True
9554408,246,0,30,7520,505316441,1,0,0,1075.05,8,652308.07,23,0,7,10,False
9689431,617,0,30,3830,177214697,1,0,0,1038.09,8,183256.17,24,1,23,11,True
9992026,617,0,451,9400,392457070,0,0,0,776.7,7,855702.27,24,6,1,11,True
9985833,1158,0,20,2547,654678389,1,0,0,442.88,5,602661.11,20,3,21,10,True
9958809,1330,0,30,1367,664030201,0,0,0,160.98,8,587495.12,24,6,12,11,True
9980872,431,0,451,6063,128957034,1,0,0,311.87,7,544776.18,21,6,22,11,True
9960883,431,0,-1,7542,732430851,1,1,0,364.75,1,76964.18,21,2,22,11,True
9729706,241,0,20,5035,623884950,0,0,0,300.92,5,905517.49,8,5,10,10,True
9816292,1158,0,20,5153,167866073,0,0,0,356.92,5,131437.95,20,2,23,11,True
9934697,246,0,20,5477,220498387,1,0,0,1020.09,3,647876.71,23,2,21,11,True
9621569,1330,0,-1,4646,209967320,0,1,0,131.9,4,624296.9,24,2,8,10,True
9861543,1494,0,25,8857,188380748,1,0,0,383.2,8,854915.6,18,4,0,11,True
9737423,1290,0,451,2898,970635974,0,0,0,700.91,7,631438.08,11,3,0,9,True
9775999,432,0,10,1835,527502678,0,0,0,488.93,6,355871.64,11,1,11,11,True
9913822,1494,0,30,4320,718487679,1,0,0,666.97,8,972440.85,18,0,20,11,True
9313222,432,0,30,8999,553907874,0,0,0,1154.98,8,245441.39,11,3,15,11,True
9716366,1330,0,25,7097,346327652,1,0,0,974.11,8,762672.69,24,6,2,11,True
9913864,1472,0,451,5932,679557018,0,0,0,1061.13,7,851296.3,24,5,12,11,True
9931763,241,0,25,7975,726581709,1,0,0,492.47,8,600587.57,8,5,17,11,True
9972544,1293,0,451,9028,102589938,1,0,0,417.99,7,131983.1,7,6,10,11,True
9822863,1330,0,10,5711,817566561,0,0,0,304.06,6,655723.48,24,0,16,11,True
9707402,617,0,451,1362,371477862,1,0,0,1146.86,7,228418.56,24,3,6,11,True
9928152,432,0,20,6089,111858823,1,0,0,1085.92,5,672372.75,11,5,19,11,True
9805752,1293,0,-1,7580,584704269,0,1,0,373.19,4,361682.26,7,1,10,11,True
9665158,1489,0,-1,7511,306273803,1,1,0,308.3,4,304680.86,18,5,17,11,True
9809336,878,0,20,4989,394400803,0,0,0,288.84,3,397560.9,24,2,22,11,True
9557829,1290,0,10,5489,728541688,0,0,0,1056.87,6,830393.2,11,3,17,10,True
9769854,617,0,10,7379,479950290,0,0,0,930.01,0,354842.24,24,2,18,11,True
9976723,494,0,25,7482,841076598,0,0,0,1105.15,8,40977.31,5,4,18,8,True
9998367,1290,0,30,6764,850944455,1,0,0,1122.18,8,183726.91,11,5,21,11,True
9991041,932,0,451,1461,524606111,0,0,0,778.25,7,731000.57,28,6,9,11,True
9952043,878,0,-1,6011,404249033,1,1,0,294.94,4,641118.16,24,2,8,10,True
9549587,407,0,30,2888,574657739,1,0,0,1089.18,8,949505.93,19,3,18,11,True
9465083,1042,0,20,3594,201963321,0,0,0,1157.12,3,589847.41,24,0,3,10,True
9492744,1293,0,10,3163,570739912,0,0,0,483.72,6,641198.59,7,5,9,11,True
9963968,1432,0,30,1677,202812510,0,0,0,288.77,8,879468.69,5,4,12,11,True
9941971,272,0,10,6996,521934472,0,0,0,1119.93,0,534787.28,24,5,15,11,True
9826542,617,0,10,4559,763187731,0,0,0,366.02,6,861697.88,24,2,16,11,True
9989080,1489,0,-1,5495,818078390,0,1,0,202.1,1,664139.92,18,1,5,11,True
9903407,241,0,451,8609,823468214,1,0,0,212.01,7,532153.8,8,0,13,11,True
9820989,1042,0,20,1352,147314088,0,0,0,122.91,5,132505.84,24,5,14,11,True
9888949,432,0,-1,1563,611596623,0,1,0,712.12,4,718716.0,11,0,1,11,True
9920008,246,0,20,7795,197038936,0,0,0,1065.94,5,685360.57,23,0,10,9,True
9899751,1432,0,25,2967,243732473,1,0,0,466.86,8,403313.97,5,3,0,11,True
9947433,1489,0,451,6112,366001526,1,0,0,831.52,7,832647.48,18,2,19,11,True
9944322,246,0,25,1439,280721386,0,0,0,644.83,8,784400.1,23,2,23,11,True
9836923,1293,0,25,1154,903240159,0,0,0,997.83,8,954503.02,7,0,13,10,True
9901243,1432,0,451,7235,674536747,1,0,0,449.14,7,417378.22,5,0,14,11,True
9553373,432,0,30,8654,978801717,0,0,0,918.1,8,188331.96,11,1,3,10,True
9999636,1494,0,30,3448,949492860,1,0,0,968.42,8,643204.61,18,5,18,10,True
9908782,407,0,10,7696,674157653,0,0,0,1144.93,6,893772.75,19,4,23,11,True
9818268,932,0,25,3173,203482113,0,0,0,336.76,8,756183.32,28,2,8,11,True
9798398,617,0,451,7949,418757019,1,0,0,645.14,7,765344.91,24,2,17,11,True
9691649,624,0,25,2615,517930210,0,0,0,379.96,8,312205.57,13,6,23,11,True
9508453,489,0,30,3064,619523584,1,0,0,1069.16,8,788823.22,24,2,17,9,True
9991665,1432,0,451,5405,730775143,0,0,0,711.81,7,357239.26,5,2,9,11,True
9890641,1330,0,451,7384,697084905,0,0,0,982.67,7,275408.4,24,1,20,11,True
9957837,617,0,10,8698,138322584,1,0,0,502.81,6,770078.68,24,3,19,10,True
9589449,624,0,451,1131,329445955,1,0,0,602.97,7,227700.48,13,2,23,10,True
9518469,246,0,-1,4006,485841243,0,1,0,539.1,4,609093.88,23,4,4,11,True
9966241,1158,0,30,7241,281074905,1,0,0,300.03,8,431455.46,20,2,2,11,True
9320360,1158,0,451,6418,377490942,1,0,0,914.9,7,50569.93,20,1,12,11,True
9934130,1330,0,-1,4306,640012988,1,1,0,476.09,4,663457.29,24,6,1,11,True
9857301,1494,0,10,6824,836536926,0,0,0,1150.12,6,462491.0,18,6,17,11,True
9726689,1330,0,451,2305,590833996,1,0,0,1006.98,7,106674.45,24,3,23,11,True
9663822,272,0,20,3213,319177944,0,0,0,899.99,3,339872.54,24,0,2,11,True
9919626,1330,0,20,5493,401725586,1,0,0,482.21,3,551699.47,24,5,20,11,True
9993579,494,0,30,3392,986635933,0,0,0,1188.12,8,205784.14,5,2,0,10,True
9629748,431,0,25,9075,111722266,0,0,0,708.04,8,360121.54,21,0,3,9,True
9860499,617,0,25,5348,864850098,0,0,0,870.98,8,788029.69,24,6,21,11,True
9677271,878,0,30,3309,328916497,0,0,0,151.95,8,255552.43,24,3,12,10,True
9973169,431,0,25,3867,676100474,0,0,0,724.82,8,336533.29,21,6,16,10,True
9807137,407,0,10,3377,908893847,1,0,0,584.81,0,99936.38,19,1,10,11,True
9770726,932,0,20,5502,659781448,1,0,0,888.89,3,277890.04,28,0,9,11,True
9197682,246,0,30,5970,396964211,0,0,0,425.9,8,214982.26,23,3,1,11,True
9782385,617,0,20,2085,666942287,1,0,0,883.02,3,163633.1,24,4,6,11,True
9960405,1489,0,30,6065,436169573,0,0,0,745.15,8,939693.68,18,1,12,11,True
9823492,246,0,451,7642,705361847,1,0,0,982.82,7,620520.84,23,3,23,11,True
9792423,932,0,451,9849,341975582,0,0,0,1040.77,7,407535.3,28,2,2,11,True
9568721,1290,0,30,9261,989786011,1,0,0,341.97,8,464761.48,11,2,8,10,True
9810720,241,0,10,5740,900867232,0,0,0,592.97,6,218436.84,8,5,12,11,True
9884083,246,0,451,7092,542158484,1,0,0,428.93,7,819288.37,23,4,7,11,True
9907130,1472,0,20,6714,833240327,0,0,0,234.85,5,987433.19,24,2,22,11,True
9935461,489,0,25,8579,113952064,0,0,0,1122.82,8,382154.82,24,2,16,11,True
9967331,624,0,25,1684,767968568,0,0,0,909.77,8,30367.72,13,6,7,11,True
9956832,932,0,-1,7486,694568427,0,1,0,751.88,1,712752.99,28,0,7,11,True
9781291,1494,0,451,3853,761889942,1,0,0,981.81,7,39598.21,18,6,19,10,True
9499581,1494,0,20,8083,248884997,1,0,0,1085.97,5,555165.76,18,4,13,11,True
9942436,878,0,451,6397,237750619,0,0,0,1037.08,7,209606.54,24,1,12,11,True
9951787,624,0,25,3382,404719393,0,0,0,486.9,8,382256.92,13,3,3,11,True
9949236,494,0,451,8591,403539486,0,0,0,234.09,7,314295.88,5,1,5,11,True
9964081,494,0,20,4981,235846750,0,0,0,1165.77,3,395680.43,5,0,0,11,True
9970866,407,0,451,5511,171444948,1,0,0,224.1,7,348175.32,19,3,15,11,True
9980982,432,0,-1,5720,344425794,1,1,0,1034.82,4,835894.31,11,0,15,11,True
9977690,431,0,30,7574,577162787,1,0,0,485.14,8,671016.08,21,2,15,11,True
9967745,432,0,20,1229,186038039,0,0,0,882.2,5,263321.05,11,3,9,11,True
9636339,246,0,30,4911,970190581,0,0,0,849.12,8,209916.9,23,4,2,11,True
9974951,1472,0,451,1732,156494933,1,0,0,130.18,7,76658.01,24,6,12,11,True
9866857,1432,0,30,5594,283776205,1,0,0,424.86,8,276902.29,5,3,1,11,True
9992753,494,0,451,3865,138367808,0,0,0,1117.07,7,735386.1,5,4,13,11,True
9957441,932,0,451,4271,457130353,0,0,0,570.06,7,565756.57,28,3,12,10,False
9953709,1042,0,25,4235,960497101,0,0,0,858.11,8,444538.28,24,6,7,11,True
9941432,432,0,30,3506,676546369,1,0,0,308.01,8,855735.45,11,2,11,10,True
9887845,246,0,10,6117,869103866,0,0,0,953.36,0,396770.11,23,3,10,9,True
9873325,617,0,451,8027,967641916,1,0,0,180.62,7,341137.18,24,5,10,11,True
9953570,1293,0,-1,1171,256837934,1,1,0,1184.03,4,899472.27,7,0,16,11,True
9811664,272,0,451,7064,932558963,0,0,0,824.92,7,706078.98,24,1,2,11,True
9710903,1494,0,451,8404,327350261,1,0,0,1137.33,7,687364.85,18,1,13,11,True
9938972,624,0,30,4809,821753751,1,0,0,107.02,8,749280.59,13,4,5,11,True
9965874,624,0,30,7907,356278256,0,0,0,1086.82,8,546484.53,13,5,12,10,True
9635701,246,0,451,2651,989476871,0,0,0,1126.16,7,937143.21,23,5,20,9,True
9973111,624,0,10,3815,466594225,0,0,0,184.3,6,559298.35,13,6,4,11,True
9579870,431,0,20,3655,171969202,0,0,0,693.02,3,900018.05,21,3,5,11,True
9631924,624,0,-1,8624,566813666,0,1,0,746.1,4,706281.76,13,6,13,11,True
9783954,624,0,25,4731,684239232,1,0,0,1094.15,8,490998.18,13,2,11,11,True
9935452,407,0,25,4798,776377571,1,0,0,501.06,8,237294.48,19,0,16,11,True
9901631,1042,0,30,1160,106476302,1,0,0,930.82,8,369963.78,24,0,23,11,True
9915564,407,0,451,4953,412877762,0,0,0,810.12,7,202005.93,19,2,12,10,True
9923348,1472,0,30,6124,402009816,1,0,0,632.17,8,109844.29,24,4,12,11,True
9632591,431,0,25,8544,755433519,0,0,0,607.92,8,787229.92,21,6,13,10,True
9899410,272,0,30,2370,710989031,0,0,0,429.13,8,378797.52,24,4,9,11,True
9389887,932,0,10,8975,431046314,0,0,0,287.08,6,268114.38,28,6,7,11,True
9982546,489,0,10,6107,531019743,1,0,0,309.98,6,119951.77,24,6,20,11,True
9982818,241,0,451,4185,420262424,1,0,0,954.03,7,697422.22,8,6,0,11,True
9904245,246,0,451,9539,179210465,0,0,0,620.86,7,230289.27,23,3,10,10,False
9978429,878,0,451,8693,741885619,1,0,0,1042.09,7,696764.44,24,6,9,10,True
9832942,1042,0,25,2276,340716316,0,0,0,1128.07,8,621978.26,24,2,20,11,True
9973152,246,0,30,7835,770678867,1,0,0,975.08,8,801869.9,23,3,22,10,True
9333856,1158,0,20,8923,599163838,1,0,0,1064.83,5,399125.52,20,6,20,11,True
9888142,1290,0,10,2285,377896811,0,0,0,761.11,6,470750.9,11,1,15,11,True
9990592,432,0,-1,8221,918362177,0,1,0,501.18,4,389935.73,11,5,1,11,True
9739679,1042,0,10,3570,749599882,1,0,0,658.96,6,53672.41,24,1,14,10,True
9945421,494,0,25,2165,565761454,0,0,0,164.06,8,130860.99,5,4,10,11,True
9593757,407,0,-1,7719,692935008,0,1,0,681.98,1,290211.01,19,0,19,10,True
9437192,1330,0,20,6545,112657514,0,0,0,661.83,5,452888.8,24,3,12,10,True
9911203,241,0,10,8541,924583506,1,0,0,282.11,6,65920.0,8,5,20,11,True
9884466,1489,0,451,8792,272447412,1,0,0,1011.84,7,265909.05,18,5,16,11,True
9978960,878,0,30,7322,968766396,1,0,0,771.05,8,469484.62,24,2,14,11,True
9999450,1489,0,451,1528,889367375,1,0,0,141.83,7,917780.42,18,5,22,10,True
9797806,1290,0,25,6172,958252617,0,0,0,1043.1,8,121394.63,11,4,5,10,True
9960117,432,0,25,6731,324080282,0,0,0,587.0,8,175783.54,11,3,11,11,True
9996826,1293,0,10,3695,773274125,0,0,0,688.0,6,353346.71,7,2,11,11,True
9952019,1489,0,-1,5440,347544546,1,1,0,1126.2,1,259404.96,18,5,0,11,True
9982084,1494,0,451,8864,593799844,1,0,0,847.1,7,757185.31,18,1,9,10,True
9849986,1330,0,30,5418,247321389,1,0,0,845.01,8,803316.03,24,6,3,8,True
9982457,878,0,10,9538,177611200,1,0,0,887.06,6,285067.54,24,4,20,11,True
9895014,272,0,10,1934,147285147,0,0,0,872.9,6,460895.97,24,4,2,11,True
9871041,617,0,451,9096,531163525,1,0,0,670.77,7,849494.06,24,2,23,11,True
9868042,1432,0,-1,1083,829433057,0,1,0,1146.72,4,856926.43,5,5,6,11,True
9943034,272,0,451,2175,242499731,1,0,0,218.08,7,359131.76,24,5,5,11,True
9950421,1432,0,20,2005,341794334,1,0,0,608.33,5,289498.64,5,4,20,10,True
9632298,624,0,-1,2495,987098139,0,1,0,1165.79,1,861763.07,13,2,10,11,True
9992352,241,0,30,2672,651619074,0,0,0,750.0,8,310905.7,8,1,20,10,True
9999630,241,0,10,3994,842361684,1,0,0,480.74,6,945094.62,8,0,7,11,True
9972606,431,0,25,9394,384782220,0,0,0,590.82,8,608771.92,21,0,16,11,True
9588077,489,0,-1,8806,581929313,1,1,0,899.91,4,509429.49,24,1,20,11,True
9082499,1432,0,25,6988,975153253,1,0,0,231.87,8,669913.83,5,5,9,11,True
9980256,494,0,451,5983,595753034,1,0,0,875.19,7,385999.46,5,1,0,11,True
9987291,1042,0,10,3288,992042996,1,0,0,764.12,6,929148.1,24,1,17,11,True
9920181,878,0,451,2688,483027660,0,0,0,1106.06,7,753453.63,24,4,19,10,True
9962403,1432,0,20,1145,456450627,1,0,0,607.91,3,679521.5,5,0,2,11,True
9999809,246,0,20,5270,568684881,0,0,0,603.08,3,790408.94,23,5,19,10,True
9957593,878,0,451,7435,596081835,0,0,0,569.02,7,86543.35,24,0,5,10,True
9680627,272,0,10,1628,123611684,1,0,0,1145.18,6,658545.1,24,4,20,11,True
9949872,1472,0,25,2570,556760800,1,0,0,956.08,8,46470.63,24,6,7,11,True
9976268,1290,0,-1,5315,931754355,1,1,0,482.12,4,913825.64,11,4,14,11,True
9810712,1472,0,451,6038,964243678,0,0,0,852.13,7,823149.55,24,0,5,11,False
9987107,431,0,10,4886,976393135,0,0,0,355.15,0,103029.76,21,5,22,11,False
9759341,1432,0,451,8470,508124574,1,0,0,534.94,7,160634.48,5,3,16,11,False
9871920,431,0,30,7383,637434812,0,0,0,1051.13,8,826988.43,21,0,10,10,True
9999708,1472,0,451,1090,247822289,1,0,0,762.88,7,273584.9,24,1,4,11,True
9721123,1330,0,30,1920,230910910,1,0,0,270.25,8,855360.42,24,5,5,11,False
9836391,1330,0,25,5563,578900606,1,0,0,994.81,8,737042.16,24,2,1,10,True
9904842,494,0,30,1173,923039857,0,0,0,1067.99,8,761200.59,5,3,11,11,True
9913709,932,0,20,8396,550404976,1,0,0,623.12,5,595391.85,28,0,4,11,True
9905614,1489,0,25,1097,679813296,1,0,0,1181.2,8,921590.46,18,2,8,11,True
9163111,932,0,451,7483,713494989,1,0,0,591.85,7,668145.57,28,5,12,11,True
9983433,489,0,25,7569,175836677,1,0,0,941.81,8,329160.86,24,3,17,11,True
9983532,1432,0,25,1756,853518193,0,0,0,142.98,8,900337.74,5,4,3,9,True
9921531,241,0,10,5589,567438568,0,0,0,785.16,6,162512.24,8,2,17,11,True
9992019,1489,0,-1,4200,291071571,1,1,0,1133.92,4,51007.26,18,0,7,11,True
9969144,1042,0,451,3884,360934287,1,0,0,940.05,7,509654.63,24,4,11,9,True
9946982,1432,0,30,5754,776435697,0,0,0,1078.89,8,345572.2,5,2,21,11,True
9941598,624,0,-1,8468,193658755,0,1,0,357.24,4,879898.22,13,1,8,11,True
9918338,1330,0,20,7643,679234207,0,0,0,1156.93,5,37681.09,24,4,21,9,True
9793060,1290,0,20,9477,626057645,0,0,0,1033.05,5,377498.47,11,2,21,10,True
9648958,1494,0,25,4202,966746926,0,0,0,649.98,8,304444.77,18,3,7,11,True
9690070,431,0,-1,8474,400484308,1,2,0,1116.06,1,688099.33,21,1,1,11,True
9970485,1290,0,20,8280,748587402,1,0,0,268.87,5,322788.09,11,6,15,11,True
9260117,1330,0,10,2530,173275626,0,0,0,211.96,6,743542.24,24,6,18,11,True
9829008,1472,0,-1,3129,365145700,1,1,0,413.28,4,98780.44,24,2,5,11,True
9957397,617,0,20,5481,159878092,0,0,0,1163.13,5,504710.44,24,4,15,10,True
9528051,272,0,451,9196,506341585,0,0,0,300.93,7,316592.12,24,2,21,10,True
9969832,246,0,25,5219,583657772,1,0,0,464.94,8,495945.25,23,6,4,11,True
9854146,431,0,20,8031,245466948,1,0,0,355.96,5,409743.29,21,2,13,11,True
9843601,1290,0,10,5939,518655870,1,0,0,743.18,6,418175.42,11,5,23,11,True
9970599,246,0,451,2521,727185884,1,0,0,680.18,7,919277.79,23,1,23,11,True
9783987,407,0,10,9713,202802628,0,0,0,283.81,6,471865.16,19,5,12,11,True
9996887,241,0,451,8258,313395413,0,0,0,905.38,7,208713.68,8,4,10,10,True
9890257,1494,0,-1,6654,889412206,1,1,0,300.84,1,580462.4,18,2,13,11,True
9778132,1293,0,451,6459,426753339,0,0,0,606.99,7,468248.01,7,6,5,11,True
9999698,1290,0,451,1407,199529444,0,0,0,323.96,7,953603.9,11,6,11,11,True
9885123,1330,0,30,7167,734726720,0,0,0,710.1,8,853904.49,24,3,9,11,True
9664123,432,0,25,3955,266837317,0,0,0,1152.18,8,152666.36,11,3,12,10,True
9985071,431,0,20,4247,343352047,1,0,0,977.98,3,53738.58,21,6,14,10,True
9705581,431,0,10,5076,287387513,1,0,0,549.02,0,568772.11,21,3,11,11,True
9984771,1494,0,25,8095,559074906,1,0,0,1084.01,8,924764.41,18,3,21,11,True
9958725,1472,0,-1,4983,919161352,1,1,0,275.19,1,238045.25,24,1,9,11,True
9816345,431,0,451,8526,457913045,0,0,0,806.14,7,327384.07,21,1,20,10,True
9921767,1042,0,30,8834,257075370,0,0,0,105.98,8,858386.43,24,5,8,11,True
9915279,1290,0,25,9056,505495095,1,0,0,892.3,8,937767.2,11,0,11,10,True
9805783,1293,0,451,7160,959013235,1,0,0,1159.93,7,143726.06,7,3,11,11,True
9953576,617,0,10,6798,564897163,1,0,0,1164.2,6,396463.43,24,2,13,11,True
9969130,1330,0,451,7965,324841078,0,0,0,394.09,7,845793.63,24,2,7,11,True
9861614,1290,0,451,9022,397640070,0,0,0,816.91,7,676774.13,11,3,21,11,True
9988415,1432,0,10,6267,227934684,1,0,0,802.06,6,326322.14,5,3,15,10,True
9791783,624,0,30,2091,295598601,1,0,0,1178.98,8,827192.79,13,5,10,11,True
9673318,432,0,451,9287,365018790,0,0,0,507.07,7,508417.38,11,4,2,11,True
9888721,932,0,10,4096,675319524,0,0,0,220.24,6,968209.66,28,4,12,11,True
9942498,932,0,20,8035,363376202,1,0,0,241.98,5,474377.95,28,4,18,11,True
9694771,1042,0,451,4233,489160099,0,0,0,1097.82,7,509729.24,24,0,14,10,True
9670041,489,0,30,4825,477564302,1,0,0,739.99,8,768240.7,24,1,10,11,True
9915637,489,0,451,5077,891226415,1,0,0,778.01,7,439669.52,24,4,12,11,True
9772712,624,0,25,3115,441191378,0,0,0,208.88,8,435148.69,13,3,9,10,False
9934362,1494,0,10,3161,921374419,1,0,0,138.02,0,434362.04,18,2,11,11,True
9807921,878,0,25,1211,295185826,0,0,0,954.8,8,813741.79,24,3,23,11,True
9867180,1472,0,451,4149,188078162,1,0,0,204.83,7,474747.92,24,5,5,11,True
9950647,431,0,20,1802,830172112,0,0,0,613.23,5,949543.43,21,2,14,10,True
9975455,1489,0,10,4935,615571717,0,0,0,600.09,0,881879.23,18,2,9,11,True
9947999,932,0,451,9704,882201495,0,0,0,646.98,7,541570.15,28,0,10,11,True
9964455,407,0,451,8611,711156544,0,0,0,539.98,7,708499.0,19,1,6,11,True
9943832,1432,0,25,8549,413349313,0,0,0,1054.14,8,40399.14,5,5,2,11,True
9879785,617,0,30,5564,738565035,0,0,0,279.95,8,131989.81,24,0,1,11,True
9443677,932,0,-1,2860,829987627,1,1,0,548.15,1,169955.77,28,1,19,11,True
9928498,1489,0,25,6567,717565716,1,0,0,1072.17,8,471446.1,18,6,20,10,True
9880128,241,0,10,5154,970026543,0,0,0,715.03,0,676061.64,8,1,19,11,True
9876448,489,0,451,2859,497681935,0,0,0,138.93,7,800287.79,24,6,12,11,True
9903371,407,0,20,4377,260369955,1,0,0,209.96,5,515713.03,19,2,12,11,True
9855247,1290,0,10,7042,708399354,0,0,0,551.1,6,372728.03,11,0,0,11,True
9746512,1494,0,-1,3229,530567562,1,1,0,479.75,1,381789.4,18,3,0,10,True
9956860,878,0,20,9174,683729410,1,0,0,973.92,5,694427.04,24,3,9,11,True
9896465,1042,0,-1,4322,282627895,1,1,0,534.02,4,251051.88,24,0,20,11,True
9831434,617,0,10,3064,646562552,1,0,0,586.8,6,953977.32,24,5,8,11,True
9639043,1494,0,-1,8751,616728081,1,2,0,850.86,4,81584.05,18,2,4,11,True
9935391,241,0,30,6332,466665529,1,0,0,822.96,8,631913.78,8,4,9,11,True
9895669,1042,0,30,6126,673985502,0,0,0,1188.83,8,72403.24,24,1,6,11,True
9946305,241,0,10,9978,866915784,0,0,0,886.99,6,242938.7,8,0,10,11,True
9918242,1494,0,25,3759,514952760,0,0,0,552.95,8,561335.03,18,1,21,11,True
9475579,489,0,10,6418,837005116,1,0,0,861.04,0,397655.92,24,6,19,11,True
9909782,489,0,30,6811,309219333,1,0,0,508.13,8,179254.5,24,0,1,11,True
9888135,432,0,30,8490,432545246,1,0,0,246.27,8,623358.15,11,3,6,11,True
9991257,489,0,20,9891,248999712,1,0,0,357.76,3,578484.69,24,5,6,11,True
9922618,272,0,451,5232,427421458,1,0,0,1151.07,7,74376.11,24,3,1,10,True
9906247,1042,0,451,1124,730138880,1,0,0,581.98,7,336337.72,24,4,16,11,True
9813622,272,0,25,4867,340704103,0,0,0,1148.99,8,802444.6,24,1,3,11,True
9861340,432,0,20,9710,696404722,1,0,0,142.37,5,558117.11,11,3,1,8,True
9812926,1472,0,25,1101,268836182,1,0,0,302.03,8,481521.4,24,1,12,11,True
9300745,494,0,25,6300,621775423,1,0,0,400.95,8,686961.32,5,4,7,10,True
9604796,1158,0,-1,5279,771218220,0,1,0,546.04,4,770339.54,20,2,8,9,True
9903090,407,0,451,7173,362831868,1,0,0,184.18,7,757283.54,19,4,9,11,True
9940678,494,0,451,3819,327909007,1,0,0,614.94,7,293412.91,5,3,22,11,True
9890590,407,0,30,1845,148326112,0,0,0,521.9,8,257387.82,19,3,23,11,True
9945240,1158,0,30,4932,870737401,1,0,0,482.13,8,862227.99,20,2,5,11,True
9817050,617,0,30,9655,621252145,0,0,0,476.06,8,825874.32,24,0,4,10,True
9726123,272,0,-1,3723,201691274,0,2,0,1035.98,1,465662.33,24,3,6,11,True
9602116,246,0,-1,7249,901354850,1,1,0,257.87,4,941400.04,23,2,1,11,True
9864829,489,0,451,3762,680564094,1,0,0,855.07,7,192935.65,24,0,11,11,True
9998807,1158,0,20,7846,405490269,1,0,0,977.0,5,186106.58,20,1,21,11,True
9853032,1290,0,451,9857,424717250,1,0,0,891.95,7,123002.77,11,1,12,11,True
9976315,272,0,451,8702,488949538,1,0,0,1124.84,7,751936.25,24,4,9,11,True
9817481,1432,0,451,3563,550056777,1,0,0,209.84,7,222514.3,5,4,3,11,True
9977204,489,0,30,4100,402911113,0,0,0,290.87,8,214604.16,24,3,6,11,True
9946790,1293,0,20,6044,123100439,1,0,0,342.8,3,838673.25,7,6,19,11,True
9941585,431,0,451,2327,856444864,0,0,0,360.27,7,233055.0,21,2,16,11,True
9739847,932,0,-1,3710,383363365,1,1,0,964.79,4,348370.5,28,2,2,11,True
9918912,431,0,20,7142,431847786,1,0,0,1127.91,5,773730.47,21,2,16,11,True
9996887,1494,0,-1,1965,861605364,1,1,0,1082.86,4,497144.14,18,0,11,11,True
9813670,246,0,10,1321,670732003,1,0,0,570.32,0,521894.6,23,2,23,11,True
9994868,494,0,20,6438,764369448,0,0,0,1112.82,3,402650.47,5,2,10,9,True
9983516,617,0,25,4439,594578657,1,0,0,417.75,8,350241.78,24,5,23,11,True
9820707,272,0,451,8176,410869150,1,0,0,206.81,7,533732.61,24,0,23,11,True
9425533,624,0,-1,8572,279387932,1,1,0,683.05,4,243334.55,13,0,11,11,True
9727422,1042,0,10,8788,973142228,0,0,0,465.95,6,240467.45,24,0,7,11,True
9950810,432,0,30,8350,963925436,0,0,0,401.19,8,864823.91,11,5,15,11,True
9948325,624,0,30,3775,622626117,1,0,0,237.06,8,850023.77,13,2,5,11,True
9080506,1290,0,-1,4666,447240663,0,2,0,560.1,4,862174.3,11,2,10,10,True
9931935,432,0,451,2978,305426918,0,0,0,420.89,7,912220.1,11,5,10,11,True
9883331,241,0,451,2329,119625355,0,0,0,185.18,7,975570.14,8,0,0,11,True
9958672,1158,0,20,7674,956721481,0,0,0,1025.04,5,500987.24,20,6,14,11,True
9593171,1432,0,10,3023,658810916,1,0,0,319.85,6,259233.08,5,4,18,11,True
9861747,1293,0,10,8268,201244212,0,0,0,495.82,6,943377.02,7,0,18,11,True
9946391,241,0,451,4183,955496040,0,0,0,1058.08,7,887660.16,8,2,13,11,True
9840713,1330,0,30,9871,268329228,0,0,0,1124.94,8,456687.84,24,5,14,11,True
9239561,1489,0,30,1915,496227508,1,0,0,836.8,8,408443.3,18,6,8,11,True
9942557,878,0,25,6337,373712246,0,0,0,1035.91,8,824493.86,24,3,13,11,True
9947156,1042,0,25,7830,691299089,1,0,0,472.81,8,954284.61,24,3,2,11,True
9973212,1293,0,451,9828,852095186,0,0,0,421.02,7,654107.35,7,1,15,11,True
9996218,624,0,20,8127,540828728,0,0,0,612.88,3,265584.33,13,6,16,10,True
9992808,431,0,20,3565,816927907,1,0,0,503.15,5,978690.82,21,5,5,11,True
9985874,1158,0,-1,4057,625068913,0,1,0,655.87,1,107795.35,20,6,1,11,True
9999941,932,0,451,3448,111449910,1,0,0,882.84,7,75472.05,28,3,22,11,True
9902225,241,0,-1,2048,792962581,0,1,0,846.03,4,659160.85,8,2,20,11,True
9978327,246,0,-1,7780,296881602,0,1,0,479.99,4,842622.32,23,1,20,11,True
9763060,617,0,30,4855,785737963,0,0,0,568.87,8,277952.93,24,0,9,11,True
9754768,617,0,25,6355,439695388,1,0,0,1130.95,8,427213.27,24,5,3,11,True
9827399,431,0,25,7661,415496396,1,0,0,873.02,8,785652.32,21,2,12,11,True
9888467,932,0,10,7655,128792772,0,0,0,935.19,0,79591.28,28,4,6,11,True
9975288,246,0,-1,9750,518191198,0,1,0,931.92,4,714272.06,23,3,1,10,True
9672241,1290,0,451,8345,179936822,0,0,0,889.06,7,739434.0,11,3,13,10,True
9872487,246,0,451,5128,654155968,0,0,0,542.89,7,507105.72,23,1,6,11,True
9929778,432,0,-1,3134,830509311,1,1,0,660.24,4,579349.31,11,1,13,11,True
9817803,246,0,30,4127,255153350,1,0,0,824.72,8,654874.65,23,3,14,11,True
9983471,489,0,30,9871,720044336,1,0,0,528.04,8,51237.66,24,6,20,11,True
9788953,624,0,30,1485,117144351,1,0,0,536.11,8,191539.32,13,6,2,11,True
9459728,932,0,25,6718,855309763,0,0,0,610.1,8,343486.72,28,1,8,11,True
9962704,494,0,-1,9139,372131824,0,2,0,381.38,4,980851.2,5,1,16,11,True
9815742,1472,0,25,6569,174664493,0,0,0,1176.73,8,479557.3,24,1,8,11,True
9981603,494,0,25,6477,787931501,1,0,0,993.82,8,850773.75,5,0,23,11,False
9979903,932,0,25,4655,942167558,0,0,0,267.33,8,519759.05,28,4,4,10,True
9305828,494,0,25,9634,498979888,1,0,0,1098.66,8,487589.8,5,3,16,9,True
9637041,431,0,451,2036,509382539,1,0,0,998.94,7,130569.77,21,2,12,11,True
9957902,1042,0,451,3726,607657794,0,0,0,753.08,7,170023.25,24,5,3,11,False
9999568,1432,0,-1,7534,363251813,0,1,0,210.18,1,507085.86,5,5,14,11,True
9893988,1432,0,451,4574,491507054,1,0,0,1190.9,7,213681.66,5,3,18,11,True
9620659,1489,0,451,6762,736889665,0,0,0,1112.81,7,822610.32,18,6,17,11,False
9593875,407,0,25,7966,243016955,1,0,0,968.14,8,41589.51,19,1,4,11,True
9918480,489,0,10,5261,967485566,0,0,0,509.75,6,240250.62,24,5,15,11,True
9916335,489,0,451,6220,213012550,0,0,0,212.33,7,896221.5,24,2,1,11,True
9534188,407,0,25,9026,471492551,0,0,0,1033.08,8,269218.52,19,1,5,10,True
9916465,489,0,10,6950,951013974,1,0,0,236.65,0,816257.64,24,6,2,11,True
9969870,1472,0,25,5889,417330613,0,0,0,1143.0,8,547186.36,24,2,14,10,False
9921453,1472,0,30,1277,129979700,0,0,0,905.8,8,550262.19,24,4,14,11,True
9982400,1472,0,30,1666,529758209,1,0,0,1134.12,8,147852.03,24,6,8,11,True
9999515,272,0,451,5077,256997825,0,0,0,1095.26,7,574412.33,24,6,4,11,True
9933525,617,0,20,3430,985323970,1,0,0,602.93,5,716282.69,24,2,8,10,False
9962855,1042,0,451,8846,934231474,0,0,0,578.93,7,90265.01,24,0,2,11,True
9468141,1489,0,20,1745,949035958,1,0,0,722.98,5,710501.53,18,3,3,11,False
9915642,489,0,10,7178,159179437,0,0,0,739.94,6,860081.62,24,4,20,11,True
9987697,431,0,20,4974,204950471,0,0,0,213.76,3,856833.59,21,1,16,11,True
9965487,494,0,451,5008,418776351,1,0,0,127.03,7,354453.79,5,0,19,11,True
9900236,272,0,-1,8126,628239029,0,1,0,141.0,4,380754.89,24,5,16,11,True
9618038,241,0,-1,9762,485047679,1,1,0,1058.23,4,269002.9,8,4,16,11,True
9777336,1158,0,20,5913,568822861,1,0,0,384.33,5,537389.4,20,5,18,10,True
9946150,878,0,451,4783,114878881,1,0,0,301.81,7,200726.19,24,5,10,11,True
9691091,272,0,-1,1076,359855333,0,1,0,625.76,4,713355.47,24,1,15,11,True
9882049,431,0,30,3322,661294494,0,0,0,523.14,8,845456.15,21,5,18,11,True
9896579,878,0,451,8573,217703991,1,0,0,786.86,7,697777.76,24,1,22,11,True
9864823,489,0,25,2022,233726460,0,0,0,969.9,8,850592.17,24,2,15,11,True
9748727,246,0,-1,2826,357617827,0,1,0,564.07,4,730232.78,23,4,18,11,True
9958934,1489,0,451,4660,113666551,0,0,0,1026.88,7,546982.73,18,3,23,10,False
9920143,878,0,10,5113,765571752,0,0,0,1156.92,6,165364.26,24,4,4,11,True
9982939,407,0,25,2204,730611846,0,0,0,525.95,8,787396.54,19,0,9,11,True
9918922,241,0,30,1612,684764952,1,0,0,928.34,8,769305.04,8,3,13,11,True
9996620,1472,0,30,4273,459364252,0,0,0,907.95,8,705803.28,24,5,8,11,True
9719715,1042,0,30,4290,853086289,1,0,0,908.08,8,410599.18,24,6,4,9,True
9928880,1494,0,30,8340,132879023,0,0,0,481.85,8,429218.52,18,6,16,11,True
9980416,624,0,451,1690,598141203,1,0,0,628.07,7,247401.99,13,0,14,11,True
9854260,1290,0,20,4519,168141784,1,0,0,917.03,5,830900.29,11,2,2,11,True
9934022,1293,0,10,7374,468316659,1,0,0,478.17,6,378756.48,7,5,9,11,True
9491122,1042,0,10,9226,809031486,1,0,0,510.06,6,859358.07,24,5,15,9,True
9981354,1042,0,25,8624,224623414,0,0,0,101.89,8,297386.91,24,3,21,11,True
9904473,1432,0,20,8760,183026126,1,0,0,855.9,5,102781.23,5,4,8,10,True
9428285,1042,0,451,6394,588359116,1,0,0,398.97,7,800360.08,24,2,14,11,True
9786784,1330,0,451,6722,416701917,0,0,0,769.27,7,494277.98,24,4,22,11,True
9712595,494,0,20,9211,649224361,1,0,0,615.85,5,796641.97,5,4,2,11,True
9951495,241,0,10,4104,167036221,1,0,0,554.72,0,517447.94,8,3,2,11,True
9851670,1293,0,10,8410,709279006,1,0,0,1138.27,0,617470.73,7,3,23,11,True
9909425,432,0,20,3358,883619905,0,0,0,539.05,3,486828.06,11,6,17,10,True
9807652,932,0,25,9009,589801094,0,0,0,493.84,8,130983.81,28,1,21,10,True
9809044,1158,0,10,1638,397583634,1,0,0,445.19,6,251295.62,20,0,5,11,True
9944426,241,0,30,3580,178753471,0,0,0,964.12,8,391817.56,8,0,7,10,True
9838711,878,0,25,5038,821697781,1,0,0,583.72,8,100520.57,24,0,16,11,True
9993179,489,0,-1,8110,820320751,0,1,0,1096.26,4,324566.76,24,3,3,10,True
9797802,431,0,10,5937,493618293,1,0,0,626.97,6,432998.21,21,1,21,11,True
9961392,489,0,10,9488,370075089,0,0,0,466.9,0,516682.27,24,3,14,11,True
9965394,1432,0,10,2049,810027619,0,0,0,176.11,6,737336.88,5,2,3,11,True
9958872,432,0,30,2508,662630695,0,0,0,388.96,8,459925.96,11,3,9,11,True
9867323,272,0,30,4304,282565904,0,0,0,879.06,8,845274.91,24,0,0,11,True
9883463,624,0,-1,5940,313145901,0,1,0,298.5,1,567684.35,13,6,21,11,False
9947848,1293,0,10,1803,486840620,0,0,0,872.13,6,932384.15,7,1,19,11,True
9945568,624,0,451,3130,667781576,1,0,0,672.71,7,882358.19,13,0,12,11,True
9960107,624,0,10,2901,238851621,1,0,0,1020.92,6,630448.78,13,0,20,11,True
9967511,932,0,25,1357,264530503,1,0,0,512.95,8,137909.71,28,3,11,10,True
9978737,878,0,451,5710,650214627,1,0,0,1081.03,7,235928.52,24,2,22,11,True
9930885,1293,0,25,4222,626111495,0,0,0,415.98,8,510590.8,7,3,22,11,True
9856938,431,0,20,4937,913049567,1,0,0,344.11,5,529647.82,21,5,11,11,True
9874522,432,0,-1,6952,733108593,1,1,0,705.86,4,96797.97,11,4,19,11,True
9978110,246,0,20,8701,375595021,1,0,0,516.14,3,826161.24,23,6,1,11,True
9831174,1494,0,25,7232,476962367,1,0,0,655.01,8,478021.15,18,5,7,10,True
9939934,494,0,-1,3331,739648982,1,2,0,236.98,1,795559.92,5,2,10,11,True
9762535,878,0,-1,1198,356110300,1,1,0,1186.06,4,109055.64,24,1,17,11,True
9705971,1472,0,20,1074,981736567,1,0,0,688.78,5,620566.33,24,0,14,11,True
9128021,1489,0,451,8578,834912187,0,0,0,226.34,7,151194.6,18,4,12,11,True
9972755,1432,0,25,1963,881992474,0,0,0,881.97,8,513609.37,5,6,21,10,True
9909742,494,0,10,2191,952794669,0,0,0,627.89,0,279837.96,5,3,2,9,True
9920541,272,0,30,4998,729050654,0,0,0,756.06,8,693239.3,24,6,22,11,True
9941676,432,0,30,6116,638020573,0,0,0,1004.97,8,523908.98,11,0,3,11,True
9736305,1489,0,451,1362,211001165,0,0,0,721.89,7,786254.13,18,1,8,10,True
9808822,1494,0,20,7075,736927428,0,0,0,906.99,5,726536.67,18,2,18,11,True
9966646,1042,0,-1,9192,546844539,1,1,0,1049.9,4,849759.31,24,6,19,11,True
9925719,1330,0,451,2477,153472984,1,0,0,317.21,7,143765.89,24,6,4,11,True
9697229,1494,0,451,6235,273880071,0,0,0,840.68,7,572062.31,18,1,5,10,True
9759555,932,0,20,9221,576552229,1,0,0,347.89,5,77410.73,28,2,20,10,True
9644372,1472,0,451,8461,326420263,0,0,0,159.98,7,175878.84,24,4,23,11,True
9978292,272,0,-1,2863,168847159,0,2,0,1037.06,4,178740.09,24,6,11,10,True
9926402,246,0,25,8609,466915142,1,0,0,466.94,8,378623.32,23,5,18,11,True
9992211,246,0,30,9808,745962072,1,0,0,1157.88,8,711794.19,23,2,6,11,True
9981330,1472,0,20,6116,289249620,1,0,0,929.23,5,308310.85,24,5,8,11,True
9837177,494,0,20,4444,667131057,0,0,0,125.0,5,853789.88,5,1,18,11,True
9987076,1330,0,25,3604,782852627,1,0,0,386.14,8,487299.43,24,1,8,11,True
9964964,932,0,451,4057,999660534,1,0,0,713.92,7,360293.75,28,0,22,11,True
9929758,1158,0,30,1493,315864478,0,0,0,118.3,8,768122.2,20,5,13,11,True
9840222,272,0,30,5547,180587807,0,0,0,589.95,8,750501.35,24,3,1,11,True
9879098,1472,0,20,6421,716439202,0,0,0,946.79,3,453804.27,24,6,10,11,True
9597168,1489,0,10,3692,702890747,0,0,0,312.9,6,523660.0,18,1,21,11,True
9963416,1432,0,-1,8495,576464614,0,1,0,306.05,4,364882.18,5,0,13,11,True
9943133,1432,0,30,4652,753984993,1,0,0,805.62,8,646945.94,5,5,5,11,True
9467084,489,0,451,7111,785612871,0,0,0,318.25,7,823832.7,24,0,16,11,True
9978125,1290,0,-1,6650,800454494,1,1,0,1012.98,4,267034.83,11,4,16,10,True
9976290,1290,0,451,7625,241464203,1,0,0,672.97,7,303391.4,11,2,4,10,True
9664977,246,0,-1,8027,142776076,0,2,0,1049.08,1,249253.41,23,1,17,9,True
9552622,932,0,25,8623,731906429,1,0,0,378.01,8,540564.48,28,4,13,11,True
9973863,1158,0,-1,9336,505457889,1,1,0,1038.21,4,637376.66,20,0,1,11,True
9726718,1290,0,451,8500,569977786,0,0,0,253.05,7,484825.85,11,4,9,9,True
9749371,241,0,451,5289,296726164,0,0,0,253.77,7,801865.55,8,3,7,10,True
9923592,1472,0,30,1927,210562394,1,0,0,348.82,8,215456.58,24,1,13,11,True
9980573,1494,0,25,3086,645614101,0,0,0,951.98,8,641132.0,18,3,0,10,True
9945908,1290,0,25,5811,144633903,0,0,0,670.26,8,833653.51,11,2,11,11,True
9764276,431,0,30,4279,609997307,0,0,0,1103.97,8,145251.66,21,3,20,9,True
9895506,1489,0,10,7548,664765062,1,0,0,1088.0,0,516428.33,18,5,12,11,True
9914273,489,0,-1,9112,292408413,0,1,0,745.71,4,289527.67,24,5,17,11,True
9666429,878,0,451,2086,439911730,1,0,0,1114.08,7,414763.21,24,5,22,11,True
9936535,494,0,20,1063,311083835,1,0,0,612.82,5,134549.18,5,6,22,10,True
9955646,932,0,30,9288,473037261,1,0,0,834.02,8,891755.93,28,0,2,11,True
9996620,1472,0,10,6341,644904760,1,0,0,832.01,6,904214.54,24,6,2,11,True
9871629,878,0,10,2123,565907549,0,0,0,245.91,6,97202.81,24,1,13,11,True
9984577,241,0,30,1656,743725248,0,0,0,959.76,8,727138.63,8,6,2,11,True
9951586,1432,0,30,2056,382676735,1,0,0,1104.84,8,58343.02,5,5,15,11,True
9127559,1158,0,25,3601,706487512,0,0,0,980.12,8,290665.99,20,0,7,11,True
9992388,241,0,25,7987,404966438,0,0,0,806.15,8,411788.86,8,5,11,11,True
9961186,1494,0,30,6814,306334557,0,0,0,181.93,8,785149.66,18,2,18,11,True
9840301,489,0,20,3828,327391406,1,0,0,762.06,5,495434.99,24,5,16,11,True
9518736,432,0,451,4108,590693578,1,0,0,843.84,7,920648.34,11,4,13,11,True
9663102,1489,0,25,6615,188118633,0,0,0,781.11,8,413903.73,18,2,18,11,True
9687851,1489,0,451,8127,784296256,1,0,0,326.72,7,444333.31,18,2,0,11,True
9521603,878,0,451,3338,140659914,0,0,0,1124.97,7,586343.94,24,6,10,11,True
9945037,878,0,10,4407,499611655,1,0,0,430.8,6,819589.85,24,2,14,11,True
9953165,246,0,451,1702,405121370,1,0,0,1154.1,7,911460.51,23,3,3,11,True
9261215,1042,0,-1,7964,774732977,0,1,0,716.04,4,306709.02,24,1,21,11,True
9969898,1293,0,30,6758,298848722,0,0,0,1096.94,8,787634.88,7,0,18,11,True
9931705,272,0,30,4343,828055432,1,0,0,654.05,8,293562.78,24,1,10,10,True
9940803,407,0,-1,9655,507494025,1,2,0,224.95,4,758305.51,19,1,7,10,True
9825346,489,0,30,4131,460684713,0,0,0,500.22,8,274632.45,24,1,8,11,True
9867348,1432,0,25,4038,909552048,0,0,0,430.06,8,817267.1,5,5,20,11,True
9705905,878,0,25,6509,866008262,1,0,0,479.04,8,264714.76,24,6,9,11,True
9923429,489,0,451,2404,703136988,1,0,0,1059.99,7,203154.72,24,3,23,11,True
9704515,1489,0,451,3614,920814984,0,0,0,194.99,7,641470.4,18,2,0,11,True
9878021,407,0,-1,3624,588644472,0,1,0,235.97,1,858787.11,19,0,6,11,True
9985736,432,0,10,9990,287484291,1,0,0,377.05,0,933701.82,11,0,17,11,True
9508882,1290,0,25,5189,673057255,1,0,0,606.06,8,474618.2,11,2,1,10,True
9862072,617,0,451,8835,353511595,1,0,0,480.85,7,183095.63,24,0,10,11,True
9890808,407,0,451,9976,108083730,0,0,0,128.19,7,376381.93,19,0,15,11,True
9939874,1330,0,-1,1994,888966004,0,2,0,1090.91,4,724610.5,24,4,23,11,True
9734027,1290,0,20,2843,602408706,0,0,0,1173.81,3,20592.97,11,5,19,11,True
9915010,624,0,20,2103,483265191,1,0,0,154.86,3,828862.42,13,0,22,11,True
9988484,878,0,25,5479,163811167,0,0,0,1118.78,8,369764.2,24,4,9,10,True
9851082,624,0,451,7853,253533366,0,0,0,383.9,7,702045.47,13,1,17,11,True
9601883,494,0,20,2083,294921463,0,0,0,395.12,5,58067.54,5,2,23,11,True
9774491,241,0,-1,4462,333026073,0,1,0,299.96,4,924443.96,8,3,13,11,True
9948320,1472,0,30,9818,699190134,0,0,0,982.98,8,827027.55,24,1,3,11,True
9978888,1293,0,451,6289,398288192,0,0,0,905.17,7,186145.39,7,1,5,10,True
9980632,1494,0,20,3957,680005319,1,0,0,746.82,5,532551.55,18,5,1,11,True
9955157,1293,0,-1,6684,505946081,1,1,0,719.91,4,186644.74,7,3,6,11,True
9632816,241,0,20,9428,279698076,1,0,0,923.85,5,843703.63,8,6,15,11,True
9538585,1042,0,451,3470,711071753,1,0,0,315.98,7,180248.56,24,3,15,11,True
9976689,617,0,10,1336,235538404,0,0,0,512.18,6,39515.79,24,3,4,11,True
9753303,1330,0,451,6517,365039055,0,0,0,775.93,7,174618.06,24,5,5,11,True
9944363,241,0,10,7792,142727949,0,0,0,130.88,6,369062.97,8,2,20,11,True
9960608,624,0,30,5487,650967804,1,0,0,253.13,8,690937.42,13,5,23,11,True
9909886,494,0,10,1737,160991527,0,0,0,103.84,0,992024.44,5,2,3,11,True
9892339,431,0,20,6191,589825591,0,0,0,665.0,3,663566.88,21,4,13,10,True
9738616,1494,0,451,2430,113863171,0,0,0,798.87,7,29331.32,18,0,2,11,True
9823678,1330,0,30,9753,493866660,1,0,0,104.94,8,813699.03,24,6,5,11,False
9984406,407,0,25,9524,751624425,1,0,0,575.11,8,318196.72,19,0,10,11,True
9879216,407,0,30,3388,853427181,1,0,0,284.29,8,371143.19,19,2,1,11,True
9895226,1158,0,451,4480,685003976,1,0,0,870.98,7,100642.45,20,1,6,11,True
9734200,1158,0,25,3685,120653269,0,0,0,170.22,8,804495.08,20,4,1,11,True
9973011,246,0,451,2693,315250952,0,0,0,742.17,7,904569.04,23,6,14,11,True
9893667,432,0,10,5845,208889256,0,0,0,1047.97,6,958369.5,11,2,11,11,True
9979903,1158,0,10,4301,467092648,0,0,0,348.01,0,845115.08,20,3,6,11,True
9940072,246,0,20,8265,624970335,1,0,0,1022.85,5,349305.54,23,2,23,11,True
9970393,1158,0,451,6613,298056410,0,0,0,1008.08,7,525468.69,20,2,8,10,True
9796012,617,0,451,4721,189717612,1,0,0,190.94,7,890745.06,24,0,1,11,True
9885673,617,0,25,7982,680800937,0,0,0,867.84,8,911046.41,24,0,1,11,True
9985484,932,0,20,7143,608706088,0,0,0,466.02,3,538870.91,28,4,18,11,True
9940771,272,0,10,8616,655971405,0,0,0,957.12,6,572533.54,24,4,9,10,True
9967732,431,0,25,6610,305375831,0,0,0,519.16,8,345892.37,21,6,13,11,True
9968389,1330,0,25,8354,186200276,1,0,0,217.06,8,741308.9,24,6,10,11,False
9710288,241,0,451,2608,598568833,0,0,0,619.0,7,867215.12,8,0,19,11,True
9887975,1432,0,-1,4013,633690968,0,1,0,846.0,4,167289.16,5,1,18,11,True
9961911,241,0,30,1204,196155834,0,0,0,921.23,8,726442.53,8,3,11,11,True
9987082,932,0,451,8313,414035214,1,0,0,271.94,7,783458.56,28,5,10,10,True
9948046,272,0,451,1389,960126463,0,0,0,941.22,7,789931.6,24,5,2,11,True
9970046,407,0,10,9251,960540992,1,0,0,666.69,6,776292.49,19,1,9,11,True
9970839,624,0,451,3924,373769158,1,0,0,923.1,7,603978.67,13,4,12,11,True
9992220,431,0,25,9853,963548109,0,0,0,907.03,8,425238.41,21,0,4,10,True
9756133,1290,0,-1,4227,358837932,1,2,0,777.21,4,219044.29,11,2,3,11,True
9987890,1330,0,451,3734,615378682,1,0,0,538.83,7,894158.02,24,2,10,11,True
9968541,272,0,25,5638,875833352,0,0,0,425.12,8,948738.4,24,1,7,11,True
9675076,1494,0,10,7075,389989706,0,0,0,1034.08,6,314323.19,18,5,16,10,True
9974833,878,0,20,4638,897188633,0,0,0,144.98,3,421025.72,24,2,0,11,True
9811968,1489,0,10,8757,592340189,1,0,0,711.43,6,538801.31,18,2,7,10,True
9937094,272,0,25,7215,469987837,0,0,0,762.03,8,651653.19,24,0,9,11,True
9750441,878,0,30,7219,986872878,0,0,0,493.75,8,959858.76,24,3,10,10,True
9678061,878,0,451,2492,841138163,1,0,0,940.23,7,112016.49,24,4,1,10,True
9990210,624,0,-1,5492,141742574,0,1,0,141.17,4,915124.51,13,2,12,11,True
9992848,617,0,20,7126,891345584,1,0,0,584.06,5,79052.18,24,4,3,11,True
9992852,407,0,20,6729,607670112,1,0,0,820.11,5,508092.56,19,0,4,11,True
9952330,878,0,30,8537,621991980,1,0,0,835.95,8,684765.72,24,0,18,11,True
9909123,432,0,30,4055,473887976,1,0,0,738.24,8,144502.07,11,2,14,11,True
9861014,431,0,451,4518,184285368,0,0,0,1186.11,7,186368.81,21,5,15,11,True
9710137,1293,0,20,4456,874559244,0,0,0,870.03,5,215251.65,7,2,6,11,True
9654777,1330,0,30,3251,981420604,1,0,0,887.05,8,135558.48,24,6,20,11,True
9980135,1472,0,451,2398,435579419,0,0,0,1068.8,7,136205.24,24,6,9,11,True
9902002,617,0,451,7341,114024738,1,0,0,862.94,7,694737.58,24,2,20,11,True
9987437,489,0,451,3468,762233158,1,0,0,680.02,7,776280.74,24,2,20,10,True
9469077,407,0,20,2283,381701386,1,0,0,768.28,5,639243.5,19,5,21,11,True
9721604,246,0,25,8960,240574938,1,0,0,238.99,8,654418.17,23,4,12,11,True
9826278,1330,0,25,9769,288824037,1,0,0,483.88,8,749199.46,24,3,8,11,True
9976444,1494,0,30,7762,291763341,0,0,0,982.07,8,537326.01,18,2,16,10,True
9886026,1432,0,-1,4330,693751966,0,1,0,748.19,4,854679.32,5,0,13,11,True
9798286,1293,0,20,7731,655241852,1,0,0,184.95,5,191299.01,7,4,1,11,True
9835378,432,0,451,3676,151225850,0,0,0,791.77,7,188736.88,11,2,22,10,True
9986456,1293,0,10,2364,542768177,1,0,0,755.15,6,254140.54,7,4,17,11,True
9715735,624,0,20,8380,866714158,1,0,0,967.86,5,540547.6,13,4,1,11,True
9807281,246,0,20,9207,120119680,1,0,0,437.08,5,577780.93,23,5,19,10,True
9972999,407,0,25,9099,522451535,0,0,0,1002.11,8,324207.01,19,0,15,10,True
9408286,1293,0,25,8739,990966140,0,0,0,628.13,8,359261.76,7,3,10,11,True
9590417,1042,0,451,8018,170042476,1,0,0,547.91,7,56415.7,24,3,13,11,True
9950047,1472,0,30,4983,736588033,1,0,0,161.89,8,950009.45,24,5,21,11,True
9915674,1494,0,451,7120,702911350,1,0,0,376.25,7,101755.68,18,1,23,11,True
9917701,246,0,451,3518,795904222,1,0,0,905.21,7,284161.7,23,3,7,10,False
9949119,494,0,451,7000,439821858,0,0,0,927.04,7,667867.01,5,6,19,11,True
9690611,432,0,-1,4411,816990241,1,1,0,297.03,4,204449.22,11,5,16,11,True
9751522,1432,0,25,9943,524315718,1,0,0,520.75,8,675850.03,5,0,7,10,True
9845226,932,0,30,1289,910018828,0,0,0,503.8,8,966203.57,28,5,19,10,True
9981191,878,0,20,1433,311824637,1,0,0,102.94,3,596599.93,24,1,12,10,True
9938928,1290,0,10,7567,337325989,0,0,0,380.78,0,603558.5,11,2,4,10,True
9707972,407,0,451,4423,632930809,1,0,0,541.96,7,908174.81,19,0,5,11,True
9962724,1293,0,451,3509,449274487,0,0,0,729.13,7,738847.58,7,0,20,11,True
9909693,431,0,451,9306,779540433,0,0,0,955.85,7,31998.01,21,3,23,11,True
9793952,246,0,-1,3737,824297491,0,1,0,1127.77,1,331667.87,23,4,17,11,True
9921072,1494,0,451,6131,175275301,1,0,0,682.1,7,825413.11,18,6,0,11,True
9964279,1494,0,10,5978,348574133,1,0,0,896.01,6,347173.11,18,1,4,11,True
9892732,272,0,10,8982,299343792,0,0,0,136.78,6,673297.0,24,3,7,11,True
9799412,624,0,451,4774,898367812,1,0,0,843.86,7,595733.54,13,2,10,11,True
9826672,246,0,451,3353,956535833,0,0,0,759.25,7,489474.4,23,1,23,11,True
9210300,1290,0,25,1826,542584564,1,0,0,126.73,8,516118.87,11,0,5,10,True
9311832,407,0,451,1302,489186876,1,0,0,1032.82,7,467153.93,19,3,15,11,True
9452677,1158,0,25,3279,796480505,1,0,0,1195.8,8,129792.03,20,0,21,11,True
9933468,407,0,10,2961,809486661,1,0,0,142.03,6,873401.9,19,4,11,9,True
9642868,432,0,10,1592,458865581,0,0,0,460.13,6,786726.67,11,5,16,9,True
9918867,1489,0,-1,8826,402035928,0,1,0,234.01,4,913123.79,18,1,7,11,True
9380191,407,0,451,3550,881872889,0,0,0,423.99,7,613086.4,19,1,3,10,True
9627541,1489,0,-1,5221,248434269,0,1,0,193.16,4,83583.56,18,0,16,10,True
9997113,489,0,451,6552,390520369,0,0,0,984.77,7,38953.39,24,6,18,11,True
9840040,407,0,451,4605,828601668,0,0,0,917.95,7,449718.8,19,4,10,11,True
9696405,878,0,20,5623,193478786,0,0,0,399.86,3,510999.07,24,4,4,9,True
9952364,1472,0,-1,2097,231469314,1,1,0,193.33,4,705986.68,24,6,0,10,True
9796006,272,0,-1,1262,572024218,0,2,0,526.93,4,645770.44,24,5,13,11,True
9999425,1330,0,-1,7724,386896706,0,2,0,904.03,4,710985.19,24,5,0,10,True
9935573,1290,0,-1,8064,901573513,0,1,0,542.06,4,144937.38,11,1,15,11,True
9729748,1042,0,25,4729,522241840,0,0,0,418.73,8,191139.79,24,0,12,11,True
9632178,1489,0,25,4650,475369946,1,0,0,515.11,8,235235.58,18,3,8,9,True
9901354,241,0,451,1367,374027133,0,0,0,1078.13,7,624883.69,8,0,13,11,True
9952201,932,0,451,8290,284347475,1,0,0,657.24,7,967576.19,28,5,6,11,True
9950686,241,0,451,8864,502788332,1,0,0,688.94,7,725718.27,8,5,18,11,True
9816040,1290,0,10,1801,256161606,0,0,0,617.3,6,666175.3,11,5,22,10,True
9710705,431,0,451,8800,696064152,0,0,0,1182.75,7,751244.19,21,1,11,11,True
9819770,1290,0,451,1982,316136270,1,0,0,383.94,7,270102.71,11,2,11,10,True
9883321,1472,0,-1,7568,475293055,0,1,0,793.24,4,947393.28,24,5,1,11,True
9869512,1330,0,30,8672,760774347,0,0,0,893.97,8,636664.13,24,0,12,11,True
9975242,241,0,-1,3132,668775790,0,1,0,807.44,4,68016.83,8,3,12,10,True
9991786,878,0,30,4887,704648707,1,0,0,987.98,8,889349.89,24,3,3,11,True
9915466,431,0,30,1845,883176016,0,0,0,121.81,8,673375.22,21,4,12,11,True
9816526,1489,0,20,1759,981768769,0,0,0,126.04,3,346564.52,18,3,0,11,True
9978659,1330,0,20,2073,512331465,0,0,0,906.99,3,330519.51,24,5,4,11,True
9235125,241,0,10,2124,220432344,1,0,0,490.21,6,266480.79,8,4,10,11,True
9898625,494,0,25,1671,682986333,1,0,0,1083.99,8,893163.52,5,6,17,9,True
9989003,494,0,20,7476,538406799,1,0,0,394.02,5,300005.23,5,5,14,11,True
9930223,1330,0,451,4876,964163162,0,0,0,303.85,7,555628.75,24,6,7,11,True
9883165,932,0,30,5932,778133517,0,0,0,623.94,8,832343.18,28,3,20,11,True
9303467,1293,0,30,3761,801384543,0,0,0,1131.05,8,379440.07,7,2,6,11,True
9901279,1290,0,-1,3850,584520677,1,1,0,861.94,4,626570.68,11,0,22,10,True
9870117,432,0,-1,3401,400668031,0,1,0,390.19,4,670773.0,11,3,19,10,True
9901818,489,0,10,4434,348889955,0,0,0,156.91,6,444866.14,24,3,12,11,True
9908768,494,0,30,1697,516090826,1,0,0,1008.86,8,126319.23,5,2,0,11,True
9992651,431,0,451,5711,265025860,0,0,0,587.71,7,746568.51,21,1,8,11,True
9895511,878,0,30,6325,724193028,1,0,0,712.94,8,525594.71,24,1,7,11,True
9795519,617,0,-1,8756,703497824,1,1,0,809.09,4,98117.51,24,2,4,11,True
9989340,407,0,30,3045,301324542,1,0,0,1033.89,8,126276.34,19,3,12,11,True
9774802,1158,0,25,9869,584035289,0,0,0,1033.81,8,411181.84,20,6,15,11,True
9890609,878,0,10,5089,517195670,1,0,0,846.95,6,913082.25,24,1,0,10,True
9774391,1042,0,25,9989,412833308,1,0,0,1110.11,8,713159.99,24,2,4,11,True
9669828,878,0,30,8297,253020703,1,0,0,409.07,8,957219.89,24,6,6,10,False
9679961,617,0,20,7509,403085721,0,0,0,556.91,3,962980.97,24,0,18,11,True
9923275,1494,0,451,5987,212991804,0,0,0,734.91,7,54822.17,18,5,5,11,True
9728378,1494,0,-1,1565,496919397,1,1,0,371.03,4,766179.06,18,0,18,11,True
9959304,617,0,20,8140,250329786,0,0,0,744.08,3,537235.41,24,6,23,11,True
9924207,1472,0,30,5722,388241689,1,0,0,503.15,8,291740.43,24,1,13,11,True
9881360,878,0,30,2184,582783010,0,0,0,294.11,8,205561.06,24,4,16,11,False
9984649,1293,0,10,7464,339231358,1,0,0,1023.79,6,521277.28,7,1,13,11,True
9956459,241,0,20,2188,541574267,1,0,0,1180.15,3,943137.23,8,4,1,11,True
9895723,494,0,30,8793,703914321,1,0,0,1169.95,8,413125.28,5,3,9,11,True
9949324,624,0,20,5533,841284706,0,0,0,121.82,3,566211.63,13,0,16,11,True
9944818,489,0,451,3868,514990118,1,0,0,660.95,7,727234.28,24,6,19,11,True
9969457,878,0,451,1554,418851665,1,0,0,898.05,7,957783.48,24,1,15,10,True
9934705,241,0,-1,2110,254699086,1,1,0,1161.08,4,366452.95,8,3,13,11,False
9684714,1432,0,451,4843,607981614,0,0,0,449.15,7,374570.97,5,5,21,11,True
9513156,1489,0,20,6460,327114013,1,0,0,394.93,5,349280.85,18,6,18,11,True
9969988,1330,0,451,1801,918561795,0,0,0,1087.99,7,565321.94,24,3,3,10,True
9709214,1158,0,25,4549,747551031,0,0,0,674.07,8,693163.9,20,1,4,10,True
9838783,431,0,451,6697,150978640,0,0,0,678.2,7,846321.11,21,1,9,11,True
9864167,1432,0,10,6537,171487032,1,0,0,1142.69,6,425827.43,5,1,13,10,True
9914493,1293,0,20,2928,241679527,1,0,0,875.87,5,669897.72,7,1,4,10,True
9784650,1494,0,10,4258,785077432,0,0,0,433.93,6,144601.62,18,2,13,11,True
9917379,878,0,30,7189,789035154,0,0,0,675.1,8,83470.44,24,3,21,11,True
9933786,1158,0,451,5505,970437056,0,0,0,236.07,7,699768.05,20,3,18,11,True
9951577,624,0,-1,5874,178679032,1,1,0,628.93,4,466165.5,13,6,7,10,True
9798988,489,0,10,7171,983813572,1,0,0,1060.66,0,741877.58,24,1,6,10,True
9816873,1432,0,451,1992,430766543,0,0,0,755.98,7,746810.53,5,3,9,11,True
9793583,1158,0,10,1096,901505935,0,0,0,596.04,6,411461.46,20,5,3,10,True
9993958,1290,0,451,4933,101814879,0,0,0,385.0,7,89117.57,11,4,17,11,True
9809155,932,0,30,5075,963281221,1,0,0,839.86,8,217192.1,28,1,2,11,True
9913087,272,0,-1,8632,807400201,1,2,0,557.84,4,880736.34,24,5,10,10,True
9641664,617,0,451,2302,951062689,0,0,0,785.01,7,417058.45,24,6,6,11,True
9985960,1489,0,20,6539,581175235,1,0,0,777.78,5,574699.23,18,3,8,11,True
9880135,272,0,451,1217,588156384,1,0,0,898.79,7,845494.24,24,3,2,11,True
9959740,1293,0,451,5553,521229176,0,0,0,240.15,7,565778.53,7,0,22,11,True
9999730,932,0,30,1523,400417528,0,0,0,469.93,8,971398.01,28,1,22,11,True
9820230,489,0,30,2962,417914526,0,0,0,176.93,8,302831.19,24,4,6,11,True
9592769,1489,0,451,6095,156921566,0,0,0,765.14,7,270965.17,18,3,11,11,True
9745024,1432,0,451,5306,320794190,1,0,0,1184.09,7,290713.45,5,6,1,9,True
9690475,241,0,10,2514,441416548,1,0,0,486.87,0,397140.68,8,0,10,11,True
9730388,1293,0,451,3693,180567478,0,0,0,325.9,7,518658.65,7,5,21,10,True
9822534,932,0,30,3292,323237454,0,0,0,420.4,8,719174.54,28,6,2,11,False
9928839,1472,0,451,9474,760910214,1,0,0,388.14,7,513538.46,24,6,22,11,True
9078099,1293,0,451,9681,728575156,1,0,0,114.15,7,123017.76,7,1,14,11,True
9713811,407,0,20,3009,225348021,1,0,0,984.88,5,333640.29,19,6,19,11,False
9853658,1489,0,-1,7748,556929405,1,1,0,971.01,4,636489.31,18,5,5,11,True
9733345,617,0,451,4138,277371852,1,0,0,395.78,7,125852.19,24,4,20,11,True
9945927,1042,0,30,5374,242748823,1,0,0,571.27,8,829265.52,24,6,22,11,True
9933041,1472,0,10,1343,306208038,1,0,0,248.05,6,822101.3,24,3,18,11,True
9780565,1494,0,20,2874,438391984,0,0,0,458.96,5,543072.74,18,2,2,10,True
9959210,1432,0,-1,9515,998717557,0,1,0,613.35,4,840522.21,5,2,8,11,True
9975993,1293,0,25,1419,410328814,1,0,0,1107.99,8,271294.19,7,2,0,11,True
9923793,1042,0,451,1327,572375593,1,0,0,1157.01,7,125250.29,24,3,2,11,True
9154155,878,0,10,6546,954571357,1,0,0,972.91,6,343178.88,24,1,0,10,True
9973662,617,0,30,9086,722863944,0,0,0,1037.0,8,952411.31,24,0,10,11,True
9873201,1472,0,20,2163,113138243,1,0,0,249.74,5,381831.99,24,3,7,11,True
9783199,1489,0,10,4058,459383836,0,0,0,547.91,0,316327.1,18,1,3,10,True
9753742,1158,0,-1,7339,542488442,1,1,0,810.95,1,488812.08,20,4,2,11,True
9976061,1042,0,30,7019,124638020,1,0,0,743.12,8,703615.3,24,2,19,11,True
9809439,489,0,25,4715,666044189,0,0,0,845.06,8,223075.58,24,3,7,11,True
9547653,432,0,451,8773,493853809,0,0,0,449.83,7,99236.41,11,5,9,11,True
9505855,494,0,30,3810,582752937,0,0,0,1096.13,8,854206.17,5,3,21,10,False
9991926,1330,0,10,6148,945037981,0,0,0,819.0,0,463047.71,24,2,10,10,True
9940759,1042,0,30,5208,880902812,1,0,0,237.02,8,861479.59,24,1,5,9,True
9996237,246,0,25,3536,847854782,0,0,0,1121.93,8,309452.58,23,1,21,10,True
9830704,1158,0,10,7305,143660501,0,0,0,686.97,6,290266.72,20,1,7,10,True
9916410,489,0,-1,2255,863733647,0,1,0,696.99,1,772751.62,24,3,9,11,True
9685753,272,0,451,6828,105878057,1,0,0,1048.88,7,430170.83,24,6,19,10,True
9338093,1293,0,25,5007,147078192,0,0,0,490.04,8,182447.88,7,4,15,11,True
9898529,932,0,-1,6809,171586193,0,1,0,378.78,1,836832.61,28,5,12,11,True
9972784,272,0,451,4925,971886936,1,0,0,1059.84,7,34958.68,24,2,13,11,True
9847180,624,0,-1,5359,394801746,1,1,0,535.04,1,937050.83,13,6,2,11,True
9937679,624,0,-1,4449,724547962,1,1,0,309.95,1,788346.47,13,6,10,11,True
9845294,1293,0,25,8744,932383991,0,0,0,909.98,8,763551.14,7,4,1,11,True
9556885,407,0,-1,5962,182676943,1,1,0,597.71,1,849249.3,19,5,12,11,True
9935723,246,0,451,6359,598582551,0,0,0,147.18,7,362793.19,23,3,5,11,True
9957266,617,0,451,1804,498719439,1,0,0,234.09,7,680695.41,24,4,11,11,True
9975142,431,0,25,8160,942296868,0,0,0,675.01,8,100637.88,21,2,20,11,True
9970259,1432,0,10,8930,961067216,1,0,0,152.07,6,525221.15,5,0,19,11,True
9883193,407,0,451,4474,319941461,0,0,0,566.87,7,612861.81,19,6,16,11,True
9919604,431,0,25,3193,526745565,0,0,0,521.37,8,183309.13,21,0,9,10,False
9902369,431,0,10,7071,364757022,0,0,0,618.99,0,337518.88,21,2,3,11,True
9939711,1042,0,10,3686,828308371,1,0,0,956.15,6,115192.93,24,0,14,11,True
9876313,494,0,25,7602,191845802,0,0,0,1194.06,8,128429.85,5,5,22,11,True
9791767,1489,0,20,9729,860457500,0,0,0,496.93,5,140533.32,18,3,17,11,True
